ID,Location_ID,Sensing_Date,HourDay,Direction_1,Direction_2,Total_of_Directions,Sensor_Name,Location
482320240214,48,2024-02-14,23,63,74,137,QVMQ_T,"-37.80631581, 144.95866697"
30620250806,30,2025-08-06,6,26,18,44,Lon189_T,"-37.8112185, 144.96656806"
201920250525,20,2025-05-25,19,367,509,876,LtB170_T,"-37.81172914, 144.9682466"
251320240509,25,2024-05-09,13,686,608,1294,MCEC_T,"-37.82401776, 144.95604426"
251220240518,25,2024-05-18,12,719,734,1453,MCEC_T,"-37.82401776, 144.95604426"
139820240809,139,2024-08-09,8,19,264,283,Signal1647_T,"-37.81959923, 144.9632832"
142520240525,142,2024-05-25,5,6,1,7,Hammer1584_T,"-37.81970749, 144.96795734"
1612220250510,161,2025-05-10,22,0,21,21,BirArt1109_T,"-37.81851276, 144.97131336"
662220241112,66,2024-11-12,22,435,259,694,QVN_T,"-37.81057846, 144.96444294"
662220250414,66,2025-04-14,22,429,149,578,QVN_T,"-37.81057846, 144.96444294"
661920241101,66,2024-11-01,19,1328,1323,2651,QVN_T,"-37.81057846, 144.96444294"
61920240617,6,2024-06-17,19,454,539,993,FliS_T,"-37.81911705, 144.96558255"
39920240314,39,2024-03-14,9,163,174,337,AlfPl_T,"-37.81379749, 144.96995745"
752020250718,75,2025-07-18,20,9,16,25,SprFli_T,"-37.81515276, 144.97467661"
772120240314,77,2024-03-14,21,37,33,70,HarEsP_T,"-37.81441438, 144.94433026"
591920250225,59,2025-02-25,19,226,218,444,RMIT_T,"-37.80825648, 144.96304859"
42920250811,42,2025-08-11,9,291,106,397,UM1_T,"-37.80008566, 144.96386412"
71320240828,71,2024-08-28,3,3,2,5,WestWP_T,"-37.81235775, 144.97136962"
311320240921,31,2024-09-21,13,242,178,420,Lyg161_T,"-37.80169681, 144.96658911"
28320240319,28,2024-03-19,3,3,23,26,VAC_T,"-37.82129925, 144.96879309"
311320250217,31,2025-02-17,13,181,150,331,Lyg161_T,"-37.80169681, 144.96658911"
361520231125,36,2023-11-25,15,145,169,314,Que85_T,"-37.81652527, 144.96121062"
37320231210,37,2023-12-10,3,4,3,7,Lyg260_T,"-37.80107122, 144.96704554"
43920250922,43,2025-09-22,9,171,64,235,UM2_T,"-37.79844526, 144.96411782"
452220240913,45,2024-09-13,22,378,461,839,Swa148_T,"-37.81414075, 144.96609379"
21520231102,21,2023-11-02,5,16,16,32,Bourke155_T,"-37.81267313, 144.96788288"
131420240311,131,2024-03-11,4,4,39,43,King2_T,"-37.82009057, 144.95758725"
1341320240126,134,2024-01-26,13,339,346,685,Spen201_T,"-37.81694221, 144.95303935"
135120231206,135,2023-12-06,1,14,34,48,Spen161_T,"-37.8172861, 144.95319102"
107820241217,107,2024-12-17,8,57,207,264,280Will_T,"-37.81246271, 144.95690188"
1331320241029,133,2024-10-29,13,609,549,1158,Spen229_T,"-37.81531435, 144.95227769"
118420250927,118,2025-09-27,4,2,0,2,Fli114C_T,"-37.81632783, 144.97090512"
1081120250122,108,2025-01-22,11,242,278,520,261Will_T,"-37.81295822, 144.95678789"
402320231214,40,2023-12-14,23,51,17,68,Spr201_T,"-37.80999341, 144.97227587"
4420250809,4,2025-08-09,4,42,39,81,Swa123_T,"-37.81487988, 144.9660878"
70020240124,70,2024-01-24,0,8,4,12,Errol20_T,"-37.80456984, 144.94946228"
412320231226,41,2023-12-26,23,337,441,778,Swa31,"-37.81668634, 144.96689733"
77420250618,77,2025-06-18,4,2,1,3,HarEsP_T,"-37.81441438, 144.94433026"
42220250828,42,2025-08-28,2,6,4,10,UM1_T,"-37.80008566, 144.96386412"
78620240726,78,2024-07-26,6,1,3,4,HarEsB_T,"-37.81471642, 144.9446508"
78520240918,78,2024-09-18,5,3,1,4,HarEsB_T,"-37.81471642, 144.9446508"
142120240214,14,2024-02-14,21,387,69,456,SanBri_T,"-37.82011242, 144.96291897"
14520240226,14,2024-02-26,5,40,40,80,SanBri_T,"-37.82011242, 144.96291897"
591320250908,59,2025-09-08,13,1307,1239,2546,RMIT_T,"-37.80825648, 144.96304859"
591520250428,59,2025-04-28,15,846,866,1712,RMIT_T,"-37.80825648, 144.96304859"
421120240611,42,2024-06-11,11,150,180,330,UM1_T,"-37.80008566, 144.96386412"
31220241213,31,2024-12-13,2,14,7,21,Lyg161_T,"-37.80169681, 144.96658911"
45220240809,45,2024-08-09,2,15,27,42,Swa148_T,"-37.81414075, 144.96609379"
5920241115,5,2024-11-15,9,354,517,871,PriNW_T,"-37.81874249, 144.96787656"
1071220251002,107,2025-10-02,12,186,192,378,280Will_T,"-37.81246271, 144.95690188"
1181020241025,118,2024-10-25,10,7,16,23,Fli114C_T,"-37.81632783, 144.97090512"
1081720240524,108,2024-05-24,17,255,219,474,261Will_T,"-37.81295822, 144.95678789"
871420250316,87,2025-03-16,14,69,56,125,Errol23_T,"-37.80454949, 144.94921863"
44220250530,44,2025-05-30,2,2,1,3,UM3_T,"-37.79698741, 144.96441306"
185020250910,185,2025-09-10,0,43,38,81,Eli197_T,"-37.81374643, 144.96276183"
179920250920,179,2025-09-20,9,43,40,83,Pow61_T,"-37.82392385, 144.96299677"
1621820250527,162,2025-05-27,18,178,250,428,Eli489_T,"-37.80740397, 144.95987909"
1671620241215,167,2024-12-15,16,5,13,18,Lat526_T,"-37.81304149, 144.95155955"
1671620250426,167,2025-04-26,16,52,62,114,Lat526_T,"-37.81304149, 144.95155955"
1401320240808,140,2024-08-08,13,80,69,149,Boyd2837_T,"-37.82590962, 144.96185972"
162220241211,162,2024-12-11,2,30,12,42,Eli489_T,"-37.80740397, 144.95987909"
1621820241212,162,2024-12-12,18,299,362,661,Eli489_T,"-37.80740397, 144.95987909"
67920240103,67,2024-01-03,9,262,308,570,FLDegS_T,"-37.81688755, 144.96562569"
671120250418,67,2025-04-18,11,408,502,910,FLDegS_T,"-37.81688755, 144.96562569"
681920240604,68,2024-06-04,19,62,6,68,FLDegN_T,"-37.8168479, 144.96559789"
11920241228,1,2024-12-28,19,1542,925,2467,Bou292_T,"-37.81349441, 144.96515323"
671320241221,67,2024-12-21,13,426,536,962,FLDegS_T,"-37.81688755, 144.96562569"
671620241016,67,2024-10-16,16,332,664,996,FLDegS_T,"-37.81688755, 144.96562569"
68420250812,68,2025-08-12,4,3,0,3,FLDegN_T,"-37.8168479, 144.96559789"
18820240622,18,2024-06-22,8,30,28,58,Col12_T,"-37.81344862, 144.97305353"
18920250502,18,2025-05-02,9,125,472,597,Col12_T,"-37.81344862, 144.97305353"
18520250323,18,2025-03-23,5,0,3,3,Col12_T,"-37.81344862, 144.97305353"
632120250518,63,2025-05-18,21,12,103,115,Bou231_T,"-37.81333081, 144.96675571"
561020241021,56,2024-10-21,10,214,156,370,Lon364_T,"-37.81234775, 144.96153311"
111920251006,11,2025-10-06,19,90,96,186,WatCit_T,"-37.81564989, 144.93970694"
121520250210,12,2025-02-10,15,96,98,194,NewQ_T,"-37.81457988, 144.94292398"
56220250916,56,2025-09-16,2,0,4,4,Lon364_T,"-37.81234775, 144.96153311"
22320250331,2,2025-03-31,23,15,46,61,Bou283_T,"-37.81380668, 144.96516718"
27520250614,27,2025-06-14,5,15,3,18,Vic_T,"-37.80606888, 144.95644692"
791820240107,79,2024-01-07,18,239,229,468,FliSS_T,"-37.81794046, 144.96616678"
23520231122,23,2023-11-22,5,26,14,40,Col623_T,"-37.81909256, 144.95452748"
481520240903,48,2024-09-03,15,254,147,401,QVMQ_T,"-37.80631581, 144.95866697"
48820231208,48,2023-12-08,8,102,95,197,QVMQ_T,"-37.80631581, 144.95866697"
251120241206,25,2024-12-06,11,336,667,1003,MCEC_T,"-37.82401776, 144.95604426"
251120240101,25,2024-01-01,11,460,655,1115,MCEC_T,"-37.82401776, 144.95604426"
782020241203,78,2024-12-03,20,13,31,44,HarEsB_T,"-37.81471642, 144.9446508"
59820250624,59,2025-06-24,8,473,223,696,RMIT_T,"-37.80825648, 144.96304859"
28820231103,28,2023-11-03,8,453,217,670,VAC_T,"-37.82129925, 144.96879309"
311220240926,31,2024-09-26,12,168,145,313,Lyg161_T,"-37.80169681, 144.96658911"
37020240504,37,2024-05-04,0,86,49,135,Lyg260_T,"-37.80107122, 144.96704554"
40120240308,40,2024-03-08,1,7,4,11,Spr201_T,"-37.80999341, 144.97227587"
50720240616,50,2024-06-16,7,8,6,14,Lyg309_T,"-37.79808192, 144.96721013"
501220250225,50,2025-02-25,12,173,247,420,Lyg309_T,"-37.79808192, 144.96721013"
501020240526,50,2024-05-26,10,107,175,282,Lyg309_T,"-37.79808192, 144.96721013"
452320250407,45,2025-04-07,23,31,104,135,Swa148_T,"-37.81414075, 144.96609379"
134620250117,134,2025-01-17,6,147,95,242,Spen201_T,"-37.81694221, 144.95303935"
1332320241111,133,2024-11-11,23,96,86,182,Spen229_T,"-37.81531435, 144.95227769"
133520241130,133,2024-11-30,5,34,47,81,Spen229_T,"-37.81531435, 144.95227769"
1241720250126,124,2025-01-26,17,7,17,24,BirBridge_T,"-37.81757416, 144.97329934"
124820250928,124,2025-09-28,8,1,0,1,BirBridge_T,"-37.81757416, 144.97329934"
1332220240419,133,2024-04-19,22,231,204,435,Spen229_T,"-37.81531435, 144.95227769"
1081520231230,108,2023-12-30,15,74,115,189,261Will_T,"-37.81295822, 144.95678789"
87620240205,87,2024-02-05,6,22,12,34,Errol23_T,"-37.80454949, 144.94921863"
1852120250723,185,2025-07-23,21,326,440,766,Eli197_T,"-37.81374643, 144.96276183"
165820241001,165,2024-10-01,8,26,75,101,Spen475_T,"-37.80953359, 144.94939004"
1520250327,1,2025-03-27,5,6,12,18,Bou292_T,"-37.81349441, 144.96515323"
631220250928,63,2025-09-28,12,379,343,722,Bou231_T,"-37.81333081, 144.96675571"
56720241215,56,2024-12-15,7,60,22,82,Lon364_T,"-37.81234775, 144.96153311"
111820240527,11,2024-05-27,18,84,95,179,WatCit_T,"-37.81564989, 144.93970694"
762020240410,76,2024-04-10,20,12,18,30,KenMac_T,"-37.79453803, 144.93036194"
761720250820,76,2025-08-20,17,42,80,122,KenMac_T,"-37.79453803, 144.93036194"
721920241113,72,2024-11-13,19,131,353,484,ACMI_T,"-37.81726338, 144.96872809"
581820240310,58,2024-03-10,18,474,207,681,Bou688_T,"-37.81686075, 144.95358075"
581420240321,58,2024-03-21,14,874,602,1476,Bou688_T,"-37.81686075, 144.95358075"
532220240907,53,2024-09-07,22,107,146,253,Col254_T,"-37.81564191, 144.965499"
27820250701,27,2025-07-01,8,58,100,158,Vic_T,"-37.80606888, 144.95644692"
51120250626,51,2025-06-26,1,4,2,6,Fra118_T,"-37.80841815, 144.95906316"
511420240611,51,2024-06-11,14,106,87,193,Fra118_T,"-37.80841815, 144.95906316"
51320241211,51,2024-12-11,3,5,11,16,Fra118_T,"-37.80841815, 144.95906316"
51520240107,51,2024-01-07,5,8,5,13,Fra118_T,"-37.80841815, 144.95906316"
231920250329,23,2025-03-29,19,198,268,466,Col623_T,"-37.81909256, 144.95452748"
201420241207,20,2024-12-07,14,262,355,617,LtB170_T,"-37.81172914, 144.9682466"
19820240228,19,2024-02-28,8,71,48,119,LtB210_T,"-37.81237202, 144.96550671"
130520250818,130,2025-08-18,5,2,0,2,Bou892T,"-37.8204637, 144.94126826"
1381820240904,138,2024-09-04,18,3,1,4,EntPark1671_T,"-37.81996544, 144.95981454"
1232220231212,123,2023-12-12,22,1,0,1,BirBridge_T,"-37.81753741, 144.97329734"
49720241022,49,2024-10-22,7,61,106,167,Eli501_T,"-37.80730068, 144.95956055"
117520241001,117,2024-10-01,5,11,6,17,Fli114F_T,"-37.81629332, 144.97090877"
19020250509,19,2025-05-09,0,72,94,166,LtB210_T,"-37.81237202, 144.96550671"
66520250528,66,2025-05-28,5,13,28,41,QVN_T,"-37.81057846, 144.96444294"
69520240509,69,2024-05-09,5,4,4,8,FLDegC_T,"-37.81687226, 144.96559144"
1421120250306,142,2025-03-06,11,307,322,629,Hammer1584_T,"-37.81970749, 144.96795734"
1301120240110,130,2024-01-10,11,11,22,33,Bou892T,"-37.8204637, 144.94126826"
1611920240727,161,2024-07-27,19,7,1,8,BirArt1109_T,"-37.81851276, 144.97131336"
49420250330,49,2025-03-30,4,33,40,73,Eli501_T,"-37.80730068, 144.95956055"
117320250217,117,2025-02-17,3,3,4,7,Fli114F_T,"-37.81629332, 144.97090877"
191020240420,19,2024-04-20,10,201,155,356,LtB210_T,"-37.81237202, 144.96550671"
661520241231,66,2024-12-31,15,1222,1228,2450,QVN_T,"-37.81057846, 144.96444294"
691820240206,69,2024-02-06,18,85,54,139,FLDegC_T,"-37.81687226, 144.96559144"
691120240805,69,2024-08-05,11,245,145,390,FLDegC_T,"-37.81687226, 144.96559144"
6920240208,6,2024-02-08,9,716,1053,1769,FliS_T,"-37.81911705, 144.96558255"
6220241102,6,2024-11-02,2,78,73,151,FliS_T,"-37.81911705, 144.96558255"
61120250905,6,2025-09-05,11,581,537,1118,FliS_T,"-37.81911705, 144.96558255"
841420241003,84,2024-10-03,14,1071,1589,2660,ElFi_T,"-37.81798049, 144.96503383"
841920250718,84,2025-07-18,19,918,1082,2000,ElFi_T,"-37.81798049, 144.96503383"
41220241220,4,2024-12-20,12,1865,1316,3181,Swa123_T,"-37.81487988, 144.9660878"
31820240425,3,2024-04-25,18,1547,1690,3237,Swa295_T,"-37.81101524, 144.96429485"
39720250611,39,2025-06-11,7,15,16,31,AlfPl_T,"-37.81379749, 144.96995745"
81520240221,8,2024-02-21,15,114,171,285,WebBN_T,"-37.82293543, 144.9471751"
14120240207,14,2024-02-07,1,21,7,28,SanBri_T,"-37.82011242, 144.96291897"
281220241215,28,2024-12-15,12,611,751,1362,VAC_T,"-37.82129925, 144.96879309"
28020240428,28,2024-04-28,0,46,31,77,VAC_T,"-37.82129925, 144.96879309"
28620250516,28,2025-05-16,6,191,98,289,VAC_T,"-37.82129925, 144.96879309"
361120250313,36,2025-03-13,11,238,194,432,Que85_T,"-37.81652527, 144.96121062"
1072120250507,107,2025-05-07,21,75,57,132,280Will_T,"-37.81246271, 144.95690188"
43120241022,43,2024-10-22,1,5,5,10,UM2_T,"-37.79844526, 144.96411782"
44120240616,44,2024-06-16,1,15,1,16,UM3_T,"-37.79698741, 144.96441306"
184820250710,184,2025-07-10,8,366,353,719,Eli124_T,"-37.81512416, 144.96371988"
1401720231222,140,2023-12-22,17,111,89,200,Boyd2837_T,"-37.82590962, 144.96185972"
1621220241127,162,2024-11-27,12,428,541,969,Eli489_T,"-37.80740397, 144.95987909"
1311020250221,131,2025-02-21,10,95,122,217,King2_T,"-37.82009057, 144.95758725"
143020250513,143,2025-05-13,0,21,22,43,Spencer_T,"-37.821728, 144.95557015"
1321720240108,132,2024-01-08,17,56,46,102,King335_T,"-37.81267639, 144.95386444"
1341020240203,134,2024-02-03,10,218,306,524,Spen201_T,"-37.81694221, 144.95303935"
1342320240719,134,2024-07-19,23,213,172,385,Spen201_T,"-37.81694221, 144.95303935"
135620240502,135,2024-05-02,6,52,53,105,Spen161_T,"-37.8172861, 144.95319102"
133720240825,133,2024-08-25,7,130,183,313,Spen229_T,"-37.81531435, 144.95227769"
1331520250108,133,2025-01-08,15,521,592,1113,Spen229_T,"-37.81531435, 144.95227769"
118420231223,118,2023-12-23,4,1,0,1,Fli114C_T,"-37.81632783, 144.97090512"
852320240112,85,2024-01-12,23,4,7,11,488Mac_T,"-37.79432415, 144.92973378"
11920231101,1,2023-11-01,19,749,384,1133,Bou292_T,"-37.81349441, 144.96515323"
56320241008,56,2024-10-08,3,8,3,11,Lon364_T,"-37.81234775, 144.96153311"
112020250628,11,2025-06-28,20,117,77,194,WatCit_T,"-37.81564989, 144.93970694"
611820240126,61,2024-01-26,18,228,283,511,RMIT14_T,"-37.80767455, 144.96309114"
44720241104,44,2024-11-04,7,13,35,48,UM3_T,"-37.79698741, 144.96441306"
5720240905,5,2024-09-05,7,294,515,809,PriNW_T,"-37.81874249, 144.96787656"
1672120241223,167,2024-12-23,21,7,28,35,Lat526_T,"-37.81304149, 144.95155955"
165620240823,165,2024-08-23,6,4,7,11,Spen475_T,"-37.80953359, 144.94939004"
1401220250516,140,2025-05-16,12,106,43,149,Boyd2837_T,"-37.82590962, 144.96185972"
1322220240220,132,2024-02-20,22,84,66,150,King335_T,"-37.81267639, 144.95386444"
107820250519,107,2025-05-19,8,69,258,327,280Will_T,"-37.81246271, 144.95690188"
118820240216,118,2024-02-16,8,27,17,44,Fli114C_T,"-37.81632783, 144.97090512"
67920241029,67,2024-10-29,9,626,338,964,FLDegS_T,"-37.81688755, 144.96562569"
851820250909,85,2025-09-09,18,52,93,145,488Mac_T,"-37.79432415, 144.92973378"
17020250717,17,2025-07-17,0,6,2,8,Col15_T,"-37.81362543, 144.97323591"
11520240513,1,2024-05-13,15,947,816,1763,Bou292_T,"-37.81349441, 144.96515323"
671520240312,67,2024-03-12,15,287,545,832,FLDegS_T,"-37.81688755, 144.96562569"
68620250807,68,2025-08-07,6,10,9,19,FLDegN_T,"-37.8168479, 144.96559789"
63920240313,63,2024-03-13,9,176,202,378,Bou231_T,"-37.81333081, 144.96675571"
631220240713,63,2024-07-13,12,433,419,852,Bou231_T,"-37.81333081, 144.96675571"
112220250310,11,2025-03-10,22,83,83,166,WatCit_T,"-37.81564989, 144.93970694"
562120240615,56,2024-06-15,21,266,299,565,Lon364_T,"-37.81234775, 144.96153311"
242320240824,24,2024-08-24,23,201,361,562,Col620_T,"-37.81887963, 144.95449198"
76220241225,76,2024-12-25,2,2,0,2,KenMac_T,"-37.79453803, 144.93036194"
58320240830,58,2024-08-30,3,8,11,19,Bou688_T,"-37.81686075, 144.95358075"
352220250830,35,2025-08-30,22,478,650,1128,SouthB_T,"-37.82018685, 144.96508508"
27820250714,27,2025-07-14,8,31,93,124,Vic_T,"-37.80606888, 144.95644692"
79520250213,79,2025-02-13,5,31,32,63,FliSS_T,"-37.81794046, 144.96616678"
792120240520,79,2024-05-20,21,146,146,292,FliSS_T,"-37.81794046, 144.96616678"
9020241231,9,2024-12-31,0,13,11,24,Col700_T,"-37.81982992, 144.95102555"
532320240616,53,2024-06-16,23,12,36,48,Col254_T,"-37.81564191, 144.965499"
51520241125,51,2024-11-25,5,4,6,10,Fra118_T,"-37.80841815, 144.95906316"
481220250222,48,2025-02-22,12,426,262,688,QVMQ_T,"-37.80631581, 144.95866697"
201620250102,20,2025-01-02,16,261,244,505,LtB170_T,"-37.81172914, 144.9682466"
141620250609,141,2025-06-09,6,12,9,21,474Fl_T,"-37.81997273, 144.95834911"
1372120250514,137,2025-05-14,21,0,4,4,BouHbr2353_T,"-37.81894815, 144.94612292"
139820250212,139,2025-02-12,8,25,544,569,Signal1647_T,"-37.81959923, 144.9632832"
1421620250107,142,2025-01-07,16,563,448,1011,Hammer1584_T,"-37.81970749, 144.96795734"
164620241229,164,2024-12-29,6,7,8,15,Lat526_T,"-37.813005, 144.95160411"
138620231225,138,2023-12-25,6,1,0,1,EntPark1671_T,"-37.81996544, 144.95981454"
117120250301,117,2025-03-01,1,31,32,63,Fli114F_T,"-37.81629332, 144.97090877"
1091020240213,109,2024-02-13,10,105,171,276,LatWill_T,"-37.81193681, 144.95621105"
692320231113,69,2023-11-13,23,5,3,8,FLDegC_T,"-37.81687226, 144.96559144"
691420241130,69,2024-11-30,14,221,206,427,FLDegC_T,"-37.81687226, 144.96559144"
661220240707,66,2024-07-07,12,1309,1191,2500,QVN_T,"-37.81057846, 144.96444294"
772120240831,77,2024-08-31,21,45,42,87,HarEsP_T,"-37.81441438, 144.94433026"
14420231022,14,2023-10-22,4,46,5,51,SanBri_T,"-37.82011242, 144.96291897"
14620240223,14,2024-02-23,6,91,105,196,SanBri_T,"-37.82011242, 144.96291897"
542020240129,54,2024-01-29,20,60,105,165,Swa607_T,"-37.804024, 144.96308399"
471820250818,47,2025-08-18,18,866,689,1555,Eli250_T,"-37.81258467, 144.9625775"
661220241207,66,2024-12-07,12,773,973,1746,QVN_T,"-37.81057846, 144.96444294"
841020240708,84,2024-07-08,10,758,618,1376,ElFi_T,"-37.81798049, 144.96503383"
392320231210,39,2023-12-10,23,20,25,45,AlfPl_T,"-37.81379749, 144.96995745"
81520250921,8,2025-09-21,15,167,246,413,WebBN_T,"-37.82293543, 144.9471751"
411620250730,41,2025-07-30,16,1284,1811,3095,Swa31,"-37.81668634, 144.96689733"
651420240324,65,2024-03-24,14,591,1077,1668,SwaCs_T,"-37.81569416, 144.9668064"
142120250501,14,2025-05-01,21,239,74,313,SanBri_T,"-37.82011242, 144.96291897"
47820241104,47,2024-11-04,8,178,408,586,Eli250_T,"-37.81258467, 144.9625775"
36720250727,36,2025-07-27,7,18,23,41,Que85_T,"-37.81652527, 144.96121062"
362320241228,36,2024-12-28,23,121,172,293,Que85_T,"-37.81652527, 144.96121062"
43120251012,43,2025-10-12,1,7,5,12,UM2_T,"-37.79844526, 144.96411782"
441720240320,44,2024-03-20,17,38,14,52,UM3_T,"-37.79698741, 144.96441306"
441620240711,44,2024-07-11,16,77,43,120,UM3_T,"-37.79698741, 144.96441306"
442120250408,44,2025-04-08,21,16,14,30,UM3_T,"-37.79698741, 144.96441306"
451320251002,45,2025-10-02,13,618,984,1602,Swa148_T,"-37.81414075, 144.96609379"
51920250928,5,2025-09-28,19,1266,586,1852,PriNW_T,"-37.81874249, 144.96787656"
1671820241201,167,2024-12-01,18,40,65,105,Lat526_T,"-37.81304149, 144.95155955"
1401420240429,140,2024-04-29,14,71,47,118,Boyd2837_T,"-37.82590962, 144.96185972"
1181120240124,118,2024-01-24,11,11,52,63,Fli114C_T,"-37.81632783, 144.97090512"
1181120240604,118,2024-06-04,11,13,14,27,Fli114C_T,"-37.81632783, 144.97090512"
1181120240708,118,2024-07-08,11,12,13,25,Fli114C_T,"-37.81632783, 144.97090512"
1181820240725,118,2024-07-25,18,16,37,53,Fli114C_T,"-37.81632783, 144.97090512"
1842120250801,184,2025-08-01,21,330,643,973,Eli124_T,"-37.81512416, 144.96371988"
1791420250208,179,2025-02-08,14,58,62,120,Pow61_T,"-37.82392385, 144.96299677"
1612220241031,161,2024-10-31,22,0,119,119,BirArt1109_T,"-37.81851276, 144.97131336"
1611120241113,161,2024-11-13,11,14,36,50,BirArt1109_T,"-37.81851276, 144.97131336"
1171620240513,117,2024-05-13,16,104,239,343,Fli114F_T,"-37.81629332, 144.97090877"
109520250619,109,2025-06-19,5,9,12,21,LatWill_T,"-37.81193681, 144.95621105"
109220240411,109,2024-04-11,2,2,4,6,LatWill_T,"-37.81193681, 144.95621105"
109320240919,109,2024-09-19,3,2,0,2,LatWill_T,"-37.81193681, 144.95621105"
67620231215,67,2023-12-15,6,71,54,125,FLDegS_T,"-37.81688755, 144.96562569"
671820240601,67,2024-06-01,18,364,443,807,FLDegS_T,"-37.81688755, 144.96562569"
68720231216,68,2023-12-16,7,25,15,40,FLDegN_T,"-37.8168479, 144.96559789"
85720240513,85,2024-05-13,7,73,17,90,488Mac_T,"-37.79432415, 144.92973378"
17920240521,17,2024-05-21,9,765,243,1008,Col15_T,"-37.81362543, 144.97323591"
1220240602,1,2024-06-02,2,23,48,71,Bou292_T,"-37.81349441, 144.96515323"
68020240125,68,2024-01-25,0,1,0,1,FLDegN_T,"-37.8168479, 144.96559789"
1620250406,1,2025-04-06,6,18,15,33,Bou292_T,"-37.81349441, 144.96515323"
181220240428,18,2024-04-28,12,98,88,186,Col12_T,"-37.81344862, 144.97305353"
861620250910,86,2025-09-10,16,47,72,119,574Qub_T,"-37.80309992, 144.94908064"
862120240519,86,2024-05-19,21,3,17,20,574Qub_T,"-37.80309992, 144.94908064"
11520240514,11,2024-05-14,5,3,3,6,WatCit_T,"-37.81564989, 144.93970694"
24920231223,24,2023-12-23,9,267,318,585,Col620_T,"-37.81887963, 144.95449198"
761220231226,76,2023-12-26,12,31,26,57,KenMac_T,"-37.79453803, 144.93036194"
721420240327,72,2024-03-27,14,234,409,643,ACMI_T,"-37.81726338, 144.96872809"
351820250414,35,2025-04-14,18,1281,1438,2719,SouthB_T,"-37.82018685, 144.96508508"
352020251007,35,2025-10-07,20,544,584,1128,SouthB_T,"-37.82018685, 144.96508508"
271720240630,27,2024-06-30,17,138,69,207,Vic_T,"-37.80606888, 144.95644692"
79020241022,79,2024-10-22,0,58,46,104,FliSS_T,"-37.81794046, 144.96616678"
51320240205,51,2024-02-05,3,2,4,6,Fra118_T,"-37.80841815, 144.95906316"
481320240913,48,2024-09-13,13,283,259,542,QVMQ_T,"-37.80631581, 144.95866697"
481220240405,48,2024-04-05,12,453,329,782,QVMQ_T,"-37.80631581, 144.95866697"
30620250823,30,2025-08-23,6,14,45,59,Lon189_T,"-37.8112185, 144.96656806"
20920250518,20,2025-05-18,9,61,61,122,LtB170_T,"-37.81172914, 144.9682466"
1801620250911,180,2025-09-11,16,56,48,104,Mac330_T,"-37.79497059, 144.93530329"
141420250811,141,2025-08-11,4,3,5,8,474Fl_T,"-37.81997273, 144.95834911"
1371920250517,137,2025-05-17,19,2,8,10,BouHbr2353_T,"-37.81894815, 144.94612292"
1371720231107,137,2023-11-07,17,21,28,49,BouHbr2353_T,"-37.81894815, 144.94612292"
1421220250223,142,2025-02-23,12,507,634,1141,Hammer1584_T,"-37.81970749, 144.96795734"
142020250302,142,2025-03-02,0,18,12,30,Hammer1584_T,"-37.81970749, 144.96795734"
1421620250609,142,2025-06-09,16,339,323,662,Hammer1584_T,"-37.81970749, 144.96795734"
61920250506,6,2025-05-06,19,665,629,1294,FliS_T,"-37.81911705, 144.96558255"
31520240309,3,2024-03-09,15,988,1161,2149,Swa295_T,"-37.81101524, 144.96429485"
31520250109,3,2025-01-09,15,871,967,1838,Swa295_T,"-37.81101524, 144.96429485"
66120240310,66,2024-03-10,1,174,184,358,QVN_T,"-37.81057846, 144.96444294"
8720240619,8,2024-06-19,7,158,96,254,WebBN_T,"-37.82293543, 144.9471751"
81920240823,8,2024-08-23,19,42,33,75,WebBN_T,"-37.82293543, 144.9471751"
81420250419,8,2025-04-19,14,175,321,496,WebBN_T,"-37.82293543, 144.9471751"
752120250927,75,2025-09-27,21,25,14,39,SprFli_T,"-37.81515276, 144.97467661"
411220250502,41,2025-05-02,12,1569,1291,2860,Swa31,"-37.81668634, 144.96689733"
781520250923,78,2025-09-23,15,25,82,107,HarEsB_T,"-37.81471642, 144.9446508"
772120250114,77,2025-01-14,21,186,180,366,HarEsP_T,"-37.81441438, 144.94433026"
591320250525,59,2025-05-25,13,301,382,683,RMIT_T,"-37.80825648, 144.96304859"
591920240929,59,2024-09-29,19,377,248,625,RMIT_T,"-37.80825648, 144.96304859"
14320250923,14,2025-09-23,3,1,4,5,SanBri_T,"-37.82011242, 144.96291897"
541120240829,54,2024-08-29,11,350,256,606,Swa607_T,"-37.804024, 144.96308399"
281320250609,28,2025-06-09,13,743,939,1682,VAC_T,"-37.82129925, 144.96879309"
401720240715,40,2024-07-15,17,120,124,244,Spr201_T,"-37.80999341, 144.97227587"
40620240717,40,2024-07-17,6,40,50,90,Spr201_T,"-37.80999341, 144.97227587"
40620240820,40,2024-08-20,6,33,41,74,Spr201_T,"-37.80999341, 144.97227587"
401520250119,40,2025-01-19,15,127,105,232,Spr201_T,"-37.80999341, 144.97227587"
40420240325,40,2024-03-25,4,0,5,5,Spr201_T,"-37.80999341, 144.97227587"
312020250202,31,2025-02-02,20,250,194,444,Lyg161_T,"-37.80169681, 144.96658911"
362320241207,36,2024-12-07,23,243,229,472,Que85_T,"-37.81652527, 144.96121062"
611620241120,61,2024-11-20,16,549,560,1109,RMIT14_T,"-37.80767455, 144.96309114"
431920251003,43,2025-10-03,19,35,55,90,UM2_T,"-37.79844526, 144.96411782"
452120250606,45,2025-06-06,21,177,545,722,Swa148_T,"-37.81414075, 144.96609379"
45720240629,45,2024-06-29,7,40,59,99,Swa148_T,"-37.81414075, 144.96609379"
211320250916,21,2025-09-16,13,387,449,836,Bourke155_T,"-37.81267313, 144.96788288"
5720240625,5,2024-06-25,7,161,389,550,PriNW_T,"-37.81874249, 144.96787656"
1671920241122,167,2024-11-22,19,35,67,102,Lat526_T,"-37.81304149, 144.95155955"
1182220240111,118,2024-01-11,22,9,11,20,Fli114C_T,"-37.81632783, 144.97090512"
1181720240827,118,2024-08-27,17,25,46,71,Fli114C_T,"-37.81632783, 144.97090512"
1081120250711,108,2025-07-11,11,244,242,486,261Will_T,"-37.81295822, 144.95678789"
108920231119,108,2023-11-19,9,115,58,173,261Will_T,"-37.81295822, 144.95678789"
671520240329,67,2024-03-29,15,369,551,920,FLDegS_T,"-37.81688755, 144.96562569"
681420250304,68,2025-03-04,14,288,193,481,FLDegN_T,"-37.8168479, 144.96559789"
85720231108,85,2023-11-08,7,80,30,110,488Mac_T,"-37.79432415, 144.92973378"
851420240825,85,2024-08-25,14,86,102,188,488Mac_T,"-37.79432415, 144.92973378"
12020240925,1,2024-09-25,20,198,247,445,Bou292_T,"-37.81349441, 144.96515323"
68720240504,68,2024-05-04,7,40,29,69,FLDegN_T,"-37.8168479, 144.96559789"
11320250402,1,2025-04-02,13,1445,1299,2744,Bou292_T,"-37.81349441, 144.96515323"
861320250518,86,2025-05-18,13,65,54,119,574Qub_T,"-37.80309992, 144.94908064"
861920240206,86,2024-02-06,19,56,64,120,574Qub_T,"-37.80309992, 144.94908064"
62020250414,62,2025-04-14,0,75,63,138,Lat224_T,"-37.80996494, 144.96216521"
56020250415,56,2025-04-15,0,29,33,62,Lon364_T,"-37.81234775, 144.96153311"
86820250320,86,2025-03-20,8,64,48,112,574Qub_T,"-37.80309992, 144.94908064"
24920240520,24,2024-05-20,9,1261,359,1620,Col620_T,"-37.81887963, 144.95449198"
101920231211,10,2023-12-11,19,51,25,76,BouHbr_T,"-37.81876474, 144.94710545"
101420240806,10,2024-08-06,14,73,29,102,BouHbr_T,"-37.81876474, 144.94710545"
24320250403,24,2025-04-03,3,8,6,14,Col620_T,"-37.81887963, 144.95449198"
10620250702,10,2025-07-02,6,3,24,27,BouHbr_T,"-37.81876474, 144.94710545"
121920250914,12,2025-09-14,19,88,68,156,NewQ_T,"-37.81457988, 144.94292398"
581620250726,58,2025-07-26,16,699,426,1125,Bou688_T,"-37.81686075, 144.95358075"
351420250816,35,2025-08-16,14,1328,1509,2837,SouthB_T,"-37.82018685, 144.96508508"
79320250314,79,2025-03-14,3,10,15,25,FliSS_T,"-37.81794046, 144.96616678"
791120231104,79,2023-11-04,11,529,425,954,FliSS_T,"-37.81794046, 144.96616678"
53420250209,53,2025-02-09,4,10,8,18,Col254_T,"-37.81564191, 144.965499"
532320231229,53,2023-12-29,23,77,85,162,Col254_T,"-37.81564191, 144.965499"
791620250907,79,2025-09-07,16,423,369,792,FliSS_T,"-37.81794046, 144.96616678"
30820240625,30,2024-06-25,8,98,94,192,Lon189_T,"-37.8112185, 144.96656806"
52520240201,52,2024-02-01,5,11,7,18,Eli263_T,"-37.81252157, 144.9619401"
51520240608,51,2024-06-08,5,4,15,19,Fra118_T,"-37.80841815, 144.95906316"
491220241017,49,2024-10-17,12,402,542,944,Eli501_T,"-37.80730068, 144.95956055"
49320241108,49,2024-11-08,3,21,17,38,Eli501_T,"-37.80730068, 144.95956055"
492120231225,49,2023-12-25,21,93,86,179,Eli501_T,"-37.80730068, 144.95956055"
19120240211,19,2024-02-11,1,142,155,297,LtB210_T,"-37.81237202, 144.96550671"
201920250113,20,2025-01-13,19,247,201,448,LtB170_T,"-37.81172914, 144.9682466"
1411820241129,141,2024-11-29,18,176,120,296,474Fl_T,"-37.81997273, 144.95834911"
141620250124,141,2025-01-24,6,38,26,64,474Fl_T,"-37.81997273, 144.95834911"
1421220250312,142,2025-03-12,12,586,635,1221,Hammer1584_T,"-37.81970749, 144.96795734"
1301120250504,130,2025-05-04,11,38,25,63,Bou892T,"-37.8204637, 144.94126826"
130320251007,130,2025-10-07,3,1,0,1,Bou892T,"-37.8204637, 144.94126826"
1611720250621,161,2025-06-21,17,61,166,227,BirArt1109_T,"-37.81851276, 144.97131336"
161920250815,161,2025-08-15,9,92,77,169,BirArt1109_T,"-37.81851276, 144.97131336"
1641320241121,164,2024-11-21,13,88,110,198,Lat526_T,"-37.813005, 144.95160411"
1172320240412,117,2024-04-12,23,150,81,231,Fli114F_T,"-37.81629332, 144.97090877"
109320250308,109,2025-03-08,3,18,8,26,LatWill_T,"-37.81193681, 144.95621105"
109320250808,109,2025-08-08,3,4,0,4,LatWill_T,"-37.81193681, 144.95621105"
841220240724,84,2024-07-24,12,994,969,1963,ElFi_T,"-37.81798049, 144.96503383"
84020240920,84,2024-09-20,0,47,55,102,ElFi_T,"-37.81798049, 144.96503383"
841020250105,84,2025-01-05,10,617,412,1029,ElFi_T,"-37.81798049, 144.96503383"
70520240720,70,2024-07-20,5,1,1,2,Errol20_T,"-37.80456984, 144.94946228"
701920250610,70,2025-06-10,19,101,142,243,Errol20_T,"-37.80456984, 144.94946228"
81220240528,8,2024-05-28,12,280,517,797,WebBN_T,"-37.82293543, 144.9471751"
411420250226,41,2025-02-26,14,1411,1719,3130,Swa31,"-37.81668634, 144.96689733"
412120250228,41,2025-02-28,21,1121,1589,2710,Swa31,"-37.81668634, 144.96689733"
292020240212,29,2024-02-12,20,173,228,401,AG_T,"-37.8199817, 144.96872865"
14220240307,14,2024-03-07,2,9,4,13,SanBri_T,"-37.82011242, 144.96291897"
541220240318,54,2024-03-18,12,173,226,399,Swa607_T,"-37.804024, 144.96308399"
28020250629,28,2025-06-29,0,56,27,83,VAC_T,"-37.82129925, 144.96879309"
241520231122,24,2023-11-22,15,595,1207,1802,Col620_T,"-37.81887963, 144.95449198"
241320240729,24,2024-07-29,13,502,688,1190,Col620_T,"-37.81887963, 144.95449198"
101320241119,10,2024-11-19,13,134,110,244,BouHbr_T,"-37.81876474, 144.94710545"
722220250204,72,2025-02-04,22,45,73,118,ACMI_T,"-37.81726338, 144.96872809"
721120240519,72,2024-05-19,11,137,194,331,ACMI_T,"-37.81726338, 144.96872809"
76520250331,76,2025-03-31,5,4,2,6,KenMac_T,"-37.79453803, 144.93036194"
531020240719,53,2024-07-19,10,447,356,803,Col254_T,"-37.81564191, 144.965499"
30420250423,30,2025-04-23,4,11,10,21,Lon189_T,"-37.8112185, 144.96656806"
23920241115,23,2024-11-15,9,253,217,470,Col623_T,"-37.81909256, 144.95452748"
23020250222,23,2025-02-22,0,35,56,91,Col623_T,"-37.81909256, 144.95452748"
231220240301,23,2024-03-01,12,332,388,720,Col623_T,"-37.81909256, 144.95452748"
23020231227,23,2023-12-27,0,23,27,50,Col623_T,"-37.81909256, 144.95452748"
51020250616,51,2025-06-16,0,10,17,27,Fra118_T,"-37.80841815, 144.95906316"
791420250902,79,2025-09-02,14,356,336,692,FliSS_T,"-37.81794046, 144.96616678"
20020250114,20,2025-01-14,0,22,15,37,LtB170_T,"-37.81172914, 144.9682466"
481520240229,48,2024-02-29,15,320,180,500,QVMQ_T,"-37.80631581, 144.95866697"
25120250427,25,2025-04-27,1,26,34,60,MCEC_T,"-37.82401776, 144.95604426"
251720250714,25,2025-07-14,17,873,367,1240,MCEC_T,"-37.82401776, 144.95604426"
461520241111,46,2024-11-11,15,109,94,203,Pel147_T,"-37.80240719, 144.9615673"
137420240603,137,2024-06-03,4,0,1,1,BouHbr2353_T,"-37.81894815, 144.94612292"
136120240928,136,2024-09-28,1,1,0,1,BirFed1120_T,"-37.8184141, 144.97357915"
136420250311,136,2025-03-11,4,1,0,1,BirFed1120_T,"-37.8184141, 144.97357915"
142720250903,142,2025-09-03,7,267,329,596,Hammer1584_T,"-37.81970749, 144.96795734"
1421420240428,142,2024-04-28,14,845,476,1321,Hammer1584_T,"-37.81970749, 144.96795734"
142320240507,142,2024-05-07,3,0,1,1,Hammer1584_T,"-37.81970749, 144.96795734"
180920250924,180,2025-09-24,9,43,25,68,Mac330_T,"-37.79497059, 144.93530329"
1381220241111,138,2024-11-11,12,6,15,21,EntPark1671_T,"-37.81996544, 144.95981454"
19120250502,19,2025-05-02,1,42,74,116,LtB210_T,"-37.81237202, 144.96550671"
19020250522,19,2025-05-22,0,25,80,105,LtB210_T,"-37.81237202, 144.96550671"
661820240126,66,2024-01-26,18,1018,1105,2123,QVN_T,"-37.81057846, 144.96444294"
661720250926,66,2025-09-26,17,1177,1440,2617,QVN_T,"-37.81057846, 144.96444294"
66020250117,66,2025-01-17,0,98,89,187,QVN_T,"-37.81057846, 144.96444294"
691520241102,69,2024-11-02,15,281,302,583,FLDegC_T,"-37.81687226, 144.96559144"
842120240520,84,2024-05-20,21,359,494,853,ElFi_T,"-37.81798049, 144.96503383"
841420240830,84,2024-08-30,14,945,1239,2184,ElFi_T,"-37.81798049, 144.96503383"
61020250908,6,2025-09-08,10,410,427,837,FliS_T,"-37.81911705, 144.96558255"
841120250811,84,2025-08-11,11,727,635,1362,ElFi_T,"-37.81798049, 144.96503383"
751720241008,75,2024-10-08,17,111,98,209,SprFli_T,"-37.81515276, 144.97467661"
771120250219,77,2025-02-19,11,107,68,175,HarEsP_T,"-37.81441438, 144.94433026"
142020240609,14,2024-06-09,20,293,104,397,SanBri_T,"-37.82011242, 144.96291897"
592120240430,59,2024-04-30,21,315,228,543,RMIT_T,"-37.80825648, 144.96304859"
652220240420,65,2024-04-20,22,489,911,1400,SwaCs_T,"-37.81569416, 144.9668064"
28920241003,28,2024-10-03,9,716,277,993,VAC_T,"-37.82129925, 144.96879309"
54020240528,54,2024-05-28,0,20,27,47,Swa607_T,"-37.804024, 144.96308399"
36920240527,36,2024-05-27,9,157,159,316,Que85_T,"-37.81652527, 144.96121062"
471820250417,47,2025-04-17,18,1072,971,2043,Eli250_T,"-37.81258467, 144.9625775"
45320241216,45,2024-12-16,3,8,20,28,Swa148_T,"-37.81414075, 144.96609379"
211620240409,21,2024-04-09,16,386,376,762,Bourke155_T,"-37.81267313, 144.96788288"
21020240908,21,2024-09-08,0,191,205,396,Bourke155_T,"-37.81267313, 144.96788288"
1071520250405,107,2025-04-05,15,116,155,271,280Will_T,"-37.81246271, 144.95690188"
871420241014,87,2024-10-14,14,99,84,183,Errol23_T,"-37.80454949, 144.94921863"
54420250403,54,2025-04-03,4,4,1,5,Swa607_T,"-37.804024, 144.96308399"
28620250111,28,2025-01-11,6,46,55,101,VAC_T,"-37.82129925, 144.96879309"
281420240424,28,2024-04-24,14,464,425,889,VAC_T,"-37.82129925, 144.96879309"
311220240502,31,2024-05-02,12,158,153,311,Lyg161_T,"-37.80169681, 144.96658911"
361720250105,36,2025-01-05,17,67,60,127,Que85_T,"-37.81652527, 144.96121062"
51820251005,5,2025-10-05,18,786,657,1443,PriNW_T,"-37.81874249, 144.96787656"
45420250625,45,2025-06-25,4,7,5,12,Swa148_T,"-37.81414075, 144.96609379"
1332120250623,133,2025-06-23,21,278,174,452,Spen229_T,"-37.81531435, 144.95227769"
1082320250417,108,2025-04-17,23,101,78,179,261Will_T,"-37.81295822, 144.95678789"
108920250704,108,2025-07-04,9,227,797,1024,261Will_T,"-37.81295822, 144.95678789"
87520240426,87,2024-04-26,5,3,3,6,Errol23_T,"-37.80454949, 144.94921863"
611920251003,61,2025-10-03,19,392,419,811,RMIT14_T,"-37.80767455, 144.96309114"
44120241116,44,2024-11-16,1,1,0,1,UM3_T,"-37.79698741, 144.96441306"
1661320250123,166,2025-01-23,13,53,54,107,Spen484_T,"-37.80896733, 144.94931703"
166120250322,166,2025-03-22,1,2,1,3,Spen484_T,"-37.80896733, 144.94931703"
1661520250715,166,2025-07-15,15,64,48,112,Spen484_T,"-37.80896733, 144.94931703"
165420240925,165,2024-09-25,4,0,1,1,Spen475_T,"-37.80953359, 144.94939004"
1311820241212,131,2024-12-12,18,101,141,242,King2_T,"-37.82009057, 144.95758725"
143820241204,143,2024-12-04,8,142,223,365,Spencer_T,"-37.821728, 144.95557015"
1432020240416,143,2024-04-16,20,146,108,254,Spencer_T,"-37.821728, 144.95557015"
1352020240716,135,2024-07-16,20,83,106,189,Spen161_T,"-37.8172861, 144.95319102"
11820240726,1,2024-07-26,18,1007,833,1840,Bou292_T,"-37.81349441, 144.96515323"
632020250801,63,2025-08-01,20,119,264,383,Bou231_T,"-37.81333081, 144.96675571"
56520240528,56,2024-05-28,5,8,10,18,Lon364_T,"-37.81234775, 144.96153311"
11120251005,1,2025-10-05,11,900,803,1703,Bou292_T,"-37.81349441, 144.96515323"
122320240227,12,2024-02-27,23,61,48,109,NewQ_T,"-37.81457988, 144.94292398"
562120250504,56,2025-05-04,21,185,261,446,Lon364_T,"-37.81234775, 144.96153311"
11220250725,11,2025-07-25,2,7,3,10,WatCit_T,"-37.81564989, 144.93970694"
102020240715,10,2024-07-15,20,2,3,5,BouHbr_T,"-37.81876474, 144.94710545"
35220250202,35,2025-02-02,2,101,92,193,SouthB_T,"-37.82018685, 144.96508508"
351420240929,35,2024-09-29,14,711,981,1692,SouthB_T,"-37.82018685, 144.96508508"
58220250109,58,2025-01-09,2,12,24,36,Bou688_T,"-37.81686075, 144.95358075"
272020241025,27,2024-10-25,20,122,82,204,Vic_T,"-37.80606888, 144.95644692"
531620250909,53,2025-09-09,16,491,418,909,Col254_T,"-37.81564191, 144.965499"
791020240404,79,2024-04-04,10,487,319,806,FliSS_T,"-37.81794046, 144.96616678"
91120250704,9,2025-07-04,11,219,220,439,Col700_T,"-37.81982992, 144.95102555"
9820250710,9,2025-07-10,8,99,2624,2723,Col700_T,"-37.81982992, 144.95102555"
53120240827,53,2024-08-27,1,5,9,14,Col254_T,"-37.81564191, 144.965499"
53020240901,53,2024-09-01,0,68,83,151,Col254_T,"-37.81564191, 144.965499"
53120240327,53,2024-03-27,1,9,8,17,Col254_T,"-37.81564191, 144.965499"
53120240413,53,2024-04-13,1,42,41,83,Col254_T,"-37.81564191, 144.965499"
19220241208,19,2024-12-08,2,72,148,220,LtB210_T,"-37.81237202, 144.96550671"
481520231102,48,2023-11-02,15,298,146,444,QVMQ_T,"-37.80631581, 144.95866697"
461220240704,46,2024-07-04,12,96,90,186,Pel147_T,"-37.80240719, 144.9615673"
1412120241106,141,2024-11-06,21,54,93,147,474Fl_T,"-37.81997273, 144.95834911"
1412320250424,141,2025-04-24,23,96,138,234,474Fl_T,"-37.81997273, 144.95834911"
1372120240128,137,2024-01-28,21,3,7,10,BouHbr2353_T,"-37.81894815, 144.94612292"
1362120240604,136,2024-06-04,21,4,1,5,BirFed1120_T,"-37.8184141, 144.97357915"
130520250404,130,2025-04-04,5,2,0,2,Bou892T,"-37.8204637, 144.94126826"
164920250702,164,2025-07-02,9,74,47,121,Lat526_T,"-37.813005, 144.95160411"
66820240926,66,2024-09-26,8,202,506,708,QVN_T,"-37.81057846, 144.96444294"
691520240114,69,2024-01-14,15,179,211,390,FLDegC_T,"-37.81687226, 144.96559144"
69420250923,69,2025-09-23,4,2,1,3,FLDegC_T,"-37.81687226, 144.96559144"
6820240213,6,2024-02-13,8,999,2456,3455,FliS_T,"-37.81911705, 144.96558255"
841520240304,84,2024-03-04,15,849,1277,2126,ElFi_T,"-37.81798049, 144.96503383"
84520250112,84,2025-01-12,5,52,55,107,ElFi_T,"-37.81798049, 144.96503383"
661620240423,66,2024-04-23,16,1330,1388,2718,QVN_T,"-37.81057846, 144.96444294"
3820250303,3,2025-03-03,8,255,259,514,Swa295_T,"-37.81101524, 144.96429485"
31020240711,3,2024-07-11,10,430,438,868,Swa295_T,"-37.81101524, 144.96429485"
32020241028,3,2024-10-28,20,596,551,1147,Swa295_T,"-37.81101524, 144.96429485"
8520240629,8,2024-06-29,5,5,2,7,WebBN_T,"-37.82293543, 144.9471751"
422120241004,42,2024-10-04,21,44,67,111,UM1_T,"-37.80008566, 144.96386412"
652320240625,65,2024-06-25,23,62,71,133,SwaCs_T,"-37.81569416, 144.9668064"
291320240716,29,2024-07-16,13,145,242,387,AG_T,"-37.8199817, 144.96872865"
14120240310,14,2024-03-10,1,157,29,186,SanBri_T,"-37.82011242, 144.96291897"
71520240226,71,2024-02-26,5,8,3,11,WestWP_T,"-37.81235775, 144.97136962"
591820250321,59,2025-03-21,18,531,781,1312,RMIT_T,"-37.80825648, 144.96304859"
28520250622,28,2025-06-22,5,11,13,24,VAC_T,"-37.82129925, 144.96879309"
471720240620,47,2024-06-20,17,1342,791,2133,Eli250_T,"-37.81258467, 144.9625775"
471420231021,47,2023-10-21,14,1111,1196,2307,Eli250_T,"-37.81258467, 144.9625775"
402020250411,40,2025-04-11,20,144,118,262,Spr201_T,"-37.80999341, 144.97227587"
311020250227,31,2025-02-27,10,93,84,177,Lyg161_T,"-37.80169681, 144.96658911"
361320240822,36,2024-08-22,13,299,434,733,Que85_T,"-37.81652527, 144.96121062"
37820240129,37,2024-01-29,8,29,57,86,Lyg260_T,"-37.80107122, 144.96704554"
5020250813,5,2025-08-13,0,30,48,78,PriNW_T,"-37.81874249, 144.96787656"
51820250918,5,2025-09-18,18,1219,1421,2640,PriNW_T,"-37.81874249, 144.96787656"
45220240204,45,2024-02-04,2,52,194,246,Swa148_T,"-37.81414075, 144.96609379"
5820240620,5,2024-06-20,8,319,754,1073,PriNW_T,"-37.81874249, 144.96787656"
1082220250624,108,2025-06-24,22,79,55,134,261Will_T,"-37.81295822, 144.95678789"
1081720240926,108,2024-09-26,17,977,283,1260,261Will_T,"-37.81295822, 144.95678789"
612220250425,61,2025-04-25,22,168,61,229,RMIT14_T,"-37.80767455, 144.96309114"
611120231204,61,2023-12-04,11,134,357,491,RMIT14_T,"-37.80767455, 144.96309114"
441720250709,44,2025-07-09,17,108,52,160,UM3_T,"-37.79698741, 144.96441306"
431420240611,43,2024-06-11,14,114,122,236,UM2_T,"-37.79844526, 144.96411782"
1661420250210,166,2025-02-10,14,54,43,97,Spen484_T,"-37.80896733, 144.94931703"
1651920241003,165,2024-10-03,19,43,18,61,Spen475_T,"-37.80953359, 144.94939004"
1811420250416,181,2025-04-16,14,805,1121,1926,Eli368_T,"-37.81009465, 144.96143149"
143120250820,143,2025-08-20,1,29,18,47,Spencer_T,"-37.821728, 144.95557015"
1311820241229,131,2024-12-29,18,220,108,328,King2_T,"-37.82009057, 144.95758725"
1312220250527,131,2025-05-27,22,70,28,98,King2_T,"-37.82009057, 144.95758725"
143120250421,143,2025-04-21,1,70,16,86,Spencer_T,"-37.821728, 144.95557015"
1321820240823,132,2024-08-23,18,125,134,259,King335_T,"-37.81267639, 144.95386444"
134220250216,134,2025-02-16,2,28,26,54,Spen201_T,"-37.81694221, 144.95303935"
172020250524,17,2025-05-24,20,122,111,233,Col15_T,"-37.81362543, 144.97323591"
67320250322,67,2025-03-22,3,8,17,25,FLDegS_T,"-37.81688755, 144.96562569"
182020240831,18,2024-08-31,20,15,23,38,Col12_T,"-37.81344862, 144.97305353"
181420241121,18,2024-11-21,14,275,174,449,Col12_T,"-37.81344862, 144.97305353"
621620251004,62,2025-10-04,16,280,316,596,Lat224_T,"-37.80996494, 144.96216521"
631620250529,63,2025-05-29,16,293,435,728,Bou231_T,"-37.81333081, 144.96675571"
621020250301,62,2025-03-01,10,189,183,372,Lat224_T,"-37.80996494, 144.96216521"
621020250318,62,2025-03-18,10,168,145,313,Lat224_T,"-37.80996494, 144.96216521"
12020250413,12,2025-04-13,0,43,28,71,NewQ_T,"-37.81457988, 144.94292398"
241220240412,24,2024-04-12,12,671,668,1339,Col620_T,"-37.81887963, 144.95449198"
121520250715,12,2025-07-15,15,124,156,280,NewQ_T,"-37.81457988, 144.94292398"
722220240523,72,2024-05-23,22,72,188,260,ACMI_T,"-37.81726338, 144.96872809"
35820240924,35,2024-09-24,8,750,2170,2920,SouthB_T,"-37.82018685, 144.96508508"
581320250417,58,2025-04-17,13,797,571,1368,Bou688_T,"-37.81686075, 144.95358075"
58920240824,58,2024-08-24,9,390,148,538,Bou688_T,"-37.81686075, 144.95358075"
79320240414,79,2024-04-14,3,89,94,183,FliSS_T,"-37.81794046, 144.96616678"
91820231121,9,2023-11-21,18,965,101,1066,Col700_T,"-37.81982992, 144.95102555"
61520240506,6,2024-05-06,15,842,586,1428,FliS_T,"-37.81911705, 144.96558255"
6520241031,6,2024-10-31,5,81,95,176,FliS_T,"-37.81911705, 144.96558255"
841420240817,84,2024-08-17,14,1000,1463,2463,ElFi_T,"-37.81798049, 144.96503383"
661320240628,66,2024-06-28,13,1069,1021,2090,QVN_T,"-37.81057846, 144.96444294"
70420250702,70,2025-07-02,4,0,1,1,Errol20_T,"-37.80456984, 144.94946228"
411420240907,41,2024-09-07,14,449,408,857,Swa31,"-37.81668634, 144.96689733"
412120240424,41,2024-04-24,21,488,750,1238,Swa31,"-37.81668634, 144.96689733"
772220250107,77,2025-01-07,22,66,73,139,HarEsP_T,"-37.81441438, 144.94433026"
781920240420,78,2024-04-20,19,26,160,186,HarEsB_T,"-37.81471642, 144.9446508"
59420231203,59,2023-12-03,4,42,7,49,RMIT_T,"-37.80825648, 144.96304859"
651020240709,65,2024-07-09,10,464,250,714,SwaCs_T,"-37.81569416, 144.9668064"
281620241020,28,2024-10-20,16,494,512,1006,VAC_T,"-37.82129925, 144.96879309"
28220240227,28,2024-02-27,2,3,7,10,VAC_T,"-37.82129925, 144.96879309"
14820240810,14,2024-08-10,8,109,66,175,SanBri_T,"-37.82011242, 144.96291897"
542120250712,54,2025-07-12,21,99,88,187,Swa607_T,"-37.804024, 144.96308399"
542120250414,54,2025-04-14,21,90,135,225,Swa607_T,"-37.804024, 144.96308399"
54120240417,54,2024-04-17,1,14,20,34,Swa607_T,"-37.804024, 144.96308399"
37720231218,37,2023-12-18,7,11,21,32,Lyg260_T,"-37.80107122, 144.96704554"
371520240404,37,2024-04-04,15,98,84,182,Lyg260_T,"-37.80107122, 144.96704554"
361520240810,36,2024-08-10,15,128,157,285,Que85_T,"-37.81652527, 144.96121062"
611520231029,61,2023-10-29,15,392,418,810,RMIT14_T,"-37.80767455, 144.96309114"
43420240706,43,2024-07-06,4,1,0,1,UM2_T,"-37.79844526, 144.96411782"
441320250215,44,2025-02-15,13,22,30,52,UM3_T,"-37.79698741, 144.96441306"
1431520240921,143,2024-09-21,15,383,391,774,Spencer_T,"-37.821728, 144.95557015"
1081420250528,108,2025-05-28,14,434,233,667,261Will_T,"-37.81295822, 144.95678789"
1351420240908,135,2024-09-08,14,363,361,724,Spen161_T,"-37.8172861, 144.95319102"
1071620250109,107,2025-01-09,16,134,82,216,280Will_T,"-37.81246271, 144.95690188"
1072220250430,107,2025-04-30,22,47,53,100,280Will_T,"-37.81246271, 144.95690188"
1071620250702,107,2025-07-02,16,84,38,122,280Will_T,"-37.81246271, 144.95690188"
118920240607,118,2024-06-07,9,19,10,29,Fli114C_T,"-37.81632783, 144.97090512"
871420250419,87,2025-04-19,14,83,93,176,Errol23_T,"-37.80454949, 144.94921863"
1401120250721,140,2025-07-21,11,72,36,108,Boyd2837_T,"-37.82590962, 144.96185972"
85120240906,85,2024-09-06,1,3,1,4,488Mac_T,"-37.79432415, 144.92973378"
11020231217,1,2023-12-17,10,671,1176,1847,Bou292_T,"-37.81349441, 144.96515323"
67520250120,67,2025-01-20,5,13,22,35,FLDegS_T,"-37.81688755, 144.96562569"
862220240702,86,2024-07-02,22,0,15,15,574Qub_T,"-37.80309992, 144.94908064"
861320250708,86,2025-07-08,13,48,60,108,574Qub_T,"-37.80309992, 144.94908064"
562120241029,56,2024-10-29,21,214,293,507,Lon364_T,"-37.81234775, 144.96153311"
862220250829,86,2025-08-29,22,0,10,10,574Qub_T,"-37.80309992, 144.94908064"
241020250326,24,2025-03-26,10,786,361,1147,Col620_T,"-37.81887963, 144.95449198"
72420250215,72,2025-02-15,4,4,5,9,ACMI_T,"-37.81726338, 144.96872809"
722020250504,72,2025-05-04,20,57,87,144,ACMI_T,"-37.81726338, 144.96872809"
351020231120,35,2023-11-20,10,559,541,1100,SouthB_T,"-37.82018685, 144.96508508"
2620240612,2,2024-06-12,6,16,31,47,Bou283_T,"-37.81380668, 144.96516718"
58220240408,58,2024-04-08,2,13,40,53,Bou688_T,"-37.81686075, 144.95358075"
79420250708,79,2025-07-08,4,12,13,25,FliSS_T,"-37.81794046, 144.96616678"
302320240128,30,2024-01-28,23,184,177,361,Lon189_T,"-37.8112185, 144.96656806"
51120250506,51,2025-05-06,1,5,9,14,Fra118_T,"-37.80841815, 144.95906316"
481920250920,48,2025-09-20,19,110,131,241,QVMQ_T,"-37.80631581, 144.95866697"
20820240324,20,2024-03-24,8,36,57,93,LtB170_T,"-37.81172914, 144.9682466"
461520241124,46,2024-11-24,15,21,42,63,Pel147_T,"-37.80240719, 144.9615673"
1372120240716,137,2024-07-16,21,0,1,1,BouHbr2353_T,"-37.81894815, 144.94612292"
142820241023,142,2024-10-23,8,125,292,417,Hammer1584_T,"-37.81970749, 144.96795734"
43320250829,43,2025-08-29,3,1,3,4,UM2_T,"-37.79844526, 144.96411782"
441220241103,44,2024-11-03,12,38,36,74,UM3_T,"-37.79698741, 144.96441306"
1661520250529,166,2025-05-29,15,26,41,67,Spen484_T,"-37.80896733, 144.94931703"
143020250409,143,2025-04-09,0,28,19,47,Spencer_T,"-37.821728, 144.95557015"
1321620240816,132,2024-08-16,16,144,136,280,King335_T,"-37.81267639, 144.95386444"
1321120240403,132,2024-04-03,11,139,104,243,King335_T,"-37.81267639, 144.95386444"
1341420250127,134,2025-01-27,14,207,187,394,Spen201_T,"-37.81694221, 144.95303935"
135420231219,135,2023-12-19,4,13,8,21,Spen161_T,"-37.8172861, 144.95319102"
871420250816,87,2025-08-16,14,118,140,258,Errol23_T,"-37.80454949, 144.94921863"
501220240425,50,2024-04-25,12,293,322,615,Lyg309_T,"-37.79808192, 144.96721013"
1651820250310,165,2025-03-10,18,37,26,63,Spen475_T,"-37.80953359, 144.94939004"
1652120250703,165,2025-07-03,21,19,11,30,Spen475_T,"-37.80953359, 144.94939004"
1661720250610,166,2025-06-10,17,50,52,102,Spen484_T,"-37.80896733, 144.94931703"
1822020250919,182,2025-09-19,20,310,293,603,King163_T,"-37.81627451, 144.95550503"
1312220251010,131,2025-10-10,22,185,97,282,King2_T,"-37.82009057, 144.95758725"
1431120241029,143,2024-10-29,11,117,144,261,Spencer_T,"-37.821728, 144.95557015"
135620250317,135,2025-03-17,6,80,63,143,Spen161_T,"-37.8172861, 144.95319102"
851520240310,85,2024-03-10,15,36,30,66,488Mac_T,"-37.79432415, 144.92973378"
11920250530,1,2025-05-30,19,828,761,1589,Bou292_T,"-37.81349441, 144.96515323"
181020240826,18,2024-08-26,10,161,205,366,Col12_T,"-37.81344862, 144.97305353"
181820250604,18,2025-06-04,18,73,65,138,Col12_T,"-37.81344862, 144.97305353"
631120250612,63,2025-06-12,11,298,372,670,Bou231_T,"-37.81333081, 144.96675571"
862120241006,86,2024-10-06,21,14,19,33,574Qub_T,"-37.80309992, 144.94908064"
862320250711,86,2025-07-11,23,0,19,19,574Qub_T,"-37.80309992, 144.94908064"
351520240819,35,2024-08-19,15,881,857,1738,SouthB_T,"-37.82018685, 144.96508508"
761920240719,76,2024-07-19,19,30,36,66,KenMac_T,"-37.79453803, 144.93036194"
21920250122,2,2025-01-22,19,277,315,592,Bou283_T,"-37.81380668, 144.96516718"
531920250131,53,2025-01-31,19,362,225,587,Col254_T,"-37.81564191, 144.965499"
79720250404,79,2025-04-04,7,237,119,356,FliSS_T,"-37.81794046, 144.96616678"
511520241130,51,2024-11-30,15,95,95,190,Fra118_T,"-37.80841815, 144.95906316"
482120240116,48,2024-01-16,21,56,76,132,QVMQ_T,"-37.80631581, 144.95866697"
201020231214,20,2023-12-14,10,102,106,208,LtB170_T,"-37.81172914, 144.9682466"
52620240228,52,2024-02-28,6,26,14,40,Eli263_T,"-37.81252157, 144.9619401"
521420240824,52,2024-08-24,14,440,430,870,Eli263_T,"-37.81252157, 144.9619401"
1371420240130,137,2024-01-30,14,12,59,71,BouHbr2353_T,"-37.81894815, 144.94612292"
1391720240428,139,2024-04-28,17,48,44,92,Signal1647_T,"-37.81959923, 144.9632832"
142920240706,142,2024-07-06,9,299,165,464,Hammer1584_T,"-37.81970749, 144.96795734"
123720231117,123,2023-11-17,7,18,22,40,BirBridge_T,"-37.81753741, 144.97329734"
661820250224,66,2025-02-24,18,1183,1267,2450,QVN_T,"-37.81057846, 144.96444294"
69820240124,69,2024-01-24,8,145,42,187,FLDegC_T,"-37.81687226, 144.96559144"
691820240708,69,2024-07-08,18,70,28,98,FLDegC_T,"-37.81687226, 144.96559144"
661320240301,66,2024-03-01,13,1113,1029,2142,QVN_T,"-37.81057846, 144.96444294"
164720250524,164,2025-05-24,7,18,17,35,Lat526_T,"-37.813005, 144.95160411"
1381720240507,138,2024-05-07,17,3,3,6,EntPark1671_T,"-37.81996544, 144.95981454"
491420240522,49,2024-05-22,14,286,259,545,Eli501_T,"-37.80730068, 144.95956055"
661020250709,66,2025-07-09,10,460,503,963,QVN_T,"-37.81057846, 144.96444294"
69120240811,69,2024-08-11,1,3,4,7,FLDegC_T,"-37.81687226, 144.96559144"
69620250422,69,2025-04-22,6,17,7,24,FLDegC_T,"-37.81687226, 144.96559144"
841820240515,84,2024-05-15,18,871,1592,2463,ElFi_T,"-37.81798049, 144.96503383"
84620250626,84,2025-06-26,6,273,76,349,ElFi_T,"-37.81798049, 144.96503383"
661820231223,66,2023-12-23,18,1302,1244,2546,QVN_T,"-37.81057846, 144.96444294"
81020240209,8,2024-02-09,10,106,143,249,WebBN_T,"-37.82293543, 144.9471751"
421120250808,42,2025-08-08,11,337,315,652,UM1_T,"-37.80008566, 144.96386412"
781920250807,78,2025-08-07,19,8,9,17,HarEsB_T,"-37.81471642, 144.9446508"
782320240606,78,2024-06-06,23,0,6,6,HarEsB_T,"-37.81471642, 144.9446508"
71320240414,71,2024-04-14,3,1,1,2,WestWP_T,"-37.81235775, 144.97136962"
651820240429,65,2024-04-29,18,103,231,334,SwaCs_T,"-37.81569416, 144.9668064"
29020250720,29,2025-07-20,0,30,55,85,AG_T,"-37.8199817, 144.96872865"
312120241121,31,2024-11-21,21,213,230,443,Lyg161_T,"-37.80169681, 144.96658911"
54520250622,54,2025-06-22,5,6,1,7,Swa607_T,"-37.804024, 144.96308399"
21420251012,21,2025-10-12,4,24,30,54,Bourke155_T,"-37.81267313, 144.96788288"
362220250507,36,2025-05-07,22,31,32,63,Que85_T,"-37.81652527, 144.96121062"
1321120240130,132,2024-01-30,11,133,79,212,King335_T,"-37.81267639, 144.95386444"
108620250505,108,2025-05-05,6,35,193,228,261Will_T,"-37.81295822, 144.95678789"
1311820240328,131,2024-03-28,18,100,105,205,King2_T,"-37.82009057, 144.95758725"
1351520250128,135,2025-01-28,15,361,369,730,Spen161_T,"-37.8172861, 144.95319102"
1351220241003,135,2024-10-03,12,678,597,1275,Spen161_T,"-37.8172861, 144.95319102"
1071520240506,107,2024-05-06,15,107,106,213,280Will_T,"-37.81246271, 144.95690188"
1071620250212,107,2025-02-12,16,126,100,226,280Will_T,"-37.81246271, 144.95690188"
87120250811,87,2025-08-11,1,2,3,5,Errol23_T,"-37.80454949, 144.94921863"
1082320241117,108,2024-11-17,23,35,73,108,261Will_T,"-37.81295822, 144.95678789"
87520240627,87,2024-06-27,5,4,2,6,Errol23_T,"-37.80454949, 144.94921863"
61320250711,61,2025-07-11,3,12,1,13,RMIT14_T,"-37.80767455, 144.96309114"
184420250809,184,2025-08-09,4,25,31,56,Eli124_T,"-37.81512416, 144.96371988"
1791520250730,179,2025-07-30,15,52,54,106,Pow61_T,"-37.82392385, 144.96299677"
1652320250521,165,2025-05-21,23,5,0,5,Spen475_T,"-37.80953359, 144.94939004"
165220250704,165,2025-07-04,2,2,1,3,Spen475_T,"-37.80953359, 144.94939004"
1621320240829,162,2024-08-29,13,653,843,1496,Eli489_T,"-37.80740397, 144.95987909"
67720231208,67,2023-12-08,7,149,144,293,FLDegS_T,"-37.81688755, 144.96562569"
671020250303,67,2025-03-03,10,356,390,746,FLDegS_T,"-37.81688755, 144.96562569"
85920240105,85,2024-01-05,9,58,51,109,488Mac_T,"-37.79432415, 144.92973378"
671220250804,67,2025-08-04,12,490,562,1052,FLDegS_T,"-37.81688755, 144.96562569"
681020240922,68,2024-09-22,10,206,156,362,FLDegN_T,"-37.8168479, 144.96559789"
621720240219,62,2024-02-19,17,243,178,421,Lat224_T,"-37.80996494, 144.96216521"
621220240618,62,2024-06-18,12,203,137,340,Lat224_T,"-37.80996494, 144.96216521"
101320240822,10,2024-08-22,13,129,84,213,BouHbr_T,"-37.81876474, 144.94710545"
76420250127,76,2025-01-27,4,3,0,3,KenMac_T,"-37.79453803, 144.93036194"
761620250210,76,2025-02-10,16,62,76,138,KenMac_T,"-37.79453803, 144.93036194"
21820240921,2,2024-09-21,18,443,307,750,Bou283_T,"-37.81380668, 144.96516718"
531920231030,53,2023-10-30,19,165,167,332,Col254_T,"-37.81564191, 144.965499"
51520250514,51,2025-05-14,5,10,12,22,Fra118_T,"-37.80841815, 144.95906316"
23720250826,23,2025-08-26,7,370,214,584,Col623_T,"-37.81909256, 144.95452748"
25720241213,25,2024-12-13,7,133,194,327,MCEC_T,"-37.82401776, 144.95604426"
251620250518,25,2025-05-18,16,1078,702,1780,MCEC_T,"-37.82401776, 144.95604426"
201220241018,20,2024-10-18,12,281,240,521,LtB170_T,"-37.81172914, 144.9682466"
20020241111,20,2024-11-11,0,8,14,22,LtB170_T,"-37.81172914, 144.9682466"
461820240423,46,2024-04-23,18,151,108,259,Pel147_T,"-37.80240719, 144.9615673"
19620240124,19,2024-01-24,6,10,17,27,LtB210_T,"-37.81237202, 144.96550671"
191620240824,19,2024-08-24,16,749,572,1321,LtB210_T,"-37.81237202, 144.96550671"
1641020250516,164,2025-05-16,10,92,84,176,Lat526_T,"-37.813005, 144.95160411"
138720250108,138,2025-01-08,7,1,4,5,EntPark1671_T,"-37.81996544, 144.95981454"
138620240214,138,2024-02-14,6,2,0,2,EntPark1671_T,"-37.81996544, 144.95981454"
109220250614,109,2025-06-14,2,3,6,9,LatWill_T,"-37.81193681, 144.95621105"
117320240430,117,2024-04-30,3,0,2,2,Fli114F_T,"-37.81629332, 144.97090877"
66920231209,66,2023-12-09,9,147,179,326,QVN_T,"-37.81057846, 144.96444294"
691120240619,69,2024-06-19,11,200,132,332,FLDegC_T,"-37.81687226, 144.96559144"
81420250120,8,2025-01-20,14,147,169,316,WebBN_T,"-37.82293543, 144.9471751"
77920250307,77,2025-03-07,9,98,98,196,HarEsP_T,"-37.81441438, 144.94433026"
291720240720,29,2024-07-20,17,156,211,367,AG_T,"-37.8199817, 144.96872865"
371220231122,37,2023-11-22,12,130,136,266,Lyg260_T,"-37.80107122, 144.96704554"
45820240726,45,2024-07-26,8,386,271,657,Swa148_T,"-37.81414075, 144.96609379"
211020240108,21,2024-01-08,10,153,104,257,Bourke155_T,"-37.81267313, 144.96788288"
441620240628,44,2024-06-28,16,67,39,106,UM3_T,"-37.79698741, 144.96441306"
1321020240217,132,2024-02-17,10,231,123,354,King335_T,"-37.81267639, 144.95386444"
108520241223,108,2024-12-23,5,20,47,67,261Will_T,"-37.81295822, 144.95678789"
1341620250723,134,2025-07-23,16,521,538,1059,Spen201_T,"-37.81694221, 144.95303935"
1072020250715,107,2025-07-15,20,58,75,133,280Will_T,"-37.81246271, 144.95690188"
1242020250105,124,2025-01-05,20,4,1,5,BirBridge_T,"-37.81757416, 144.97329934"
1081420240713,108,2024-07-13,14,76,180,256,261Will_T,"-37.81295822, 144.95678789"
1621520250218,162,2025-02-18,15,277,556,833,Eli489_T,"-37.80740397, 144.95987909"
1661320250606,166,2025-06-06,13,46,29,75,Spen484_T,"-37.80896733, 144.94931703"
140720250314,140,2025-03-14,7,94,11,105,Boyd2837_T,"-37.82590962, 144.96185972"
140820250326,140,2025-03-26,8,225,54,279,Boyd2837_T,"-37.82590962, 144.96185972"
1621720241017,162,2024-10-17,17,316,374,690,Eli489_T,"-37.80740397, 144.95987909"
1432020250218,143,2025-02-18,20,114,143,257,Spencer_T,"-37.821728, 144.95557015"
171020250603,17,2025-06-03,10,307,232,539,Col15_T,"-37.81362543, 144.97323591"
1820250601,1,2025-06-01,8,64,55,119,Bou292_T,"-37.81349441, 144.96515323"
11220250821,1,2025-08-21,12,1456,1255,2711,Bou292_T,"-37.81349441, 144.96515323"
67320240608,67,2024-06-08,3,8,29,37,FLDegS_T,"-37.81688755, 144.96562569"
182020240213,18,2024-02-13,20,23,15,38,Col12_T,"-37.81344862, 144.97305353"
181220250317,18,2025-03-17,12,221,240,461,Col12_T,"-37.81344862, 144.97305353"
67220241012,67,2024-10-12,2,9,31,40,FLDegS_T,"-37.81688755, 144.96562569"
1020251001,1,2025-10-01,0,19,28,47,Bou292_T,"-37.81349441, 144.96515323"
561020231222,56,2023-12-22,10,234,110,344,Lon364_T,"-37.81234775, 144.96153311"
111420240102,11,2024-01-02,14,104,106,210,WatCit_T,"-37.81564989, 144.93970694"
102220240506,10,2024-05-06,22,7,5,12,BouHbr_T,"-37.81876474, 144.94710545"
11820250812,11,2025-08-12,8,86,55,141,WatCit_T,"-37.81564989, 144.93970694"
10720231106,10,2023-11-06,7,24,125,149,BouHbr_T,"-37.81876474, 144.94710545"
721820240609,72,2024-06-09,18,251,307,558,ACMI_T,"-37.81726338, 144.96872809"
72220240828,72,2024-08-28,2,9,5,14,ACMI_T,"-37.81726338, 144.96872809"
581320250517,58,2025-05-17,13,610,293,903,Bou688_T,"-37.81686075, 144.95358075"
58120240829,58,2024-08-29,1,45,46,91,Bou688_T,"-37.81686075, 144.95358075"
271420231031,27,2023-10-31,14,156,73,229,Vic_T,"-37.80606888, 144.95644692"
92120241001,9,2024-10-01,21,57,33,90,Col700_T,"-37.81982992, 144.95102555"
792020241124,79,2024-11-24,20,270,262,532,FliSS_T,"-37.81794046, 144.96616678"
511020250922,51,2025-09-22,10,85,73,158,Fra118_T,"-37.80841815, 144.95906316"
51820240208,51,2024-02-08,8,75,56,131,Fra118_T,"-37.80841815, 144.95906316"
201520240628,20,2024-06-28,15,207,302,509,LtB170_T,"-37.81172914, 144.9682466"
202320231130,20,2023-11-30,23,74,198,272,LtB170_T,"-37.81172914, 144.9682466"
252220240208,25,2024-02-08,22,237,133,370,MCEC_T,"-37.82401776, 144.95604426"
1372120250927,137,2025-09-27,21,0,1,1,BouHbr2353_T,"-37.81894815, 144.94612292"
1391720241026,139,2024-10-26,17,119,75,194,Signal1647_T,"-37.81959923, 144.9632832"
1422120231227,142,2023-12-27,21,553,551,1104,Hammer1584_T,"-37.81970749, 144.96795734"
1421520241017,142,2024-10-17,15,249,243,492,Hammer1584_T,"-37.81970749, 144.96795734"
1382120250522,138,2025-05-22,21,0,1,1,EntPark1671_T,"-37.81996544, 144.95981454"
1091620241019,109,2024-10-19,16,90,144,234,LatWill_T,"-37.81193681, 144.95621105"
109220250125,109,2025-01-25,2,11,19,30,LatWill_T,"-37.81193681, 144.95621105"
191620250111,19,2025-01-11,16,553,626,1179,LtB210_T,"-37.81237202, 144.96550671"
841220240123,84,2024-01-23,12,1217,1531,2748,ElFi_T,"-37.81798049, 144.96503383"
62320250722,6,2025-07-22,23,143,111,254,FliS_T,"-37.81911705, 144.96558255"
4920240402,4,2024-04-02,9,591,339,930,Swa123_T,"-37.81487988, 144.9660878"
4120240405,4,2024-04-05,1,122,133,255,Swa123_T,"-37.81487988, 144.9660878"
41320240624,4,2024-06-24,13,1340,1287,2627,Swa123_T,"-37.81487988, 144.9660878"
751720240805,75,2024-08-05,17,60,58,118,SprFli_T,"-37.81515276, 144.97467661"
81320250505,8,2025-05-05,13,278,303,581,WebBN_T,"-37.82293543, 144.9471751"
41720241011,41,2024-10-11,7,45,59,104,Swa31,"-37.81668634, 144.96689733"
42620250205,42,2025-02-05,6,14,44,58,UM1_T,"-37.80008566, 144.96386412"
711920231030,71,2023-10-30,19,5,14,19,WestWP_T,"-37.81235775, 144.97136962"
311220240616,31,2024-06-16,12,198,134,332,Lyg161_T,"-37.80169681, 144.96658911"
31620241115,31,2024-11-15,6,7,12,19,Lyg161_T,"-37.80169681, 144.96658911"
47920231214,47,2023-12-14,9,235,606,841,Eli250_T,"-37.81258467, 144.9625775"
451520240121,45,2024-01-21,15,774,1663,2437,Swa148_T,"-37.81414075, 144.96609379"
21320240228,21,2024-02-28,3,12,3,15,Bourke155_T,"-37.81267313, 144.96788288"
361920241008,36,2024-10-08,19,127,133,260,Que85_T,"-37.81652527, 144.96121062"
1341120240902,134,2024-09-02,11,193,364,557,Spen201_T,"-37.81694221, 144.95303935"
521020251013,52,2025-10-13,10,176,151,327,Eli263_T,"-37.81252157, 144.9619401"
511820250707,51,2025-07-07,18,105,65,170,Fra118_T,"-37.80841815, 144.95906316"
49520231118,49,2023-11-18,5,21,36,57,Eli501_T,"-37.80730068, 144.95956055"
49320250921,49,2025-09-21,3,26,35,61,Eli501_T,"-37.80730068, 144.95956055"
1361220250731,136,2025-07-31,12,93,73,166,BirFed1120_T,"-37.8184141, 144.97357915"
139320240713,139,2024-07-13,3,5,2,7,Signal1647_T,"-37.81959923, 144.9632832"
1421120250403,142,2025-04-03,11,244,229,473,Hammer1584_T,"-37.81970749, 144.96795734"
1301820250506,130,2025-05-06,18,22,27,49,Bou892T,"-37.8204637, 144.94126826"
164920250212,164,2025-02-12,9,68,63,131,Lat526_T,"-37.813005, 144.95160411"
1611220250201,161,2025-02-01,12,97,121,218,BirArt1109_T,"-37.81851276, 144.97131336"
1611820250421,161,2025-04-21,18,6,216,222,BirArt1109_T,"-37.81851276, 144.97131336"
1381220241031,138,2024-10-31,12,10,9,19,EntPark1671_T,"-37.81996544, 144.95981454"
1231120231223,123,2023-12-23,11,22,15,37,BirBridge_T,"-37.81753741, 144.97329734"
84820240417,84,2024-04-17,8,1551,384,1935,ElFi_T,"-37.81798049, 144.96503383"
41120241020,4,2024-10-20,11,1106,713,1819,Swa123_T,"-37.81487988, 144.9660878"
70620240628,70,2024-06-28,6,8,5,13,Errol20_T,"-37.80456984, 144.94946228"
70720241223,70,2024-12-23,7,40,33,73,Errol20_T,"-37.80456984, 144.94946228"
771020241216,77,2024-12-16,10,52,40,92,HarEsP_T,"-37.81441438, 144.94433026"
291820250816,29,2025-08-16,18,132,192,324,AG_T,"-37.8199817, 144.96872865"
591320240221,59,2024-02-21,13,967,925,1892,RMIT_T,"-37.80825648, 144.96304859"
47720250120,47,2025-01-20,7,122,239,361,Eli250_T,"-37.81258467, 144.9625775"
40720240901,40,2024-09-01,7,14,19,33,Spr201_T,"-37.80999341, 144.97227587"
37020241205,37,2024-12-05,0,26,23,49,Lyg260_T,"-37.80107122, 144.96704554"
37220240522,37,2024-05-22,2,5,3,8,Lyg260_T,"-37.80107122, 144.96704554"
471620250330,47,2025-03-30,16,1054,931,1985,Eli250_T,"-37.81258467, 144.9625775"
21120241231,21,2024-12-31,1,14,43,57,Bourke155_T,"-37.81267313, 144.96788288"
501720250801,50,2025-08-01,17,243,252,495,Lyg309_T,"-37.79808192, 144.96721013"
502320240908,50,2024-09-08,23,28,5,33,Lyg309_T,"-37.79808192, 144.96721013"
182620250516,182,2025-05-16,6,26,31,57,King163_T,"-37.81627451, 144.95550503"
1792120250415,179,2025-04-15,21,45,51,96,Pow61_T,"-37.82392385, 144.96299677"
1651120250624,165,2025-06-24,11,35,30,65,Spen475_T,"-37.80953359, 144.94939004"
166920241019,166,2024-10-19,9,32,40,72,Spen484_T,"-37.80896733, 144.94931703"
1811220250905,181,2025-09-05,12,620,933,1553,Eli368_T,"-37.81009465, 144.96143149"
140720240908,140,2024-09-08,7,25,7,32,Boyd2837_T,"-37.82590962, 144.96185972"
131620240624,131,2024-06-24,6,9,11,20,King2_T,"-37.82009057, 144.95758725"
143920240716,143,2024-07-16,9,128,224,352,Spencer_T,"-37.821728, 144.95557015"
135220250228,135,2025-02-28,2,20,22,42,Spen161_T,"-37.8172861, 144.95319102"
135420240416,135,2024-04-16,4,18,4,22,Spen161_T,"-37.8172861, 144.95319102"
672120240528,67,2024-05-28,21,94,155,249,FLDegS_T,"-37.81688755, 144.96562569"
68820240602,68,2024-06-02,8,41,23,64,FLDegN_T,"-37.8168479, 144.96559789"
171620250407,17,2025-04-07,16,216,323,539,Col15_T,"-37.81362543, 144.97323591"
67020250313,67,2025-03-13,0,16,19,35,FLDegS_T,"-37.81688755, 144.96562569"
632020250628,63,2025-06-28,20,112,263,375,Bou231_T,"-37.81333081, 144.96675571"
12920240216,12,2024-02-16,9,155,113,268,NewQ_T,"-37.81457988, 144.94292398"
111720251014,11,2025-10-14,17,141,187,328,WatCit_T,"-37.81564989, 144.93970694"
101920240925,10,2024-09-25,19,35,26,61,BouHbr_T,"-37.81876474, 144.94710545"
1341920250227,134,2025-02-27,19,427,457,884,Spen201_T,"-37.81694221, 144.95303935"
1311820240210,131,2024-02-10,18,130,132,262,King2_T,"-37.82009057, 144.95758725"
1332220231028,133,2023-10-28,22,253,194,447,Spen229_T,"-37.81531435, 144.95227769"
109420240328,109,2024-03-28,4,3,6,9,LatWill_T,"-37.81193681, 144.95621105"
492120250826,49,2025-08-26,21,142,107,249,Eli501_T,"-37.80730068, 144.95956055"
68920250908,68,2025-09-08,9,231,182,413,FLDegN_T,"-37.8168479, 144.96559789"
672020240822,67,2024-08-22,20,200,496,696,FLDegS_T,"-37.81688755, 144.96562569"
68520241018,68,2024-10-18,5,3,1,4,FLDegN_T,"-37.8168479, 144.96559789"
562020240909,56,2024-09-09,20,183,254,437,Lon364_T,"-37.81234775, 144.96153311"
11820240512,11,2024-05-12,8,52,51,103,WatCit_T,"-37.81564989, 144.93970694"
111620240710,11,2024-07-10,16,121,133,254,WatCit_T,"-37.81564989, 144.93970694"
561620250520,56,2025-05-20,16,346,318,664,Lon364_T,"-37.81234775, 144.96153311"
12620240928,12,2024-09-28,6,19,10,29,NewQ_T,"-37.81457988, 144.94292398"
24620250205,24,2025-02-05,6,365,121,486,Col620_T,"-37.81887963, 144.95449198"
761820240831,76,2024-08-31,18,51,45,96,KenMac_T,"-37.79453803, 144.93036194"
72120250225,72,2025-02-25,1,0,3,3,ACMI_T,"-37.81726338, 144.96872809"
35620240816,35,2024-08-16,6,220,257,477,SouthB_T,"-37.82018685, 144.96508508"
352220241028,35,2024-10-28,22,270,346,616,SouthB_T,"-37.82018685, 144.96508508"
2420241228,2,2024-12-28,4,5,15,20,Bou283_T,"-37.81380668, 144.96516718"
581020240118,58,2024-01-18,10,687,244,931,Bou688_T,"-37.81686075, 144.95358075"
21120250517,2,2025-05-17,11,640,487,1127,Bou283_T,"-37.81380668, 144.96516718"
531520250117,53,2025-01-17,15,803,624,1427,Col254_T,"-37.81564191, 144.965499"
231420240109,23,2024-01-09,14,220,353,573,Col623_T,"-37.81909256, 144.95452748"
301220241022,30,2024-10-22,12,300,520,820,Lon189_T,"-37.8112185, 144.96656806"
302220231206,30,2023-12-06,22,215,296,511,Lon189_T,"-37.8112185, 144.96656806"
512120241213,51,2024-12-13,21,65,67,132,Fra118_T,"-37.80841815, 144.95906316"
20120250624,20,2025-06-24,1,7,7,14,LtB170_T,"-37.81172914, 144.9682466"
301620250424,30,2025-04-24,16,282,421,703,Lon189_T,"-37.8112185, 144.96656806"
30320250709,30,2025-07-09,3,10,29,39,Lon189_T,"-37.8112185, 144.96656806"
462120231127,46,2023-11-27,21,29,27,56,Pel147_T,"-37.80240719, 144.9615673"
1362220240714,136,2024-07-14,22,2,27,29,BirFed1120_T,"-37.8184141, 144.97357915"
1362220241028,136,2024-10-28,22,1,0,1,BirFed1120_T,"-37.8184141, 144.97357915"
1421220250325,142,2025-03-25,12,585,624,1209,Hammer1584_T,"-37.81970749, 144.96795734"
1301720240302,130,2024-03-02,17,16,17,33,Bou892T,"-37.8204637, 144.94126826"
1381320241106,138,2024-11-06,13,14,13,27,EntPark1671_T,"-37.81996544, 144.95981454"
1171020250802,117,2025-08-02,10,66,130,196,Fli114F_T,"-37.81629332, 144.97090877"
1171920250906,117,2025-09-06,19,242,149,391,Fli114F_T,"-37.81629332, 144.97090877"
1412220250731,141,2025-07-31,22,69,59,128,474Fl_T,"-37.81997273, 144.95834911"
492320250108,49,2025-01-08,23,87,91,178,Eli501_T,"-37.80730068, 144.95956055"
1821420250612,182,2025-06-12,14,179,211,390,King163_T,"-37.81627451, 144.95550503"
166920241116,166,2024-11-16,9,36,43,79,Spen484_T,"-37.80896733, 144.94931703"
1812120250514,181,2025-05-14,21,667,606,1273,Eli368_T,"-37.81009465, 144.96143149"
1621920250420,162,2025-04-20,19,250,146,396,Eli489_T,"-37.80740397, 144.95987909"
632120240718,63,2024-07-18,21,119,323,442,Bou231_T,"-37.81333081, 144.96675571"
121020240331,12,2024-03-31,10,178,146,324,NewQ_T,"-37.81457988, 144.94292398"
862320241208,86,2024-12-08,23,2,5,7,574Qub_T,"-37.80309992, 144.94908064"
24620240505,24,2024-05-05,6,67,66,133,Col620_T,"-37.81887963, 144.95449198"
242220240615,24,2024-06-15,22,219,368,587,Col620_T,"-37.81887963, 144.95449198"
76620240223,76,2024-02-23,6,17,21,38,KenMac_T,"-37.79453803, 144.93036194"
721320251006,72,2025-10-06,13,121,269,390,ACMI_T,"-37.81726338, 144.96872809"
352020250528,35,2025-05-28,20,143,212,355,SouthB_T,"-37.82018685, 144.96508508"
561520250730,56,2025-07-30,15,300,263,563,Lon364_T,"-37.81234775, 144.96153311"
27920250118,27,2025-01-18,9,118,146,264,Vic_T,"-37.80606888, 144.95644692"
581320240628,58,2024-06-28,13,765,564,1329,Bou688_T,"-37.81686075, 144.95358075"
272120240817,27,2024-08-17,21,114,59,173,Vic_T,"-37.80606888, 144.95644692"
791020240320,79,2024-03-20,10,514,282,796,FliSS_T,"-37.81794046, 144.96616678"
92020241120,9,2024-11-20,20,119,54,173,Col700_T,"-37.81982992, 144.95102555"
522220231018,52,2023-10-18,22,117,187,304,Eli263_T,"-37.81252157, 144.9619401"
522320231227,52,2023-12-27,23,60,78,138,Eli263_T,"-37.81252157, 144.9619401"
52020240908,52,2024-09-08,0,202,154,356,Eli263_T,"-37.81252157, 144.9619401"
461820240921,46,2024-09-21,18,27,28,55,Pel147_T,"-37.80240719, 144.9615673"
251020240430,25,2024-04-30,10,188,365,553,MCEC_T,"-37.82401776, 144.95604426"
1371120240620,137,2024-06-20,11,15,42,57,BouHbr2353_T,"-37.81894815, 144.94612292"
1371520241013,137,2024-10-13,15,3,3,6,BouHbr2353_T,"-37.81894815, 144.94612292"
142720231227,142,2023-12-27,7,83,50,133,Hammer1584_T,"-37.81970749, 144.96795734"
1301520240923,130,2024-09-23,15,67,54,121,Bou892T,"-37.8204637, 144.94126826"
130720250823,130,2025-08-23,7,31,8,39,Bou892T,"-37.8204637, 144.94126826"
1301220240514,130,2024-05-14,12,38,58,96,Bou892T,"-37.8204637, 144.94126826"
1642020250318,164,2025-03-18,20,59,119,178,Lat526_T,"-37.813005, 144.95160411"
1381120240213,138,2024-02-13,11,4,1,5,EntPark1671_T,"-37.81996544, 144.95981454"
1171620241214,117,2024-12-14,16,203,247,450,Fli114F_T,"-37.81629332, 144.97090877"
66820241013,66,2024-10-13,8,88,239,327,QVN_T,"-37.81057846, 144.96444294"
69020241117,69,2024-11-17,0,6,4,10,FLDegC_T,"-37.81687226, 144.96559144"
6920240124,6,2024-01-24,9,527,1018,1545,FliS_T,"-37.81911705, 144.96558255"
841220241211,84,2024-12-11,12,1080,1138,2218,ElFi_T,"-37.81798049, 144.96503383"
4820250224,4,2025-02-24,8,662,399,1061,Swa123_T,"-37.81487988, 144.9660878"
701720240421,70,2024-04-21,17,142,250,392,Errol20_T,"-37.80456984, 144.94946228"
3820250214,3,2025-02-14,8,191,248,439,Swa295_T,"-37.81101524, 144.96429485"
3720231118,3,2023-11-18,7,51,46,97,Swa295_T,"-37.81101524, 144.96429485"
751520241009,75,2024-10-09,15,48,48,96,SprFli_T,"-37.81515276, 144.97467661"
411920240611,41,2024-06-11,19,553,796,1349,Swa31,"-37.81668634, 144.96689733"
781020241211,78,2024-12-11,10,25,108,133,HarEsB_T,"-37.81471642, 144.9446508"
291720250418,29,2025-04-18,17,682,520,1202,AG_T,"-37.8199817, 144.96872865"
712120250305,71,2025-03-05,21,4,2,6,WestWP_T,"-37.81235775, 144.97136962"
71220250724,71,2025-07-24,2,8,11,19,WestWP_T,"-37.81235775, 144.97136962"
711720240101,71,2024-01-01,17,3,5,8,WestWP_T,"-37.81235775, 144.97136962"
59720231030,59,2023-10-30,7,168,107,275,RMIT_T,"-37.80825648, 144.96304859"
591620231204,59,2023-12-04,16,516,661,1177,RMIT_T,"-37.80825648, 144.96304859"
542120250828,54,2025-08-28,21,154,152,306,Swa607_T,"-37.804024, 144.96308399"
311720240805,31,2024-08-05,17,157,144,301,Lyg161_T,"-37.80169681, 144.96658911"
361820250505,36,2025-05-05,18,155,146,301,Que85_T,"-37.81652527, 144.96121062"
47920250727,47,2025-07-27,9,256,282,538,Eli250_T,"-37.81258467, 144.9625775"
47520240731,47,2024-07-31,5,23,47,70,Eli250_T,"-37.81258467, 144.9625775"
1331620250212,133,2025-02-12,16,525,712,1237,Spen229_T,"-37.81531435, 144.95227769"
871020240523,87,2024-05-23,10,86,89,175,Errol23_T,"-37.80454949, 144.94921863"
872120241128,87,2024-11-28,21,59,67,126,Errol23_T,"-37.80454949, 144.94921863"
872320250115,87,2025-01-15,23,5,17,22,Errol23_T,"-37.80454949, 144.94921863"
6320250826,6,2025-08-26,3,17,8,25,FliS_T,"-37.81911705, 144.96558255"
842120250619,84,2025-06-19,21,345,519,864,ElFi_T,"-37.81798049, 144.96503383"
702020250228,70,2025-02-28,20,308,297,605,Errol20_T,"-37.80456984, 144.94946228"
32220250210,3,2025-02-10,22,340,251,591,Swa295_T,"-37.81101524, 144.96429485"
31120250212,3,2025-02-12,11,478,416,894,Swa295_T,"-37.81101524, 144.96429485"
3520240727,3,2024-07-27,5,53,51,104,Swa295_T,"-37.81101524, 144.96429485"
752120250613,75,2025-06-13,21,4,19,23,SprFli_T,"-37.81515276, 144.97467661"
392120240908,39,2024-09-08,21,0,3,3,AlfPl_T,"-37.81379749, 144.96995745"
412220240508,41,2024-05-08,22,361,620,981,Swa31,"-37.81668634, 144.96689733"
8220240812,8,2024-08-12,2,1,2,3,WebBN_T,"-37.82293543, 144.9471751"
772220250120,77,2025-01-20,22,90,57,147,HarEsP_T,"-37.81441438, 144.94433026"
77220250518,77,2025-05-18,2,3,2,5,HarEsP_T,"-37.81441438, 144.94433026"
77820250728,77,2025-07-28,8,113,153,266,HarEsP_T,"-37.81441438, 144.94433026"
782020240530,78,2024-05-30,20,1,3,4,HarEsB_T,"-37.81471642, 144.9446508"
782120240525,78,2024-05-25,21,0,14,14,HarEsB_T,"-37.81471642, 144.9446508"
141320231126,14,2023-11-26,13,404,149,553,SanBri_T,"-37.82011242, 144.96291897"
71220241221,71,2024-12-21,2,2,2,4,WestWP_T,"-37.81235775, 144.97136962"
291620240627,29,2024-06-27,16,233,319,552,AG_T,"-37.8199817, 144.96872865"
45520240730,45,2024-07-30,5,7,14,21,Swa148_T,"-37.81414075, 144.96609379"
45520250926,45,2025-09-26,5,4,19,23,Swa148_T,"-37.81414075, 144.96609379"
51420250723,5,2025-07-23,14,791,758,1549,PriNW_T,"-37.81874249, 144.96787656"
21920250625,21,2025-06-25,9,81,73,154,Bourke155_T,"-37.81267313, 144.96788288"
21720250206,21,2025-02-06,7,30,37,67,Bourke155_T,"-37.81267313, 144.96788288"
1072020250318,107,2025-03-18,20,154,120,274,280Will_T,"-37.81246271, 144.95690188"
1072020250728,107,2025-07-28,20,58,62,120,280Will_T,"-37.81246271, 144.95690188"
107220250925,107,2025-09-25,2,5,3,8,280Will_T,"-37.81246271, 144.95690188"
118920240711,118,2024-07-11,9,21,14,35,Fli114C_T,"-37.81632783, 144.97090512"
1081820231023,108,2023-10-23,18,512,136,648,261Will_T,"-37.81295822, 144.95678789"
62220250327,6,2025-03-27,22,531,426,957,FliS_T,"-37.81911705, 144.96558255"
411620241117,41,2024-11-17,16,1434,1576,3010,Swa31,"-37.81668634, 144.96689733"
77620240306,77,2024-03-06,6,39,78,117,HarEsP_T,"-37.81441438, 144.94433026"
77520250124,77,2025-01-24,5,6,15,21,HarEsP_T,"-37.81441438, 144.94433026"
771520250928,77,2025-09-28,15,201,109,310,HarEsP_T,"-37.81441438, 144.94433026"
542120240111,54,2024-01-11,21,60,60,120,Swa607_T,"-37.804024, 144.96308399"
40620240906,40,2024-09-06,6,17,38,55,Spr201_T,"-37.80999341, 144.97227587"
401920250116,40,2025-01-16,19,140,152,292,Spr201_T,"-37.80999341, 144.97227587"
402220250213,40,2025-02-13,22,208,44,252,Spr201_T,"-37.80999341, 144.97227587"
31820250418,31,2025-04-18,8,51,26,77,Lyg161_T,"-37.80169681, 144.96658911"
541520240726,54,2024-07-26,15,278,448,726,Swa607_T,"-37.804024, 144.96308399"
47320240404,47,2024-04-04,3,23,19,42,Eli250_T,"-37.81258467, 144.9625775"
1081120250221,108,2025-02-21,11,252,352,604,261Will_T,"-37.81295822, 144.95678789"
432220250824,43,2025-08-24,22,13,32,45,UM2_T,"-37.79844526, 144.96411782"
44120240205,44,2024-02-05,1,1,0,1,UM3_T,"-37.79698741, 144.96441306"
431920231229,43,2023-12-29,19,49,24,73,UM2_T,"-37.79844526, 144.96411782"
43220241002,43,2024-10-02,2,0,1,1,UM2_T,"-37.79844526, 144.96411782"
70120240716,70,2024-07-16,1,0,2,2,Errol20_T,"-37.80456984, 144.94946228"
1622320240903,162,2024-09-03,23,76,62,138,Eli489_T,"-37.80740397, 144.95987909"
132620240615,132,2024-06-15,6,15,4,19,King335_T,"-37.81267639, 144.95386444"
134620231106,134,2023-11-06,6,141,129,270,Spen201_T,"-37.81694221, 144.95303935"
531920231220,53,2023-12-20,19,396,303,699,Col254_T,"-37.81564191, 144.965499"
30120241005,30,2024-10-05,1,229,235,464,Lon189_T,"-37.8112185, 144.96656806"
511120250504,51,2025-05-04,11,133,123,256,Fra118_T,"-37.80841815, 144.95906316"
512220240305,51,2024-03-05,22,38,41,79,Fra118_T,"-37.80841815, 144.95906316"
48220241105,48,2024-11-05,2,15,12,27,QVMQ_T,"-37.80631581, 144.95866697"
481020240305,48,2024-03-05,10,242,218,460,QVMQ_T,"-37.80631581, 144.95866697"
20920240901,20,2024-09-01,9,42,68,110,LtB170_T,"-37.81172914, 144.9682466"
462120250228,46,2025-02-28,21,6,0,6,Pel147_T,"-37.80240719, 144.9615673"
1371620251006,137,2025-10-06,16,9,163,172,BouHbr2353_T,"-37.81894815, 144.94612292"
137620240531,137,2024-05-31,6,3,2,5,BouHbr2353_T,"-37.81894815, 144.94612292"
1301720240720,130,2024-07-20,17,1,6,7,Bou892T,"-37.8204637, 144.94126826"
1171620250602,117,2025-06-02,16,102,251,353,Fli114F_T,"-37.81629332, 144.97090877"
1171220240516,117,2024-05-16,12,201,248,449,Fli114F_T,"-37.81629332, 144.97090877"
109820250218,109,2025-02-18,8,87,680,767,LatWill_T,"-37.81193681, 144.95621105"
109220240415,109,2024-04-15,2,4,2,6,LatWill_T,"-37.81193681, 144.95621105"
69820240311,69,2024-03-11,8,7,4,11,FLDegC_T,"-37.81687226, 144.96559144"
751320250204,75,2025-02-04,13,48,68,116,SprFli_T,"-37.81515276, 144.97467661"
81720250321,8,2025-03-21,17,252,336,588,WebBN_T,"-37.82293543, 144.9471751"
81020240106,8,2024-01-06,10,106,176,282,WebBN_T,"-37.82293543, 144.9471751"
591420250612,59,2025-06-12,14,635,687,1322,RMIT_T,"-37.80825648, 144.96304859"
59620241216,59,2024-12-16,6,34,40,74,RMIT_T,"-37.80825648, 144.96304859"
712120240802,71,2024-08-02,21,14,11,25,WestWP_T,"-37.81235775, 144.97136962"
711720241014,71,2024-10-14,17,24,28,52,WestWP_T,"-37.81235775, 144.97136962"
711420250115,71,2025-01-15,14,10,9,19,WestWP_T,"-37.81235775, 144.97136962"
652120231105,65,2023-11-05,21,84,311,395,SwaCs_T,"-37.81569416, 144.9668064"
28920241016,28,2024-10-16,9,565,301,866,VAC_T,"-37.82129925, 144.96879309"
291820240630,29,2024-06-30,18,61,360,421,AG_T,"-37.8199817, 144.96872865"
29620240911,29,2024-09-11,6,1,2,3,AG_T,"-37.8199817, 144.96872865"
31620241025,31,2024-10-25,6,18,15,33,Lyg161_T,"-37.80169681, 144.96658911"
37320240511,37,2024-05-11,3,3,1,4,Lyg260_T,"-37.80107122, 144.96704554"
40120240329,40,2024-03-29,1,27,21,48,Spr201_T,"-37.80999341, 144.97227587"
21420250702,21,2025-07-02,4,0,9,9,Bourke155_T,"-37.81267313, 144.96788288"
362020250120,36,2025-01-20,20,100,68,168,Que85_T,"-37.81652527, 144.96121062"
36920240630,36,2024-06-30,9,69,28,97,Que85_T,"-37.81652527, 144.96121062"
371020250313,37,2025-03-13,10,59,67,126,Lyg260_T,"-37.80107122, 144.96704554"
44120251007,44,2025-10-07,1,4,0,4,UM3_T,"-37.79698741, 144.96441306"
431220240522,43,2024-05-22,12,299,339,638,UM2_T,"-37.79844526, 144.96411782"
1321620240906,132,2024-09-06,16,133,114,247,King335_T,"-37.81267639, 144.95386444"
134420231124,134,2023-11-24,4,20,10,30,Spen201_T,"-37.81694221, 144.95303935"
135120250309,135,2025-03-09,1,67,45,112,Spen161_T,"-37.8172861, 144.95319102"
124720251016,124,2025-10-16,7,1,3,4,BirBridge_T,"-37.81757416, 144.97329934"
1181020241107,118,2024-11-07,10,10,22,32,Fli114C_T,"-37.81632783, 144.97090512"
872320250805,87,2025-08-05,23,5,7,12,Errol23_T,"-37.80454949, 144.94921863"
1661420250413,166,2025-04-13,14,48,55,103,Spen484_T,"-37.80896733, 144.94931703"
1621920240718,162,2024-07-18,19,180,184,364,Eli489_T,"-37.80740397, 144.95987909"
68320240603,68,2024-06-03,3,1,1,2,FLDegN_T,"-37.8168479, 144.96559789"
85920231219,85,2023-12-19,9,82,60,142,488Mac_T,"-37.79432415, 144.92973378"
17820241110,17,2024-11-10,8,51,38,89,Col15_T,"-37.81362543, 144.97323591"
17720250331,17,2025-03-31,7,364,95,459,Col15_T,"-37.81362543, 144.97323591"
70020240712,70,2024-07-12,0,0,5,5,Errol20_T,"-37.80456984, 144.94946228"
1791920250416,179,2025-04-16,19,70,62,132,Pow61_T,"-37.82392385, 144.96299677"
1651420250618,165,2025-06-18,14,34,24,58,Spen475_T,"-37.80953359, 144.94939004"
162420250529,162,2025-05-29,4,11,7,18,Eli489_T,"-37.80740397, 144.95987909"
1321920250701,132,2025-07-01,19,82,108,190,King335_T,"-37.81267639, 144.95386444"
132020240229,132,2024-02-29,0,31,25,56,King335_T,"-37.81267639, 144.95386444"
134520231023,134,2023-10-23,5,41,64,105,Spen201_T,"-37.81694221, 144.95303935"
181220250729,18,2025-07-29,12,277,228,505,Col12_T,"-37.81344862, 144.97305353"
86920250828,86,2025-08-28,9,53,37,90,574Qub_T,"-37.80309992, 144.94908064"
241020241009,24,2024-10-09,10,633,290,923,Col620_T,"-37.81887963, 144.95449198"
24720250323,24,2025-03-23,7,107,152,259,Col620_T,"-37.81887963, 144.95449198"
101620240529,10,2024-05-29,16,265,51,316,BouHbr_T,"-37.81876474, 144.94710545"
72020231030,72,2023-10-30,0,15,11,26,ACMI_T,"-37.81726338, 144.96872809"
582220240226,58,2024-02-26,22,165,154,319,Bou688_T,"-37.81686075, 144.95358075"
791120250908,79,2025-09-08,11,277,288,565,FliSS_T,"-37.81794046, 144.96616678"
791320250614,79,2025-06-14,13,658,525,1183,FliSS_T,"-37.81794046, 144.96616678"
52620241226,52,2024-12-26,6,12,8,20,Eli263_T,"-37.81252157, 144.9619401"
1392220250208,139,2025-02-08,22,44,17,61,Signal1647_T,"-37.81959923, 144.9632832"
1361620240211,136,2024-02-11,16,32,88,120,BirFed1120_T,"-37.8184141, 144.97357915"
1361320240829,136,2024-08-29,13,87,40,127,BirFed1120_T,"-37.8184141, 144.97357915"
1422220240121,142,2024-01-21,22,133,200,333,Hammer1584_T,"-37.81970749, 144.96795734"
130020241111,130,2024-11-11,0,0,1,1,Bou892T,"-37.8204637, 144.94126826"
1231120231225,123,2023-12-25,11,19,5,24,BirBridge_T,"-37.81753741, 144.97329734"
1171220231031,117,2023-10-31,12,177,178,355,Fli114F_T,"-37.81629332, 144.97090877"
1091120250816,109,2025-08-16,11,96,82,178,LatWill_T,"-37.81193681, 144.95621105"
69120240210,69,2024-02-10,1,3,7,10,FLDegC_T,"-37.81687226, 144.96559144"
4420231117,4,2023-11-17,4,19,26,45,Swa123_T,"-37.81487988, 144.9660878"
70320240305,70,2024-03-05,3,2,3,5,Errol20_T,"-37.80456984, 144.94946228"
701820240903,70,2024-09-03,18,171,224,395,Errol20_T,"-37.80456984, 144.94946228"
751120240229,75,2024-02-29,11,46,43,89,SprFli_T,"-37.81515276, 144.97467661"
39320240303,39,2024-03-03,3,4,11,15,AlfPl_T,"-37.81379749, 144.96995745"
781420250808,78,2025-08-08,14,24,62,86,HarEsB_T,"-37.81471642, 144.9446508"
281620231202,28,2023-12-02,16,538,831,1369,VAC_T,"-37.82129925, 144.96879309"
47620240726,47,2024-07-26,6,40,161,201,Eli250_T,"-37.81258467, 144.9625775"
181220231028,18,2023-10-28,12,111,100,211,Col12_T,"-37.81344862, 144.97305353"
561520231230,56,2023-12-30,15,353,326,679,Lon364_T,"-37.81234775, 144.96153311"
861020250731,86,2025-07-31,10,55,48,103,574Qub_T,"-37.80309992, 144.94908064"
621620240818,62,2024-08-18,16,214,135,349,Lat224_T,"-37.80996494, 144.96216521"
62320250305,62,2025-03-05,3,11,5,16,Lat224_T,"-37.80996494, 144.96216521"
11020250705,11,2025-07-05,0,14,2,16,WatCit_T,"-37.81564989, 144.93970694"
11220250908,11,2025-09-08,2,0,2,2,WatCit_T,"-37.81564989, 144.93970694"
122120250329,12,2025-03-29,21,220,184,404,NewQ_T,"-37.81457988, 144.94292398"
721420250110,72,2025-01-10,14,229,333,562,ACMI_T,"-37.81726338, 144.96872809"
351120231221,35,2023-12-21,11,932,1101,2033,SouthB_T,"-37.82018685, 144.96508508"
2020240327,2,2024-03-27,0,6,22,28,Bou283_T,"-37.81380668, 144.96516718"
272120250602,27,2025-06-02,21,44,22,66,Vic_T,"-37.80606888, 144.95644692"
302220250322,30,2025-03-22,22,385,586,971,Lon189_T,"-37.8112185, 144.96656806"
201020240618,20,2024-06-18,10,80,57,137,LtB170_T,"-37.81172914, 144.9682466"
20720240312,20,2024-03-12,7,26,31,57,LtB170_T,"-37.81172914, 144.9682466"
252020240403,25,2024-04-03,20,146,141,287,MCEC_T,"-37.82401776, 144.95604426"
521120250130,52,2025-01-30,11,155,193,348,Eli263_T,"-37.81252157, 144.9619401"
142920250923,142,2025-09-23,9,157,189,346,Hammer1584_T,"-37.81970749, 144.96795734"
142620240103,142,2024-01-03,6,46,22,68,Hammer1584_T,"-37.81970749, 144.96795734"
142720241011,142,2024-10-11,7,191,199,390,Hammer1584_T,"-37.81970749, 144.96795734"
1611120250829,161,2025-08-29,11,85,56,141,BirArt1109_T,"-37.81851276, 144.97131336"
123920250323,123,2025-03-23,9,53,32,85,BirBridge_T,"-37.81753741, 144.97329734"
491620231230,49,2023-12-30,16,233,470,703,Eli501_T,"-37.80730068, 144.95956055"
69320250325,69,2025-03-25,3,3,5,8,FLDegC_T,"-37.81687226, 144.96559144"
84420241011,84,2024-10-11,4,8,36,44,ElFi_T,"-37.81798049, 144.96503383"
66820240517,66,2024-05-17,8,193,329,522,QVN_T,"-37.81057846, 144.96444294"
4720240828,4,2024-08-28,7,178,100,278,Swa123_T,"-37.81487988, 144.9660878"
41120240903,4,2024-09-03,11,824,711,1535,Swa123_T,"-37.81487988, 144.9660878"
70920240211,70,2024-02-11,9,70,64,134,Errol20_T,"-37.80456984, 144.94946228"
70120240214,70,2024-02-14,1,3,4,7,Errol20_T,"-37.80456984, 144.94946228"
751320250310,75,2025-03-10,13,34,27,61,SprFli_T,"-37.81515276, 144.97467661"
8420240328,8,2024-03-28,4,11,2,13,WebBN_T,"-37.82293543, 144.9471751"
81720240928,8,2024-09-28,17,216,164,380,WebBN_T,"-37.82293543, 144.9471751"
781120250316,78,2025-03-16,11,18,15,33,HarEsB_T,"-37.81471642, 144.9446508"
591020250516,59,2025-05-16,10,980,798,1778,RMIT_T,"-37.80825648, 144.96304859"
711720251002,71,2025-10-02,17,21,29,50,WestWP_T,"-37.81235775, 144.97136962"
141620231122,14,2023-11-22,16,790,185,975,SanBri_T,"-37.82011242, 144.96291897"
292120240605,29,2024-06-05,21,47,60,107,AG_T,"-37.8199817, 144.96872865"
37620231204,37,2023-12-04,6,10,10,20,Lyg260_T,"-37.80107122, 144.96704554"
471820250301,47,2025-03-01,18,980,905,1885,Eli250_T,"-37.81258467, 144.9625775"
40620240824,40,2024-08-24,6,18,13,31,Spr201_T,"-37.80999341, 144.97227587"
401120231108,40,2023-11-08,11,175,270,445,Spr201_T,"-37.80999341, 144.97227587"
5320240501,5,2024-05-01,3,13,3,16,PriNW_T,"-37.81874249, 144.96787656"
501120251013,50,2025-10-13,11,145,155,300,Lyg309_T,"-37.79808192, 144.96721013"
612020231108,61,2023-11-08,20,224,200,424,RMIT14_T,"-37.80767455, 144.96309114"
441620250930,44,2025-09-30,16,99,57,156,UM3_T,"-37.79698741, 144.96441306"
43920250509,43,2025-05-09,9,209,93,302,UM2_T,"-37.79844526, 144.96411782"
1321220241207,132,2024-12-07,12,153,143,296,King335_T,"-37.81267639, 144.95386444"
1342120250403,134,2025-04-03,21,113,73,186,Spen201_T,"-37.81694221, 144.95303935"
1341220250711,134,2025-07-11,12,465,460,925,Spen201_T,"-37.81694221, 144.95303935"
135820250423,135,2025-04-23,8,258,367,625,Spen161_T,"-37.8172861, 144.95319102"
1231320250215,123,2025-02-15,13,31,11,42,BirBridge_T,"-37.81753741, 144.97329734"
191220250829,19,2025-08-29,12,368,349,717,LtB210_T,"-37.81237202, 144.96550671"
492120250908,49,2025-09-08,21,155,113,268,Eli501_T,"-37.80730068, 144.95956055"
192320240831,19,2024-08-31,23,333,338,671,LtB210_T,"-37.81237202, 144.96550671"
682320250523,68,2025-05-23,23,62,66,128,FLDegN_T,"-37.8168479, 144.96559789"
18220231224,18,2023-12-24,2,1,0,1,Col12_T,"-37.81344862, 144.97305353"
861320240405,86,2024-04-05,13,66,100,166,574Qub_T,"-37.80309992, 144.94908064"
86920250326,86,2025-03-26,9,45,28,73,574Qub_T,"-37.80309992, 144.94908064"
561620240620,56,2024-06-20,16,274,243,517,Lon364_T,"-37.81234775, 144.96153311"
56520250427,56,2025-04-27,5,29,15,44,Lon364_T,"-37.81234775, 144.96153311"
10420231216,10,2023-12-16,4,0,1,1,BouHbr_T,"-37.81876474, 144.94710545"
351420240516,35,2024-05-16,14,885,974,1859,SouthB_T,"-37.82018685, 144.96508508"
352220250207,35,2025-02-07,22,1013,1347,2360,SouthB_T,"-37.82018685, 144.96508508"
532220240825,53,2024-08-25,22,46,60,106,Col254_T,"-37.81564191, 144.965499"
9920241006,9,2024-10-06,9,52,26,78,Col700_T,"-37.81982992, 144.95102555"
301020250131,30,2025-01-31,10,80,142,222,Lon189_T,"-37.8112185, 144.96656806"
79020240103,79,2024-01-03,0,65,53,118,FliSS_T,"-37.81794046, 144.96616678"
512120250129,51,2025-01-29,21,53,74,127,Fra118_T,"-37.80841815, 144.95906316"
51220250619,51,2025-06-19,2,8,6,14,Fra118_T,"-37.80841815, 144.95906316"
251520240912,25,2024-09-12,15,4,16,20,MCEC_T,"-37.82401776, 144.95604426"
252120250913,25,2025-09-13,21,544,485,1029,MCEC_T,"-37.82401776, 144.95604426"
201320240505,20,2024-05-05,13,316,391,707,LtB170_T,"-37.81172914, 144.9682466"
461920250613,46,2025-06-13,19,3,2,5,Pel147_T,"-37.80240719, 144.9615673"
84420231106,84,2023-11-06,4,22,25,47,ElFi_T,"-37.81798049, 144.96503383"
841120241009,84,2024-10-09,11,883,728,1611,ElFi_T,"-37.81798049, 144.96503383"
842020241025,84,2024-10-25,20,704,1056,1760,ElFi_T,"-37.81798049, 144.96503383"
42220241108,4,2024-11-08,22,796,911,1707,Swa123_T,"-37.81487988, 144.9660878"
702220240821,70,2024-08-21,22,137,69,206,Errol20_T,"-37.80456984, 144.94946228"
701720250304,70,2025-03-04,17,152,141,293,Errol20_T,"-37.80456984, 144.94946228"
70120250621,70,2025-06-21,1,1,1,2,Errol20_T,"-37.80456984, 144.94946228"
75620240514,75,2024-05-14,6,34,17,51,SprFli_T,"-37.81515276, 144.97467661"
77520241221,77,2024-12-21,5,3,6,9,HarEsP_T,"-37.81441438, 144.94433026"
771220250525,77,2025-05-25,12,206,127,333,HarEsP_T,"-37.81441438, 144.94433026"
77120250711,77,2025-07-11,1,4,1,5,HarEsP_T,"-37.81441438, 144.94433026"
78820240507,78,2024-05-07,8,142,60,202,HarEsB_T,"-37.81471642, 144.9446508"
771820231021,77,2023-10-21,18,285,1410,1695,HarEsP_T,"-37.81441438, 144.94433026"
591320250408,59,2025-04-08,13,944,1234,2178,RMIT_T,"-37.80825648, 144.96304859"
59420240331,59,2024-03-31,4,40,13,53,RMIT_T,"-37.80825648, 144.96304859"
311820241214,31,2024-12-14,18,275,202,477,Lyg161_T,"-37.80169681, 144.96658911"
54620240516,54,2024-05-16,6,19,13,32,Swa607_T,"-37.804024, 144.96308399"
36820240121,36,2024-01-21,8,31,42,73,Que85_T,"-37.81652527, 144.96121062"
361020240313,36,2024-03-13,10,201,169,370,Que85_T,"-37.81652527, 144.96121062"
21820231104,21,2023-11-04,8,52,54,106,Bourke155_T,"-37.81267313, 144.96788288"
1181620250924,118,2025-09-24,16,7,36,43,Fli114C_T,"-37.81632783, 144.97090512"
1082020241110,108,2024-11-10,20,46,61,107,261Will_T,"-37.81295822, 144.95678789"
681520250206,68,2025-02-06,15,295,182,477,FLDegN_T,"-37.8168479, 144.96559789"
85520240908,85,2024-09-08,5,2,1,3,488Mac_T,"-37.79432415, 144.92973378"
85520250107,85,2025-01-07,5,5,0,5,488Mac_T,"-37.79432415, 144.92973378"
171920250403,17,2025-04-03,19,135,198,333,Col15_T,"-37.81362543, 144.97323591"
672120240513,67,2024-05-13,21,56,103,159,FLDegS_T,"-37.81688755, 144.96562569"
621220240502,62,2024-05-02,12,257,170,427,Lat224_T,"-37.80996494, 144.96216521"
56320231226,56,2023-12-26,3,8,24,32,Lon364_T,"-37.81234775, 144.96153311"
111920240604,11,2024-06-04,19,47,53,100,WatCit_T,"-37.81564989, 144.93970694"
122020231102,12,2023-11-02,20,185,146,331,NewQ_T,"-37.81457988, 144.94292398"
10720240424,10,2024-04-24,7,31,125,156,BouHbr_T,"-37.81876474, 144.94710545"
721020240804,72,2024-08-04,10,78,188,266,ACMI_T,"-37.81726338, 144.96872809"
721820231205,72,2023-12-05,18,370,600,970,ACMI_T,"-37.81726338, 144.96872809"
761720240514,76,2024-05-14,17,65,88,153,KenMac_T,"-37.79453803, 144.93036194"
351220250207,35,2025-02-07,12,1125,1135,2260,SouthB_T,"-37.82018685, 144.96508508"
761120231024,76,2023-10-24,11,55,51,106,KenMac_T,"-37.79453803, 144.93036194"
581520250922,58,2025-09-22,15,490,489,979,Bou688_T,"-37.81686075, 144.95358075"
27720240216,27,2024-02-16,7,49,57,106,Vic_T,"-37.80606888, 144.95644692"
91920250215,9,2025-02-15,19,50,38,88,Col700_T,"-37.81982992, 144.95102555"
20320250922,20,2025-09-22,3,1,7,8,LtB170_T,"-37.81172914, 144.9682466"
201920240315,20,2024-03-15,19,543,577,1120,LtB170_T,"-37.81172914, 144.9682466"
19320250914,19,2025-09-14,3,44,74,118,LtB210_T,"-37.81237202, 144.96550671"
1421620240619,142,2024-06-19,16,289,207,496,Hammer1584_T,"-37.81970749, 144.96795734"
1611520240826,161,2024-08-26,15,88,65,153,BirArt1109_T,"-37.81851276, 144.97131336"
161620241015,161,2024-10-15,6,71,75,146,BirArt1109_T,"-37.81851276, 144.97131336"
1381520240607,138,2024-06-07,15,9,5,14,EntPark1671_T,"-37.81996544, 144.95981454"
492320240808,49,2024-08-08,23,83,55,138,Eli501_T,"-37.80730068, 144.95956055"
21820231115,21,2023-11-15,8,116,139,255,Bourke155_T,"-37.81267313, 144.96788288"
133520240318,133,2024-03-18,5,70,116,186,Spen229_T,"-37.81531435, 144.95227769"
1081620250706,108,2025-07-06,16,121,145,266,261Will_T,"-37.81295822, 144.95678789"
611820250326,61,2025-03-26,18,945,1168,2113,RMIT14_T,"-37.80767455, 144.96309114"
131420250910,131,2025-09-10,4,5,4,9,King2_T,"-37.82009057, 144.95758725"
132720240725,132,2024-07-25,7,60,40,100,King335_T,"-37.81267639, 144.95386444"
1341820231209,134,2023-12-09,18,240,273,513,Spen201_T,"-37.81694221, 144.95303935"
135820250324,135,2025-03-24,8,287,451,738,Spen161_T,"-37.8172861, 144.95319102"
1351520250626,135,2025-06-26,15,351,323,674,Spen161_T,"-37.8172861, 144.95319102"
671720250527,67,2025-05-27,17,299,629,928,FLDegS_T,"-37.81688755, 144.96562569"
681720241231,68,2024-12-31,17,270,253,523,FLDegN_T,"-37.8168479, 144.96559789"
671520240926,67,2024-09-26,15,359,659,1018,FLDegS_T,"-37.81688755, 144.96562569"
181020240412,18,2024-04-12,10,141,215,356,Col12_T,"-37.81344862, 144.97305353"
18220250413,18,2025-04-13,2,9,7,16,Col12_T,"-37.81344862, 144.97305353"
131520240616,131,2024-06-16,5,15,59,74,King2_T,"-37.82009057, 144.95758725"
1352120241126,135,2024-11-26,21,214,261,475,Spen161_T,"-37.8172861, 144.95319102"
107220240826,107,2024-08-26,2,1,2,3,280Will_T,"-37.81246271, 144.95690188"
1072320250325,107,2025-03-25,23,31,27,58,280Will_T,"-37.81246271, 144.95690188"
1241120250401,124,2025-04-01,11,0,2,2,BirBridge_T,"-37.81757416, 144.97329934"
871820240723,87,2024-07-23,18,109,68,177,Errol23_T,"-37.80454949, 144.94921863"
871320240909,87,2024-09-09,13,117,132,249,Errol23_T,"-37.80454949, 144.94921863"
143720251011,143,2025-10-11,7,44,120,164,Spencer_T,"-37.821728, 144.95557015"
172220250425,17,2025-04-25,22,36,39,75,Col15_T,"-37.81362543, 144.97323591"
17420250721,17,2025-07-21,4,10,8,18,Col15_T,"-37.81362543, 144.97323591"
18920241012,18,2024-10-12,9,64,57,121,Col12_T,"-37.81344862, 144.97305353"
18920250515,18,2025-05-15,9,209,699,908,Col12_T,"-37.81344862, 144.97305353"
67120240106,67,2024-01-06,1,21,29,50,FLDegS_T,"-37.81688755, 144.96562569"
561420241111,56,2024-11-11,14,324,293,617,Lon364_T,"-37.81234775, 144.96153311"
56120250512,56,2025-05-12,1,9,10,19,Lon364_T,"-37.81234775, 144.96153311"
241720231018,24,2023-10-18,17,640,2224,2864,Col620_T,"-37.81887963, 144.95449198"
72120231124,72,2023-11-24,1,29,14,43,ACMI_T,"-37.81726338, 144.96872809"
76820240728,76,2024-07-28,8,20,11,31,KenMac_T,"-37.79453803, 144.93036194"
581420240229,58,2024-02-29,14,591,492,1083,Bou688_T,"-37.81686075, 144.95358075"
91020240619,9,2024-06-19,10,183,501,684,Col700_T,"-37.81982992, 144.95102555"
531520250606,53,2025-06-06,15,632,476,1108,Col254_T,"-37.81564191, 144.965499"
531720250829,53,2025-08-29,17,646,473,1119,Col254_T,"-37.81564191, 144.965499"
92320241103,9,2024-11-03,23,771,68,839,Col700_T,"-37.81982992, 144.95102555"
23620231115,23,2023-11-15,6,108,79,187,Col623_T,"-37.81909256, 144.95452748"
302220241210,30,2024-12-10,22,177,251,428,Lon189_T,"-37.8112185, 144.96656806"
791320250618,79,2025-06-18,13,397,339,736,FliSS_T,"-37.81794046, 144.96616678"
511920250717,51,2025-07-17,19,70,77,147,Fra118_T,"-37.80841815, 144.95906316"
511520240630,51,2024-06-30,15,164,119,283,Fra118_T,"-37.80841815, 144.95906316"
23420241019,23,2024-10-19,4,1,10,11,Col623_T,"-37.81909256, 144.95452748"
46820250726,46,2025-07-26,8,21,13,34,Pel147_T,"-37.80240719, 144.9615673"
521920240426,52,2024-04-26,19,476,354,830,Eli263_T,"-37.81252157, 144.9619401"
19520231224,19,2023-12-24,5,12,16,28,LtB210_T,"-37.81237202, 144.96550671"
1371820240823,137,2024-08-23,18,5,8,13,BouHbr2353_T,"-37.81894815, 144.94612292"
1391220241206,139,2024-12-06,12,49,42,91,Signal1647_T,"-37.81959923, 144.9632832"
1391820231211,139,2023-12-11,18,118,48,166,Signal1647_T,"-37.81959923, 144.9632832"
142320240424,142,2024-04-24,3,2,1,3,Hammer1584_T,"-37.81970749, 144.96795734"
1381420240823,138,2024-08-23,14,5,5,10,EntPark1671_T,"-37.81996544, 144.95981454"
1231720240303,123,2024-03-03,17,36,7,43,BirBridge_T,"-37.81753741, 144.97329734"
123820241118,123,2024-11-18,8,7,0,7,BirBridge_T,"-37.81753741, 144.97329734"
1171720240802,117,2024-08-02,17,168,312,480,Fli114F_T,"-37.81629332, 144.97090877"
1092220250717,109,2025-07-17,22,70,47,117,LatWill_T,"-37.81193681, 144.95621105"
6220240706,6,2024-07-06,2,83,49,132,FliS_T,"-37.81911705, 144.96558255"
841820240113,84,2024-01-13,18,887,1129,2016,ElFi_T,"-37.81798049, 144.96503383"
75620241014,75,2024-10-14,6,12,11,23,SprFli_T,"-37.81515276, 144.97467661"
75520250306,75,2025-03-06,5,2,0,2,SprFli_T,"-37.81515276, 144.97467661"
81820231117,8,2023-11-17,18,166,251,417,WebBN_T,"-37.82293543, 144.9471751"
41220250816,41,2025-08-16,2,103,168,271,Swa31,"-37.81668634, 144.96689733"
42220250410,42,2025-04-10,2,2,2,4,UM1_T,"-37.80008566, 144.96386412"
78520240216,78,2024-02-16,5,2,2,4,HarEsB_T,"-37.81471642, 144.9446508"
781720240720,78,2024-07-20,17,12,42,54,HarEsB_T,"-37.81471642, 144.9446508"
591120250618,59,2025-06-18,11,381,393,774,RMIT_T,"-37.80825648, 144.96304859"
181520250809,18,2025-08-09,15,119,89,208,Col12_T,"-37.81344862, 144.97305353"
62020240107,62,2024-01-07,0,140,101,241,Lat224_T,"-37.80996494, 144.96216521"
111620240612,11,2024-06-12,16,32,24,56,WatCit_T,"-37.81564989, 144.93970694"
121620240205,12,2024-02-05,16,110,124,234,NewQ_T,"-37.81457988, 144.94292398"
12420240105,12,2024-01-05,4,5,2,7,NewQ_T,"-37.81457988, 144.94292398"
242220241113,24,2024-11-13,22,171,369,540,Col620_T,"-37.81887963, 144.95449198"
101020240731,10,2024-07-31,10,59,70,129,BouHbr_T,"-37.81876474, 144.94710545"
121820251006,12,2025-10-06,18,159,276,435,NewQ_T,"-37.81457988, 144.94292398"
721620241104,72,2024-11-04,16,142,425,567,ACMI_T,"-37.81726338, 144.96872809"
722020240702,72,2024-07-02,20,29,96,125,ACMI_T,"-37.81726338, 144.96872809"
10920250212,10,2025-02-12,9,68,120,188,BouHbr_T,"-37.81876474, 144.94710545"
352020240308,35,2024-03-08,20,1707,1611,3318,SouthB_T,"-37.82018685, 144.96508508"
582120240401,58,2024-04-01,21,115,91,206,Bou688_T,"-37.81686075, 144.95358075"
22020241117,2,2024-11-17,20,183,399,582,Bou283_T,"-37.81380668, 144.96516718"
581520250505,58,2025-05-05,15,530,492,1022,Bou688_T,"-37.81686075, 144.95358075"
9520240222,9,2024-02-22,5,15,50,65,Col700_T,"-37.81982992, 144.95102555"
9920250707,9,2025-07-07,9,135,1377,1512,Col700_T,"-37.81982992, 144.95102555"
301920250516,30,2025-05-16,19,458,636,1094,Lon189_T,"-37.8112185, 144.96656806"
511220250908,51,2025-09-08,12,114,91,205,Fra118_T,"-37.80841815, 144.95906316"
19020250503,19,2025-05-03,0,139,175,314,LtB210_T,"-37.81237202, 144.96550671"
48920250323,48,2025-03-23,9,179,240,419,QVMQ_T,"-37.80631581, 144.95866697"
48020231204,48,2023-12-04,0,20,10,30,QVMQ_T,"-37.80631581, 144.95866697"
48020240401,48,2024-04-01,0,21,39,60,QVMQ_T,"-37.80631581, 144.95866697"
49820250405,49,2025-04-05,8,169,141,310,Eli501_T,"-37.80730068, 144.95956055"
1411620241111,141,2024-11-11,16,131,121,252,474Fl_T,"-37.81997273, 144.95834911"
1371320240425,137,2024-04-25,13,7,16,23,BouHbr2353_T,"-37.81894815, 144.94612292"
1302120240110,130,2024-01-10,21,1,1,2,Bou892T,"-37.8204637, 144.94126826"
1641620250130,164,2025-01-30,16,152,96,248,Lat526_T,"-37.813005, 144.95160411"
492120241123,49,2024-11-23,21,111,65,176,Eli501_T,"-37.80730068, 144.95956055"
1172220241115,117,2024-11-15,22,175,115,290,Fli114F_T,"-37.81629332, 144.97090877"
1091720240521,109,2024-05-21,17,509,181,690,LatWill_T,"-37.81193681, 144.95621105"
692020250824,69,2025-08-24,20,30,38,68,FLDegC_T,"-37.81687226, 144.96559144"
691620251007,69,2025-10-07,16,162,257,419,FLDegC_T,"-37.81687226, 144.96559144"
842020251013,84,2025-10-13,20,525,694,1219,ElFi_T,"-37.81798049, 144.96503383"
4220241004,4,2024-10-04,2,32,23,55,Swa123_T,"-37.81487988, 144.9660878"
31020240123,3,2024-01-23,10,360,412,772,Swa295_T,"-37.81101524, 144.96429485"
32120240902,3,2024-09-02,21,483,420,903,Swa295_T,"-37.81101524, 144.96429485"
81520240206,8,2024-02-06,15,115,261,376,WebBN_T,"-37.82293543, 144.9471751"
392020250330,39,2025-03-30,20,7,2,9,AlfPl_T,"-37.81379749, 144.96995745"
411820231203,41,2023-12-03,18,1438,1384,2822,Swa31,"-37.81668634, 144.96689733"
54320231221,54,2023-12-21,3,2,5,7,Swa607_T,"-37.804024, 144.96308399"
28320250220,28,2025-02-20,3,2,22,24,VAC_T,"-37.82129925, 144.96879309"
281320241106,28,2024-11-06,13,559,355,914,VAC_T,"-37.82129925, 144.96879309"
402020241209,40,2024-12-09,20,84,62,146,Spr201_T,"-37.80999341, 144.97227587"
402320250403,40,2025-04-03,23,58,5,63,Spr201_T,"-37.80999341, 144.97227587"
402320250420,40,2025-04-20,23,31,11,42,Spr201_T,"-37.80999341, 144.97227587"
361220250705,36,2025-07-05,12,120,170,290,Que85_T,"-37.81652527, 144.96121062"
5220240510,5,2024-05-10,2,0,2,2,PriNW_T,"-37.81874249, 144.96787656"
1332220240913,133,2024-09-13,22,240,211,451,Spen229_T,"-37.81531435, 144.95227769"
1181620241209,118,2024-12-09,16,19,27,46,Fli114C_T,"-37.81632783, 144.97090512"
871420250919,87,2025-09-19,14,97,137,234,Errol23_T,"-37.80454949, 144.94921863"
71120240331,71,2024-03-31,1,4,6,10,WestWP_T,"-37.81235775, 144.97136962"
29520240918,29,2024-09-18,5,10,21,31,AG_T,"-37.8199817, 144.96872865"
541420250725,54,2025-07-25,14,138,217,355,Swa607_T,"-37.804024, 144.96308399"
541920250825,54,2025-08-25,19,150,249,399,Swa607_T,"-37.804024, 144.96308399"
541320240408,54,2024-04-08,13,222,255,477,Swa607_T,"-37.804024, 144.96308399"
541820240504,54,2024-05-04,18,141,154,295,Swa607_T,"-37.804024, 144.96308399"
401420250113,40,2025-01-13,14,189,159,348,Spr201_T,"-37.80999341, 144.97227587"
51920250808,5,2025-08-08,19,791,1538,2329,PriNW_T,"-37.81874249, 144.96787656"
21020240408,21,2024-04-08,0,41,41,82,Bourke155_T,"-37.81267313, 144.96788288"
361220240329,36,2024-03-29,12,128,96,224,Que85_T,"-37.81652527, 144.96121062"
501220241008,50,2024-10-08,12,186,214,400,Lyg309_T,"-37.79808192, 144.96721013"
44220240728,44,2024-07-28,2,2,1,3,UM3_T,"-37.79698741, 144.96441306"
451820250625,45,2025-06-25,18,265,701,966,Swa148_T,"-37.81414075, 144.96609379"
1322120240725,132,2024-07-25,21,62,95,157,King335_T,"-37.81267639, 144.95386444"
143820240617,143,2024-06-17,8,145,287,432,Spencer_T,"-37.821728, 144.95557015"
134420240322,134,2024-03-22,4,31,21,52,Spen201_T,"-37.81694221, 144.95303935"
134320240413,134,2024-04-13,3,46,24,70,Spen201_T,"-37.81694221, 144.95303935"
1081620240903,108,2024-09-03,16,392,206,598,261Will_T,"-37.81295822, 144.95678789"
1081820231209,108,2023-12-09,18,86,79,165,261Will_T,"-37.81295822, 144.95678789"
61620240404,61,2024-04-04,6,21,52,73,RMIT14_T,"-37.80767455, 144.96309114"
611320240808,61,2024-08-08,13,655,558,1213,RMIT14_T,"-37.80767455, 144.96309114"
1401420231211,140,2023-12-11,14,65,56,121,Boyd2837_T,"-37.82590962, 144.96185972"
67820250411,67,2025-04-11,8,255,236,491,FLDegS_T,"-37.81688755, 144.96562569"
561620231022,56,2023-10-22,16,246,143,389,Lon364_T,"-37.81234775, 144.96153311"
861620241028,86,2024-10-28,16,57,54,111,574Qub_T,"-37.80309992, 144.94908064"
861120250225,86,2025-02-25,11,60,62,122,574Qub_T,"-37.80309992, 144.94908064"
622120250429,62,2025-04-29,21,127,121,248,Lat224_T,"-37.80996494, 144.96216521"
561020240930,56,2024-09-30,10,216,147,363,Lon364_T,"-37.81234775, 144.96153311"
112320250609,11,2025-06-09,23,10,13,23,WatCit_T,"-37.81564989, 144.93970694"
24320241011,24,2024-10-11,3,20,20,40,Col620_T,"-37.81887963, 144.95449198"
76720250121,76,2025-01-21,7,43,15,58,KenMac_T,"-37.79453803, 144.93036194"
761720240101,76,2024-01-01,17,39,26,65,KenMac_T,"-37.79453803, 144.93036194"
351120240405,35,2024-04-05,11,842,760,1602,SouthB_T,"-37.82018685, 144.96508508"
582020231228,58,2023-12-28,20,295,228,523,Bou688_T,"-37.81686075, 144.95358075"
231120231125,23,2023-11-25,11,295,448,743,Col623_T,"-37.81909256, 144.95452748"
79020250906,79,2025-09-06,0,133,130,263,FliSS_T,"-37.81794046, 144.96616678"
791920250401,79,2025-04-01,19,319,280,599,FliSS_T,"-37.81794046, 144.96616678"
51420250519,51,2025-05-19,4,6,3,9,Fra118_T,"-37.80841815, 144.95906316"
511220241020,51,2024-10-20,12,175,161,336,Fra118_T,"-37.80841815, 144.95906316"
481520240403,48,2024-04-03,15,121,134,255,QVMQ_T,"-37.80631581, 144.95866697"
482020240705,48,2024-07-05,20,64,166,230,QVMQ_T,"-37.80631581, 144.95866697"
301820251012,30,2025-10-12,18,391,431,822,Lon189_T,"-37.8112185, 144.96656806"
251420241130,25,2024-11-30,14,601,690,1291,MCEC_T,"-37.82401776, 144.95604426"
462020250908,46,2025-09-08,20,2,1,3,Pel147_T,"-37.80240719, 144.9615673"
139520250128,139,2025-01-28,5,2,5,7,Signal1647_T,"-37.81959923, 144.9632832"
139220231121,139,2023-11-21,2,1,1,2,Signal1647_T,"-37.81959923, 144.9632832"
1361720240831,136,2024-08-31,17,55,95,150,BirFed1120_T,"-37.8184141, 144.97357915"
441120241112,44,2024-11-12,11,47,68,115,UM3_T,"-37.79698741, 144.96441306"
1841820250807,184,2025-08-07,18,751,1043,1794,Eli124_T,"-37.81512416, 144.96371988"
1651720251016,165,2025-10-16,17,74,36,110,Spen475_T,"-37.80953359, 144.94939004"
1811720250814,181,2025-08-14,17,1167,1575,2742,Eli368_T,"-37.81009465, 144.96143149"
1401520250927,140,2025-09-27,15,103,78,181,Boyd2837_T,"-37.82590962, 144.96185972"
1621720250114,162,2025-01-14,17,265,411,676,Eli489_T,"-37.80740397, 144.95987909"
162420240714,162,2024-07-14,4,29,30,59,Eli489_T,"-37.80740397, 144.95987909"
1432320250715,143,2025-07-15,23,60,31,91,Spencer_T,"-37.821728, 144.95557015"
133620240813,133,2024-08-13,6,450,195,645,Spen229_T,"-37.81531435, 144.95227769"
18720250412,18,2025-04-12,7,15,18,33,Col12_T,"-37.81344862, 144.97305353"
181920240523,18,2024-05-23,19,0,8,8,Col12_T,"-37.81344862, 144.97305353"
861920241104,86,2024-11-04,19,36,52,88,574Qub_T,"-37.80309992, 144.94908064"
722120250224,72,2025-02-24,21,60,85,145,ACMI_T,"-37.81726338, 144.96872809"
21920240427,2,2024-04-27,19,195,260,455,Bou283_T,"-37.81380668, 144.96516718"
21320250910,2,2025-09-10,13,713,861,1574,Bou283_T,"-37.81380668, 144.96516718"
791220250224,79,2025-02-24,12,473,354,827,FliSS_T,"-37.81794046, 144.96616678"
20320250407,20,2025-04-07,3,1,2,3,LtB170_T,"-37.81172914, 144.9682466"
191920240116,19,2024-01-16,19,463,418,881,LtB210_T,"-37.81237202, 144.96550671"
48720250320,48,2025-03-20,7,87,58,145,QVMQ_T,"-37.80631581, 144.95866697"
301620250918,30,2025-09-18,16,214,399,613,Lon189_T,"-37.8112185, 144.96656806"
251520250318,25,2025-03-18,15,518,503,1021,MCEC_T,"-37.82401776, 144.95604426"
521220250914,52,2025-09-14,12,265,273,538,Eli263_T,"-37.81252157, 144.9619401"
1421520250114,142,2025-01-14,15,497,424,921,Hammer1584_T,"-37.81970749, 144.96795734"
142320240528,142,2024-05-28,3,2,2,4,Hammer1584_T,"-37.81970749, 144.96795734"
142220241016,142,2024-10-16,2,0,1,1,Hammer1584_T,"-37.81970749, 144.96795734"
1641320250320,164,2025-03-20,13,115,91,206,Lat526_T,"-37.813005, 144.95160411"
161920241203,161,2024-12-03,9,66,59,125,BirArt1109_T,"-37.81851276, 144.97131336"
141820240915,141,2024-09-15,8,42,51,93,474Fl_T,"-37.81997273, 144.95834911"
49520240502,49,2024-05-02,5,25,23,48,Eli501_T,"-37.80730068, 144.95956055"
19320250813,19,2025-08-13,3,5,7,12,LtB210_T,"-37.81237202, 144.96550671"
19720241205,19,2024-12-05,7,28,19,47,LtB210_T,"-37.81237202, 144.96550671"
691420240127,69,2024-01-27,14,250,277,527,FLDegC_T,"-37.81687226, 144.96559144"
62120240603,6,2024-06-03,21,343,329,672,FliS_T,"-37.81911705, 144.96558255"
61820240810,6,2024-08-10,18,1150,1181,2331,FliS_T,"-37.81911705, 144.96558255"
84320240330,84,2024-03-30,3,137,168,305,ElFi_T,"-37.81798049, 144.96503383"
841620250726,84,2025-07-26,16,1076,1334,2410,ElFi_T,"-37.81798049, 144.96503383"
42320240128,4,2024-01-28,23,361,155,516,Swa123_T,"-37.81487988, 144.9660878"
41820250423,4,2025-04-23,18,1278,1101,2379,Swa123_T,"-37.81487988, 144.9660878"
701220240214,70,2024-02-14,12,194,203,397,Errol20_T,"-37.80456984, 144.94946228"
39420240811,39,2024-08-11,4,1,4,5,AlfPl_T,"-37.81379749, 144.96995745"
391120240229,39,2024-02-29,11,191,137,328,AlfPl_T,"-37.81379749, 144.96995745"
75720251012,75,2025-10-12,7,42,98,140,SprFli_T,"-37.81515276, 144.97467661"
8120240302,8,2024-03-02,1,2,7,9,WebBN_T,"-37.82293543, 144.9471751"
781520240221,78,2024-02-21,15,42,83,125,HarEsB_T,"-37.81471642, 144.9446508"
78020240406,78,2024-04-06,0,2,3,5,HarEsB_T,"-37.81471642, 144.9446508"
771520240628,77,2024-06-28,15,243,156,399,HarEsP_T,"-37.81441438, 144.94433026"
421320240731,42,2024-07-31,13,493,581,1074,UM1_T,"-37.80008566, 144.96386412"
421420241006,42,2024-10-06,14,130,85,215,UM1_T,"-37.80008566, 144.96386412"
781420250707,78,2025-07-07,14,37,101,138,HarEsB_T,"-37.81471642, 144.9446508"
1642020251002,164,2025-10-02,20,16,59,75,Lat526_T,"-37.813005, 144.95160411"
1381720231219,138,2023-12-19,17,13,3,16,EntPark1671_T,"-37.81996544, 144.95981454"
1171020250629,117,2025-06-29,10,67,116,183,Fli114F_T,"-37.81629332, 144.97090877"
1232120231202,123,2023-12-02,21,1,0,1,BirBridge_T,"-37.81753741, 144.97329734"
1091520240710,109,2024-07-10,15,266,151,417,LatWill_T,"-37.81193681, 144.95621105"
191120250420,19,2025-04-20,11,385,287,672,LtB210_T,"-37.81237202, 144.96550671"
66420250826,66,2025-08-26,4,5,8,13,QVN_T,"-37.81057846, 144.96444294"
69420240807,69,2024-08-07,4,3,3,6,FLDegC_T,"-37.81687226, 144.96559144"
842220231129,84,2023-11-29,22,393,574,967,ElFi_T,"-37.81798049, 144.96503383"
701420250423,70,2025-04-23,14,102,117,219,Errol20_T,"-37.80456984, 144.94946228"
701920250727,70,2025-07-27,19,104,117,221,Errol20_T,"-37.80456984, 144.94946228"
391020250930,39,2025-09-30,10,78,86,164,AlfPl_T,"-37.81379749, 144.96995745"
391120240315,39,2024-03-15,11,133,94,227,AlfPl_T,"-37.81379749, 144.96995745"
412020240131,41,2024-01-31,20,604,843,1447,Swa31,"-37.81668634, 144.96689733"
411320240807,41,2024-08-07,13,398,407,805,Swa31,"-37.81668634, 144.96689733"
42020250707,42,2025-07-07,0,5,5,10,UM1_T,"-37.80008566, 144.96386412"
771120250722,77,2025-07-22,11,26,19,45,HarEsP_T,"-37.81441438, 144.94433026"
77420240921,77,2024-09-21,4,0,2,2,HarEsP_T,"-37.81441438, 144.94433026"
59420240421,59,2024-04-21,4,60,6,66,RMIT_T,"-37.80825648, 144.96304859"
711020240204,71,2024-02-04,10,7,1,8,WestWP_T,"-37.81235775, 144.97136962"
282120250125,28,2025-01-25,21,666,319,985,VAC_T,"-37.82129925, 144.96879309"
28520240219,28,2024-02-19,5,23,36,59,VAC_T,"-37.82129925, 144.96879309"
29420231122,29,2023-11-22,4,2,3,5,AG_T,"-37.8199817, 144.96872865"
311920241211,31,2024-12-11,19,202,165,367,Lyg161_T,"-37.80169681, 144.96658911"
401420250516,40,2025-05-16,14,209,150,359,Spr201_T,"-37.80999341, 144.97227587"
211120240807,21,2024-08-07,11,312,212,524,Bourke155_T,"-37.81267313, 144.96788288"
361120250403,36,2025-04-03,11,168,142,310,Que85_T,"-37.81652527, 144.96121062"
371120241126,37,2024-11-26,11,70,84,154,Lyg260_T,"-37.80107122, 144.96704554"
371320250216,37,2025-02-16,13,67,75,142,Lyg260_T,"-37.80107122, 144.96704554"
451620250628,45,2025-06-28,16,761,1061,1822,Swa148_T,"-37.81414075, 144.96609379"
452020250724,45,2025-07-24,20,259,624,883,Swa148_T,"-37.81414075, 144.96609379"
1322120250514,132,2025-05-14,21,85,100,185,King335_T,"-37.81267639, 144.95386444"
132620240801,132,2024-08-01,6,19,10,29,King335_T,"-37.81267639, 144.95386444"
134720231201,134,2023-12-01,7,340,251,591,Spen201_T,"-37.81694221, 144.95303935"
135220250727,135,2025-07-27,2,42,50,92,Spen161_T,"-37.8172861, 144.95319102"
1312020231106,131,2023-11-06,20,85,67,152,King2_T,"-37.82009057, 144.95758725"
1312320231121,131,2023-11-21,23,2,1,3,King2_T,"-37.82009057, 144.95758725"
135220240530,135,2024-05-30,2,6,10,16,Spen161_T,"-37.8172861, 144.95319102"
107520250930,107,2025-09-30,5,7,11,18,280Will_T,"-37.81246271, 144.95690188"
1331720250919,133,2025-09-19,17,686,617,1303,Spen229_T,"-37.81531435, 144.95227769"
118920251011,118,2025-10-11,9,4,14,18,Fli114C_T,"-37.81632783, 144.97090512"
1182320231119,118,2023-11-19,23,0,1,1,Fli114C_T,"-37.81632783, 144.97090512"
1181520240103,118,2024-01-03,15,29,20,49,Fli114C_T,"-37.81632783, 144.97090512"
1181720240417,118,2024-04-17,17,28,55,83,Fli114C_T,"-37.81632783, 144.97090512"
1081520241115,108,2024-11-15,15,312,213,525,261Will_T,"-37.81295822, 144.95678789"
166620250217,166,2025-02-17,6,2,12,14,Spen484_T,"-37.80896733, 144.94931703"
1792220250404,179,2025-04-04,22,38,92,130,Pow61_T,"-37.82392385, 144.96299677"
179420250906,179,2025-09-06,4,5,7,12,Pow61_T,"-37.82392385, 144.96299677"
1401420250122,140,2025-01-22,14,80,59,139,Boyd2837_T,"-37.82590962, 144.96185972"
162720250917,162,2025-09-17,7,117,97,214,Eli489_T,"-37.80740397, 144.95987909"
162220251013,162,2025-10-13,2,26,19,45,Eli489_T,"-37.80740397, 144.95987909"
1391720231127,139,2023-11-27,17,249,53,302,Signal1647_T,"-37.81959923, 144.9632832"
1361320240402,136,2024-04-02,13,73,59,132,BirFed1120_T,"-37.8184141, 144.97357915"
1301620250520,130,2025-05-20,16,55,50,105,Bou892T,"-37.8204637, 144.94126826"
164520250105,164,2025-01-05,5,0,5,5,Lat526_T,"-37.813005, 144.95160411"
1382020250402,138,2025-04-02,20,0,1,1,EntPark1671_T,"-37.81996544, 144.95981454"
1231220250228,123,2025-02-28,12,31,34,65,BirBridge_T,"-37.81753741, 144.97329734"
117220231229,117,2023-12-29,2,15,11,26,Fli114F_T,"-37.81629332, 144.97090877"
1091520240813,109,2024-08-13,15,267,137,404,LatWill_T,"-37.81193681, 144.95621105"
67720240530,67,2024-05-30,7,145,117,262,FLDegS_T,"-37.81688755, 144.96562569"
172020250623,17,2025-06-23,20,43,79,122,Col15_T,"-37.81362543, 144.97323591"
11320240410,1,2024-04-10,13,1655,1445,3100,Bou292_T,"-37.81349441, 144.96515323"
182120240208,18,2024-02-08,21,10,11,21,Col12_T,"-37.81344862, 144.97305353"
631520250819,63,2025-08-19,15,287,394,681,Bou231_T,"-37.81333081, 144.96675571"
561220240524,56,2024-05-24,12,386,337,723,Lon364_T,"-37.81234775, 144.96153311"
56020240704,56,2024-07-04,0,15,27,42,Lon364_T,"-37.81234775, 144.96153311"
561320250125,56,2025-01-25,13,411,293,704,Lon364_T,"-37.81234775, 144.96153311"
112120240119,11,2024-01-19,21,154,142,296,WatCit_T,"-37.81564989, 144.93970694"
111920240704,11,2024-07-04,19,52,35,87,WatCit_T,"-37.81564989, 144.93970694"
111320240817,11,2024-08-17,13,105,88,193,WatCit_T,"-37.81564989, 144.93970694"
101920241109,10,2024-11-09,19,74,71,145,BouHbr_T,"-37.81876474, 144.94710545"
241420240104,24,2024-01-04,14,214,302,516,Col620_T,"-37.81887963, 144.95449198"
121120250521,12,2025-05-21,11,84,106,190,NewQ_T,"-37.81457988, 144.94292398"
24620241005,24,2024-10-05,6,94,115,209,Col620_T,"-37.81887963, 144.95449198"
242320250107,24,2025-01-07,23,101,155,256,Col620_T,"-37.81887963, 144.95449198"
35020231031,35,2023-10-31,0,24,89,113,SouthB_T,"-37.82018685, 144.96508508"
58320241210,58,2024-12-10,3,6,7,13,Bou688_T,"-37.81686075, 144.95358075"
22020250919,2,2025-09-19,20,579,546,1125,Bou283_T,"-37.81380668, 144.96516718"
2020250926,2,2025-09-26,0,42,116,158,Bou283_T,"-37.81380668, 144.96516718"
23920231128,23,2023-11-28,9,477,252,729,Col623_T,"-37.81909256, 144.95452748"
79720250322,79,2025-03-22,7,100,84,184,FliSS_T,"-37.81794046, 144.96616678"
79420250410,79,2025-04-10,4,13,11,24,FliSS_T,"-37.81794046, 144.96616678"
511120240307,51,2024-03-07,11,162,119,281,Fra118_T,"-37.80841815, 144.95906316"
231420240511,23,2024-05-11,14,199,247,446,Col623_T,"-37.81909256, 144.95452748"
481720240812,48,2024-08-12,17,146,125,271,QVMQ_T,"-37.80631581, 144.95866697"
20520241223,20,2024-12-23,5,4,4,8,LtB170_T,"-37.81172914, 144.9682466"
48220231222,48,2023-12-22,2,4,21,25,QVMQ_T,"-37.80631581, 144.95866697"
301720251011,30,2025-10-11,17,453,507,960,Lon189_T,"-37.8112185, 144.96656806"
20220240614,20,2024-06-14,2,41,26,67,LtB170_T,"-37.81172914, 144.9682466"
371420241120,37,2024-11-20,14,105,89,194,Lyg260_T,"-37.80107122, 144.96704554"
501420250903,50,2025-09-03,14,164,137,301,Lyg309_T,"-37.79808192, 144.96721013"
108620241216,108,2024-12-16,6,22,182,204,261Will_T,"-37.81295822, 144.95678789"
1072020231124,107,2023-11-24,20,70,97,167,280Will_T,"-37.81246271, 144.95690188"
1341720251001,134,2025-10-01,17,595,528,1123,Spen201_T,"-37.81694221, 144.95303935"
1072020240516,107,2024-05-16,20,60,65,125,280Will_T,"-37.81246271, 144.95690188"
1071920250206,107,2025-02-06,19,92,99,191,280Will_T,"-37.81246271, 144.95690188"
1071520250426,107,2025-04-26,15,115,156,271,280Will_T,"-37.81246271, 144.95690188"
1181720240327,118,2024-03-27,17,33,51,84,Fli114C_T,"-37.81632783, 144.97090512"
611020250223,61,2025-02-23,10,230,494,724,RMIT14_T,"-37.80767455, 144.96309114"
1811320250810,181,2025-08-10,13,978,1379,2357,Eli368_T,"-37.81009465, 144.96143149"
66720240815,66,2024-08-15,7,81,234,315,QVN_T,"-37.81057846, 144.96444294"
691420240717,69,2024-07-17,14,208,183,391,FLDegC_T,"-37.81687226, 144.96559144"
32320241206,3,2024-12-06,23,515,463,978,Swa295_T,"-37.81101524, 144.96429485"
4820250412,4,2025-04-12,8,301,229,530,Swa123_T,"-37.81487988, 144.9660878"
81120231111,8,2023-11-11,11,129,213,342,WebBN_T,"-37.82293543, 144.9471751"
392120250105,39,2025-01-05,21,6,1,7,AlfPl_T,"-37.81379749, 144.96995745"
39720240219,39,2024-02-19,7,46,41,87,AlfPl_T,"-37.81379749, 144.96995745"
81120250525,8,2025-05-25,11,182,310,492,WebBN_T,"-37.82293543, 144.9471751"
47820231119,47,2023-11-19,8,118,196,314,Eli250_T,"-37.81258467, 144.9625775"
211720250401,21,2025-04-01,17,484,406,890,Bourke155_T,"-37.81267313, 144.96788288"
361120231231,36,2023-12-31,11,74,71,145,Que85_T,"-37.81652527, 144.96121062"
441020250327,44,2025-03-27,10,83,99,182,UM3_T,"-37.79698741, 144.96441306"
44220240713,44,2024-07-13,2,0,4,4,UM3_T,"-37.79698741, 144.96441306"
451520250321,45,2025-03-21,15,469,862,1331,Swa148_T,"-37.81414075, 144.96609379"
1401720241023,140,2024-10-23,17,112,160,272,Boyd2837_T,"-37.82590962, 144.96185972"
1341920240416,134,2024-04-16,19,242,215,457,Spen201_T,"-37.81694221, 144.95303935"
1341420240930,134,2024-09-30,14,506,434,940,Spen201_T,"-37.81694221, 144.95303935"
1342020250410,134,2025-04-10,20,325,280,605,Spen201_T,"-37.81694221, 144.95303935"
1352320240714,135,2024-07-14,23,24,13,37,Spen161_T,"-37.8172861, 144.95319102"
1181420241202,118,2024-12-02,14,16,22,38,Fli114C_T,"-37.81632783, 144.97090512"
108620240722,108,2024-07-22,6,7,150,157,261Will_T,"-37.81295822, 144.95678789"
851920250314,85,2025-03-14,19,98,107,205,488Mac_T,"-37.79432415, 144.92973378"
852020251006,85,2025-10-06,20,21,31,52,488Mac_T,"-37.79432415, 144.92973378"
17120231123,17,2023-11-23,1,9,10,19,Col15_T,"-37.81362543, 144.97323591"
681320240903,68,2024-09-03,13,339,228,567,FLDegN_T,"-37.8168479, 144.96559789"
86620240513,86,2024-05-13,6,7,3,10,574Qub_T,"-37.80309992, 144.94908064"
56420240619,56,2024-06-19,4,2,0,2,Lon364_T,"-37.81234775, 144.96153311"
11620250220,11,2025-02-20,6,18,24,42,WatCit_T,"-37.81564989, 144.93970694"
11820250902,11,2025-09-02,8,82,66,148,WatCit_T,"-37.81564989, 144.93970694"
35720231215,35,2023-12-15,7,397,502,899,SouthB_T,"-37.82018685, 144.96508508"
352120240416,35,2024-04-16,21,393,734,1127,SouthB_T,"-37.82018685, 144.96508508"
721420241011,72,2024-10-11,14,178,292,470,ACMI_T,"-37.81726338, 144.96872809"
351920240601,35,2024-06-01,19,1017,1505,2522,SouthB_T,"-37.82018685, 144.96508508"
35220240904,35,2024-09-04,2,8,10,18,SouthB_T,"-37.82018685, 144.96508508"
351120250725,35,2025-07-25,11,1334,1273,2607,SouthB_T,"-37.82018685, 144.96508508"
91020240704,9,2024-07-04,10,192,469,661,Col700_T,"-37.81982992, 144.95102555"
521520241125,52,2024-11-25,15,378,202,580,Eli263_T,"-37.81252157, 144.9619401"
1231520240407,123,2024-04-07,15,24,9,33,BirBridge_T,"-37.81753741, 144.97329734"
1411820240111,141,2024-01-11,18,106,112,218,474Fl_T,"-37.81997273, 144.95834911"
1412320241209,141,2024-12-09,23,27,48,75,474Fl_T,"-37.81997273, 144.95834911"
491020240427,49,2024-04-27,10,395,560,955,Eli501_T,"-37.80730068, 144.95956055"
109420240501,109,2024-05-01,4,4,0,4,LatWill_T,"-37.81193681, 144.95621105"
19420240222,19,2024-02-22,4,7,7,14,LtB210_T,"-37.81237202, 144.96550671"
482220250328,48,2025-03-28,22,41,106,147,QVMQ_T,"-37.80631581, 144.95866697"
872020240905,87,2024-09-05,20,49,56,105,Errol23_T,"-37.80454949, 144.94921863"
612120250915,61,2025-09-15,21,204,170,374,RMIT14_T,"-37.80767455, 144.96309114"
441520240608,44,2024-06-08,15,51,43,94,UM3_T,"-37.79698741, 144.96441306"
44320241115,44,2024-11-15,3,2,0,2,UM3_T,"-37.79698741, 144.96441306"
431320250127,43,2025-01-27,13,24,27,51,UM2_T,"-37.79844526, 144.96411782"
1431520250814,143,2025-08-14,15,155,257,412,Spencer_T,"-37.821728, 144.95557015"
1351920240511,135,2024-05-11,19,164,1372,1536,Spen161_T,"-37.8172861, 144.95319102"
1351320240905,135,2024-09-05,13,501,461,962,Spen161_T,"-37.8172861, 144.95319102"
85720250226,85,2025-02-26,7,79,21,100,488Mac_T,"-37.79432415, 144.92973378"
17020231113,17,2023-11-13,0,11,14,25,Col15_T,"-37.81362543, 144.97323591"
11220231222,1,2023-12-22,12,1231,1838,3069,Bou292_T,"-37.81349441, 144.96515323"
63320231229,63,2023-12-29,3,10,60,70,Bou231_T,"-37.81333081, 144.96675571"
862120250909,86,2025-09-09,21,8,38,46,574Qub_T,"-37.80309992, 144.94908064"
111920240520,11,2024-05-20,19,10,16,26,WatCit_T,"-37.81564989, 144.93970694"
111620240524,11,2024-05-24,16,206,105,311,WatCit_T,"-37.81564989, 144.93970694"
121420241027,12,2024-10-27,14,169,181,350,NewQ_T,"-37.81457988, 144.94292398"
122320240313,12,2024-03-13,23,80,1261,1341,NewQ_T,"-37.81457988, 144.94292398"
101920241012,10,2024-10-12,19,84,61,145,BouHbr_T,"-37.81876474, 144.94710545"
241320250628,24,2025-06-28,13,1,6,7,Col620_T,"-37.81887963, 144.95449198"
72920250704,72,2025-07-04,9,259,100,359,ACMI_T,"-37.81726338, 144.96872809"
76320241129,76,2024-11-29,3,1,1,2,KenMac_T,"-37.79453803, 144.93036194"
351120241005,35,2024-10-05,11,1302,1241,2543,SouthB_T,"-37.82018685, 144.96508508"
351620231205,35,2023-12-05,16,1374,1159,2533,SouthB_T,"-37.82018685, 144.96508508"
35020250702,35,2025-07-02,0,17,29,46,SouthB_T,"-37.82018685, 144.96508508"
271320240609,27,2024-06-09,13,350,339,689,Vic_T,"-37.80606888, 144.95644692"
271420240830,27,2024-08-30,14,159,113,272,Vic_T,"-37.80606888, 144.95644692"
9720240830,9,2024-08-30,7,47,700,747,Col700_T,"-37.81982992, 144.95102555"
23320240420,23,2024-04-20,3,14,18,32,Col623_T,"-37.81909256, 144.95452748"
231820241019,23,2024-10-19,18,126,171,297,Col623_T,"-37.81909256, 144.95452748"
52820240804,52,2024-08-04,8,24,35,59,Eli263_T,"-37.81252157, 144.9619401"
46520241208,46,2024-12-08,5,1,1,2,Pel147_T,"-37.80240719, 144.9615673"
53320250113,53,2025-01-13,3,2,0,2,Col254_T,"-37.81564191, 144.965499"
49520240508,49,2024-05-08,5,33,27,60,Eli501_T,"-37.80730068, 144.95956055"
48720240914,48,2024-09-14,7,50,66,116,QVMQ_T,"-37.80631581, 144.95866697"
48920241120,48,2024-11-20,9,100,99,199,QVMQ_T,"-37.80631581, 144.95866697"
1361220250209,136,2025-02-09,12,58,46,104,BirFed1120_T,"-37.8184141, 144.97357915"
136620250726,136,2025-07-26,6,2,0,2,BirFed1120_T,"-37.8184141, 144.97357915"
130620250317,130,2025-03-17,6,5,4,9,Bou892T,"-37.8204637, 144.94126826"
130720250424,130,2025-04-24,7,13,19,32,Bou892T,"-37.8204637, 144.94126826"
1381520241008,138,2024-10-08,15,5,4,9,EntPark1671_T,"-37.81996544, 144.95981454"
1092320250914,109,2025-09-14,23,17,17,34,LatWill_T,"-37.81193681, 144.95621105"
66020250719,66,2025-07-19,0,165,116,281,QVN_T,"-37.81057846, 144.96444294"
84720250704,84,2025-07-04,7,496,171,667,ElFi_T,"-37.81798049, 144.96503383"
78020250107,78,2025-01-07,0,1,1,2,HarEsB_T,"-37.81471642, 144.9446508"
781320250524,78,2025-05-24,13,33,88,121,HarEsB_T,"-37.81471642, 144.9446508"
652120231209,65,2023-12-09,21,232,291,523,SwaCs_T,"-37.81569416, 144.9668064"
311820240218,31,2024-02-18,18,334,272,606,Lyg161_T,"-37.80169681, 144.96658911"
312120250423,31,2025-04-23,21,163,200,363,Lyg161_T,"-37.80169681, 144.96658911"
51120241129,5,2024-11-29,11,490,846,1336,PriNW_T,"-37.81874249, 144.96787656"
21420231111,21,2023-11-11,4,36,39,75,Bourke155_T,"-37.81267313, 144.96788288"
36720250309,36,2025-03-09,7,31,19,50,Que85_T,"-37.81652527, 144.96121062"
851720240107,85,2024-01-07,17,33,27,60,488Mac_T,"-37.79432415, 144.92973378"
631020250809,63,2025-08-09,10,188,319,507,Bou231_T,"-37.81333081, 144.96675571"
861520240822,86,2024-08-22,15,57,79,136,574Qub_T,"-37.80309992, 144.94908064"
861120241025,86,2024-10-25,11,44,36,80,574Qub_T,"-37.80309992, 144.94908064"
621320250705,62,2025-07-05,13,357,300,657,Lat224_T,"-37.80996494, 144.96216521"
101420250226,10,2025-02-26,14,116,65,181,BouHbr_T,"-37.81876474, 144.94710545"
112120250420,11,2025-04-20,21,114,128,242,WatCit_T,"-37.81564989, 144.93970694"
241420250407,24,2025-04-07,14,494,870,1364,Col620_T,"-37.81887963, 144.95449198"
761720231128,76,2023-11-28,17,55,75,130,KenMac_T,"-37.79453803, 144.93036194"
721920240412,72,2024-04-12,19,416,450,866,ACMI_T,"-37.81726338, 144.96872809"
21820240818,2,2024-08-18,18,299,263,562,Bou283_T,"-37.81380668, 144.96516718"
91520240317,9,2024-03-17,15,187,215,402,Col700_T,"-37.81982992, 144.95102555"
27220250707,27,2025-07-07,2,3,3,6,Vic_T,"-37.80606888, 144.95644692"
302320250201,30,2025-02-01,23,345,529,874,Lon189_T,"-37.8112185, 144.96656806"
79220240917,79,2024-09-17,2,13,17,30,FliSS_T,"-37.81794046, 144.96616678"
23920250417,23,2025-04-17,9,399,245,644,Col623_T,"-37.81909256, 144.95452748"
48320240423,48,2024-04-23,3,2,10,12,QVMQ_T,"-37.80631581, 144.95866697"
252320240729,25,2024-07-29,23,25,26,51,MCEC_T,"-37.82401776, 144.95604426"
521820250218,52,2025-02-18,18,325,296,621,Eli263_T,"-37.81252157, 144.9619401"
46720241211,46,2024-12-11,7,26,11,37,Pel147_T,"-37.80240719, 144.9615673"
1371220250909,137,2025-09-09,12,51,115,166,BouHbr2353_T,"-37.81894815, 144.94612292"
141520240827,141,2024-08-27,5,11,7,18,474Fl_T,"-37.81997273, 144.95834911"
1301120241012,130,2024-10-12,11,64,65,129,Bou892T,"-37.8204637, 144.94126826"
142420241207,142,2024-12-07,4,0,1,1,Hammer1584_T,"-37.81970749, 144.96795734"
1232020240209,123,2024-02-09,20,51,11,62,BirBridge_T,"-37.81753741, 144.97329734"
49020231223,49,2023-12-23,0,64,64,128,Eli501_T,"-37.80730068, 144.95956055"
61820241230,6,2024-12-30,18,1107,1116,2223,FliS_T,"-37.81911705, 144.96558255"
70720240326,70,2024-03-26,7,30,26,56,Errol20_T,"-37.80456984, 144.94946228"
75820250422,75,2025-04-22,8,49,51,100,SprFli_T,"-37.81515276, 144.97467661"
391320240605,39,2024-06-05,13,187,189,376,AlfPl_T,"-37.81379749, 144.96995745"
82220240416,8,2024-04-16,22,12,12,24,WebBN_T,"-37.82293543, 144.9471751"
411920250711,41,2025-07-11,19,1349,1189,2538,Swa31,"-37.81668634, 144.96689733"
71820240314,71,2024-03-14,8,23,21,44,WestWP_T,"-37.81235775, 144.97136962"
71620240809,71,2024-08-09,6,32,23,55,WestWP_T,"-37.81235775, 144.97136962"
65620240209,65,2024-02-09,6,63,26,89,SwaCs_T,"-37.81569416, 144.9668064"
541420250815,54,2025-08-15,14,168,238,406,Swa607_T,"-37.804024, 144.96308399"
541420231225,54,2023-12-25,14,41,30,71,Swa607_T,"-37.804024, 144.96308399"
372120240603,37,2024-06-03,21,74,96,170,Lyg260_T,"-37.80107122, 144.96704554"
401120240922,40,2024-09-22,11,122,162,284,Spr201_T,"-37.80999341, 144.97227587"
40720240716,40,2024-07-16,7,86,102,188,Spr201_T,"-37.80999341, 144.97227587"
61620231116,61,2023-11-16,6,56,50,106,RMIT14_T,"-37.80767455, 144.96309114"
442020241004,44,2024-10-04,20,17,37,54,UM3_T,"-37.79698741, 144.96441306"
441220250503,44,2025-05-03,12,33,47,80,UM3_T,"-37.79698741, 144.96441306"
441920250507,44,2025-05-07,19,43,96,139,UM3_T,"-37.79698741, 144.96441306"
44120240603,44,2024-06-03,1,2,0,2,UM3_T,"-37.79698741, 144.96441306"
45020250518,45,2025-05-18,0,145,223,368,Swa148_T,"-37.81414075, 144.96609379"
452220250127,45,2025-01-27,22,76,190,266,Swa148_T,"-37.81414075, 144.96609379"
132220251002,132,2025-10-02,2,3,5,8,King335_T,"-37.81267639, 144.95386444"
1432220240803,143,2024-08-03,22,291,144,435,Spencer_T,"-37.821728, 144.95557015"
135920241201,135,2024-12-01,9,293,326,619,Spen161_T,"-37.8172861, 144.95319102"
1652020250423,165,2025-04-23,20,25,19,44,Spen475_T,"-37.80953359, 144.94939004"
140720240427,140,2024-04-27,7,47,9,56,Boyd2837_T,"-37.82590962, 144.96185972"
851720240210,85,2024-02-10,17,86,72,158,488Mac_T,"-37.79432415, 144.92973378"
851720241206,85,2024-12-06,17,105,118,223,488Mac_T,"-37.79432415, 144.92973378"
12320250819,1,2025-08-19,23,35,58,93,Bou292_T,"-37.81349441, 144.96515323"
631420240117,63,2024-01-17,14,288,377,665,Bou231_T,"-37.81333081, 144.96675571"
63020241103,63,2024-11-03,0,79,145,224,Bou231_T,"-37.81333081, 144.96675571"
862020241214,86,2024-12-14,20,52,64,116,574Qub_T,"-37.80309992, 144.94908064"
671520240428,67,2024-04-28,15,279,445,724,FLDegS_T,"-37.81688755, 144.96562569"
621420250408,62,2025-04-08,14,290,234,524,Lat224_T,"-37.80996494, 144.96216521"
561220250408,56,2025-04-08,12,404,340,744,Lon364_T,"-37.81234775, 144.96153311"
12420240621,12,2024-06-21,4,2,3,5,NewQ_T,"-37.81457988, 144.94292398"
12820250406,12,2025-04-06,8,370,275,645,NewQ_T,"-37.81457988, 144.94292398"
761620240223,76,2024-02-23,16,78,85,163,KenMac_T,"-37.79453803, 144.93036194"
11120240925,11,2024-09-25,1,1,0,1,WatCit_T,"-37.81564989, 144.93970694"
2820250124,2,2025-01-24,8,83,112,195,Bou283_T,"-37.81380668, 144.96516718"
27420240907,27,2024-09-07,4,6,6,12,Vic_T,"-37.80606888, 144.95644692"
92220240511,9,2024-05-11,22,19,57,76,Col700_T,"-37.81982992, 144.95102555"
9520240722,9,2024-07-22,5,10,20,30,Col700_T,"-37.81982992, 144.95102555"
791820251014,79,2025-10-14,18,488,388,876,FliSS_T,"-37.81794046, 144.96616678"
79920240624,79,2024-06-24,9,446,230,676,FliSS_T,"-37.81794046, 144.96616678"
51720240628,51,2024-06-28,7,18,23,41,Fra118_T,"-37.80841815, 144.95906316"
512320240927,51,2024-09-27,23,20,21,41,Fra118_T,"-37.80841815, 144.95906316"
511920240311,51,2024-03-11,19,85,93,178,Fra118_T,"-37.80841815, 144.95906316"
25420250904,25,2025-09-04,4,7,5,12,MCEC_T,"-37.82401776, 144.95604426"
25420240206,25,2024-02-06,4,6,7,13,MCEC_T,"-37.82401776, 144.95604426"
46220240313,46,2024-03-13,2,2,1,3,Pel147_T,"-37.80240719, 144.9615673"
46820240320,46,2024-03-20,8,59,213,272,Pel147_T,"-37.80240719, 144.9615673"
521120231031,52,2023-10-31,11,241,225,466,Eli263_T,"-37.81252157, 144.9619401"
19920240606,19,2024-06-06,9,87,80,167,LtB210_T,"-37.81237202, 144.96550671"
1391120250726,139,2025-07-26,11,100,70,170,Signal1647_T,"-37.81959923, 144.9632832"
1421820250526,142,2025-05-26,18,76,19,95,Hammer1584_T,"-37.81970749, 144.96795734"
1301920240107,130,2024-01-07,19,3,5,8,Bou892T,"-37.8204637, 144.94126826"
164220240912,164,2024-09-12,2,0,2,2,Lat526_T,"-37.813005, 144.95160411"
117320240917,117,2024-09-17,3,1,2,3,Fli114F_T,"-37.81629332, 144.97090877"
1091020240628,109,2024-06-28,10,99,127,226,LatWill_T,"-37.81193681, 144.95621105"
1091320250905,109,2025-09-05,13,172,142,314,LatWill_T,"-37.81193681, 144.95621105"
137920240706,137,2024-07-06,9,6,10,16,BouHbr2353_T,"-37.81894815, 144.94612292"
137820240726,137,2024-07-26,8,84,18,102,BouHbr2353_T,"-37.81894815, 144.94612292"
1392320250822,139,2025-08-22,23,9,20,29,Signal1647_T,"-37.81959923, 144.9632832"
1362120240120,136,2024-01-20,21,40,156,196,BirFed1120_T,"-37.8184141, 144.97357915"
142220250322,142,2025-03-22,2,4,0,4,Hammer1584_T,"-37.81970749, 144.96795734"
661220250612,66,2025-06-12,12,916,1139,2055,QVN_T,"-37.81057846, 144.96444294"
842020250928,84,2025-09-28,20,487,658,1145,ElFi_T,"-37.81798049, 144.96503383"
662320240117,66,2024-01-17,23,202,124,326,QVN_T,"-37.81057846, 144.96444294"
392220240901,39,2024-09-01,22,11,6,17,AlfPl_T,"-37.81379749, 144.96995745"
751220240616,75,2024-06-16,12,61,31,92,SprFli_T,"-37.81515276, 144.97467661"
8520241129,8,2024-11-29,5,11,13,24,WebBN_T,"-37.82293543, 144.9471751"
75020250912,75,2025-09-12,0,1,0,1,SprFli_T,"-37.81515276, 144.97467661"
78120231104,78,2023-11-04,1,1,16,17,HarEsB_T,"-37.81471642, 144.9446508"
78620240325,78,2024-03-25,6,6,3,9,HarEsB_T,"-37.81471642, 144.9446508"
771720240528,77,2024-05-28,17,281,174,455,HarEsP_T,"-37.81441438, 144.94433026"
59520250120,59,2025-01-20,5,12,17,29,RMIT_T,"-37.80825648, 144.96304859"
591320240608,59,2024-06-08,13,508,464,972,RMIT_T,"-37.80825648, 144.96304859"
14520241213,14,2024-12-13,5,44,28,72,SanBri_T,"-37.82011242, 144.96291897"
14620240721,14,2024-07-21,6,81,35,116,SanBri_T,"-37.82011242, 144.96291897"
281320241208,28,2024-12-08,13,842,1531,2373,VAC_T,"-37.82129925, 144.96879309"
28320250119,28,2025-01-19,3,21,13,34,VAC_T,"-37.82129925, 144.96879309"
281020240130,28,2024-01-30,10,640,429,1069,VAC_T,"-37.82129925, 144.96879309"
21520250503,21,2025-05-03,5,5,11,16,Bourke155_T,"-37.81267313, 144.96788288"
87920240722,87,2024-07-22,9,74,57,131,Errol23_T,"-37.80454949, 144.94921863"
871620241224,87,2024-12-24,16,77,88,165,Errol23_T,"-37.80454949, 144.94921863"
502020231126,50,2023-11-26,20,190,117,307,Lyg309_T,"-37.79808192, 144.96721013"
51420250311,5,2025-03-11,14,714,820,1534,PriNW_T,"-37.81874249, 144.96787656"
165220241005,165,2024-10-05,2,10,1,11,Spen475_T,"-37.80953359, 144.94939004"
1621920250102,162,2025-01-02,19,280,290,570,Eli489_T,"-37.80740397, 144.95987909"
143220250330,143,2025-03-30,2,74,24,98,Spencer_T,"-37.821728, 144.95557015"
143120250904,143,2025-09-04,1,15,10,25,Spencer_T,"-37.821728, 144.95557015"
1322020241017,132,2024-10-17,20,94,106,200,King335_T,"-37.81267639, 144.95386444"
17520231125,17,2023-11-25,5,15,8,23,Col15_T,"-37.81362543, 144.97323591"
632320250204,63,2025-02-04,23,7,61,68,Bou231_T,"-37.81333081, 144.96675571"
671820250405,67,2025-04-05,18,380,543,923,FLDegS_T,"-37.81688755, 144.96562569"
681020250712,68,2025-07-12,10,380,399,779,FLDegN_T,"-37.8168479, 144.96559789"
621020250314,62,2025-03-14,10,223,204,427,Lat224_T,"-37.80996494, 144.96216521"
862220241031,86,2024-10-31,22,3,20,23,574Qub_T,"-37.80309992, 144.94908064"
111420250806,11,2025-08-06,14,42,36,78,WatCit_T,"-37.81564989, 144.93970694"
191020240920,19,2024-09-20,10,153,157,310,LtB210_T,"-37.81237202, 144.96550671"
66320241014,66,2024-10-14,3,28,16,44,QVN_T,"-37.81057846, 144.96444294"
6020240502,6,2024-05-02,0,73,60,133,FliS_T,"-37.81911705, 144.96558255"
84620240221,84,2024-02-21,6,262,153,415,ElFi_T,"-37.81798049, 144.96503383"
661620240624,66,2024-06-24,16,1254,1135,2389,QVN_T,"-37.81057846, 144.96444294"
84020250708,84,2025-07-08,0,32,51,83,ElFi_T,"-37.81798049, 144.96503383"
3020250118,3,2025-01-18,0,290,228,518,Swa295_T,"-37.81101524, 144.96429485"
701420250523,70,2025-05-23,14,124,120,244,Errol20_T,"-37.80456984, 144.94946228"
751320241107,75,2024-11-07,13,77,79,156,SprFli_T,"-37.81515276, 144.97467661"
391120250617,39,2025-06-17,11,127,57,184,AlfPl_T,"-37.81379749, 144.96995745"
391820250721,39,2025-07-21,18,33,7,40,AlfPl_T,"-37.81379749, 144.96995745"
411220250202,41,2025-02-02,12,1453,1057,2510,Swa31,"-37.81668634, 144.96689733"
41120250308,41,2025-03-08,1,203,303,506,Swa31,"-37.81668634, 144.96689733"
78120250702,78,2025-07-02,1,1,1,2,HarEsB_T,"-37.81471642, 144.9446508"
59220250128,59,2025-01-28,2,4,9,13,RMIT_T,"-37.80825648, 144.96304859"
28820241023,28,2024-10-23,8,514,235,749,VAC_T,"-37.82129925, 144.96879309"
31120250901,31,2025-09-01,1,3,2,5,Lyg161_T,"-37.80169681, 144.96658911"
401520250918,40,2025-09-18,15,157,174,331,Spr201_T,"-37.80999341, 144.97227587"
401420231102,40,2023-11-02,14,244,167,411,Spr201_T,"-37.80999341, 144.97227587"
45420240207,45,2024-02-07,4,8,16,24,Swa148_T,"-37.81414075, 144.96609379"
43620241021,43,2024-10-21,6,22,8,30,UM2_T,"-37.79844526, 144.96411782"
132120240620,132,2024-06-20,1,3,9,12,King335_T,"-37.81267639, 144.95386444"
1431920241123,143,2024-11-23,19,181,262,443,Spencer_T,"-37.821728, 144.95557015"
1311020240624,131,2024-06-24,10,70,121,191,King2_T,"-37.82009057, 144.95758725"
107820240730,107,2024-07-30,8,70,262,332,280Will_T,"-37.81246271, 144.95690188"
107520250430,107,2025-04-30,5,3,7,10,280Will_T,"-37.81246271, 144.95690188"
872320240802,87,2024-08-02,23,16,15,31,Errol23_T,"-37.80454949, 144.94921863"
162220240711,162,2024-07-11,2,22,14,36,Eli489_T,"-37.80740397, 144.95987909"
67120240525,67,2024-05-25,1,28,56,84,FLDegS_T,"-37.81688755, 144.96562569"
67120250722,67,2025-07-22,1,5,4,9,FLDegS_T,"-37.81688755, 144.96562569"
851420250830,85,2025-08-30,14,81,105,186,488Mac_T,"-37.79432415, 144.92973378"
11820250127,1,2025-01-27,18,647,376,1023,Bou292_T,"-37.81349441, 144.96515323"
63620240725,63,2024-07-25,6,30,37,67,Bou231_T,"-37.81333081, 144.96675571"
67220250314,67,2025-03-14,2,3,3,6,FLDegS_T,"-37.81688755, 144.96562569"
181220231127,18,2023-11-27,12,207,183,390,Col12_T,"-37.81344862, 144.97305353"
181620240217,18,2024-02-17,16,92,87,179,Col12_T,"-37.81344862, 144.97305353"
63520241215,63,2024-12-15,5,2,15,17,Bou231_T,"-37.81333081, 144.96675571"
862120250411,86,2025-04-11,21,11,54,65,574Qub_T,"-37.80309992, 144.94908064"
56720250413,56,2025-04-13,7,51,23,74,Lon364_T,"-37.81234775, 144.96153311"
10120231120,10,2023-11-20,1,1,1,2,BouHbr_T,"-37.81876474, 144.94710545"
10620250611,10,2025-06-11,6,4,14,18,BouHbr_T,"-37.81876474, 144.94710545"
121920250927,12,2025-09-27,19,94,81,175,NewQ_T,"-37.81457988, 144.94292398"
351920241013,35,2024-10-13,19,1131,1317,2448,SouthB_T,"-37.82018685, 144.96508508"
2220241227,2,2024-12-27,2,6,22,28,Bou283_T,"-37.81380668, 144.96516718"
581920241004,58,2024-10-04,19,392,291,683,Bou688_T,"-37.81686075, 144.95358075"
21320250307,2,2025-03-07,13,614,693,1307,Bou283_T,"-37.81380668, 144.96516718"
271920240919,27,2024-09-19,19,87,67,154,Vic_T,"-37.80606888, 144.95644692"
531520240306,53,2024-03-06,15,615,576,1191,Col254_T,"-37.81564191, 144.965499"
91620250323,9,2025-03-23,16,60,69,129,Col700_T,"-37.81982992, 144.95102555"
231120240426,23,2024-04-26,11,172,188,360,Col623_T,"-37.81909256, 144.95452748"
79020250820,79,2025-08-20,0,34,49,83,FliSS_T,"-37.81794046, 144.96616678"
30020250314,30,2025-03-14,0,123,100,223,Lon189_T,"-37.8112185, 144.96656806"
30320231120,30,2023-11-20,3,35,69,104,Lon189_T,"-37.8112185, 144.96656806"
79020240501,79,2024-05-01,0,34,42,76,FliSS_T,"-37.81794046, 144.96616678"
23320250216,23,2025-02-16,3,9,17,26,Col623_T,"-37.81909256, 144.95452748"
251920250602,25,2025-06-02,19,212,212,424,MCEC_T,"-37.82401776, 144.95604426"
201320231204,20,2023-12-04,13,195,218,413,LtB170_T,"-37.81172914, 144.9682466"
1371620240307,137,2024-03-07,16,13,213,226,BouHbr2353_T,"-37.81894815, 144.94612292"
1391320240528,139,2024-05-28,13,71,92,163,Signal1647_T,"-37.81959923, 144.9632832"
1301820241117,130,2024-11-17,18,38,38,76,Bou892T,"-37.8204637, 144.94126826"
161920251005,161,2025-10-05,9,156,111,267,BirArt1109_T,"-37.81851276, 144.97131336"
123920240110,123,2024-01-10,9,29,28,57,BirBridge_T,"-37.81753741, 144.97329734"
1091920240909,109,2024-09-09,19,112,90,202,LatWill_T,"-37.81193681, 144.95621105"
661520250121,66,2025-01-21,15,928,959,1887,QVN_T,"-37.81057846, 144.96444294"
661320250928,66,2025-09-28,13,1127,1626,2753,QVN_T,"-37.81057846, 144.96444294"
751720240508,75,2024-05-08,17,74,80,154,SprFli_T,"-37.81515276, 144.97467661"
39420240727,39,2024-07-27,4,1,0,1,AlfPl_T,"-37.81379749, 144.96995745"
391420250921,39,2025-09-21,14,32,31,63,AlfPl_T,"-37.81379749, 144.96995745"
39720240621,39,2024-06-21,7,49,26,75,AlfPl_T,"-37.81379749, 144.96995745"
77020250112,77,2025-01-12,0,23,14,37,HarEsP_T,"-37.81441438, 144.94433026"
591320250512,59,2025-05-12,13,966,1121,2087,RMIT_T,"-37.80825648, 144.96304859"
59320241222,59,2024-12-22,3,71,30,101,RMIT_T,"-37.80825648, 144.96304859"
65620231112,65,2023-11-12,6,22,26,48,SwaCs_T,"-37.81569416, 144.9668064"
71520241213,71,2024-12-13,5,4,1,5,WestWP_T,"-37.81235775, 144.97136962"
28420240329,28,2024-03-29,4,7,14,21,VAC_T,"-37.82129925, 144.96879309"
14820241211,14,2024-12-11,8,294,599,893,SanBri_T,"-37.82011242, 144.96291897"
141920250114,14,2025-01-14,19,280,117,397,SanBri_T,"-37.82011242, 144.96291897"
542320250114,54,2025-01-14,23,17,25,42,Swa607_T,"-37.804024, 144.96308399"
5420250813,5,2025-08-13,4,32,9,41,PriNW_T,"-37.81874249, 144.96787656"
211920250619,21,2025-06-19,19,197,262,459,Bourke155_T,"-37.81267313, 144.96788288"
36420250815,36,2025-08-15,4,5,3,8,Que85_T,"-37.81652527, 144.96121062"
362220240605,36,2024-06-05,22,22,118,140,Que85_T,"-37.81652527, 144.96121062"
611720231028,61,2023-10-28,17,295,400,695,RMIT14_T,"-37.80767455, 144.96309114"
50620231206,50,2023-12-06,6,11,20,31,Lyg309_T,"-37.79808192, 144.96721013"
441520250427,44,2025-04-27,15,36,33,69,UM3_T,"-37.79698741, 144.96441306"
132420251003,132,2025-10-03,4,5,2,7,King335_T,"-37.81267639, 144.95386444"
143120240721,143,2024-07-21,1,114,35,149,Spencer_T,"-37.821728, 144.95557015"
1342220250711,134,2025-07-11,22,296,250,546,Spen201_T,"-37.81694221, 144.95303935"
135620250304,135,2025-03-04,6,76,110,186,Spen161_T,"-37.8172861, 144.95319102"
133720240407,133,2024-04-07,7,138,181,319,Spen229_T,"-37.81531435, 144.95227769"
61820240627,61,2024-06-27,8,130,326,456,RMIT14_T,"-37.80767455, 144.96309114"
61720241117,61,2024-11-17,7,31,62,93,RMIT14_T,"-37.80767455, 144.96309114"
181020250501,181,2025-05-01,0,125,138,263,Eli368_T,"-37.81009465, 144.96143149"
672220240102,67,2024-01-02,22,46,99,145,FLDegS_T,"-37.81688755, 144.96562569"
671020231130,67,2023-11-30,10,358,413,771,FLDegS_T,"-37.81688755, 144.96562569"
27920250206,27,2025-02-06,9,74,93,167,Vic_T,"-37.80606888, 144.95644692"
123920250911,123,2025-09-11,9,35,10,45,BirBridge_T,"-37.81753741, 144.97329734"
117720241025,117,2024-10-25,7,81,57,138,Fli114F_T,"-37.81629332, 144.97090877"
191120241209,19,2024-12-09,11,297,215,512,LtB210_T,"-37.81237202, 144.96550671"
142920241117,142,2024-11-17,9,277,249,526,Hammer1584_T,"-37.81970749, 144.96795734"
1301220250214,130,2025-02-14,12,40,58,98,Bou892T,"-37.8204637, 144.94126826"
66220250221,66,2025-02-21,2,22,14,36,QVN_T,"-37.81057846, 144.96444294"
69820240714,69,2024-07-14,8,42,18,60,FLDegC_T,"-37.81687226, 144.96559144"
69220240203,69,2024-02-03,2,0,1,1,FLDegC_T,"-37.81687226, 144.96559144"
70520240707,70,2024-07-07,5,2,2,4,Errol20_T,"-37.80456984, 144.94946228"
78120231202,78,2023-12-02,1,4,5,9,HarEsB_T,"-37.81471642, 144.9446508"
771220240305,77,2024-03-05,12,161,96,257,HarEsP_T,"-37.81441438, 144.94433026"
78620240728,78,2024-07-28,6,1,1,2,HarEsB_T,"-37.81471642, 144.9446508"
771220240206,77,2024-02-06,12,235,137,372,HarEsP_T,"-37.81441438, 144.94433026"
59520250611,59,2025-06-11,5,10,12,22,RMIT_T,"-37.80825648, 144.96304859"
59820231120,59,2023-11-20,8,331,188,519,RMIT_T,"-37.80825648, 144.96304859"
291820250402,29,2025-04-02,18,279,347,626,AG_T,"-37.8199817, 144.96872865"
312120250910,31,2025-09-10,21,76,118,194,Lyg161_T,"-37.80169681, 144.96658911"
47720250622,47,2025-06-22,7,74,113,187,Eli250_T,"-37.81258467, 144.9625775"
40520240812,40,2024-08-12,5,4,9,13,Spr201_T,"-37.80999341, 144.97227587"
611220231123,61,2023-11-23,12,286,444,730,RMIT14_T,"-37.80767455, 144.96309114"
43420251006,43,2025-10-06,4,1,1,2,UM2_T,"-37.79844526, 144.96411782"
51520250625,5,2025-06-25,15,692,444,1136,PriNW_T,"-37.81874249, 144.96787656"
1431320250307,143,2025-03-07,13,134,196,330,Spencer_T,"-37.821728, 144.95557015"
107720250524,107,2025-05-24,7,32,36,68,280Will_T,"-37.81246271, 144.95690188"
87120250828,87,2025-08-28,1,7,1,8,Errol23_T,"-37.80454949, 144.94921863"
179420250322,179,2025-03-22,4,5,1,6,Pow61_T,"-37.82392385, 144.96299677"
179920250405,179,2025-04-05,9,41,36,77,Pow61_T,"-37.82392385, 144.96299677"
1791420250825,179,2025-08-25,14,51,91,142,Pow61_T,"-37.82392385, 144.96299677"
68120240630,68,2024-06-30,1,2,0,2,FLDegN_T,"-37.8168479, 144.96559789"
171020240831,17,2024-08-31,10,105,64,169,Col15_T,"-37.81362543, 144.97323591"
172120241027,17,2024-10-27,21,77,59,136,Col15_T,"-37.81362543, 144.97323591"
17720250227,17,2025-02-27,7,464,105,569,Col15_T,"-37.81362543, 144.97323591"
67420250918,67,2025-09-18,4,10,6,16,FLDegS_T,"-37.81688755, 144.96562569"
631720240516,63,2024-05-16,17,349,461,810,Bou231_T,"-37.81333081, 144.96675571"
18320231215,18,2023-12-15,3,0,2,2,Col12_T,"-37.81344862, 144.97305353"
631820250131,63,2025-01-31,18,423,448,871,Bou231_T,"-37.81333081, 144.96675571"
68420250515,68,2025-05-15,4,1,1,2,FLDegN_T,"-37.8168479, 144.96559789"
112320250120,11,2025-01-20,23,23,33,56,WatCit_T,"-37.81564989, 144.93970694"
11620250326,11,2025-03-26,6,17,11,28,WatCit_T,"-37.81564989, 144.93970694"
762120250708,76,2025-07-08,21,6,10,16,KenMac_T,"-37.79453803, 144.93036194"
35720250715,35,2025-07-15,7,412,663,1075,SouthB_T,"-37.82018685, 144.96508508"
351920241103,35,2024-11-03,19,1170,1409,2579,SouthB_T,"-37.82018685, 144.96508508"
582220240428,58,2024-04-28,22,146,116,262,Bou688_T,"-37.81686075, 144.95358075"
581520250916,58,2025-09-16,15,490,603,1093,Bou688_T,"-37.81686075, 144.95358075"
532320250922,53,2025-09-22,23,19,34,53,Col254_T,"-37.81564191, 144.965499"
531420240918,53,2024-09-18,14,699,562,1261,Col254_T,"-37.81564191, 144.965499"
792220240426,79,2024-04-26,22,260,335,595,FliSS_T,"-37.81794046, 144.96616678"
51220250606,51,2025-06-06,2,7,9,16,Fra118_T,"-37.80841815, 144.95906316"
511320240424,51,2024-04-24,13,102,104,206,Fra118_T,"-37.80841815, 144.95906316"
232320250515,23,2025-05-15,23,41,73,114,Col623_T,"-37.81909256, 144.95452748"
25420250521,25,2025-05-21,4,4,2,6,MCEC_T,"-37.82401776, 144.95604426"
52420251014,52,2025-10-14,4,4,4,8,Eli263_T,"-37.81252157, 144.9619401"
461220241221,46,2024-12-21,12,30,38,68,Pel147_T,"-37.80240719, 144.9615673"
46220250719,46,2025-07-19,2,0,1,1,Pel147_T,"-37.80240719, 144.9615673"
1371020250322,137,2025-03-22,10,12,9,21,BouHbr2353_T,"-37.81894815, 144.94612292"
141720241106,141,2024-11-06,7,46,54,100,474Fl_T,"-37.81997273, 144.95834911"
1392120231203,139,2023-12-03,21,121,113,234,Signal1647_T,"-37.81959923, 144.9632832"
1372120240815,137,2024-08-15,21,0,2,2,BouHbr2353_T,"-37.81894815, 144.94612292"
1611920250516,161,2025-05-16,19,1,0,1,BirArt1109_T,"-37.81851276, 144.97131336"
1612320250611,161,2025-06-11,23,1,0,1,BirArt1109_T,"-37.81851276, 144.97131336"
1411520250604,141,2025-06-04,15,147,124,271,474Fl_T,"-37.81997273, 144.95834911"
661920241019,66,2024-10-19,19,1388,1398,2786,QVN_T,"-37.81057846, 144.96444294"
692020231119,69,2023-11-19,20,45,28,73,FLDegC_T,"-37.81687226, 144.96559144"
61020250311,6,2025-03-11,10,537,443,980,FliS_T,"-37.81911705, 144.96558255"
751220250905,75,2025-09-05,12,79,45,124,SprFli_T,"-37.81515276, 144.97467661"
39420240817,39,2024-08-17,4,2,1,3,AlfPl_T,"-37.81379749, 144.96995745"
392220241216,39,2024-12-16,22,1,2,3,AlfPl_T,"-37.81379749, 144.96995745"
412320250530,41,2025-05-30,23,549,644,1193,Swa31,"-37.81668634, 144.96689733"
41020250625,41,2025-06-25,0,82,72,154,Swa31,"-37.81668634, 144.96689733"
772120250530,77,2025-05-30,21,148,74,222,HarEsP_T,"-37.81441438, 144.94433026"
14520241025,14,2024-10-25,5,26,35,61,SanBri_T,"-37.82011242, 144.96291897"
40220250118,40,2025-01-18,2,9,8,17,Spr201_T,"-37.80999341, 144.97227587"
451620240412,45,2024-04-12,16,645,1009,1654,Swa148_T,"-37.81414075, 144.96609379"
21520240817,21,2024-08-17,5,24,22,46,Bourke155_T,"-37.81267313, 144.96788288"
362220240502,36,2024-05-02,22,86,105,191,Que85_T,"-37.81652527, 144.96121062"
37720241101,37,2024-11-01,7,14,20,34,Lyg260_T,"-37.80107122, 144.96704554"
441220250903,44,2025-09-03,12,137,134,271,UM3_T,"-37.79698741, 144.96441306"
1321420250531,132,2025-05-31,14,195,187,382,King335_T,"-37.81267639, 144.95386444"
1311920240819,131,2024-08-19,19,33,35,68,King2_T,"-37.82009057, 144.95758725"
1311420250415,131,2025-04-15,14,108,155,263,King2_T,"-37.82009057, 144.95758725"
1331420240802,133,2024-08-02,14,474,541,1015,Spen229_T,"-37.81531435, 144.95227769"
1241620241223,124,2024-12-23,16,4,4,8,BirBridge_T,"-37.81757416, 144.97329934"
1241020250801,124,2025-08-01,10,2,1,3,BirBridge_T,"-37.81757416, 144.97329934"
1081320251001,108,2025-10-01,13,561,458,1019,261Will_T,"-37.81295822, 144.95678789"
611420240615,61,2024-06-15,14,250,439,689,RMIT14_T,"-37.80767455, 144.96309114"
182220250514,182,2025-05-14,2,20,26,46,King163_T,"-37.81627451, 144.95550503"
1622320250309,162,2025-03-09,23,200,82,282,Eli489_T,"-37.80740397, 144.95987909"
166620241017,166,2024-10-17,6,4,11,15,Spen484_T,"-37.80896733, 144.94931703"
166620250114,166,2025-01-14,6,3,7,10,Spen484_T,"-37.80896733, 144.94931703"
167020250923,167,2025-09-23,0,6,2,8,Lat526_T,"-37.81304149, 144.95155955"
42320250304,42,2025-03-04,3,5,3,8,UM1_T,"-37.80008566, 144.96386412"
592020240721,59,2024-07-21,20,303,267,570,RMIT_T,"-37.80825648, 144.96304859"
59320240825,59,2024-08-25,3,106,24,130,RMIT_T,"-37.80825648, 144.96304859"
59020240930,59,2024-09-30,0,38,33,71,RMIT_T,"-37.80825648, 144.96304859"
591720241007,59,2024-10-07,17,612,1031,1643,RMIT_T,"-37.80825648, 144.96304859"
71720240321,71,2024-03-21,7,10,23,33,WestWP_T,"-37.81235775, 144.97136962"
14320250910,14,2025-09-10,3,2,0,2,SanBri_T,"-37.82011242, 144.96291897"
54220250713,54,2025-07-13,2,13,8,21,Swa607_T,"-37.804024, 144.96308399"
31720251010,31,2025-10-10,7,34,23,57,Lyg161_T,"-37.80169681, 144.96658911"
541520241226,54,2024-12-26,15,26,40,66,Swa607_T,"-37.804024, 144.96308399"
471120231107,47,2023-11-07,11,489,502,991,Eli250_T,"-37.81258467, 144.9625775"
5320250904,5,2025-09-04,3,26,10,36,PriNW_T,"-37.81874249, 144.96787656"
51320231120,5,2023-11-20,13,938,1012,1950,PriNW_T,"-37.81874249, 144.96787656"
131720241102,131,2024-11-02,7,22,39,61,King2_T,"-37.82009057, 144.95758725"
1351720240119,135,2024-01-19,17,627,489,1116,Spen161_T,"-37.8172861, 144.95319102"
107120240114,107,2024-01-14,1,24,29,53,280Will_T,"-37.81246271, 144.95690188"
1071520241207,107,2024-12-07,15,77,100,177,280Will_T,"-37.81246271, 144.95690188"
184020250803,184,2025-08-03,0,79,209,288,Eli124_T,"-37.81512416, 144.96371988"
165320250627,165,2025-06-27,3,2,0,2,Spen475_T,"-37.80953359, 144.94939004"
56320250913,56,2025-09-13,3,4,10,14,Lon364_T,"-37.81234775, 144.96153311"
91920240917,9,2024-09-17,19,258,55,313,Col700_T,"-37.81982992, 144.95102555"
9420231121,9,2023-11-21,4,3,9,12,Col700_T,"-37.81982992, 144.95102555"
531420240328,53,2024-03-28,14,687,658,1345,Col254_T,"-37.81564191, 144.965499"
23020231214,23,2023-12-14,0,10,21,31,Col623_T,"-37.81909256, 144.95452748"
79720250822,79,2025-08-22,7,150,117,267,FliSS_T,"-37.81794046, 144.96616678"
792120241020,79,2024-10-20,21,167,233,400,FliSS_T,"-37.81794046, 144.96616678"
30020240518,30,2024-05-18,0,195,230,425,Lon189_T,"-37.8112185, 144.96656806"
481120250305,48,2025-03-05,11,194,135,329,QVMQ_T,"-37.80631581, 144.95866697"
25720240131,25,2024-01-31,7,206,300,506,MCEC_T,"-37.82401776, 144.95604426"
1371320250208,137,2025-02-08,13,15,31,46,BouHbr2353_T,"-37.81894815, 144.94612292"
1411620231224,141,2023-12-24,16,132,94,226,474Fl_T,"-37.81997273, 144.95834911"
1361220241028,136,2024-10-28,12,123,95,218,BirFed1120_T,"-37.8184141, 144.97357915"
41620240504,4,2024-05-04,16,2163,1519,3682,Swa123_T,"-37.81487988, 144.9660878"
41520250111,4,2025-01-11,15,1641,1409,3050,Swa123_T,"-37.81487988, 144.9660878"
701520240109,70,2024-01-09,15,105,112,217,Errol20_T,"-37.80456984, 144.94946228"
39720250105,39,2025-01-05,7,27,15,42,AlfPl_T,"-37.81379749, 144.96995745"
391620250211,39,2025-02-11,16,96,95,191,AlfPl_T,"-37.81379749, 144.96995745"
41420240415,41,2024-04-15,4,44,41,85,Swa31,"-37.81668634, 144.96689733"
781620250313,78,2025-03-13,16,35,140,175,HarEsB_T,"-37.81471642, 144.9446508"
421620240610,42,2024-06-10,16,69,137,206,UM1_T,"-37.80008566, 144.96386412"
29120240916,29,2024-09-16,1,2,9,11,AG_T,"-37.8199817, 144.96872865"
291720241216,29,2024-12-16,17,111,177,288,AG_T,"-37.8199817, 144.96872865"
141020250506,14,2025-05-06,10,190,155,345,SanBri_T,"-37.82011242, 144.96291897"
14120240713,14,2024-07-13,1,114,21,135,SanBri_T,"-37.82011242, 144.96291897"
29120240516,29,2024-05-16,1,0,3,3,AG_T,"-37.8199817, 144.96872865"
47020240408,47,2024-04-08,0,62,62,124,Eli250_T,"-37.81258467, 144.9625775"
31920250513,31,2025-05-13,9,53,50,103,Lyg161_T,"-37.80169681, 144.96658911"
37220240524,37,2024-05-24,2,1,2,3,Lyg260_T,"-37.80107122, 144.96704554"
372120240104,37,2024-01-04,21,31,43,74,Lyg260_T,"-37.80107122, 144.96704554"
133720240819,133,2024-08-19,7,777,401,1178,Spen229_T,"-37.81531435, 144.95227769"
611220240507,61,2024-05-07,12,667,729,1396,RMIT14_T,"-37.80767455, 144.96309114"
441320240502,44,2024-05-02,13,150,162,312,UM3_T,"-37.79698741, 144.96441306"
1821520250424,182,2025-04-24,15,194,211,405,King163_T,"-37.81627451, 144.95550503"
166120250324,166,2025-03-24,1,4,1,5,Spen484_T,"-37.80896733, 144.94931703"
167320250331,167,2025-03-31,3,1,4,5,Lat526_T,"-37.81304149, 144.95155955"
1401720240609,140,2024-06-09,17,36,50,86,Boyd2837_T,"-37.82590962, 144.96185972"
1311020250724,131,2025-07-24,10,73,127,200,King2_T,"-37.82009057, 144.95758725"
1432220240617,143,2024-06-17,22,67,56,123,Spencer_T,"-37.821728, 144.95557015"
134220250706,134,2025-07-06,2,49,25,74,Spen201_T,"-37.81694221, 144.95303935"
11920240814,1,2024-08-14,19,490,360,850,Bou292_T,"-37.81349441, 144.96515323"
63420241124,63,2024-11-24,4,1,51,52,Bou231_T,"-37.81333081, 144.96675571"
671320240824,67,2024-08-24,13,430,666,1096,FLDegS_T,"-37.81688755, 144.96562569"
681320240330,68,2024-03-30,13,278,179,457,FLDegN_T,"-37.8168479, 144.96559789"
182020240829,18,2024-08-29,20,16,16,32,Col12_T,"-37.81344862, 144.97305353"
671520250125,67,2025-01-25,15,421,589,1010,FLDegS_T,"-37.81688755, 144.96562569"
62520240603,62,2024-06-03,5,13,7,20,Lat224_T,"-37.80996494, 144.96216521"
561020240521,56,2024-05-21,10,197,132,329,Lon364_T,"-37.81234775, 144.96153311"
86720250724,86,2025-07-24,7,25,13,38,574Qub_T,"-37.80309992, 144.94908064"
12420240120,12,2024-01-20,4,0,2,2,NewQ_T,"-37.81457988, 144.94292398"
122020240304,12,2024-03-04,20,231,210,441,NewQ_T,"-37.81457988, 144.94292398"
561220250906,56,2025-09-06,12,442,327,769,Lon364_T,"-37.81234775, 144.96153311"
241020240907,24,2024-09-07,10,570,438,1008,Col620_T,"-37.81887963, 144.95449198"
242120250403,24,2025-04-03,21,307,376,683,Col620_T,"-37.81887963, 144.95449198"
761020250425,76,2025-04-25,10,72,59,131,KenMac_T,"-37.79453803, 144.93036194"
352320240616,35,2024-06-16,23,105,152,257,SouthB_T,"-37.82018685, 144.96508508"
11420240527,11,2024-05-27,4,2,0,2,WatCit_T,"-37.81564989, 144.93970694"
22320250316,2,2025-03-16,23,23,60,83,Bou283_T,"-37.81380668, 144.96516718"
58720240306,58,2024-03-06,7,770,131,901,Bou688_T,"-37.81686075, 144.95358075"
22120250110,2,2025-01-10,21,159,224,383,Bou283_T,"-37.81380668, 144.96516718"
22120250127,2,2025-01-27,21,65,107,172,Bou283_T,"-37.81380668, 144.96516718"
2720240325,2,2024-03-25,7,37,65,102,Bou283_T,"-37.81380668, 144.96516718"
21620240914,2,2024-09-14,16,626,566,1192,Bou283_T,"-37.81380668, 144.96516718"
27920240824,27,2024-08-24,9,154,153,307,Vic_T,"-37.80606888, 144.95644692"
53820231110,53,2023-11-10,8,313,280,593,Col254_T,"-37.81564191, 144.965499"
231620250415,23,2025-04-15,16,241,635,876,Col623_T,"-37.81909256, 144.95452748"
792020250108,79,2025-01-08,20,272,329,601,FliSS_T,"-37.81794046, 144.96616678"
23120231218,23,2023-12-18,1,12,12,24,Col623_T,"-37.81909256, 144.95452748"
46820231023,46,2023-10-23,8,61,99,160,Pel147_T,"-37.80240719, 144.9615673"
521120240328,52,2024-03-28,11,275,228,503,Eli263_T,"-37.81252157, 144.9619401"
51220240802,51,2024-08-02,2,6,3,9,Fra118_T,"-37.80841815, 144.95906316"
512020231202,51,2023-12-02,20,83,61,144,Fra118_T,"-37.80841815, 144.95906316"
191020231208,19,2023-12-08,10,215,185,400,LtB210_T,"-37.81237202, 144.96550671"
18120250905,18,2025-09-05,1,0,2,2,Col12_T,"-37.81344862, 144.97305353"
671220250118,67,2025-01-18,12,380,505,885,FLDegS_T,"-37.81688755, 144.96562569"
112120241021,11,2024-10-21,21,106,82,188,WatCit_T,"-37.81564989, 144.93970694"
10920240512,10,2024-05-12,9,24,45,69,BouHbr_T,"-37.81876474, 144.94710545"
2620251014,2,2025-10-14,6,16,36,52,Bou283_T,"-37.81380668, 144.96516718"
30120240924,30,2024-09-24,1,28,24,52,Lon189_T,"-37.8112185, 144.96656806"
251020231218,25,2023-12-18,10,182,440,622,MCEC_T,"-37.82401776, 144.95604426"
521120250115,52,2025-01-15,11,246,195,441,Eli263_T,"-37.81252157, 144.9619401"
522220231102,52,2023-11-02,22,83,169,252,Eli263_T,"-37.81252157, 144.9619401"
51620251005,51,2025-10-05,6,11,9,20,Fra118_T,"-37.80841815, 144.95906316"
1411920241103,141,2024-11-03,19,99,121,220,474Fl_T,"-37.81997273, 144.95834911"
1171320231104,117,2023-11-04,13,136,168,304,Fli114F_T,"-37.81629332, 144.97090877"
49920240613,49,2024-06-13,9,140,199,339,Eli501_T,"-37.80730068, 144.95956055"
1372120240210,137,2024-02-10,21,4,13,17,BouHbr2353_T,"-37.81894815, 144.94612292"
1381520240123,138,2024-01-23,15,9,7,16,EntPark1671_T,"-37.81996544, 144.95981454"
691520240529,69,2024-05-29,15,104,135,239,FLDegC_T,"-37.81687226, 144.96559144"
62220240110,6,2024-01-10,22,592,413,1005,FliS_T,"-37.81911705, 144.96558255"
6020240616,6,2024-06-16,0,269,164,433,FliS_T,"-37.81911705, 144.96558255"
4120241009,4,2024-10-09,1,26,12,38,Swa123_T,"-37.81487988, 144.9660878"
391220240701,39,2024-07-01,12,219,143,362,AlfPl_T,"-37.81379749, 144.96995745"
391320250905,39,2025-09-05,13,143,169,312,AlfPl_T,"-37.81379749, 144.96995745"
421320250117,42,2025-01-17,13,122,168,290,UM1_T,"-37.80008566, 144.96386412"
421520250622,42,2025-06-22,15,57,57,114,UM1_T,"-37.80008566, 144.96386412"
421720251003,42,2025-10-03,17,150,188,338,UM1_T,"-37.80008566, 144.96386412"
42820241016,42,2024-10-16,8,274,96,370,UM1_T,"-37.80008566, 144.96386412"
591320241206,59,2024-12-06,13,412,208,620,RMIT_T,"-37.80825648, 144.96304859"
591520250528,59,2025-05-28,15,768,1110,1878,RMIT_T,"-37.80825648, 144.96304859"
59120250626,59,2025-06-26,1,27,5,32,RMIT_T,"-37.80825648, 144.96304859"
591120240318,59,2024-03-18,11,1665,1313,2978,RMIT_T,"-37.80825648, 144.96304859"
592320240615,59,2024-06-15,23,222,156,378,RMIT_T,"-37.80825648, 144.96304859"
591520240812,59,2024-08-12,15,1093,1572,2665,RMIT_T,"-37.80825648, 144.96304859"
591120241002,59,2024-10-02,11,1036,1015,2051,RMIT_T,"-37.80825648, 144.96304859"
65420240828,65,2024-08-28,4,32,11,43,SwaCs_T,"-37.81569416, 144.9668064"
652220231031,65,2023-10-31,22,84,188,272,SwaCs_T,"-37.81569416, 144.9668064"
291320240214,29,2024-02-14,13,276,491,767,AG_T,"-37.8199817, 144.96872865"
14220240320,14,2024-03-20,2,8,1,9,SanBri_T,"-37.82011242, 144.96291897"
40220250219,40,2025-02-19,2,3,0,3,Spr201_T,"-37.80999341, 144.97227587"
401220240624,40,2024-06-24,12,269,333,602,Spr201_T,"-37.80999341, 144.97227587"
401220240711,40,2024-07-11,12,257,414,671,Spr201_T,"-37.80999341, 144.97227587"
137820240310,137,2024-03-10,8,6,7,13,BouHbr2353_T,"-37.81894815, 144.94612292"
1371720250208,137,2025-02-08,17,20,101,121,BouHbr2353_T,"-37.81894815, 144.94612292"
139920250723,139,2025-07-23,9,43,147,190,Signal1647_T,"-37.81959923, 144.9632832"
1362320240306,136,2024-03-06,23,9,287,296,BirFed1120_T,"-37.8184141, 144.97357915"
1172120250407,117,2025-04-07,21,45,65,110,Fli114F_T,"-37.81629332, 144.97090877"
109520240319,109,2024-03-19,5,7,15,22,LatWill_T,"-37.81193681, 144.95621105"
841320240129,84,2024-01-29,13,1017,1256,2273,ElFi_T,"-37.81798049, 144.96503383"
84320240412,84,2024-04-12,3,23,20,43,ElFi_T,"-37.81798049, 144.96503383"
42120240514,4,2024-05-14,21,399,321,720,Swa123_T,"-37.81487988, 144.9660878"
4920240919,4,2024-09-19,9,626,433,1059,Swa123_T,"-37.81487988, 144.9660878"
702320250727,70,2025-07-27,23,10,8,18,Errol20_T,"-37.80456984, 144.94946228"
751720250709,75,2025-07-09,17,63,52,115,SprFli_T,"-37.81515276, 144.97467661"
752020231114,75,2023-11-14,20,10,12,22,SprFli_T,"-37.81515276, 144.97467661"
412020241204,41,2024-12-04,20,856,1947,2803,Swa31,"-37.81668634, 144.96689733"
78920250330,78,2025-03-30,9,46,74,120,HarEsB_T,"-37.81471642, 144.9446508"
78920250729,78,2025-07-29,9,52,42,94,HarEsB_T,"-37.81471642, 144.9446508"
422320240723,42,2024-07-23,23,7,15,22,UM1_T,"-37.80008566, 144.96386412"
42320250731,42,2025-07-31,3,2,2,4,UM1_T,"-37.80008566, 144.96386412"
29820240518,29,2024-05-18,8,77,111,188,AG_T,"-37.8199817, 144.96872865"
29020241004,29,2024-10-04,0,10,38,48,AG_T,"-37.8199817, 144.96872865"
29820240501,29,2024-05-01,8,162,145,307,AG_T,"-37.8199817, 144.96872865"
14120240312,14,2024-03-12,1,15,4,19,SanBri_T,"-37.82011242, 144.96291897"
711620250312,71,2025-03-12,16,17,7,24,WestWP_T,"-37.81235775, 144.97136962"
712020250411,71,2025-04-11,20,9,17,26,WestWP_T,"-37.81235775, 144.97136962"
471520240219,47,2024-02-19,15,1028,931,1959,Eli250_T,"-37.81258467, 144.9625775"
21220240325,21,2024-03-25,2,31,18,49,Bourke155_T,"-37.81267313, 144.96788288"
107620240710,107,2024-07-10,6,6,22,28,280Will_T,"-37.81246271, 144.95690188"
1181320250729,118,2025-07-29,13,12,23,35,Fli114C_T,"-37.81632783, 144.97090512"
1181120250925,118,2025-09-25,11,16,27,43,Fli114C_T,"-37.81632783, 144.97090512"
1181720240228,118,2024-02-28,17,16,52,68,Fli114C_T,"-37.81632783, 144.97090512"
1081320231225,108,2023-12-25,13,23,35,58,261Will_T,"-37.81295822, 144.95678789"
44020250429,44,2025-04-29,0,0,1,1,UM3_T,"-37.79698741, 144.96441306"
43820241110,43,2024-11-10,8,26,15,41,UM2_T,"-37.79844526, 144.96411782"
43620250804,43,2025-08-04,6,13,5,18,UM2_T,"-37.79844526, 144.96411782"
43320250325,43,2025-03-25,3,0,2,2,UM2_T,"-37.79844526, 144.96411782"
44920240129,44,2024-01-29,9,39,43,82,UM3_T,"-37.79698741, 144.96441306"
1401720240121,140,2024-01-21,17,90,96,186,Boyd2837_T,"-37.82590962, 144.96185972"
1431120240730,143,2024-07-30,11,107,196,303,Spencer_T,"-37.821728, 144.95557015"
1322320250731,132,2025-07-31,23,29,57,86,King335_T,"-37.81267639, 144.95386444"
1341020240304,134,2024-03-04,10,280,250,530,Spen201_T,"-37.81694221, 144.95303935"
135220250302,135,2025-03-02,2,51,72,123,Spen161_T,"-37.8172861, 144.95319102"
17820250824,17,2025-08-24,8,56,32,88,Col15_T,"-37.81362543, 144.97323591"
1320240111,1,2024-01-11,3,1,3,4,Bou292_T,"-37.81349441, 144.96515323"
1020240218,1,2024-02-18,0,95,131,226,Bou292_T,"-37.81349441, 144.96515323"
63620240610,63,2024-06-10,6,5,14,19,Bou231_T,"-37.81333081, 144.96675571"
18820250907,18,2025-09-07,8,13,12,25,Col12_T,"-37.81344862, 144.97305353"
18220250814,18,2025-08-14,2,0,1,1,Col12_T,"-37.81344862, 144.97305353"
67120250221,67,2025-02-21,1,7,11,18,FLDegS_T,"-37.81688755, 144.96562569"
1301520240427,130,2024-04-27,15,19,28,47,Bou892T,"-37.8204637, 144.94126826"
1381820250804,138,2025-08-04,18,0,1,1,EntPark1671_T,"-37.81996544, 144.95981454"
1411520250625,141,2025-06-25,15,107,75,182,474Fl_T,"-37.81997273, 144.95834911"
671320231107,67,2023-11-07,13,245,388,633,FLDegS_T,"-37.81688755, 144.96562569"
68620250725,68,2025-07-25,6,6,1,7,FLDegN_T,"-37.8168479, 144.96559789"
17920240517,17,2024-05-17,9,486,211,697,Col15_T,"-37.81362543, 144.97323591"
171320250511,17,2025-05-11,13,185,113,298,Col15_T,"-37.81362543, 144.97323591"
18720241123,18,2024-11-23,7,15,20,35,Col12_T,"-37.81344862, 144.97305353"
561220240503,56,2024-05-03,12,349,241,590,Lon364_T,"-37.81234775, 144.96153311"
241320240401,24,2024-04-01,13,653,394,1047,Col620_T,"-37.81887963, 144.95449198"
241720240727,24,2024-07-27,17,456,618,1074,Col620_T,"-37.81887963, 144.95449198"
722320251002,72,2025-10-02,23,6,30,36,ACMI_T,"-37.81726338, 144.96872809"
581420250201,58,2025-02-01,14,498,242,740,Bou688_T,"-37.81686075, 144.95358075"
58320250429,58,2025-04-29,3,4,7,11,Bou688_T,"-37.81686075, 144.95358075"
66520240312,66,2024-03-12,5,17,26,43,QVN_T,"-37.81057846, 144.96444294"
6420241209,6,2024-12-09,4,39,15,54,FliS_T,"-37.81911705, 144.96558255"
61720250611,6,2025-06-11,17,2455,922,3377,FliS_T,"-37.81911705, 144.96558255"
84120240928,84,2024-09-28,1,85,164,249,ElFi_T,"-37.81798049, 144.96503383"
842020250409,84,2025-04-09,20,561,896,1457,ElFi_T,"-37.81798049, 144.96503383"
4620241004,4,2024-10-04,6,98,37,135,Swa123_T,"-37.81487988, 144.9660878"
70620241111,70,2024-11-11,6,8,8,16,Errol20_T,"-37.80456984, 144.94946228"
39320241215,39,2024-12-15,3,0,1,1,AlfPl_T,"-37.81379749, 144.96995745"
6820231228,6,2023-12-28,8,243,342,585,FliS_T,"-37.81911705, 144.96558255"
6120241109,6,2024-11-09,1,170,70,240,FliS_T,"-37.81911705, 144.96558255"
701720240605,70,2024-06-05,17,187,154,341,Errol20_T,"-37.80456984, 144.94946228"
70720240706,70,2024-07-06,7,15,18,33,Errol20_T,"-37.80456984, 144.94946228"
39120240804,39,2024-08-04,1,2,4,6,AlfPl_T,"-37.81379749, 144.96995745"
8720240719,8,2024-07-19,7,101,52,153,WebBN_T,"-37.82293543, 144.9471751"
411620250906,41,2025-09-06,16,1665,2373,4038,Swa31,"-37.81668634, 144.96689733"
41720250228,41,2025-02-28,7,826,334,1160,Swa31,"-37.81668634, 144.96689733"
781820250406,78,2025-04-06,18,24,35,59,HarEsB_T,"-37.81471642, 144.9446508"
71720240229,71,2024-02-29,7,13,9,22,WestWP_T,"-37.81235775, 144.97136962"
28220231117,28,2023-11-17,2,16,11,27,VAC_T,"-37.82129925, 144.96879309"
14420241220,14,2024-12-20,4,37,7,44,SanBri_T,"-37.82011242, 144.96291897"
14620240708,14,2024-07-08,6,69,70,139,SanBri_T,"-37.82011242, 144.96291897"
402220250710,40,2025-07-10,22,130,27,157,Spr201_T,"-37.80999341, 144.97227587"
40620240406,40,2024-04-06,6,17,15,32,Spr201_T,"-37.80999341, 144.97227587"
211620250712,21,2025-07-12,16,487,512,999,Bourke155_T,"-37.81267313, 144.96788288"
36820231205,36,2023-12-05,8,236,192,428,Que85_T,"-37.81652527, 144.96121062"
36820240108,36,2024-01-08,8,144,95,239,Que85_T,"-37.81652527, 144.96121062"
37620250322,37,2025-03-22,6,6,2,8,Lyg260_T,"-37.80107122, 144.96704554"
501520241105,50,2024-11-05,15,195,227,422,Lyg309_T,"-37.79808192, 144.96721013"
1082020250309,108,2025-03-09,20,157,129,286,261Will_T,"-37.81295822, 144.95678789"
1311720250317,131,2025-03-17,17,118,190,308,King2_T,"-37.82009057, 144.95758725"
87720250402,87,2025-04-02,7,29,36,65,Errol23_T,"-37.80454949, 144.94921863"
611920250503,61,2025-05-03,19,424,276,700,RMIT14_T,"-37.80767455, 144.96309114"
441220250819,44,2025-08-19,12,138,142,280,UM3_T,"-37.79698741, 144.96441306"
441320240506,44,2024-05-06,13,117,122,239,UM3_T,"-37.79698741, 144.96441306"
501420240130,50,2024-01-30,14,198,160,358,Lyg309_T,"-37.79808192, 144.96721013"
44820240203,44,2024-02-03,8,24,11,35,UM3_T,"-37.79698741, 144.96441306"
51820250518,5,2025-05-18,18,506,444,950,PriNW_T,"-37.81874249, 144.96787656"
1811220250909,181,2025-09-09,12,686,948,1634,Eli368_T,"-37.81009465, 144.96143149"
162420251010,162,2025-10-10,4,25,23,48,Eli489_T,"-37.80740397, 144.95987909"
1671420241102,167,2024-11-02,14,33,100,133,Lat526_T,"-37.81304149, 144.95155955"
1671720250101,167,2025-01-01,17,43,71,114,Lat526_T,"-37.81304149, 144.95155955"
1081020250505,108,2025-05-05,10,301,425,726,261Will_T,"-37.81295822, 144.95678789"
1431420240624,143,2024-06-24,14,225,223,448,Spencer_T,"-37.821728, 144.95557015"
1321520240614,132,2024-06-14,15,119,143,262,King335_T,"-37.81267639, 144.95386444"
1341920250305,134,2025-03-05,19,445,346,791,Spen201_T,"-37.81694221, 144.95303935"
131620240205,131,2024-02-05,6,16,10,26,King2_T,"-37.82009057, 144.95758725"
1181020240921,118,2024-09-21,10,12,17,29,Fli114C_T,"-37.81632783, 144.97090512"
1081020241207,108,2024-12-07,10,90,82,172,261Will_T,"-37.81295822, 144.95678789"
70420251016,70,2025-10-16,4,1,0,1,Errol20_T,"-37.80456984, 144.94946228"
1651720250914,165,2025-09-14,17,46,38,84,Spen475_T,"-37.80953359, 144.94939004"
18120231203,18,2023-12-03,1,0,3,3,Col12_T,"-37.81344862, 144.97305353"
631520240102,63,2024-01-02,15,337,356,693,Bou231_T,"-37.81333081, 144.96675571"
68120240613,68,2024-06-13,1,0,1,1,FLDegN_T,"-37.8168479, 144.96559789"
121320250123,12,2025-01-23,13,252,195,447,NewQ_T,"-37.81457988, 144.94292398"
121520250301,12,2025-03-01,15,360,446,806,NewQ_T,"-37.81457988, 144.94292398"
24620231121,24,2023-11-21,6,431,188,619,Col620_T,"-37.81887963, 144.95449198"
352020240205,35,2024-02-05,20,585,845,1430,SouthB_T,"-37.82018685, 144.96508508"
761820240913,76,2024-09-13,18,51,53,104,KenMac_T,"-37.79453803, 144.93036194"
581220241207,58,2024-12-07,12,876,256,1132,Bou688_T,"-37.81686075, 144.95358075"
272320241002,27,2024-10-02,23,47,14,61,Vic_T,"-37.80606888, 144.95644692"
271320250415,27,2025-04-15,13,212,145,357,Vic_T,"-37.80606888, 144.95644692"
27520250612,27,2025-06-12,5,5,3,8,Vic_T,"-37.80606888, 144.95644692"
53020250218,53,2025-02-18,0,7,25,32,Col254_T,"-37.81564191, 144.965499"
23020231123,23,2023-11-23,0,16,38,54,Col623_T,"-37.81909256, 144.95452748"
201420250428,20,2025-04-28,14,158,203,361,LtB170_T,"-37.81172914, 144.9682466"
251920240712,25,2024-07-12,19,681,500,1181,MCEC_T,"-37.82401776, 144.95604426"
462220250120,46,2025-01-20,22,2,0,2,Pel147_T,"-37.80240719, 144.9615673"
1231020250709,123,2025-07-09,10,25,14,39,BirBridge_T,"-37.81753741, 144.97329734"
117420240615,117,2024-06-15,4,12,6,18,Fli114F_T,"-37.81629332, 144.97090877"
191120250909,19,2025-09-09,11,276,149,425,LtB210_T,"-37.81237202, 144.96550671"
482220240509,48,2024-05-09,22,75,129,204,QVMQ_T,"-37.80631581, 144.95866697"
180420250416,180,2025-04-16,4,0,1,1,Mac330_T,"-37.79497059, 144.93530329"
136020250824,136,2025-08-24,0,1,0,1,BirFed1120_T,"-37.8184141, 144.97357915"
1611220241018,161,2024-10-18,12,54,65,119,BirArt1109_T,"-37.81851276, 144.97131336"
691820250611,69,2025-06-11,18,45,69,114,FLDegC_T,"-37.81687226, 144.96559144"
662120240505,66,2024-05-05,21,506,361,867,QVN_T,"-37.81057846, 144.96444294"
662020240624,66,2024-06-24,20,713,548,1261,QVN_T,"-37.81057846, 144.96444294"
3520240802,3,2024-08-02,5,19,39,58,Swa295_T,"-37.81101524, 144.96429485"
621820240720,62,2024-07-20,18,235,131,366,Lat224_T,"-37.80996494, 144.96216521"
622220241201,62,2024-12-01,22,78,69,147,Lat224_T,"-37.80996494, 144.96216521"
861820240704,86,2024-07-04,18,66,50,116,574Qub_T,"-37.80309992, 144.94908064"
86720241021,86,2024-10-21,7,28,16,44,574Qub_T,"-37.80309992, 144.94908064"
121120240702,12,2024-07-02,11,134,144,278,NewQ_T,"-37.81457988, 144.94292398"
241920250421,24,2025-04-21,19,325,562,887,Col620_T,"-37.81887963, 144.95449198"
121720250625,12,2025-06-25,17,39,36,75,NewQ_T,"-37.81457988, 144.94292398"
12620250821,12,2025-08-21,6,17,10,27,NewQ_T,"-37.81457988, 144.94292398"
722220240906,72,2024-09-06,22,165,903,1068,ACMI_T,"-37.81726338, 144.96872809"
35220250221,35,2025-02-21,2,12,21,33,SouthB_T,"-37.82018685, 144.96508508"
76020240821,76,2024-08-21,0,0,2,2,KenMac_T,"-37.79453803, 144.93036194"
351920231216,35,2023-12-16,19,1772,2490,4262,SouthB_T,"-37.82018685, 144.96508508"
2320240205,2,2024-02-05,3,1,3,4,Bou283_T,"-37.81380668, 144.96516718"
271420241229,27,2024-12-29,14,239,175,414,Vic_T,"-37.80606888, 144.95644692"
53720250719,53,2025-07-19,7,2,4,6,Col254_T,"-37.81564191, 144.965499"
53220240408,53,2024-04-08,2,41,47,88,Col254_T,"-37.81564191, 144.965499"
23220231113,23,2023-11-13,2,4,4,8,Col623_T,"-37.81909256, 144.95452748"
23820231207,23,2023-12-07,8,691,348,1039,Col623_T,"-37.81909256, 144.95452748"
23920250831,23,2025-08-31,9,104,114,218,Col623_T,"-37.81909256, 144.95452748"
521520241210,52,2024-12-10,15,397,270,667,Eli263_T,"-37.81252157, 144.9619401"
521420240305,52,2024-03-05,14,451,318,769,Eli263_T,"-37.81252157, 144.9619401"
201720250324,20,2025-03-24,17,209,176,385,LtB170_T,"-37.81172914, 144.9682466"
202020240507,20,2024-05-07,20,138,292,430,LtB170_T,"-37.81172914, 144.9682466"
202120240713,20,2024-07-13,21,256,447,703,LtB170_T,"-37.81172914, 144.9682466"
1412020250430,141,2025-04-30,20,78,97,175,474Fl_T,"-37.81997273, 144.95834911"
1391720241015,139,2024-10-15,17,341,44,385,Signal1647_T,"-37.81959923, 144.9632832"
1612220251006,161,2025-10-06,22,0,347,347,BirArt1109_T,"-37.81851276, 144.97131336"
117220250914,117,2025-09-14,2,10,5,15,Fli114F_T,"-37.81629332, 144.97090877"
1171020240426,117,2024-04-26,10,128,130,258,Fli114F_T,"-37.81629332, 144.97090877"
42320240229,4,2024-02-29,23,365,205,570,Swa123_T,"-37.81487988, 144.9660878"
41120241001,4,2024-10-01,11,1202,858,2060,Swa123_T,"-37.81487988, 144.9660878"
41720250926,4,2025-09-26,17,1962,1439,3401,Swa123_T,"-37.81487988, 144.9660878"
411420250625,41,2025-06-25,14,1091,1320,2411,Swa31,"-37.81668634, 144.96689733"
8420241227,8,2024-12-27,4,1,0,1,WebBN_T,"-37.82293543, 144.9471751"
781020241230,78,2024-12-30,10,78,72,150,HarEsB_T,"-37.81471642, 144.9446508"
78120231031,78,2023-10-31,1,1,4,5,HarEsB_T,"-37.81471642, 144.9446508"
771620250721,77,2025-07-21,16,221,132,353,HarEsP_T,"-37.81441438, 144.94433026"
281620231115,28,2023-11-15,16,397,1029,1426,VAC_T,"-37.82129925, 144.96879309"
472320250421,47,2025-04-21,23,71,92,163,Eli250_T,"-37.81258467, 144.9625775"
452120240218,45,2024-02-18,21,261,463,724,Swa148_T,"-37.81414075, 144.96609379"
45320250414,45,2025-04-14,3,13,25,38,Swa148_T,"-37.81414075, 144.96609379"
451020250508,45,2025-05-08,10,240,318,558,Swa148_T,"-37.81414075, 144.96609379"
52320231024,5,2023-10-24,23,81,99,180,PriNW_T,"-37.81874249, 144.96787656"
21920231108,21,2023-11-08,9,111,136,247,Bourke155_T,"-37.81267313, 144.96788288"
1332020250417,133,2025-04-17,20,584,473,1057,Spen229_T,"-37.81531435, 144.95227769"
1241520231112,124,2023-11-12,15,1,4,5,BirBridge_T,"-37.81757416, 144.97329934"
1241020250305,124,2025-03-05,10,3,6,9,BirBridge_T,"-37.81757416, 144.97329934"
872220241127,87,2024-11-27,22,15,22,37,Errol23_T,"-37.80454949, 144.94921863"
134420241023,134,2024-10-23,4,26,24,50,Spen201_T,"-37.81694221, 144.95303935"
1351120250715,135,2025-07-15,11,367,464,831,Spen161_T,"-37.8172861, 144.95319102"
1351420240512,135,2024-05-12,14,305,423,728,Spen161_T,"-37.8172861, 144.95319102"
135720240921,135,2024-09-21,7,58,139,197,Spen161_T,"-37.8172861, 144.95319102"
133320240716,133,2024-07-16,3,5,9,14,Spen229_T,"-37.81531435, 144.95227769"
107420241230,107,2024-12-30,4,1,1,2,280Will_T,"-37.81246271, 144.95690188"
1791520250626,179,2025-06-26,15,50,63,113,Pow61_T,"-37.82392385, 144.96299677"
851220231107,85,2023-11-07,12,94,105,199,488Mac_T,"-37.79432415, 144.92973378"
11320231109,1,2023-11-09,13,1468,1282,2750,Bou292_T,"-37.81349441, 144.96515323"
68720250319,68,2025-03-19,7,77,46,123,FLDegN_T,"-37.8168479, 144.96559789"
861720241201,86,2024-12-01,17,28,46,74,574Qub_T,"-37.80309992, 144.94908064"
67420240502,67,2024-05-02,4,5,7,12,FLDegS_T,"-37.81688755, 144.96562569"
11620250623,11,2025-06-23,6,7,13,20,WatCit_T,"-37.81564989, 144.93970694"
72720240415,72,2024-04-15,7,179,41,220,ACMI_T,"-37.81726338, 144.96872809"
351720250517,35,2025-05-17,17,629,944,1573,SouthB_T,"-37.82018685, 144.96508508"
22120240726,2,2024-07-26,21,117,159,276,Bou283_T,"-37.81380668, 144.96516718"
22320250831,2,2025-08-31,23,16,25,41,Bou283_T,"-37.81380668, 144.96516718"
531620231105,53,2023-11-05,16,522,416,938,Col254_T,"-37.81564191, 144.965499"
511620240718,51,2024-07-18,16,90,123,213,Fra118_T,"-37.80841815, 144.95906316"
481620250806,48,2025-08-06,16,176,267,443,QVMQ_T,"-37.80631581, 144.95866697"
201920240830,20,2024-08-30,19,583,661,1244,LtB170_T,"-37.81172914, 144.9682466"
252320240901,25,2024-09-01,23,53,30,83,MCEC_T,"-37.82401776, 144.95604426"
522120240910,52,2024-09-10,21,197,124,321,Eli263_T,"-37.81252157, 144.9619401"
1391020240709,139,2024-07-09,10,8,38,46,Signal1647_T,"-37.81959923, 144.9632832"
1231720250430,123,2025-04-30,17,56,39,95,BirBridge_T,"-37.81753741, 144.97329734"
1092120241027,109,2024-10-27,21,41,80,121,LatWill_T,"-37.81193681, 144.95621105"
191220241109,19,2024-11-09,12,572,448,1020,LtB210_T,"-37.81237202, 144.96550671"
180620250808,180,2025-08-08,6,8,4,12,Mac330_T,"-37.79497059, 144.93530329"
66820250815,66,2025-08-15,8,219,317,536,QVN_T,"-37.81057846, 144.96444294"
84820250815,84,2025-08-15,8,1101,349,1450,ElFi_T,"-37.81798049, 144.96503383"
4920241017,4,2024-10-17,9,534,421,955,Swa123_T,"-37.81487988, 144.9660878"
701520240623,70,2024-06-23,15,118,129,247,Errol20_T,"-37.80456984, 144.94946228"
32320240120,3,2024-01-20,23,769,608,1377,Swa295_T,"-37.81101524, 144.96429485"
391320250418,39,2025-04-18,13,47,23,70,AlfPl_T,"-37.81379749, 144.96995745"
751020250316,75,2025-03-16,10,17,12,29,SprFli_T,"-37.81515276, 144.97467661"
75820250509,75,2025-05-09,8,59,40,99,SprFli_T,"-37.81515276, 144.97467661"
81920240403,8,2024-04-03,19,63,74,137,WebBN_T,"-37.82293543, 144.9471751"
82320250222,8,2025-02-22,23,8,20,28,WebBN_T,"-37.82293543, 144.9471751"
78220231110,78,2023-11-10,2,0,4,4,HarEsB_T,"-37.81471642, 144.9446508"
781920240924,78,2024-09-24,19,1,14,15,HarEsB_T,"-37.81471642, 144.9446508"
59120240324,59,2024-03-24,1,134,52,186,RMIT_T,"-37.80825648, 144.96304859"
65520240302,65,2024-03-02,5,4,10,14,SwaCs_T,"-37.81569416, 144.9668064"
42520250316,42,2025-03-16,5,1,5,6,UM1_T,"-37.80008566, 144.96386412"
54820250407,54,2025-04-07,8,247,62,309,Swa607_T,"-37.804024, 144.96308399"
421020240810,42,2024-08-10,10,73,78,151,UM1_T,"-37.80008566, 144.96386412"
591420240325,59,2024-03-25,14,1494,1340,2834,RMIT_T,"-37.80825648, 144.96304859"
139720250616,139,2025-06-16,7,5,85,90,Signal1647_T,"-37.81959923, 144.9632832"
1361920240203,136,2024-02-03,19,219,46,265,BirFed1120_T,"-37.8184141, 144.97357915"
1421520250701,142,2025-07-01,15,236,164,400,Hammer1584_T,"-37.81970749, 144.96795734"
130520241104,130,2024-11-04,5,1,0,1,Bou892T,"-37.8204637, 144.94126826"
1381520241124,138,2024-11-24,15,4,2,6,EntPark1671_T,"-37.81996544, 144.95981454"
851020240330,85,2024-03-30,10,87,68,155,488Mac_T,"-37.79432415, 144.92973378"
85520250122,85,2025-01-22,5,8,4,12,488Mac_T,"-37.79432415, 144.92973378"
85320231123,85,2023-11-23,3,1,0,1,488Mac_T,"-37.79432415, 144.92973378"
171720240222,17,2024-02-22,17,327,760,1087,Col15_T,"-37.81362543, 144.97323591"
682020231113,68,2023-11-13,20,69,13,82,FLDegN_T,"-37.8168479, 144.96559789"
622220251007,62,2025-10-07,22,158,375,533,Lat224_T,"-37.80996494, 144.96216521"
631420251003,63,2025-10-03,14,468,513,981,Bou231_T,"-37.81333081, 144.96675571"
622320250211,62,2025-02-11,23,106,68,174,Lat224_T,"-37.80996494, 144.96216521"
621120250516,62,2025-05-16,11,194,133,327,Lat224_T,"-37.80996494, 144.96216521"
111420241019,11,2024-10-19,14,1243,1344,2587,WatCit_T,"-37.81564989, 144.93970694"
121420241109,12,2024-11-09,14,150,195,345,NewQ_T,"-37.81457988, 144.94292398"
24020240519,24,2024-05-19,0,111,218,329,Col620_T,"-37.81887963, 144.95449198"
24020231218,24,2023-12-18,0,57,114,171,Col620_T,"-37.81887963, 144.95449198"
241420250804,24,2025-08-04,14,417,779,1196,Col620_T,"-37.81887963, 144.95449198"
101320250105,10,2025-01-05,13,19,23,42,BouHbr_T,"-37.81876474, 144.94710545"
761220240613,76,2024-06-13,12,78,74,152,KenMac_T,"-37.79453803, 144.93036194"
582320231218,58,2023-12-18,23,126,97,223,Bou688_T,"-37.81686075, 144.95358075"
58920250124,58,2025-01-24,9,759,151,910,Bou688_T,"-37.81686075, 144.95358075"
582220240329,58,2024-03-29,22,240,323,563,Bou688_T,"-37.81686075, 144.95358075"
91620250219,9,2025-02-19,16,2585,129,2714,Col700_T,"-37.81982992, 144.95102555"
301220240922,30,2024-09-22,12,327,432,759,Lon189_T,"-37.8112185, 144.96656806"
20020251013,20,2025-10-13,0,16,35,51,LtB170_T,"-37.81172914, 144.9682466"
25020240129,25,2024-01-29,0,26,86,112,MCEC_T,"-37.82401776, 144.95604426"
46620250102,46,2025-01-02,6,5,7,12,Pel147_T,"-37.80240719, 144.9615673"
511520250902,51,2025-09-02,15,86,72,158,Fra118_T,"-37.80841815, 144.95906316"
511720241024,51,2024-10-24,17,83,102,185,Fra118_T,"-37.80841815, 144.95906316"
23120240506,23,2024-05-06,1,5,7,12,Col623_T,"-37.81909256, 144.95452748"
49720241009,49,2024-10-09,7,55,64,119,Eli501_T,"-37.80730068, 144.95956055"
117320231216,117,2023-12-16,3,18,9,27,Fli114F_T,"-37.81629332, 144.97090877"
1091920250326,109,2025-03-26,19,127,142,269,LatWill_T,"-37.81193681, 144.95621105"
192320240402,19,2024-04-02,23,102,179,281,LtB210_T,"-37.81237202, 144.96550671"
192320240419,19,2024-04-19,23,288,463,751,LtB210_T,"-37.81237202, 144.96550671"
48320240427,48,2024-04-27,3,7,10,17,QVMQ_T,"-37.80631581, 144.95866697"
311220240513,31,2024-05-13,12,175,155,330,Lyg161_T,"-37.80169681, 144.96658911"
54320240922,54,2024-09-22,3,12,11,23,Swa607_T,"-37.804024, 144.96308399"
47420240512,47,2024-05-12,4,55,44,99,Eli250_T,"-37.81258467, 144.9625775"
471520240708,47,2024-07-08,15,867,811,1678,Eli250_T,"-37.81258467, 144.9625775"
401020250423,40,2025-04-23,10,262,230,492,Spr201_T,"-37.80999341, 144.97227587"
40920241006,40,2024-10-06,9,51,65,116,Spr201_T,"-37.80999341, 144.97227587"
212220250717,21,2025-07-17,22,172,209,381,Bourke155_T,"-37.81267313, 144.96788288"
36320250822,36,2025-08-22,3,5,7,12,Que85_T,"-37.81652527, 144.96121062"
21120250117,21,2025-01-17,1,47,33,80,Bourke155_T,"-37.81267313, 144.96788288"
361220250116,36,2025-01-16,12,354,318,672,Que85_T,"-37.81652527, 144.96121062"
37620250725,37,2025-07-25,6,4,4,8,Lyg260_T,"-37.80107122, 144.96704554"
441520241026,44,2024-10-26,15,33,52,85,UM3_T,"-37.79698741, 144.96441306"
5020250224,5,2025-02-24,0,42,68,110,PriNW_T,"-37.81874249, 144.96787656"
1311620250123,131,2025-01-23,16,163,144,307,King2_T,"-37.82009057, 144.95758725"
165920240907,165,2024-09-07,9,22,32,54,Spen475_T,"-37.80953359, 144.94939004"
1401920250211,140,2025-02-11,19,116,99,215,Boyd2837_T,"-37.82590962, 144.96185972"
1241120240119,124,2024-01-19,11,0,2,2,BirBridge_T,"-37.81757416, 144.97329934"
166720240929,166,2024-09-29,7,9,7,16,Spen484_T,"-37.80896733, 144.94931703"
67420240102,67,2024-01-02,4,5,1,6,FLDegS_T,"-37.81688755, 144.96562569"
17720240427,17,2024-04-27,7,42,26,68,Col15_T,"-37.81362543, 144.97323591"
172220240608,17,2024-06-08,22,109,88,197,Col15_T,"-37.81362543, 144.97323591"
171920240614,17,2024-06-14,19,167,156,323,Col15_T,"-37.81362543, 144.97323591"
11420240201,1,2024-02-01,14,1021,941,1962,Bou292_T,"-37.81349441, 144.96515323"
63120240131,63,2024-01-31,1,13,51,64,Bou231_T,"-37.81333081, 144.96675571"
631020240509,63,2024-05-09,10,213,203,416,Bou231_T,"-37.81333081, 144.96675571"
63920250109,63,2025-01-09,9,94,143,237,Bou231_T,"-37.81333081, 144.96675571"
62920250517,62,2025-05-17,9,64,50,114,Lat224_T,"-37.80996494, 144.96216521"
86620240509,86,2024-05-09,6,8,4,12,574Qub_T,"-37.80309992, 144.94908064"
862120250323,86,2025-03-23,21,15,28,43,574Qub_T,"-37.80309992, 144.94908064"
11920241123,11,2024-11-23,9,40,36,76,WatCit_T,"-37.81564989, 144.93970694"
12920240718,12,2024-07-18,9,126,169,295,NewQ_T,"-37.81457988, 144.94292398"
101620240114,10,2024-01-14,16,50,40,90,BouHbr_T,"-37.81876474, 144.94710545"
102320241211,10,2024-12-11,23,8,5,13,BouHbr_T,"-37.81876474, 144.94710545"
761120240222,76,2024-02-22,11,52,46,98,KenMac_T,"-37.79453803, 144.93036194"
762220250616,76,2025-06-16,22,2,6,8,KenMac_T,"-37.79453803, 144.93036194"
2820250624,2,2025-06-24,8,108,181,289,Bou283_T,"-37.81380668, 144.96516718"
21320250822,2,2025-08-22,13,1097,1292,2389,Bou283_T,"-37.81380668, 144.96516718"
58220240822,58,2024-08-22,2,25,44,69,Bou688_T,"-37.81686075, 144.95358075"
351820250425,35,2025-04-25,18,777,2728,3505,SouthB_T,"-37.82018685, 144.96508508"
27320250126,27,2025-01-26,3,7,4,11,Vic_T,"-37.80606888, 144.95644692"
791720240211,79,2024-02-11,17,474,335,809,FliSS_T,"-37.81794046, 144.96616678"
791020240421,79,2024-04-21,10,362,220,582,FliSS_T,"-37.81794046, 144.96616678"
521820240914,52,2024-09-14,18,309,407,716,Eli263_T,"-37.81252157, 144.9619401"
521420240309,52,2024-03-09,14,304,281,585,Eli263_T,"-37.81252157, 144.9619401"
1171620250516,117,2025-05-16,16,133,242,375,Fli114F_T,"-37.81629332, 144.97090877"
1172220250906,117,2025-09-06,22,153,118,271,Fli114F_T,"-37.81629332, 144.97090877"
1231020250223,123,2025-02-23,10,22,19,41,BirBridge_T,"-37.81753741, 144.97329734"
1302020240302,130,2024-03-02,20,0,3,3,Bou892T,"-37.8204637, 144.94126826"
1412220231227,141,2023-12-27,22,80,126,206,474Fl_T,"-37.81997273, 144.95834911"
1411220240312,141,2024-03-12,12,218,161,379,474Fl_T,"-37.81997273, 144.95834911"
1171920241121,117,2024-11-21,19,150,255,405,Fli114F_T,"-37.81629332, 144.97090877"
192020240925,19,2024-09-25,20,375,559,934,LtB210_T,"-37.81237202, 144.96550671"
19120241111,19,2024-11-11,1,35,28,63,LtB210_T,"-37.81237202, 144.96550671"
1372220250522,137,2025-05-22,22,3,0,3,BouHbr2353_T,"-37.81894815, 144.94612292"
66620250206,66,2025-02-06,6,15,81,96,QVN_T,"-37.81057846, 144.96444294"
691720250226,69,2025-02-26,17,152,218,370,FLDegC_T,"-37.81687226, 144.96559144"
84620250120,84,2025-01-20,6,356,123,479,ElFi_T,"-37.81798049, 144.96503383"
70220251013,70,2025-10-13,2,1,2,3,Errol20_T,"-37.80456984, 144.94946228"
391120251014,39,2025-10-14,11,109,104,213,AlfPl_T,"-37.81379749, 144.96995745"
412320250413,41,2025-04-13,23,193,278,471,Swa31,"-37.81668634, 144.96689733"
59320250621,59,2025-06-21,3,52,8,60,RMIT_T,"-37.80825648, 144.96304859"
61020240617,61,2024-06-17,0,17,23,40,RMIT14_T,"-37.80767455, 144.96309114"
502120241120,50,2024-11-20,21,169,84,253,Lyg309_T,"-37.79808192, 144.96721013"
166820250222,166,2025-02-22,8,26,23,49,Spen484_T,"-37.80896733, 144.94931703"
1671220250224,167,2025-02-24,12,24,64,88,Lat526_T,"-37.81304149, 144.95155955"
181820250513,181,2025-05-13,8,758,495,1253,Eli368_T,"-37.81009465, 144.96143149"
131520241129,131,2024-11-29,5,16,11,27,King2_T,"-37.82009057, 144.95758725"
131720250504,131,2025-05-04,7,24,49,73,King2_T,"-37.82009057, 144.95758725"
1341820231226,134,2023-12-26,18,438,448,886,Spen201_T,"-37.81694221, 144.95303935"
135720231209,135,2023-12-09,7,92,92,184,Spen161_T,"-37.8172861, 144.95319102"
1411920250308,141,2025-03-08,19,163,185,348,474Fl_T,"-37.81997273, 144.95834911"
1411120250311,141,2025-03-11,11,243,91,334,474Fl_T,"-37.81997273, 144.95834911"
1371020250919,137,2025-09-19,10,18,32,50,BouHbr2353_T,"-37.81894815, 144.94612292"
1362320240304,136,2024-03-04,23,0,44,44,BirFed1120_T,"-37.8184141, 144.97357915"
1611720250106,161,2025-01-06,17,193,227,420,BirArt1109_T,"-37.81851276, 144.97131336"
1611520250212,161,2025-02-12,15,56,59,115,BirArt1109_T,"-37.81851276, 144.97131336"
117920250412,117,2025-04-12,9,71,151,222,Fli114F_T,"-37.81629332, 144.97090877"
1171120250930,117,2025-09-30,11,108,132,240,Fli114F_T,"-37.81629332, 144.97090877"
68220240107,68,2024-01-07,2,1,0,1,FLDegN_T,"-37.8168479, 144.96559789"
851520231028,85,2023-10-28,15,60,70,130,488Mac_T,"-37.79432415, 144.92973378"
85420250806,85,2025-08-06,4,2,1,3,488Mac_T,"-37.79432415, 144.92973378"
852320250928,85,2025-09-28,23,1,6,7,488Mac_T,"-37.79432415, 144.92973378"
17520240407,17,2024-04-07,5,6,8,14,Col15_T,"-37.81362543, 144.97323591"
67220240514,67,2024-05-14,2,1,5,6,FLDegS_T,"-37.81688755, 144.96562569"
621420240111,62,2024-01-11,14,263,235,498,Lat224_T,"-37.80996494, 144.96216521"
11920241009,11,2024-10-09,9,43,52,95,WatCit_T,"-37.81564989, 144.93970694"
12320250705,1,2025-07-05,23,205,130,335,Bou292_T,"-37.81349441, 144.96515323"
10920250214,10,2025-02-14,9,46,69,115,BouHbr_T,"-37.81876474, 144.94710545"
761020250826,76,2025-08-26,10,45,36,81,KenMac_T,"-37.79453803, 144.93036194"
761320231215,76,2023-12-15,13,68,103,171,KenMac_T,"-37.79453803, 144.93036194"
582120240418,58,2024-04-18,21,591,303,894,Bou688_T,"-37.81686075, 144.95358075"
53020250119,53,2025-01-19,0,33,59,92,Col254_T,"-37.81564191, 144.965499"
791020240807,79,2024-08-07,10,352,240,592,FliSS_T,"-37.81794046, 144.96616678"
512320240501,51,2024-05-01,23,30,19,49,Fra118_T,"-37.80841815, 144.95906316"
512120240226,51,2024-02-26,21,63,56,119,Fra118_T,"-37.80841815, 144.95906316"
781920250220,78,2025-02-20,19,23,78,101,HarEsB_T,"-37.81471642, 144.9446508"
422020240727,42,2024-07-27,20,21,25,46,UM1_T,"-37.80008566, 144.96386412"
771020250420,77,2025-04-20,10,113,128,241,HarEsP_T,"-37.81441438, 144.94433026"
291920250921,29,2025-09-21,19,44,64,108,AG_T,"-37.8199817, 144.96872865"
71420250110,71,2025-01-10,4,3,2,5,WestWP_T,"-37.81235775, 144.97136962"
591320241123,59,2024-11-23,13,227,283,510,RMIT_T,"-37.80825648, 144.96304859"
541120231116,54,2023-11-16,11,84,104,188,Swa607_T,"-37.804024, 144.96308399"
281820250720,28,2025-07-20,18,315,524,839,VAC_T,"-37.82129925, 144.96879309"
371020250725,37,2025-07-25,10,52,48,100,Lyg260_T,"-37.80107122, 144.96704554"
21220240308,21,2024-03-08,2,36,44,80,Bourke155_T,"-37.81267313, 144.96788288"
211320240517,21,2024-05-17,13,408,453,861,Bourke155_T,"-37.81267313, 144.96788288"
45120240312,45,2024-03-12,1,18,18,36,Swa148_T,"-37.81414075, 144.96609379"
212120231019,21,2023-10-19,21,323,383,706,Bourke155_T,"-37.81267313, 144.96788288"
107620241123,107,2024-11-23,6,10,13,23,280Will_T,"-37.81246271, 144.95690188"
107020241224,107,2024-12-24,0,17,14,31,280Will_T,"-37.81246271, 144.95690188"
282020241119,28,2024-11-19,20,170,221,391,VAC_T,"-37.82129925, 144.96879309"
501920240803,50,2024-08-03,19,210,243,453,Lyg309_T,"-37.79808192, 144.96721013"
135220240515,135,2024-05-15,2,3,7,10,Spen161_T,"-37.8172861, 144.95319102"
132220250603,132,2025-06-03,2,7,7,14,King335_T,"-37.81267639, 144.95386444"
1181320231030,118,2023-10-30,13,18,11,29,Fli114C_T,"-37.81632783, 144.97090512"
1082320241115,108,2024-11-15,23,64,100,164,261Will_T,"-37.81295822, 144.95678789"
871020250308,87,2025-03-08,10,102,97,199,Errol23_T,"-37.80454949, 144.94921863"
612120240101,61,2024-01-01,21,167,102,269,RMIT14_T,"-37.80767455, 144.96309114"
1621520241020,162,2024-10-20,15,613,969,1582,Eli489_T,"-37.80740397, 144.95987909"
1401620240517,140,2024-05-17,16,80,88,168,Boyd2837_T,"-37.82590962, 144.96185972"
1321920240812,132,2024-08-12,19,99,150,249,King335_T,"-37.81267639, 144.95386444"
672220250420,67,2025-04-20,22,120,153,273,FLDegS_T,"-37.81688755, 144.96562569"
17420250320,17,2025-03-20,4,7,7,14,Col15_T,"-37.81362543, 144.97323591"
67120250323,67,2025-03-23,1,25,47,72,FLDegS_T,"-37.81688755, 144.96562569"
681620250514,68,2025-05-14,16,233,208,441,FLDegN_T,"-37.8168479, 144.96559789"
121720250110,12,2025-01-10,17,186,195,381,NewQ_T,"-37.81457988, 144.94292398"
861920241108,86,2024-11-08,19,54,63,117,574Qub_T,"-37.80309992, 144.94908064"
10720231110,10,2023-11-10,7,35,114,149,BouHbr_T,"-37.81876474, 144.94710545"
24220231221,24,2023-12-21,2,23,27,50,Col620_T,"-37.81887963, 144.95449198"
721120240517,72,2024-05-17,11,134,261,395,ACMI_T,"-37.81726338, 144.96872809"
35820250813,35,2025-08-13,8,725,1980,2705,SouthB_T,"-37.82018685, 144.96508508"
21920231107,2,2023-11-07,19,126,142,268,Bou283_T,"-37.81380668, 144.96516718"
92220231123,9,2023-11-23,22,61,42,103,Col700_T,"-37.81982992, 144.95102555"
53420250207,53,2025-02-07,4,5,12,17,Col254_T,"-37.81564191, 144.965499"
531920241015,53,2024-10-15,19,211,185,396,Col254_T,"-37.81564191, 144.965499"
522220240317,52,2024-03-17,22,74,119,193,Eli263_T,"-37.81252157, 144.9619401"
522020250414,52,2025-04-14,20,197,169,366,Eli263_T,"-37.81252157, 144.9619401"
491820240705,49,2024-07-05,18,205,284,489,Eli501_T,"-37.80730068, 144.95956055"
191120240622,19,2024-06-22,11,354,254,608,LtB210_T,"-37.81237202, 144.96550671"
136820250416,136,2025-04-16,8,135,187,322,BirFed1120_T,"-37.8184141, 144.97357915"
1421020241003,142,2024-10-03,10,160,88,248,Hammer1584_T,"-37.81970749, 144.96795734"
130820240619,130,2024-06-19,8,1,2,3,Bou892T,"-37.8204637, 144.94126826"
1611120241031,161,2024-10-31,11,129,103,232,BirArt1109_T,"-37.81851276, 144.97131336"
1231820250514,123,2025-05-14,18,2,0,2,BirBridge_T,"-37.81753741, 144.97329734"
1171020250714,117,2025-07-14,10,78,106,184,Fli114F_T,"-37.81629332, 144.97090877"
66720250801,66,2025-08-01,7,64,176,240,QVN_T,"-37.81057846, 144.96444294"
61720240412,6,2024-04-12,17,1813,1297,3110,FliS_T,"-37.81911705, 144.96558255"
711120250627,71,2025-06-27,11,14,8,22,WestWP_T,"-37.81235775, 144.97136962"
31520241101,31,2024-11-01,5,8,1,9,Lyg161_T,"-37.80169681, 144.96658911"
281120250202,28,2025-02-02,11,781,636,1417,VAC_T,"-37.82129925, 144.96879309"
281320250408,28,2025-04-08,13,848,912,1760,VAC_T,"-37.82129925, 144.96879309"
40020231020,40,2023-10-20,0,12,6,18,Spr201_T,"-37.80999341, 144.97227587"
21120240229,21,2024-02-29,1,80,45,125,Bourke155_T,"-37.81267313, 144.96788288"
37020250821,37,2025-08-21,0,13,7,20,Lyg260_T,"-37.80107122, 144.96704554"
611020250120,61,2025-01-20,10,220,362,582,RMIT14_T,"-37.80767455, 144.96309114"
612120250831,61,2025-08-31,21,77,78,155,RMIT14_T,"-37.80767455, 144.96309114"
502020240427,50,2024-04-27,20,361,292,653,Lyg309_T,"-37.79808192, 144.96721013"
441420240625,44,2024-06-25,14,82,52,134,UM3_T,"-37.79698741, 144.96441306"
441820241231,44,2024-12-31,18,14,4,18,UM3_T,"-37.79698741, 144.96441306"
45320240627,45,2024-06-27,3,21,15,36,Swa148_T,"-37.81414075, 144.96609379"
1311720250129,131,2025-01-29,17,121,183,304,King2_T,"-37.82009057, 144.95758725"
167620241008,167,2024-10-08,6,3,17,20,Lat526_T,"-37.81304149, 144.95155955"
1671220250211,167,2025-02-11,12,28,62,90,Lat526_T,"-37.81304149, 144.95155955"
143820240704,143,2024-07-04,8,185,317,502,Spencer_T,"-37.821728, 144.95557015"
143220250916,143,2025-09-16,2,10,5,15,Spencer_T,"-37.821728, 144.95557015"
1321820231102,132,2023-11-02,18,146,112,258,King335_T,"-37.81267639, 144.95386444"
1321720231122,132,2023-11-22,17,229,112,341,King335_T,"-37.81267639, 144.95386444"
1351720251007,135,2025-10-07,17,489,733,1222,Spen161_T,"-37.8172861, 144.95319102"
1081820240408,108,2024-04-08,18,99,98,197,261Will_T,"-37.81295822, 144.95678789"
1082220250709,108,2025-07-09,22,117,111,228,261Will_T,"-37.81295822, 144.95678789"
166620250716,166,2025-07-16,6,2,3,5,Spen484_T,"-37.80896733, 144.94931703"
1651820250825,165,2025-08-25,18,33,10,43,Spen475_T,"-37.80953359, 144.94939004"
171020240318,17,2024-03-18,10,396,296,692,Col15_T,"-37.81362543, 144.97323591"
621220231218,62,2023-12-18,12,185,148,333,Lat224_T,"-37.80996494, 144.96216521"
62020231225,62,2023-12-25,0,3,0,3,Lat224_T,"-37.80996494, 144.96216521"
62120240117,62,2024-01-17,1,57,27,84,Lat224_T,"-37.80996494, 144.96216521"
561320231112,56,2023-11-12,13,402,167,569,Lon364_T,"-37.81234775, 144.96153311"
12820250427,12,2025-04-27,8,77,66,143,NewQ_T,"-37.81457988, 144.94292398"
121420241012,12,2024-10-12,14,216,262,478,NewQ_T,"-37.81457988, 144.94292398"
12720231226,12,2023-12-26,7,56,31,87,NewQ_T,"-37.81457988, 144.94292398"
351020240807,35,2024-08-07,10,500,490,990,SouthB_T,"-37.82018685, 144.96508508"
53120240909,53,2024-09-09,1,0,3,3,Col254_T,"-37.81564191, 144.965499"
53220231107,53,2023-11-07,2,7,27,34,Col254_T,"-37.81564191, 144.965499"
30720250318,30,2025-03-18,7,41,57,98,Lon189_T,"-37.8112185, 144.96656806"
30220240517,30,2024-05-17,2,66,69,135,Lon189_T,"-37.8112185, 144.96656806"
461420240310,46,2024-03-10,14,41,50,91,Pel147_T,"-37.80240719, 144.9615673"
201720250824,20,2025-08-24,17,413,248,661,LtB170_T,"-37.81172914, 144.9682466"
252220240204,25,2024-02-04,22,272,121,393,MCEC_T,"-37.82401776, 144.95604426"
521420240406,52,2024-04-06,14,461,416,877,Eli263_T,"-37.81252157, 144.9619401"
511120240801,51,2024-08-01,11,114,86,200,Fra118_T,"-37.80841815, 144.95906316"
512120240814,51,2024-08-14,21,90,62,152,Fra118_T,"-37.80841815, 144.95906316"
23320250203,23,2025-02-03,3,6,16,22,Col623_T,"-37.81909256, 144.95452748"
1171920250423,117,2025-04-23,19,98,156,254,Fli114F_T,"-37.81629332, 144.97090877"
191920241202,19,2024-12-02,19,560,539,1099,LtB210_T,"-37.81237202, 144.96550671"
25220241129,25,2024-11-29,2,6,8,14,MCEC_T,"-37.82401776, 144.95604426"
1801120250429,180,2025-04-29,11,24,24,48,Mac330_T,"-37.79497059, 144.93530329"
118920241205,118,2024-12-05,9,32,15,47,Fli114C_T,"-37.81632783, 144.97090512"
108420250624,108,2025-06-24,4,3,5,8,261Will_T,"-37.81295822, 144.95678789"
87920250524,87,2025-05-24,9,89,95,184,Errol23_T,"-37.80454949, 144.94921863"
185420250813,185,2025-08-13,4,7,20,27,Eli197_T,"-37.81374643, 144.96276183"
1791420250829,179,2025-08-29,14,29,34,63,Pow61_T,"-37.82392385, 144.96299677"
1811420250501,181,2025-05-01,14,686,1094,1780,Eli368_T,"-37.81009465, 144.96143149"
131920251007,131,2025-10-07,9,88,67,155,King2_T,"-37.82009057, 144.95758725"
1311520240101,131,2024-01-01,15,159,98,257,King2_T,"-37.82009057, 144.95758725"
1312020250811,131,2025-08-11,20,81,65,146,King2_T,"-37.82009057, 144.95758725"
1321720231207,132,2023-12-07,17,181,137,318,King335_T,"-37.81267639, 144.95386444"
1322220250104,132,2025-01-04,22,70,87,157,King335_T,"-37.81267639, 144.95386444"
1352220231217,135,2023-12-17,22,111,143,254,Spen161_T,"-37.8172861, 144.95319102"
135920240528,135,2024-05-28,9,307,304,611,Spen161_T,"-37.8172861, 144.95319102"
135920240616,135,2024-06-16,9,216,164,380,Spen161_T,"-37.8172861, 144.95319102"
662120240101,66,2024-01-01,21,603,293,896,QVN_T,"-37.81057846, 144.96444294"
662120240501,66,2024-05-01,21,646,445,1091,QVN_T,"-37.81057846, 144.96444294"
61120240607,6,2024-06-07,11,505,461,966,FliS_T,"-37.81911705, 144.96558255"
84320240811,84,2024-08-11,3,72,135,207,ElFi_T,"-37.81798049, 144.96503383"
70520240618,70,2024-06-18,5,3,2,5,Errol20_T,"-37.80456984, 144.94946228"
702320250828,70,2025-08-28,23,7,15,22,Errol20_T,"-37.80456984, 144.94946228"
3120250715,3,2025-07-15,1,35,16,51,Swa295_T,"-37.81101524, 144.96429485"
81820240416,8,2024-04-16,18,147,190,337,WebBN_T,"-37.82293543, 144.9471751"
672020240307,67,2024-03-07,20,170,183,353,FLDegS_T,"-37.81688755, 144.96562569"
671420240924,67,2024-09-24,14,495,782,1277,FLDegS_T,"-37.81688755, 144.96562569"
56920241201,56,2024-12-01,9,191,86,277,Lon364_T,"-37.81234775, 144.96153311"
112320240820,11,2024-08-20,23,6,7,13,WatCit_T,"-37.81564989, 144.93970694"
10020231024,10,2023-10-24,0,1,4,5,BouHbr_T,"-37.81876474, 144.94710545"
72220250702,72,2025-07-02,2,5,0,5,ACMI_T,"-37.81726338, 144.96872809"
72620231018,72,2023-10-18,6,64,37,101,ACMI_T,"-37.81726338, 144.96872809"
351520250604,35,2025-06-04,15,781,703,1484,SouthB_T,"-37.82018685, 144.96508508"
27420231020,27,2023-10-20,4,0,2,2,Vic_T,"-37.80606888, 144.95644692"
272120240903,27,2024-09-03,21,63,25,88,Vic_T,"-37.80606888, 144.95644692"
9620240307,9,2024-03-07,6,22,317,339,Col700_T,"-37.81982992, 144.95102555"
53020240918,53,2024-09-18,0,9,18,27,Col254_T,"-37.81564191, 144.965499"
231720240704,23,2024-07-04,17,471,1082,1553,Col623_T,"-37.81909256, 144.95452748"
301620250522,30,2025-05-22,16,235,346,581,Lon189_T,"-37.8112185, 144.96656806"
301320231024,30,2023-10-24,13,333,392,725,Lon189_T,"-37.8112185, 144.96656806"
521220241127,52,2024-11-27,12,477,311,788,Eli263_T,"-37.81252157, 144.9619401"
46020240327,46,2024-03-27,0,7,9,16,Pel147_T,"-37.80240719, 144.9615673"
251320250809,25,2025-08-09,13,753,878,1631,MCEC_T,"-37.82401776, 144.95604426"
25420240702,25,2024-07-02,4,0,0,0,MCEC_T,"-37.82401776, 144.95604426"
180820250918,180,2025-09-18,8,108,47,155,Mac330_T,"-37.79497059, 144.93530329"
1801120250929,180,2025-09-29,11,32,22,54,Mac330_T,"-37.79497059, 144.93530329"
141120250901,141,2025-09-01,1,10,14,24,474Fl_T,"-37.81997273, 144.95834911"
137020241214,137,2024-12-14,0,3,1,4,BouHbr2353_T,"-37.81894815, 144.94612292"
137720251014,137,2025-10-14,7,88,6,94,BouHbr2353_T,"-37.81894815, 144.94612292"
1361520250723,136,2025-07-23,15,106,103,209,BirFed1120_T,"-37.8184141, 144.97357915"
1641420250606,164,2025-06-06,14,95,91,186,Lat526_T,"-37.813005, 144.95160411"
1391320231227,139,2023-12-27,13,56,76,132,Signal1647_T,"-37.81959923, 144.9632832"
1391820240923,139,2024-09-23,18,109,70,179,Signal1647_T,"-37.81959923, 144.9632832"
130320241004,130,2024-10-04,3,1,0,1,Bou892T,"-37.8204637, 144.94126826"
130020250812,130,2025-08-12,0,2,0,2,Bou892T,"-37.8204637, 144.94126826"
1381620250126,138,2025-01-26,16,15,6,21,EntPark1671_T,"-37.81996544, 144.95981454"
84220240408,84,2024-04-08,2,29,37,66,ElFi_T,"-37.81798049, 144.96503383"
84120240827,84,2024-08-27,1,17,20,37,ElFi_T,"-37.81798049, 144.96503383"
841820250815,84,2025-08-15,18,852,1188,2040,ElFi_T,"-37.81798049, 144.96503383"
31420240904,3,2024-09-04,14,716,883,1599,Swa295_T,"-37.81101524, 144.96429485"
751320240504,75,2024-05-04,13,48,44,92,SprFli_T,"-37.81515276, 144.97467661"
751220241019,75,2024-10-19,12,26,46,72,SprFli_T,"-37.81515276, 144.97467661"
82220250113,8,2025-01-13,22,10,7,17,WebBN_T,"-37.82293543, 144.9471751"
75620250902,75,2025-09-02,6,13,43,56,SprFli_T,"-37.81515276, 144.97467661"
75120240605,75,2024-06-05,1,0,2,2,SprFli_T,"-37.81515276, 144.97467661"
412220250219,41,2025-02-19,22,499,750,1249,Swa31,"-37.81668634, 144.96689733"
78420240912,78,2024-09-12,4,1,1,2,HarEsB_T,"-37.81471642, 144.9446508"
541320240725,54,2024-07-25,13,315,317,632,Swa607_T,"-37.804024, 144.96308399"
54820250907,54,2025-09-07,8,27,33,60,Swa607_T,"-37.804024, 144.96308399"
28220231111,28,2023-11-11,2,38,18,56,VAC_T,"-37.82129925, 144.96879309"
40420250627,40,2025-06-27,4,4,0,4,Spr201_T,"-37.80999341, 144.97227587"
361020240401,36,2024-04-01,10,85,58,143,Que85_T,"-37.81652527, 144.96121062"
43120250811,43,2025-08-11,1,5,0,5,UM2_T,"-37.79844526, 144.96411782"
441320231118,44,2023-11-18,13,21,43,64,UM3_T,"-37.79698741, 144.96441306"
51420240422,5,2024-04-22,14,962,765,1727,PriNW_T,"-37.81874249, 144.96787656"
1622120250921,162,2025-09-21,21,144,82,226,Eli489_T,"-37.80740397, 144.95987909"
1401620240515,140,2024-05-15,16,65,98,163,Boyd2837_T,"-37.82590962, 144.96185972"
1322120250529,132,2025-05-29,21,102,81,183,King335_T,"-37.81267639, 144.95386444"
135920240930,135,2024-09-30,9,295,323,618,Spen161_T,"-37.8172861, 144.95319102"
1351320250522,135,2025-05-22,13,497,537,1034,Spen161_T,"-37.8172861, 144.95319102"
107620241110,107,2024-11-10,6,10,10,20,280Will_T,"-37.81246271, 144.95690188"
179220250802,179,2025-08-02,2,3,2,5,Pow61_T,"-37.82392385, 144.96299677"
165220250307,165,2025-03-07,2,3,1,4,Spen475_T,"-37.80953359, 144.94939004"
12020250225,1,2025-02-25,20,314,318,632,Bou292_T,"-37.81349441, 144.96515323"
63120240114,63,2024-01-14,1,113,257,370,Bou231_T,"-37.81333081, 144.96675571"
631720231031,63,2023-10-31,17,346,457,803,Bou231_T,"-37.81333081, 144.96675571"
631320250818,63,2025-08-18,13,476,497,973,Bou231_T,"-37.81333081, 144.96675571"
621920241124,62,2024-11-24,19,280,273,553,Lat224_T,"-37.80996494, 144.96216521"
622120250512,62,2025-05-12,21,166,118,284,Lat224_T,"-37.80996494, 144.96216521"
10620240313,10,2024-03-13,6,5,15,20,BouHbr_T,"-37.81876474, 144.94710545"
721020240216,72,2024-02-16,10,257,298,555,ACMI_T,"-37.81726338, 144.96872809"
102020250101,10,2025-01-01,20,40,23,63,BouHbr_T,"-37.81876474, 144.94710545"
35420240420,35,2024-04-20,4,15,16,31,SouthB_T,"-37.82018685, 144.96508508"
351420240427,35,2024-04-27,14,2082,1743,3825,SouthB_T,"-37.82018685, 144.96508508"
581520251003,58,2025-10-03,15,646,549,1195,Bou688_T,"-37.81686075, 144.95358075"
53620240305,53,2024-03-05,6,39,45,84,Col254_T,"-37.81564191, 144.965499"
53620240805,53,2024-08-05,6,36,23,59,Col254_T,"-37.81564191, 144.965499"
79220250323,79,2025-03-23,2,46,67,113,FliSS_T,"-37.81794046, 144.96616678"
461720240526,46,2024-05-26,17,59,51,110,Pel147_T,"-37.80240719, 144.9615673"
51920241218,51,2024-12-18,9,59,54,113,Fra118_T,"-37.80841815, 144.95906316"
841220231024,84,2023-10-24,12,958,925,1883,ElFi_T,"-37.81798049, 144.96503383"
42020241220,4,2024-12-20,20,1581,2096,3677,Swa123_T,"-37.81487988, 144.9660878"
701320250821,70,2025-08-21,13,174,165,339,Errol20_T,"-37.80456984, 144.94946228"
75720250510,75,2025-05-10,7,10,25,35,SprFli_T,"-37.81515276, 144.97467661"
81220250416,8,2025-04-16,12,237,413,650,WebBN_T,"-37.82293543, 144.9471751"
411620231230,41,2023-12-30,16,1845,1934,3779,Swa31,"-37.81668634, 144.96689733"
77820240408,77,2024-04-08,8,96,178,274,HarEsP_T,"-37.81441438, 144.94433026"
78220250224,78,2025-02-24,2,0,1,1,HarEsB_T,"-37.81471642, 144.9446508"
782120241006,78,2024-10-06,21,4,11,15,HarEsB_T,"-37.81471642, 144.9446508"
421220240925,42,2024-09-25,12,131,179,310,UM1_T,"-37.80008566, 144.96386412"
421520250120,42,2025-01-20,15,117,103,220,UM1_T,"-37.80008566, 144.96386412"
14520251011,14,2025-10-11,5,10,6,16,SanBri_T,"-37.82011242, 144.96291897"
14220240803,14,2024-08-03,2,73,21,94,SanBri_T,"-37.82011242, 144.96291897"
312020250116,31,2025-01-16,20,260,303,563,Lyg161_T,"-37.80169681, 144.96658911"
31620231228,31,2023-12-28,6,9,2,11,Lyg161_T,"-37.80169681, 144.96658911"
361620250930,36,2025-09-30,16,185,188,373,Que85_T,"-37.81652527, 144.96121062"
501520241103,50,2024-11-03,15,287,242,529,Lyg309_T,"-37.79808192, 144.96721013"
431320250627,43,2025-06-27,13,147,142,289,UM2_T,"-37.79844526, 144.96411782"
134120240925,134,2024-09-25,1,18,21,39,Spen201_T,"-37.81694221, 144.95303935"
135520250218,135,2025-02-18,5,27,29,56,Spen161_T,"-37.8172861, 144.95319102"
135020250730,135,2025-07-30,0,13,27,40,Spen161_T,"-37.8172861, 144.95319102"
1312320231117,131,2023-11-17,23,132,90,222,King2_T,"-37.82009057, 144.95758725"
131520240113,131,2024-01-13,5,18,40,58,King2_T,"-37.82009057, 144.95758725"
1311420240617,131,2024-06-17,14,141,90,231,King2_T,"-37.82009057, 144.95758725"
1351220231031,135,2023-10-31,12,371,428,799,Spen161_T,"-37.8172861, 144.95319102"
133920240828,133,2024-08-28,9,370,363,733,Spen229_T,"-37.81531435, 144.95227769"
871620250509,87,2025-05-09,16,103,110,213,Errol23_T,"-37.80454949, 144.94921863"
1821920250709,182,2025-07-09,19,257,263,520,King163_T,"-37.81627451, 144.95550503"
166320241004,166,2024-10-04,3,1,0,1,Spen484_T,"-37.80896733, 144.94931703"
1671120250830,167,2025-08-30,11,32,33,65,Lat526_T,"-37.81304149, 144.95155955"
1621920240804,162,2024-08-04,19,259,204,463,Eli489_T,"-37.80740397, 144.95987909"
143120250919,143,2025-09-19,1,33,48,81,Spencer_T,"-37.821728, 144.95557015"
143820250923,143,2025-09-23,8,107,149,256,Spencer_T,"-37.821728, 144.95557015"
1401220240804,140,2024-08-04,12,136,120,256,Boyd2837_T,"-37.82590962, 144.96185972"
171720241126,17,2024-11-26,17,324,708,1032,Col15_T,"-37.81362543, 144.97323591"
11720240927,1,2024-09-27,17,1533,1084,2617,Bou292_T,"-37.81349441, 144.96515323"
181720250202,18,2025-02-02,17,63,29,92,Col12_T,"-37.81344862, 144.97305353"
632120240804,63,2024-08-04,21,91,205,296,Bou231_T,"-37.81333081, 144.96675571"
1220250508,1,2025-05-08,2,6,7,13,Bou292_T,"-37.81349441, 144.96515323"
12820241208,12,2024-12-08,8,76,73,149,NewQ_T,"-37.81457988, 144.94292398"
62720240122,62,2024-01-22,7,67,68,135,Lat224_T,"-37.80996494, 144.96216521"
621720250120,62,2025-01-20,17,288,251,539,Lat224_T,"-37.80996494, 144.96216521"
11820240531,11,2024-05-31,8,56,55,111,WatCit_T,"-37.81564989, 144.93970694"
721620250404,72,2025-04-04,16,170,462,632,ACMI_T,"-37.81726338, 144.96872809"
722020240202,72,2024-02-02,20,203,224,427,ACMI_T,"-37.81726338, 144.96872809"
271320250428,27,2025-04-28,13,126,102,228,Vic_T,"-37.80606888, 144.95644692"
27520240628,27,2024-06-28,5,7,9,16,Vic_T,"-37.80606888, 144.95644692"
271020240706,27,2024-07-06,10,187,189,376,Vic_T,"-37.80606888, 144.95644692"
53120231026,53,2023-10-26,1,8,5,13,Col254_T,"-37.81564191, 144.965499"
23220231211,23,2023-12-11,2,1,8,9,Col623_T,"-37.81909256, 144.95452748"
1171420250821,117,2025-08-21,14,155,200,355,Fli114F_T,"-37.81629332, 144.97090877"
109020231124,109,2023-11-24,0,19,47,66,LatWill_T,"-37.81193681, 144.95621105"
61420240117,6,2024-01-17,14,734,676,1410,FliS_T,"-37.81911705, 144.96558255"
61520250219,6,2025-02-19,15,1012,629,1641,FliS_T,"-37.81911705, 144.96558255"
6020250319,6,2025-03-19,0,62,47,109,FliS_T,"-37.81911705, 144.96558255"
841720240628,84,2024-06-28,17,1064,1725,2789,ElFi_T,"-37.81798049, 144.96503383"
392020250819,39,2025-08-19,20,26,23,49,AlfPl_T,"-37.81379749, 144.96995745"
75820241122,75,2024-11-22,8,47,56,103,SprFli_T,"-37.81515276, 144.97467661"
771220240221,77,2024-02-21,12,161,103,264,HarEsP_T,"-37.81441438, 144.94433026"
781520240206,78,2024-02-06,15,50,95,145,HarEsB_T,"-37.81471642, 144.9446508"
771020241201,77,2024-12-01,10,234,176,410,HarEsP_T,"-37.81441438, 144.94433026"
29920240513,29,2024-05-13,9,65,98,163,AG_T,"-37.8199817, 144.96872865"
592320240531,59,2024-05-31,23,243,184,427,RMIT_T,"-37.80825648, 144.96304859"
281320240706,28,2024-07-06,13,1316,1828,3144,VAC_T,"-37.82129925, 144.96879309"
362020240303,36,2024-03-03,20,74,55,129,Que85_T,"-37.81652527, 144.96121062"
471920250309,47,2025-03-09,19,742,787,1529,Eli250_T,"-37.81258467, 144.9625775"
471620250313,47,2025-03-13,16,1116,1025,2141,Eli250_T,"-37.81258467, 144.9625775"
5320250719,5,2025-07-19,3,8,16,24,PriNW_T,"-37.81874249, 144.96787656"
211920231108,21,2023-11-08,19,344,329,673,Bourke155_T,"-37.81267313, 144.96788288"
1071520241021,107,2024-10-21,15,127,89,216,280Will_T,"-37.81246271, 144.95690188"
1182220241129,118,2024-11-29,22,32,20,52,Fli114C_T,"-37.81632783, 144.97090512"
108020240331,108,2024-03-31,0,39,51,90,261Will_T,"-37.81295822, 144.95678789"
87920250907,87,2025-09-07,9,52,70,122,Errol23_T,"-37.80454949, 144.94921863"
87920250424,87,2025-04-24,9,87,124,211,Errol23_T,"-37.80454949, 144.94921863"
502120241118,50,2024-11-18,21,130,108,238,Lyg309_T,"-37.79808192, 144.96721013"
441020250827,44,2025-08-27,10,60,102,162,UM3_T,"-37.79698741, 144.96441306"
44520250905,44,2025-09-05,5,1,1,2,UM3_T,"-37.79698741, 144.96441306"
431220250809,43,2025-08-09,12,136,137,273,UM2_T,"-37.79844526, 144.96411782"
43020250831,43,2025-08-31,0,15,7,22,UM2_T,"-37.79844526, 144.96411782"
1821520250511,182,2025-05-11,15,173,204,377,King163_T,"-37.81627451, 144.95550503"
671820250522,67,2025-05-22,18,375,573,948,FLDegS_T,"-37.81688755, 144.96562569"
67520250722,67,2025-07-22,5,4,13,17,FLDegS_T,"-37.81688755, 144.96562569"
852220250306,85,2025-03-06,22,7,17,24,488Mac_T,"-37.79432415, 144.92973378"
171020240820,17,2024-08-20,10,290,236,526,Col15_T,"-37.81362543, 144.97323591"
632220250112,63,2025-01-12,22,37,119,156,Bou231_T,"-37.81333081, 144.96675571"
621320231122,62,2023-11-22,13,273,158,431,Lat224_T,"-37.80996494, 144.96216521"
62320241022,62,2024-10-22,3,20,15,35,Lat224_T,"-37.80996494, 144.96216521"
861120250913,86,2025-09-13,11,122,94,216,574Qub_T,"-37.80309992, 144.94908064"
111020231123,11,2023-11-23,10,79,104,183,WatCit_T,"-37.81564989, 144.93970694"
121320240924,12,2024-09-24,13,219,204,423,NewQ_T,"-37.81457988, 144.94292398"
12220241015,12,2024-10-15,2,5,2,7,NewQ_T,"-37.81457988, 144.94292398"
121520250316,12,2025-03-16,15,59,85,144,NewQ_T,"-37.81457988, 144.94292398"
12320250703,1,2025-07-03,23,50,74,124,Bou292_T,"-37.81349441, 144.96515323"
10520231103,10,2023-11-03,5,10,5,15,BouHbr_T,"-37.81876474, 144.94710545"
721120250304,72,2025-03-04,11,228,228,456,ACMI_T,"-37.81726338, 144.96872809"
72420240902,72,2024-09-02,4,11,16,27,ACMI_T,"-37.81726338, 144.96872809"
722320241029,72,2024-10-29,23,57,67,124,ACMI_T,"-37.81726338, 144.96872809"
76020241222,76,2024-12-22,0,3,3,6,KenMac_T,"-37.79453803, 144.93036194"
23920231215,23,2023-12-15,9,363,197,560,Col623_T,"-37.81909256, 144.95452748"
19220250506,19,2025-05-06,2,18,25,43,LtB210_T,"-37.81237202, 144.96550671"
48820250315,48,2025-03-15,8,127,150,277,QVMQ_T,"-37.80631581, 144.95866697"
139620250509,139,2025-05-09,6,3,11,14,Signal1647_T,"-37.81959923, 144.9632832"
1421820250509,142,2025-05-09,18,90,16,106,Hammer1584_T,"-37.81970749, 144.96795734"
1301720250203,130,2025-02-03,17,52,31,83,Bou892T,"-37.8204637, 144.94126826"
1611420240607,161,2024-06-07,14,150,135,285,BirArt1109_T,"-37.81851276, 144.97131336"
109520250606,109,2025-06-06,5,17,11,28,LatWill_T,"-37.81193681, 144.95621105"
842120250303,84,2025-03-03,21,482,635,1117,ElFi_T,"-37.81798049, 144.96503383"
4520240310,4,2024-03-10,5,35,32,67,Swa123_T,"-37.81487988, 144.9660878"
392220240330,39,2024-03-30,22,56,43,99,AlfPl_T,"-37.81379749, 144.96995745"
752020250802,75,2025-08-02,20,19,12,31,SprFli_T,"-37.81515276, 144.97467661"
82020231129,8,2023-11-29,20,47,42,89,WebBN_T,"-37.82293543, 144.9471751"
751520240513,75,2024-05-13,15,40,48,88,SprFli_T,"-37.81515276, 144.97467661"
751020241113,75,2024-11-13,10,58,31,89,SprFli_T,"-37.81515276, 144.97467661"
41520240822,41,2024-08-22,5,22,29,51,Swa31,"-37.81668634, 144.96689733"
41620240317,41,2024-03-17,6,141,130,271,Swa31,"-37.81668634, 144.96689733"
411620250402,41,2025-04-02,16,1496,2450,3946,Swa31,"-37.81668634, 144.96689733"
771620250218,77,2025-02-18,16,215,82,297,HarEsP_T,"-37.81441438, 144.94433026"
71020240403,71,2024-04-03,0,3,3,6,WestWP_T,"-37.81235775, 144.97136962"
59220250201,59,2025-02-01,2,31,16,47,RMIT_T,"-37.80825648, 144.96304859"
312020240915,31,2024-09-15,20,199,185,384,Lyg161_T,"-37.80169681, 144.96658911"
31720241024,31,2024-10-24,7,31,39,70,Lyg161_T,"-37.80169681, 144.96658911"
541820250407,54,2025-04-07,18,215,364,579,Swa607_T,"-37.804024, 144.96308399"
47820231202,47,2023-12-02,8,105,238,343,Eli250_T,"-37.81258467, 144.9625775"
40920240921,40,2024-09-21,9,67,62,129,Spr201_T,"-37.80999341, 144.97227587"
371720240315,37,2024-03-15,17,118,93,211,Lyg260_T,"-37.80107122, 144.96704554"
50020250422,50,2025-04-22,0,2,2,4,Lyg309_T,"-37.79808192, 144.96721013"
502120250505,50,2025-05-05,21,114,71,185,Lyg309_T,"-37.79808192, 144.96721013"
501620250514,50,2025-05-14,16,159,134,293,Lyg309_T,"-37.79808192, 144.96721013"
452320240421,45,2024-04-21,23,129,211,340,Swa148_T,"-37.81414075, 144.96609379"
452220250110,45,2025-01-10,22,605,684,1289,Swa148_T,"-37.81414075, 144.96609379"
51020250212,5,2025-02-12,10,65,132,197,PriNW_T,"-37.81874249, 144.96787656"
1341920250316,134,2025-03-16,19,636,334,970,Spen201_T,"-37.81694221, 144.95303935"
1311820240729,131,2024-07-29,18,20,59,79,King2_T,"-37.82009057, 144.95758725"
133320240315,133,2024-03-15,3,8,13,21,Spen229_T,"-37.81531435, 144.95227769"
1081720250815,108,2025-08-15,17,648,148,796,261Will_T,"-37.81295822, 144.95678789"
108320250108,108,2025-01-08,3,11,10,21,261Will_T,"-37.81295822, 144.95678789"
611420231228,61,2023-12-28,14,192,356,548,RMIT14_T,"-37.80767455, 144.96309114"
1812120250531,181,2025-05-31,21,741,623,1364,Eli368_T,"-37.81009465, 144.96143149"
1651520250103,165,2025-01-03,15,60,45,105,Spen475_T,"-37.80953359, 144.94939004"
1652320250921,165,2025-09-21,23,6,1,7,Spen475_T,"-37.80953359, 144.94939004"
1401820241020,140,2024-10-20,18,91,110,201,Boyd2837_T,"-37.82590962, 144.96185972"
85420240517,85,2024-05-17,4,1,0,1,488Mac_T,"-37.79432415, 144.92973378"
1820240211,1,2024-02-11,8,69,55,124,Bou292_T,"-37.81349441, 144.96515323"
68120241113,68,2024-11-13,1,2,1,3,FLDegN_T,"-37.8168479, 144.96559789"
682320250624,68,2025-06-24,23,2,2,4,FLDegN_T,"-37.8168479, 144.96559789"
181720250605,18,2025-06-05,17,322,137,459,Col12_T,"-37.81344862, 144.97305353"
621520250826,62,2025-08-26,15,262,211,473,Lat224_T,"-37.80996494, 144.96216521"
631120240209,63,2024-02-09,11,218,292,510,Bou231_T,"-37.81333081, 144.96675571"
861020231125,86,2023-11-25,10,60,51,111,574Qub_T,"-37.80309992, 144.94908064"
561120241119,56,2024-11-19,11,287,197,484,Lon364_T,"-37.81234775, 144.96153311"
56320250424,56,2025-04-24,3,5,11,16,Lon364_T,"-37.81234775, 144.96153311"
101320241221,10,2024-12-21,13,27,39,66,BouHbr_T,"-37.81876474, 144.94710545"
10720250224,10,2025-02-24,7,28,70,98,BouHbr_T,"-37.81876474, 144.94710545"
722220250308,72,2025-03-08,22,562,744,1306,ACMI_T,"-37.81726338, 144.96872809"
562220250925,56,2025-09-25,22,257,211,468,Lon364_T,"-37.81234775, 144.96153311"
58120241230,58,2024-12-30,1,34,30,64,Bou688_T,"-37.81686075, 144.95358075"
27120241228,27,2024-12-28,1,6,2,8,Vic_T,"-37.80606888, 144.95644692"
79420231221,79,2023-12-21,4,11,13,24,FliSS_T,"-37.81794046, 144.96616678"
53220240904,53,2024-09-04,2,2,5,7,Col254_T,"-37.81564191, 144.965499"
231720241219,23,2024-12-19,17,293,635,928,Col623_T,"-37.81909256, 144.95452748"
23020240411,23,2024-04-11,0,13,27,40,Col623_T,"-37.81909256, 144.95452748"
46020250127,46,2025-01-27,0,2,0,2,Pel147_T,"-37.80240719, 144.9615673"
192120250518,19,2025-05-18,21,246,406,652,LtB210_T,"-37.81237202, 144.96550671"
202120250110,20,2025-01-10,21,308,468,776,LtB170_T,"-37.81172914, 144.9682466"
1801620250515,180,2025-05-15,16,44,46,90,Mac330_T,"-37.79497059, 144.93530329"
1361120240107,136,2024-01-07,11,79,58,137,BirFed1120_T,"-37.8184141, 144.97357915"
136220240525,136,2024-05-25,2,0,1,1,BirFed1120_T,"-37.8184141, 144.97357915"
123920240510,123,2024-05-10,9,5,3,8,BirBridge_T,"-37.81753741, 144.97329734"
117520231119,117,2023-11-19,5,5,6,11,Fli114F_T,"-37.81629332, 144.97090877"
117720231224,117,2023-12-24,7,13,26,39,Fli114F_T,"-37.81629332, 144.97090877"
66220231205,66,2023-12-05,2,19,11,30,QVN_T,"-37.81057846, 144.96444294"
66420240922,66,2024-09-22,4,30,18,48,QVN_T,"-37.81057846, 144.96444294"
691720250211,69,2025-02-11,17,156,191,347,FLDegC_T,"-37.81687226, 144.96559144"
66020231102,66,2023-11-02,0,85,48,133,QVN_T,"-37.81057846, 144.96444294"
701220241101,70,2024-11-01,12,166,148,314,Errol20_T,"-37.80456984, 144.94946228"
32020250412,3,2025-04-12,20,1070,963,2033,Swa295_T,"-37.81101524, 144.96429485"
781020250110,78,2025-01-10,10,41,28,69,HarEsB_T,"-37.81471642, 144.9446508"
782120241008,78,2024-10-08,21,3,6,9,HarEsB_T,"-37.81471642, 144.9446508"
291920240507,29,2024-05-07,19,94,116,210,AG_T,"-37.8199817, 144.96872865"
711420231018,71,2023-10-18,14,17,17,34,WestWP_T,"-37.81235775, 144.97136962"
711220240626,71,2024-06-26,12,21,32,53,WestWP_T,"-37.81235775, 144.97136962"
712120240819,71,2024-08-19,21,9,3,12,WestWP_T,"-37.81235775, 144.97136962"
591820250221,59,2025-02-21,18,240,202,442,RMIT_T,"-37.80825648, 144.96304859"
54520240322,54,2024-03-22,5,2,12,14,Swa607_T,"-37.804024, 144.96308399"
352320240705,35,2024-07-05,23,471,1439,1910,SouthB_T,"-37.82018685, 144.96508508"
27020250617,27,2025-06-17,0,10,6,16,Vic_T,"-37.80606888, 144.95644692"
9220250705,9,2025-07-05,2,1,9,10,Col700_T,"-37.81982992, 144.95102555"
92020250823,9,2025-08-23,20,57,48,105,Col700_T,"-37.81982992, 144.95102555"
91320251013,9,2025-10-13,13,476,380,856,Col700_T,"-37.81982992, 144.95102555"
30520241009,30,2024-10-09,5,15,11,26,Lon189_T,"-37.8112185, 144.96656806"
23720250729,23,2025-07-29,7,420,190,610,Col623_T,"-37.81909256, 144.95452748"
52920231026,52,2023-10-26,9,148,261,409,Eli263_T,"-37.81252157, 144.9619401"
52820231117,52,2023-11-17,8,116,261,377,Eli263_T,"-37.81252157, 144.9619401"
51820240324,51,2024-03-24,8,34,47,81,Fra118_T,"-37.80841815, 144.95906316"
481020240818,48,2024-08-18,10,350,384,734,QVMQ_T,"-37.80631581, 144.95866697"
252220241121,25,2024-11-21,22,199,195,394,MCEC_T,"-37.82401776, 144.95604426"
202020231217,20,2023-12-17,20,207,510,717,LtB170_T,"-37.81172914, 144.9682466"
491120250401,49,2025-04-01,11,277,421,698,Eli501_T,"-37.80730068, 144.95956055"
136120250403,136,2025-04-03,1,1,0,1,BirFed1120_T,"-37.8184141, 144.97357915"
1381920250622,138,2025-06-22,19,1,0,1,EntPark1671_T,"-37.81996544, 144.95981454"
117120231204,117,2023-12-04,1,14,8,22,Fli114F_T,"-37.81629332, 144.97090877"
691820240908,69,2024-09-08,18,53,42,95,FLDegC_T,"-37.81687226, 144.96559144"
691020250407,69,2025-04-07,10,253,156,409,FLDegC_T,"-37.81687226, 144.96559144"
61520240930,6,2024-09-30,15,947,747,1694,FliS_T,"-37.81911705, 144.96558255"
4820250209,4,2025-02-09,8,228,181,409,Swa123_T,"-37.81487988, 144.9660878"
702320250712,70,2025-07-12,23,35,12,47,Errol20_T,"-37.80456984, 144.94946228"
781720240203,78,2024-02-03,17,40,52,92,HarEsB_T,"-37.81471642, 144.9446508"
42920241028,42,2024-10-28,9,210,251,461,UM1_T,"-37.80008566, 144.96386412"
421320250115,42,2025-01-15,13,190,141,331,UM1_T,"-37.80008566, 144.96386412"
29220231208,29,2023-12-08,2,4,25,29,AG_T,"-37.8199817, 144.96872865"
141320240112,14,2024-01-12,13,222,80,302,SanBri_T,"-37.82011242, 144.96291897"
59920240401,59,2024-04-01,9,122,208,330,RMIT_T,"-37.80825648, 144.96304859"
59220240501,59,2024-05-01,2,35,8,43,RMIT_T,"-37.80825648, 144.96304859"
28320250621,28,2025-06-21,3,16,12,28,VAC_T,"-37.82129925, 144.96879309"
282320240114,28,2024-01-14,23,82,76,158,VAC_T,"-37.82129925, 144.96879309"
36220240529,36,2024-05-29,2,3,2,5,Que85_T,"-37.81652527, 144.96121062"
37320241028,37,2024-10-28,3,1,4,5,Lyg260_T,"-37.80107122, 144.96704554"
47720240919,47,2024-09-19,7,146,274,420,Eli250_T,"-37.81258467, 144.9625775"
5320241016,5,2024-10-16,3,15,5,20,PriNW_T,"-37.81874249, 144.96787656"
21320250131,21,2025-01-31,3,12,12,24,Bourke155_T,"-37.81267313, 144.96788288"
107520241128,107,2024-11-28,5,3,11,14,280Will_T,"-37.81246271, 144.95690188"
1071720241001,107,2024-10-01,17,211,148,359,280Will_T,"-37.81246271, 144.95690188"
133920250208,133,2025-02-08,9,371,472,843,Spen229_T,"-37.81531435, 144.95227769"
1081520240213,108,2024-02-13,15,536,226,762,261Will_T,"-37.81295822, 144.95678789"
872220240623,87,2024-06-23,22,4,12,16,Errol23_T,"-37.80454949, 144.94921863"
442320231108,44,2023-11-08,23,16,5,21,UM3_T,"-37.79698741, 144.96441306"
162420250427,162,2025-04-27,4,22,15,37,Eli489_T,"-37.80740397, 144.95987909"
1431120241215,143,2024-12-15,11,171,340,511,Spencer_T,"-37.821728, 144.95557015"
132320240623,132,2024-06-23,3,23,3,26,King335_T,"-37.81267639, 144.95386444"
135820241018,135,2024-10-18,8,269,293,562,Spen161_T,"-37.8172861, 144.95319102"
682120240106,68,2024-01-06,21,80,22,102,FLDegN_T,"-37.8168479, 144.96559789"
23420250804,23,2025-08-04,4,3,6,9,Col623_T,"-37.81909256, 144.95452748"
1171320250619,117,2025-06-19,13,128,245,373,Fli114F_T,"-37.81629332, 144.97090877"
491420240606,49,2024-06-06,14,256,407,663,Eli501_T,"-37.80730068, 144.95956055"
492320240726,49,2024-07-26,23,136,99,235,Eli501_T,"-37.80730068, 144.95956055"
1091920250729,109,2025-07-29,19,89,100,189,LatWill_T,"-37.81193681, 144.95621105"
1372220240209,137,2024-02-09,22,1,1,2,BouHbr2353_T,"-37.81894815, 144.94612292"
1421520250302,142,2025-03-02,15,632,518,1150,Hammer1584_T,"-37.81970749, 144.96795734"
1422320240717,142,2024-07-17,23,9,6,15,Hammer1584_T,"-37.81970749, 144.96795734"
161720250812,161,2025-08-12,7,126,221,347,BirArt1109_T,"-37.81851276, 144.97131336"
1641620240916,164,2024-09-16,16,139,104,243,Lat526_T,"-37.813005, 144.95160411"
1641320250904,164,2025-09-04,13,113,58,171,Lat526_T,"-37.813005, 144.95160411"
1381420240222,138,2024-02-22,14,5,14,19,EntPark1671_T,"-37.81996544, 144.95981454"
1611020250302,161,2025-03-02,10,108,127,235,BirArt1109_T,"-37.81851276, 144.97131336"
6820240129,6,2024-01-29,8,673,1905,2578,FliS_T,"-37.81911705, 144.96558255"
841520240802,84,2024-08-02,15,953,1412,2365,ElFi_T,"-37.81798049, 144.96503383"
4920241002,4,2024-10-02,9,595,466,1061,Swa123_T,"-37.81487988, 144.9660878"
4320250709,4,2025-07-09,3,10,6,16,Swa123_T,"-37.81487988, 144.9660878"
82120250523,8,2025-05-23,21,0,3,3,WebBN_T,"-37.82293543, 144.9471751"
411620231215,41,2023-12-15,16,1935,2070,4005,Swa31,"-37.81668634, 144.96689733"
81320240102,8,2024-01-02,13,141,201,342,WebBN_T,"-37.82293543, 144.9471751"
78120250717,78,2025-07-17,1,0,4,4,HarEsB_T,"-37.81471642, 144.9446508"
591220240801,59,2024-08-01,12,1640,1742,3382,RMIT_T,"-37.80825648, 144.96304859"
29820231130,29,2023-11-30,8,102,118,220,AG_T,"-37.8199817, 144.96872865"
14920240305,14,2024-03-05,9,253,324,577,SanBri_T,"-37.82011242, 144.96291897"
141520240618,14,2024-06-18,15,397,102,499,SanBri_T,"-37.82011242, 144.96291897"
711820231110,71,2023-11-10,18,9,11,20,WestWP_T,"-37.81235775, 144.97136962"
311820240214,31,2024-02-14,18,323,176,499,Lyg161_T,"-37.80169681, 144.96658911"
281120250116,28,2025-01-16,11,1194,761,1955,VAC_T,"-37.82129925, 144.96879309"
472220240929,47,2024-09-29,22,204,181,385,Eli250_T,"-37.81258467, 144.9625775"
401120250608,40,2025-06-08,11,120,196,316,Spr201_T,"-37.80999341, 144.97227587"
472120241021,47,2024-10-21,21,420,329,749,Eli250_T,"-37.81258467, 144.9625775"
36920240615,36,2024-06-15,9,121,75,196,Que85_T,"-37.81652527, 144.96121062"
61420250822,61,2025-08-22,4,14,5,19,RMIT14_T,"-37.80767455, 144.96309114"
441820250619,44,2025-06-19,18,56,42,98,UM3_T,"-37.79698741, 144.96441306"
432220240107,43,2024-01-07,22,3,6,9,UM2_T,"-37.79844526, 144.96411782"
431420240110,43,2024-01-10,14,65,67,132,UM2_T,"-37.79844526, 144.96411782"
43820240627,43,2024-06-27,8,98,65,163,UM2_T,"-37.79844526, 144.96411782"
44920240211,44,2024-02-11,9,13,25,38,UM3_T,"-37.79698741, 144.96441306"
1672120241022,167,2024-10-22,21,3,27,30,Lat526_T,"-37.81304149, 144.95155955"
167520250315,167,2025-03-15,5,1,5,6,Lat526_T,"-37.81304149, 144.95155955"
132120240308,132,2024-03-08,1,54,28,82,King335_T,"-37.81267639, 144.95386444"
132320240208,132,2024-02-08,3,7,2,9,King335_T,"-37.81267639, 144.95386444"
1341320250529,134,2025-05-29,13,346,396,742,Spen201_T,"-37.81694221, 144.95303935"
1341120250808,134,2025-08-08,11,360,342,702,Spen201_T,"-37.81694221, 144.95303935"
107520251004,107,2025-10-04,5,5,7,12,280Will_T,"-37.81246271, 144.95690188"
1331520240207,133,2024-02-07,15,503,645,1148,Spen229_T,"-37.81531435, 144.95227769"
133320240304,133,2024-03-04,3,3,18,21,Spen229_T,"-37.81531435, 144.95227769"
1241120251005,124,2025-10-05,11,3,8,11,BirBridge_T,"-37.81757416, 144.97329934"
1081420240316,108,2024-03-16,14,164,154,318,261Will_T,"-37.81295822, 144.95678789"
107420250614,107,2025-06-14,4,6,1,7,280Will_T,"-37.81246271, 144.95690188"
107420251013,107,2025-10-13,4,0,1,1,280Will_T,"-37.81246271, 144.95690188"
1821220250417,182,2025-04-17,12,391,257,648,King163_T,"-37.81627451, 144.95550503"
1651420250217,165,2025-02-17,14,38,30,68,Spen475_T,"-37.80953359, 144.94939004"
1652120250705,165,2025-07-05,21,56,13,69,Spen475_T,"-37.80953359, 144.94939004"
165920250727,165,2025-07-27,9,22,28,50,Spen475_T,"-37.80953359, 144.94939004"
85020231214,85,2023-12-14,0,0,2,2,488Mac_T,"-37.79432415, 144.92973378"
85720241013,85,2024-10-13,7,11,8,19,488Mac_T,"-37.79432415, 144.92973378"
171220240321,17,2024-03-21,12,869,722,1591,Col15_T,"-37.81362543, 144.97323591"
171120250322,17,2025-03-22,11,218,158,376,Col15_T,"-37.81362543, 144.97323591"
11220240123,1,2024-01-23,12,1399,1225,2624,Bou292_T,"-37.81349441, 144.96515323"
632220250517,63,2025-05-17,22,55,239,294,Bou231_T,"-37.81333081, 144.96675571"
62720241210,62,2024-12-10,7,44,48,92,Lat224_T,"-37.80996494, 144.96216521"
24020240104,24,2024-01-04,0,33,69,102,Col620_T,"-37.81887963, 144.95449198"
242220250814,24,2025-08-14,22,213,406,619,Col620_T,"-37.81887963, 144.95449198"
76020240804,76,2024-08-04,0,1,0,1,KenMac_T,"-37.79453803, 144.93036194"
761920250707,76,2025-07-07,19,16,28,44,KenMac_T,"-37.79453803, 144.93036194"
35920231218,35,2023-12-18,9,608,832,1440,SouthB_T,"-37.82018685, 144.96508508"
351620231220,35,2023-12-20,16,1467,1543,3010,SouthB_T,"-37.82018685, 144.96508508"
35920240104,35,2024-01-04,9,625,331,956,SouthB_T,"-37.82018685, 144.96508508"
2720240726,2,2024-07-26,7,31,61,92,Bou283_T,"-37.81380668, 144.96516718"
35120250712,35,2025-07-12,1,46,68,114,SouthB_T,"-37.82018685, 144.96508508"
91020240717,9,2024-07-17,10,243,556,799,Col700_T,"-37.81982992, 144.95102555"
23520250120,23,2025-01-20,5,20,24,44,Col623_T,"-37.81909256, 144.95452748"
511620231104,51,2023-11-04,16,147,118,265,Fra118_T,"-37.80841815, 144.95906316"
30720250831,30,2025-08-31,7,39,71,110,Lon189_T,"-37.8112185, 144.96656806"
201620231031,20,2023-10-31,16,176,181,357,LtB170_T,"-37.81172914, 144.9682466"
130820240520,130,2024-05-20,8,2,4,6,Bou892T,"-37.8204637, 144.94126826"
1171420250823,117,2025-08-23,14,218,209,427,Fli114F_T,"-37.81629332, 144.97090877"
492120250328,49,2025-03-28,21,220,237,457,Eli501_T,"-37.80730068, 144.95956055"
109420240912,109,2024-09-12,4,3,2,5,LatWill_T,"-37.81193681, 144.95621105"
69620240115,69,2024-01-15,6,12,8,20,FLDegC_T,"-37.81687226, 144.96559144"
69520250412,69,2025-04-12,5,2,3,5,FLDegC_T,"-37.81687226, 144.96559144"
84020240918,84,2024-09-18,0,37,55,92,ElFi_T,"-37.81798049, 144.96503383"
702020250819,70,2025-08-19,20,98,99,197,Errol20_T,"-37.80456984, 144.94946228"
391920250608,39,2025-06-08,19,13,10,23,AlfPl_T,"-37.81379749, 144.96995745"
39020240221,39,2024-02-21,0,11,11,22,AlfPl_T,"-37.81379749, 144.96995745"
422220240929,42,2024-09-29,22,26,32,58,UM1_T,"-37.80008566, 144.96386412"
421220250728,42,2025-07-28,12,526,673,1199,UM1_T,"-37.80008566, 144.96386412"
14520250913,14,2025-09-13,5,5,11,16,SanBri_T,"-37.82011242, 144.96291897"
711420250704,71,2025-07-04,14,17,14,31,WestWP_T,"-37.81235775, 144.97136962"
712020250829,71,2025-08-29,20,7,14,21,WestWP_T,"-37.81235775, 144.97136962"
47020240406,47,2024-04-06,0,175,204,379,Eli250_T,"-37.81258467, 144.9625775"
311920250909,31,2025-09-09,19,113,161,274,Lyg161_T,"-37.80169681, 144.96658911"
361620231215,36,2023-12-15,16,259,216,475,Que85_T,"-37.81652527, 144.96121062"
45220240223,45,2024-02-23,2,22,26,48,Swa148_T,"-37.81414075, 144.96609379"
118820250916,118,2025-09-16,8,33,15,48,Fli114C_T,"-37.81632783, 144.97090512"
124920251006,124,2025-10-06,9,1,4,5,BirBridge_T,"-37.81757416, 144.97329934"
1241420251014,124,2025-10-14,14,4,3,7,BirBridge_T,"-37.81757416, 144.97329934"
671420240610,67,2024-06-10,14,361,445,806,FLDegS_T,"-37.81688755, 144.96562569"
182120250412,18,2025-04-12,21,32,41,73,Col12_T,"-37.81344862, 144.97305353"
621120250429,62,2025-04-29,11,195,181,376,Lat224_T,"-37.80996494, 144.96216521"
86420240613,86,2024-06-13,4,0,1,1,574Qub_T,"-37.80309992, 144.94908064"
79420240107,79,2024-01-07,4,50,43,93,FliSS_T,"-37.81794046, 144.96616678"
91720231211,9,2023-12-11,17,1932,131,2063,Col700_T,"-37.81982992, 144.95102555"
792220250330,79,2025-03-30,22,84,146,230,FliSS_T,"-37.81794046, 144.96616678"
791920241103,79,2024-11-03,19,338,363,701,FliSS_T,"-37.81794046, 144.96616678"
30820241028,30,2024-10-28,8,81,77,158,Lon189_T,"-37.8112185, 144.96656806"
301420231128,30,2023-11-28,14,274,375,649,Lon189_T,"-37.8112185, 144.96656806"
201120240228,20,2024-02-28,11,169,109,278,LtB170_T,"-37.81172914, 144.9682466"
20320251007,20,2025-10-07,3,2,3,5,LtB170_T,"-37.81172914, 144.9682466"
1301520240510,130,2024-05-10,15,14,24,38,Bou892T,"-37.8204637, 144.94126826"
191620240809,19,2024-08-09,16,597,416,1013,LtB210_T,"-37.81237202, 144.96550671"
251920250429,25,2025-04-29,19,108,98,206,MCEC_T,"-37.82401776, 144.95604426"
251420250829,25,2025-08-29,14,358,356,714,MCEC_T,"-37.82401776, 144.95604426"
48420240105,48,2024-01-05,4,4,5,9,QVMQ_T,"-37.80631581, 144.95866697"
1391120240324,139,2024-03-24,11,44,28,72,Signal1647_T,"-37.81959923, 144.9632832"
69720250930,69,2025-09-30,7,181,33,214,FLDegC_T,"-37.81687226, 144.96559144"
70720250525,70,2025-05-25,7,8,11,19,Errol20_T,"-37.80456984, 144.94946228"
31120250709,3,2025-07-09,11,706,778,1484,Swa295_T,"-37.81101524, 144.96429485"
32120250709,3,2025-07-09,21,582,556,1138,Swa295_T,"-37.81101524, 144.96429485"
39520240705,39,2024-07-05,5,3,2,5,AlfPl_T,"-37.81379749, 144.96995745"
39720241221,39,2024-12-21,7,11,10,21,AlfPl_T,"-37.81379749, 144.96995745"
751320250223,75,2025-02-23,13,37,19,56,SprFli_T,"-37.81515276, 144.97467661"
8420250628,8,2025-06-28,4,0,1,1,WebBN_T,"-37.82293543, 144.9471751"
411020240330,41,2024-03-30,10,1245,694,1939,Swa31,"-37.81668634, 144.96689733"
421120250814,42,2025-08-14,11,285,391,676,UM1_T,"-37.80008566, 144.96386412"
771920250717,77,2025-07-17,19,161,205,366,HarEsP_T,"-37.81441438, 144.94433026"
59920231115,59,2023-11-15,9,319,234,553,RMIT_T,"-37.80825648, 144.96304859"
592220231122,59,2023-11-22,22,311,150,461,RMIT_T,"-37.80825648, 144.96304859"
591320240204,59,2024-02-04,13,362,325,687,RMIT_T,"-37.80825648, 144.96304859"
59920240918,59,2024-09-18,9,961,354,1315,RMIT_T,"-37.80825648, 144.96304859"
651920240407,65,2024-04-07,19,320,471,791,SwaCs_T,"-37.81569416, 144.9668064"
651120240410,65,2024-04-10,11,499,433,932,SwaCs_T,"-37.81569416, 144.9668064"
54420250302,54,2025-03-02,4,10,8,18,Swa607_T,"-37.804024, 144.96308399"
28020250714,28,2025-07-14,0,14,8,22,VAC_T,"-37.82129925, 144.96879309"
471120231113,47,2023-11-13,11,577,672,1249,Eli250_T,"-37.81258467, 144.9625775"
47320240902,47,2024-09-02,3,6,4,10,Eli250_T,"-37.81258467, 144.9625775"
401520240117,40,2024-01-17,15,148,129,277,Spr201_T,"-37.80999341, 144.97227587"
40020240403,40,2024-04-03,0,6,4,10,Spr201_T,"-37.80999341, 144.97227587"
31420240714,31,2024-07-14,4,11,0,11,Lyg161_T,"-37.80169681, 144.96658911"
311320231116,31,2023-11-16,13,130,191,321,Lyg161_T,"-37.80169681, 144.96658911"
371520250204,37,2025-02-04,15,79,78,157,Lyg260_T,"-37.80107122, 144.96704554"
872320250706,87,2025-07-06,23,5,8,13,Errol23_T,"-37.80454949, 144.94921863"
501020240511,50,2024-05-11,10,171,213,384,Lyg309_T,"-37.79808192, 144.96721013"
43520250324,43,2025-03-24,5,6,2,8,UM2_T,"-37.79844526, 144.96411782"
431420240531,43,2024-05-31,14,129,180,309,UM2_T,"-37.79844526, 144.96411782"
43120241024,43,2024-10-24,1,7,13,20,UM2_T,"-37.79844526, 144.96411782"
441420240124,44,2024-01-24,14,23,4,27,UM3_T,"-37.79698741, 144.96441306"
51720250506,5,2025-05-06,17,1279,1137,2416,PriNW_T,"-37.81874249, 144.96787656"
1811320250814,181,2025-08-14,13,876,1269,2145,Eli368_T,"-37.81009465, 144.96143149"
431420241012,43,2024-10-12,14,76,74,150,UM2_T,"-37.79844526, 144.96411782"
165820250715,165,2025-07-15,8,22,53,75,Spen475_T,"-37.80953359, 144.94939004"
162720250419,162,2025-04-19,7,132,83,215,Eli489_T,"-37.80740397, 144.95987909"
131720250417,131,2025-04-17,7,64,32,96,King2_T,"-37.82009057, 144.95758725"
1431520250810,143,2025-08-10,15,197,220,417,Spencer_T,"-37.821728, 144.95557015"
1341920240518,134,2024-05-18,19,274,328,602,Spen201_T,"-37.81694221, 144.95303935"
1351220250717,135,2025-07-17,12,503,685,1188,Spen161_T,"-37.8172861, 144.95319102"
87520240530,87,2024-05-30,5,4,4,8,Errol23_T,"-37.80454949, 144.94921863"
87220250505,87,2025-05-05,2,0,2,2,Errol23_T,"-37.80454949, 144.94921863"
61520241009,61,2024-10-09,5,17,24,41,RMIT14_T,"-37.80767455, 144.96309114"
50720240605,50,2024-06-05,7,16,39,55,Lyg309_T,"-37.79808192, 144.96721013"
50220240706,50,2024-07-06,2,3,2,5,Lyg309_T,"-37.79808192, 144.96721013"
50220241121,50,2024-11-21,2,2,1,3,Lyg309_T,"-37.79808192, 144.96721013"
44520250418,44,2025-04-18,5,1,1,2,UM3_T,"-37.79698741, 144.96441306"
431320240909,43,2024-09-09,13,142,192,334,UM2_T,"-37.79844526, 144.96411782"
431020231118,43,2023-11-18,10,51,34,85,UM2_T,"-37.79844526, 144.96411782"
185720250723,185,2025-07-23,7,86,273,359,Eli197_T,"-37.81374643, 144.96276183"
1401920241009,140,2024-10-09,19,88,55,143,Boyd2837_T,"-37.82590962, 144.96185972"
132920250131,132,2025-01-31,9,115,74,189,King335_T,"-37.81267639, 144.95386444"
134920241003,134,2024-10-03,9,298,391,689,Spen201_T,"-37.81694221, 144.95303935"
1351620240601,135,2024-06-01,16,411,392,803,Spen161_T,"-37.8172861, 144.95319102"
852120250828,85,2025-08-28,21,8,12,20,488Mac_T,"-37.79432415, 144.92973378"
172220250222,17,2025-02-22,22,177,167,344,Col15_T,"-37.81362543, 144.97323591"
63420241211,63,2024-12-11,4,0,1,1,Bou231_T,"-37.81333081, 144.96675571"
672320240213,67,2024-02-13,23,26,45,71,FLDegS_T,"-37.81688755, 144.96562569"
11420250531,1,2025-05-31,14,1630,1809,3439,Bou292_T,"-37.81349441, 144.96515323"
62620240114,62,2024-01-14,6,50,33,83,Lat224_T,"-37.80996494, 144.96216521"
12120241121,12,2024-11-21,1,9,10,19,NewQ_T,"-37.81457988, 144.94292398"
12820241125,12,2024-11-25,8,43,50,93,NewQ_T,"-37.81457988, 144.94292398"
10720240407,10,2024-04-07,7,5,4,9,BouHbr_T,"-37.81876474, 144.94710545"
10120250720,10,2025-07-20,1,7,4,11,BouHbr_T,"-37.81876474, 144.94710545"
351620240508,35,2024-05-08,16,1303,1088,2391,SouthB_T,"-37.82018685, 144.96508508"
352320240701,35,2024-07-01,23,126,138,264,SouthB_T,"-37.82018685, 144.96508508"
27420240308,27,2024-03-08,4,3,3,6,Vic_T,"-37.80606888, 144.95644692"
92220250123,9,2025-01-23,22,47,31,78,Col700_T,"-37.81982992, 144.95102555"
531520240802,53,2024-08-02,15,709,536,1245,Col254_T,"-37.81564191, 144.965499"
23520240902,23,2024-09-02,5,15,28,43,Col623_T,"-37.81909256, 144.95452748"
792020250110,79,2025-01-10,20,782,488,1270,FliSS_T,"-37.81794046, 144.96616678"
23420250817,23,2025-08-17,4,3,9,12,Col623_T,"-37.81909256, 144.95452748"
231920250825,23,2025-08-25,19,86,192,278,Col623_T,"-37.81909256, 144.95452748"
52920231028,52,2023-10-28,9,145,135,280,Eli263_T,"-37.81252157, 144.9619401"
512320231130,51,2023-11-30,23,14,23,37,Fra118_T,"-37.80841815, 144.95906316"
492020240417,49,2024-04-17,20,358,494,852,Eli501_T,"-37.80730068, 144.95956055"
20620250518,20,2025-05-18,6,4,7,11,LtB170_T,"-37.81172914, 144.9682466"
20920240317,20,2024-03-17,9,66,60,126,LtB170_T,"-37.81172914, 144.9682466"
136620250409,136,2025-04-09,6,42,67,109,BirFed1120_T,"-37.8184141, 144.97357915"
492020240816,49,2024-08-16,20,171,160,331,Eli501_T,"-37.80730068, 144.95956055"
49220241111,49,2024-11-11,2,16,27,43,Eli501_T,"-37.80730068, 144.95956055"
1171720240705,117,2024-07-05,17,462,533,995,Fli114F_T,"-37.81629332, 144.97090877"
54220250717,54,2025-07-17,2,10,7,17,Swa607_T,"-37.804024, 144.96308399"
47520240302,47,2024-03-02,5,21,35,56,Eli250_T,"-37.81258467, 144.9625775"
36620250814,36,2025-08-14,6,32,21,53,Que85_T,"-37.81652527, 144.96121062"
361620241102,36,2024-11-02,16,140,119,259,Que85_T,"-37.81652527, 144.96121062"
37520240529,37,2024-05-29,5,3,9,12,Lyg260_T,"-37.80107122, 144.96704554"
43020231217,43,2023-12-17,0,8,5,13,UM2_T,"-37.79844526, 144.96411782"
45620250523,45,2025-05-23,6,55,54,109,Swa148_T,"-37.81414075, 144.96609379"
1341820250825,134,2025-08-25,18,513,398,911,Spen201_T,"-37.81694221, 144.95303935"
135420250305,135,2025-03-05,4,32,12,44,Spen161_T,"-37.8172861, 144.95319102"
107120250504,107,2025-05-04,1,23,9,32,280Will_T,"-37.81246271, 144.95690188"
442320240825,44,2024-08-25,23,70,1,71,UM3_T,"-37.79698741, 144.96441306"
140620250101,140,2025-01-01,6,9,6,15,Boyd2837_T,"-37.82590962, 144.96185972"
1312320250218,131,2025-02-18,23,33,23,56,King2_T,"-37.82009057, 144.95758725"
143920241212,143,2024-12-12,9,79,175,254,Spencer_T,"-37.821728, 144.95557015"
1322320241013,132,2024-10-13,23,51,43,94,King335_T,"-37.81267639, 144.95386444"
67720250328,67,2025-03-28,7,141,118,259,FLDegS_T,"-37.81688755, 144.96562569"
851220250105,85,2025-01-05,12,70,67,137,488Mac_T,"-37.79432415, 144.92973378"
681220250715,68,2025-07-15,12,572,486,1058,FLDegN_T,"-37.8168479, 144.96559789"
182020240331,18,2024-03-31,20,13,23,36,Col12_T,"-37.81344862, 144.97305353"
18720250326,18,2025-03-26,7,28,300,328,Col12_T,"-37.81344862, 144.97305353"
181520250712,18,2025-07-12,15,136,76,212,Col12_T,"-37.81344862, 144.97305353"
63720251005,63,2025-10-05,7,16,24,40,Bou231_T,"-37.81333081, 144.96675571"
121520240929,12,2024-09-29,15,164,186,350,NewQ_T,"-37.81457988, 144.94292398"
122220240621,12,2024-06-21,22,77,91,168,NewQ_T,"-37.81457988, 144.94292398"
861620250914,86,2025-09-14,16,54,38,92,574Qub_T,"-37.80309992, 144.94908064"
62120241021,62,2024-10-21,1,34,36,70,Lat224_T,"-37.80996494, 144.96216521"
56220241103,56,2024-11-03,2,50,80,130,Lon364_T,"-37.81234775, 144.96153311"
111020240422,11,2024-04-22,10,45,69,114,WatCit_T,"-37.81564989, 144.93970694"
11220240507,11,2024-05-07,2,2,2,4,WatCit_T,"-37.81564989, 144.93970694"
101220240303,10,2024-03-03,12,6,5,11,BouHbr_T,"-37.81876474, 144.94710545"
102120240426,10,2024-04-26,21,9,10,19,BouHbr_T,"-37.81876474, 144.94710545"
721720240124,72,2024-01-24,17,268,956,1224,ACMI_T,"-37.81726338, 144.96872809"
351020240318,35,2024-03-18,10,635,506,1141,SouthB_T,"-37.82018685, 144.96508508"
58920250122,58,2025-01-22,9,1031,158,1189,Bou688_T,"-37.81686075, 144.95358075"
582120231018,58,2023-10-18,21,181,250,431,Bou688_T,"-37.81686075, 144.95358075"
22220250620,2,2025-06-20,22,65,219,284,Bou283_T,"-37.81380668, 144.96516718"
27520250513,27,2025-05-13,5,8,6,14,Vic_T,"-37.80606888, 144.95644692"
21720250906,2,2025-09-06,17,1082,865,1947,Bou283_T,"-37.81380668, 144.96516718"
791420241014,79,2024-10-14,14,63,67,130,FliSS_T,"-37.81794046, 144.96616678"
79220241019,79,2024-10-19,2,69,61,130,FliSS_T,"-37.81794046, 144.96616678"
53520240728,53,2024-07-28,5,20,8,28,Col254_T,"-37.81564191, 144.965499"
521120240828,52,2024-08-28,11,230,148,378,Eli263_T,"-37.81252157, 144.9619401"
521220251016,52,2025-10-16,12,366,355,721,Eli263_T,"-37.81252157, 144.9619401"
192120241216,19,2024-12-16,21,279,439,718,LtB210_T,"-37.81237202, 144.96550671"
201720240522,20,2024-05-22,17,334,255,589,LtB170_T,"-37.81172914, 144.9682466"
20020240726,20,2024-07-26,0,58,63,121,LtB170_T,"-37.81172914, 144.9682466"
164920240830,164,2024-08-30,9,44,29,73,Lat526_T,"-37.813005, 144.95160411"
1641520250509,164,2025-05-09,15,135,104,239,Lat526_T,"-37.813005, 144.95160411"
164320250619,164,2025-06-19,3,2,2,4,Lat526_T,"-37.813005, 144.95160411"
1802220250918,180,2025-09-18,22,1,4,5,Mac330_T,"-37.79497059, 144.93530329"
191120250924,19,2025-09-24,11,346,257,603,LtB210_T,"-37.81237202, 144.96550671"
141620240826,141,2024-08-26,6,23,21,44,474Fl_T,"-37.81997273, 144.95834911"
1391120240406,139,2024-04-06,11,37,53,90,Signal1647_T,"-37.81959923, 144.9632832"
662320240620,66,2024-06-20,23,135,107,242,QVN_T,"-37.81057846, 144.96444294"
6720250916,6,2025-09-16,7,515,1009,1524,FliS_T,"-37.81911705, 144.96558255"
39520240716,39,2024-07-16,5,1,3,4,AlfPl_T,"-37.81379749, 144.96995745"
412220241021,41,2024-10-21,22,30,24,54,Swa31,"-37.81668634, 144.96689733"
82220250214,8,2025-02-14,22,9,9,18,WebBN_T,"-37.82293543, 144.9471751"
782320250425,78,2025-04-25,23,2,11,13,HarEsB_T,"-37.81471642, 144.9446508"
78020240809,78,2024-08-09,0,1,2,3,HarEsB_T,"-37.81471642, 144.9446508"
14620241204,14,2024-12-04,6,116,156,272,SanBri_T,"-37.82011242, 144.96291897"
71420240909,71,2024-09-09,4,3,2,5,WestWP_T,"-37.81235775, 144.97136962"
711720231230,71,2023-12-30,17,21,14,35,WestWP_T,"-37.81235775, 144.97136962"
472020241229,47,2024-12-29,20,648,611,1259,Eli250_T,"-37.81258467, 144.9625775"
471820240615,47,2024-06-15,18,888,811,1699,Eli250_T,"-37.81258467, 144.9625775"
36620250316,36,2025-03-16,6,15,19,34,Que85_T,"-37.81652527, 144.96121062"
361120241101,36,2024-11-01,11,187,155,342,Que85_T,"-37.81652527, 144.96121062"
1071820240913,107,2024-09-13,18,128,166,294,280Will_T,"-37.81246271, 144.95690188"
133720250108,133,2025-01-08,7,648,323,971,Spen229_T,"-37.81531435, 144.95227769"
79020231117,79,2023-11-17,0,62,74,136,FliSS_T,"-37.81794046, 144.96616678"
23320240922,23,2024-09-22,3,15,13,28,Col623_T,"-37.81909256, 144.95452748"
30320241012,30,2024-10-12,3,63,114,177,Lon189_T,"-37.8112185, 144.96656806"
461620250719,46,2025-07-19,16,29,42,71,Pel147_T,"-37.80240719, 144.9615673"
461220240303,46,2024-03-03,12,45,45,90,Pel147_T,"-37.80240719, 144.9615673"
19920240706,19,2024-07-06,9,74,75,149,LtB210_T,"-37.81237202, 144.96550671"
30720250902,30,2025-09-02,7,44,66,110,Lon189_T,"-37.8112185, 144.96656806"
20920240315,20,2024-03-15,9,62,55,117,LtB170_T,"-37.81172914, 144.9682466"
136820250317,136,2025-03-17,8,120,189,309,BirFed1120_T,"-37.8184141, 144.97357915"
1361820251016,136,2025-10-16,18,95,40,135,BirFed1120_T,"-37.8184141, 144.97357915"
1641320251006,164,2025-10-06,13,130,84,214,Lat526_T,"-37.813005, 144.95160411"
1642220240816,164,2024-08-16,22,140,20,160,Lat526_T,"-37.813005, 144.95160411"
138520250419,138,2025-04-19,5,1,0,1,EntPark1671_T,"-37.81996544, 144.95981454"
1231220240426,123,2024-04-26,12,40,7,47,BirBridge_T,"-37.81753741, 144.97329734"
491620240615,49,2024-06-15,16,218,411,629,Eli501_T,"-37.80730068, 144.95956055"
66220250223,66,2025-02-23,2,126,96,222,QVN_T,"-37.81057846, 144.96444294"
61220250225,6,2025-02-25,12,898,801,1699,FliS_T,"-37.81911705, 144.96558255"
42320240212,4,2024-02-12,23,158,101,259,Swa123_T,"-37.81487988, 144.9660878"
4220250219,4,2025-02-19,2,23,13,36,Swa123_T,"-37.81487988, 144.9660878"
701520240526,70,2024-05-26,15,139,144,283,Errol20_T,"-37.80456984, 144.94946228"
412120250714,41,2025-07-14,21,353,550,903,Swa31,"-37.81668634, 144.96689733"
167820241114,167,2024-11-14,8,18,107,125,Lat526_T,"-37.81304149, 144.95155955"
1671320250116,167,2025-01-16,13,42,35,77,Lat526_T,"-37.81304149, 144.95155955"
167520250815,167,2025-08-15,5,3,3,6,Lat526_T,"-37.81304149, 144.95155955"
1312220250429,131,2025-04-29,22,28,33,61,King2_T,"-37.82009057, 144.95758725"
162520241015,162,2024-10-15,5,26,16,42,Eli489_T,"-37.80740397, 144.95987909"
1321720241010,132,2024-10-10,17,210,186,396,King335_T,"-37.81267639, 144.95386444"
1332320250310,133,2025-03-10,23,100,83,183,Spen229_T,"-37.81531435, 144.95227769"
118920250926,118,2025-09-26,9,12,44,56,Fli114C_T,"-37.81632783, 144.97090512"
107320240701,107,2024-07-01,3,3,2,5,280Will_T,"-37.81246271, 144.95690188"
1081020240804,108,2024-08-04,10,60,98,158,261Will_T,"-37.81295822, 144.95678789"
165820250728,165,2025-07-28,8,20,47,67,Spen475_T,"-37.80953359, 144.94939004"
1661220250201,166,2025-02-01,12,65,51,116,Spen484_T,"-37.80896733, 144.94931703"
166020250312,166,2025-03-12,0,2,2,4,Spen484_T,"-37.80896733, 144.94931703"
1612020250702,161,2025-07-02,20,1,0,1,BirArt1109_T,"-37.81851276, 144.97131336"
1381920250120,138,2025-01-20,19,4,0,4,EntPark1671_T,"-37.81996544, 144.95981454"
172120250814,17,2025-08-14,21,83,97,180,Col15_T,"-37.81362543, 144.97323591"
682320231023,68,2023-10-23,23,6,0,6,FLDegN_T,"-37.8168479, 144.96559789"
621920241226,62,2024-12-26,19,178,161,339,Lat224_T,"-37.80996494, 144.96216521"
112120241101,11,2024-11-01,21,41,57,98,WatCit_T,"-37.81564989, 144.93970694"
121420250314,12,2025-03-14,14,118,140,258,NewQ_T,"-37.81457988, 144.94292398"
351020231103,35,2023-11-03,10,621,583,1204,SouthB_T,"-37.82018685, 144.96508508"
721220250618,72,2025-06-18,12,267,332,599,ACMI_T,"-37.81726338, 144.96872809"
72720240928,72,2024-09-28,7,35,68,103,ACMI_T,"-37.81726338, 144.96872809"
2920240328,2,2024-03-28,9,166,210,376,Bou283_T,"-37.81380668, 144.96516718"
27720240804,27,2024-08-04,7,15,35,50,Vic_T,"-37.80606888, 144.95644692"
20920240817,20,2024-08-17,9,52,47,99,LtB170_T,"-37.81172914, 144.9682466"
46720240911,46,2024-09-11,7,27,17,44,Pel147_T,"-37.80240719, 144.9615673"
66120240612,66,2024-06-12,1,50,20,70,QVN_T,"-37.81057846, 144.96444294"
42120240717,4,2024-07-17,21,194,186,380,Swa123_T,"-37.81487988, 144.9660878"
4820250608,4,2025-06-08,8,154,111,265,Swa123_T,"-37.81487988, 144.9660878"
70920231019,70,2023-10-19,9,78,88,166,Errol20_T,"-37.80456984, 144.94946228"
3020250409,3,2025-04-09,0,135,61,196,Swa295_T,"-37.81101524, 144.96429485"
32020240227,3,2024-02-27,20,956,930,1886,Swa295_T,"-37.81101524, 144.96429485"
31320240625,3,2024-06-25,13,938,1085,2023,Swa295_T,"-37.81101524, 144.96429485"
75620240910,75,2024-09-10,6,31,23,54,SprFli_T,"-37.81515276, 144.97467661"
78620240308,78,2024-03-08,6,2,4,6,HarEsB_T,"-37.81471642, 144.9446508"
411420240610,41,2024-06-10,14,1510,1471,2981,Swa31,"-37.81668634, 144.96689733"
292020240718,29,2024-07-18,20,89,98,187,AG_T,"-37.8199817, 144.96872865"
292020240319,29,2024-03-19,20,110,109,219,AG_T,"-37.8199817, 144.96872865"
591320240101,59,2024-01-01,13,201,276,477,RMIT_T,"-37.80825648, 144.96304859"
31620240324,31,2024-03-24,6,9,4,13,Lyg161_T,"-37.80169681, 144.96658911"
31220250701,31,2025-07-01,2,0,2,2,Lyg161_T,"-37.80169681, 144.96658911"
37320250405,37,2025-04-05,3,2,3,5,Lyg260_T,"-37.80107122, 144.96704554"
1342220240307,134,2024-03-07,22,198,189,387,Spen201_T,"-37.81694221, 144.95303935"
135320240707,135,2024-07-07,3,15,13,28,Spen161_T,"-37.8172861, 144.95319102"
1331320250717,133,2025-07-17,13,560,511,1071,Spen229_T,"-37.81531435, 144.95227769"
133320240225,133,2024-02-25,3,21,18,39,Spen229_T,"-37.81531435, 144.95227769"
1081720250625,108,2025-06-25,17,1243,192,1435,261Will_T,"-37.81295822, 144.95678789"
872220250406,87,2025-04-06,22,13,13,26,Errol23_T,"-37.80454949, 144.94921863"
1081020240128,108,2024-01-28,10,125,99,224,261Will_T,"-37.81295822, 144.95678789"
1651720241106,165,2024-11-06,17,84,48,132,Spen475_T,"-37.80953359, 144.94939004"
1661220250222,166,2025-02-22,12,58,62,120,Spen484_T,"-37.80896733, 144.94931703"
1671020250413,167,2025-04-13,10,36,126,162,Lat526_T,"-37.81304149, 144.95155955"
672020241117,67,2024-11-17,20,217,283,500,FLDegS_T,"-37.81688755, 144.96562569"
11820240804,1,2024-08-04,18,760,442,1202,Bou292_T,"-37.81349441, 144.96515323"
67220241202,67,2024-12-02,2,1,1,2,FLDegS_T,"-37.81688755, 144.96562569"
682020240712,68,2024-07-12,20,92,8,100,FLDegN_T,"-37.8168479, 144.96559789"
62520250913,62,2025-09-13,5,12,8,20,Lat224_T,"-37.80996494, 144.96216521"
631920250308,63,2025-03-08,19,397,531,928,Bou231_T,"-37.81333081, 144.96675571"
63120250409,63,2025-04-09,1,1,9,10,Bou231_T,"-37.81333081, 144.96675571"
17220240703,17,2024-07-03,2,3,0,3,Col15_T,"-37.81362543, 144.97323591"
101320250320,10,2025-03-20,13,148,118,266,BouHbr_T,"-37.81876474, 144.94710545"
241420240123,24,2024-01-23,14,486,720,1206,Col620_T,"-37.81887963, 144.95449198"
11120251017,11,2025-10-17,1,5,10,15,WatCit_T,"-37.81564989, 144.93970694"
722020240114,72,2024-01-14,20,136,198,334,ACMI_T,"-37.81726338, 144.96872809"
21220250413,2,2025-04-13,12,574,532,1106,Bou283_T,"-37.81380668, 144.96516718"
9120250119,9,2025-01-19,1,8,13,21,Col700_T,"-37.81982992, 144.95102555"
231520231114,23,2023-11-14,15,191,323,514,Col623_T,"-37.81909256, 144.95452748"
191420240930,19,2024-09-30,14,523,556,1079,LtB210_T,"-37.81237202, 144.96550671"
251320231214,25,2023-12-14,13,887,787,1674,MCEC_T,"-37.82401776, 144.95604426"
19320240426,19,2024-04-26,3,19,51,70,LtB210_T,"-37.81237202, 144.96550671"
481020240410,48,2024-04-10,10,160,104,264,QVMQ_T,"-37.80631581, 144.95866697"
1372120250923,137,2025-09-23,21,1,1,2,BouHbr2353_T,"-37.81894815, 144.94612292"
137820251005,137,2025-10-05,8,14,10,24,BouHbr2353_T,"-37.81894815, 144.94612292"
1422020240412,142,2024-04-12,20,239,277,516,Hammer1584_T,"-37.81970749, 144.96795734"
1301520250816,130,2025-08-16,15,61,50,111,Bou892T,"-37.8204637, 144.94126826"
123620241126,123,2024-11-26,6,1,0,1,BirBridge_T,"-37.81753741, 144.97329734"
1171220240326,117,2024-03-26,12,198,261,459,Fli114F_T,"-37.81629332, 144.97090877"
691620240312,69,2024-03-12,16,143,101,244,FLDegC_T,"-37.81687226, 144.96559144"
69720240624,69,2024-06-24,7,57,16,73,FLDegC_T,"-37.81687226, 144.96559144"
41520240501,4,2024-05-01,15,1606,1263,2869,Swa123_T,"-37.81487988, 144.9660878"
42220251012,4,2025-10-12,22,302,338,640,Swa123_T,"-37.81487988, 144.9660878"
701220240317,70,2024-03-17,12,131,118,249,Errol20_T,"-37.80456984, 144.94946228"
702020250409,70,2025-04-09,20,149,149,298,Errol20_T,"-37.80456984, 144.94946228"
31720240707,3,2024-07-07,17,1194,1388,2582,Swa295_T,"-37.81101524, 144.96429485"
3120240809,3,2024-08-09,1,107,64,171,Swa295_T,"-37.81101524, 144.96429485"
82020240312,8,2024-03-12,20,23,32,55,WebBN_T,"-37.82293543, 144.9471751"
5920240213,5,2024-02-13,9,408,623,1031,PriNW_T,"-37.81874249, 144.96787656"
211020231209,21,2023-12-09,10,175,165,340,Bourke155_T,"-37.81267313, 144.96788288"
21320240504,21,2024-05-04,3,70,49,119,Bourke155_T,"-37.81267313, 144.96788288"
1081920250126,108,2025-01-26,19,96,116,212,261Will_T,"-37.81295822, 144.95678789"
61320241016,61,2024-10-16,3,17,3,20,RMIT14_T,"-37.80767455, 144.96309114"
502320241202,50,2024-12-02,23,29,13,42,Lyg309_T,"-37.79808192, 144.96721013"
501420241207,50,2024-12-07,14,272,285,557,Lyg309_T,"-37.79808192, 144.96721013"
431520250113,43,2025-01-13,15,75,82,157,UM2_T,"-37.79844526, 144.96411782"
1821720250508,182,2025-05-08,17,411,275,686,King163_T,"-37.81627451, 144.95550503"
1851920250724,185,2025-07-24,19,560,506,1066,Eli197_T,"-37.81374643, 144.96276183"
1431220240923,143,2024-09-23,12,169,278,447,Spencer_T,"-37.821728, 144.95557015"
134020250629,134,2025-06-29,0,114,104,218,Spen201_T,"-37.81694221, 144.95303935"
1071920250603,107,2025-06-03,19,58,79,137,280Will_T,"-37.81246271, 144.95690188"
56320240702,56,2024-07-02,3,8,12,20,Lon364_T,"-37.81234775, 144.96153311"
861520240110,86,2024-01-10,15,21,18,39,574Qub_T,"-37.80309992, 144.94908064"
11620250719,11,2025-07-19,6,1,5,6,WatCit_T,"-37.81564989, 144.93970694"
72820250911,72,2025-09-11,8,916,103,1019,ACMI_T,"-37.81726338, 144.96872809"
722220231030,72,2023-10-30,22,69,172,241,ACMI_T,"-37.81726338, 144.96872809"
21320250109,2,2025-01-09,13,811,846,1657,Bou283_T,"-37.81380668, 144.96516718"
2820250419,2,2025-04-19,8,71,96,167,Bou283_T,"-37.81380668, 144.96516718"
53320250721,53,2025-07-21,3,5,5,10,Col254_T,"-37.81564191, 144.965499"
51920240323,51,2024-03-23,9,93,79,172,Fra118_T,"-37.80841815, 144.95906316"
23320240414,23,2024-04-14,3,6,20,26,Col623_T,"-37.81909256, 144.95452748"
481920231225,48,2023-12-25,19,85,82,167,QVMQ_T,"-37.80631581, 144.95866697"
25720250521,25,2025-05-21,7,156,251,407,MCEC_T,"-37.82401776, 144.95604426"
20420240307,20,2024-03-07,4,6,5,11,LtB170_T,"-37.81172914, 144.9682466"
49220250325,49,2025-03-25,2,31,39,70,Eli501_T,"-37.80730068, 144.95956055"
1411520250617,141,2025-06-17,15,132,105,237,474Fl_T,"-37.81997273, 144.95834911"
491020240410,49,2024-04-10,10,222,317,539,Eli501_T,"-37.80730068, 144.95956055"
191420250716,19,2025-07-16,14,496,586,1082,LtB210_T,"-37.81237202, 144.96550671"
19420231222,19,2023-12-22,4,23,26,49,LtB210_T,"-37.81237202, 144.96550671"
1391520240406,139,2024-04-06,15,79,48,127,Signal1647_T,"-37.81959923, 144.9632832"
1421020240313,142,2024-03-13,10,167,87,254,Hammer1584_T,"-37.81970749, 144.96795734"
661220250828,66,2025-08-28,12,958,1249,2207,QVN_T,"-37.81057846, 144.96444294"
69820250713,69,2025-07-13,8,77,31,108,FLDegC_T,"-37.81687226, 144.96559144"
79520231229,79,2023-12-29,5,20,20,40,FliSS_T,"-37.81794046, 144.96616678"
51620241112,51,2024-11-12,6,21,19,40,Fra118_T,"-37.80841815, 144.95906316"
252120241107,25,2024-11-07,21,260,150,410,MCEC_T,"-37.82401776, 144.95604426"
1362320240325,136,2024-03-25,23,2,1,3,BirFed1120_T,"-37.8184141, 144.97357915"
1381620250816,138,2025-08-16,16,17,1,18,EntPark1671_T,"-37.81996544, 144.95981454"
1231020250118,123,2025-01-18,10,34,76,110,BirBridge_T,"-37.81753741, 144.97329734"
109820250717,109,2025-07-17,8,68,476,544,LatWill_T,"-37.81193681, 144.95621105"
691220240223,69,2024-02-23,12,270,261,531,FLDegC_T,"-37.81687226, 144.96559144"
69020241014,69,2024-10-14,0,1,0,1,FLDegC_T,"-37.81687226, 144.96559144"
69520250727,69,2025-07-27,5,1,1,2,FLDegC_T,"-37.81687226, 144.96559144"
841720240402,84,2024-04-02,17,939,1960,2899,ElFi_T,"-37.81798049, 144.96503383"
4220240913,4,2024-09-13,2,15,10,25,Swa123_T,"-37.81487988, 144.9660878"
4220250221,4,2025-02-21,2,31,34,65,Swa123_T,"-37.81487988, 144.9660878"
391220240911,39,2024-09-11,12,220,130,350,AlfPl_T,"-37.81379749, 144.96995745"
391720240402,39,2024-04-02,17,127,71,198,AlfPl_T,"-37.81379749, 144.96995745"
3820250824,3,2025-08-24,8,99,119,218,Swa295_T,"-37.81101524, 144.96429485"
82220250723,8,2025-07-23,22,2,2,4,WebBN_T,"-37.82293543, 144.9471751"
772020250902,77,2025-09-02,20,121,101,222,HarEsP_T,"-37.81441438, 144.94433026"
591020250927,59,2025-09-27,10,279,286,565,RMIT_T,"-37.80825648, 144.96304859"
71420240526,71,2024-05-26,4,1,0,1,WestWP_T,"-37.81235775, 144.97136962"
47620240502,47,2024-05-02,6,48,160,208,Eli250_T,"-37.81258467, 144.9625775"
311620241002,31,2024-10-02,16,169,168,337,Lyg161_T,"-37.80169681, 144.96658911"
311720231220,31,2023-12-20,17,146,52,198,Lyg161_T,"-37.80169681, 144.96658911"
361820251009,36,2025-10-09,18,237,212,449,Que85_T,"-37.81652527, 144.96121062"
44720240214,44,2024-02-14,7,20,32,52,UM3_T,"-37.79698741, 144.96441306"
211120231126,21,2023-11-26,11,329,234,563,Bourke155_T,"-37.81267313, 144.96788288"
21020241025,21,2024-10-25,0,49,64,113,Bourke155_T,"-37.81267313, 144.96788288"
107620240602,107,2024-06-02,6,12,5,17,280Will_T,"-37.81246271, 144.95690188"
1332320240930,133,2024-09-30,23,71,63,134,Spen229_T,"-37.81531435, 144.95227769"
1332020250101,133,2025-01-01,20,429,323,752,Spen229_T,"-37.81531435, 144.95227769"
1241320250705,124,2025-07-05,13,2,8,10,BirBridge_T,"-37.81757416, 144.97329934"
87820250406,87,2025-04-06,8,34,36,70,Errol23_T,"-37.80454949, 144.94921863"
441920250918,44,2025-09-18,19,46,88,134,UM3_T,"-37.79698741, 144.96441306"
44020250111,44,2025-01-11,0,5,0,5,UM3_T,"-37.79698741, 144.96441306"
43420240610,43,2024-06-10,4,5,0,5,UM2_T,"-37.79844526, 144.96411782"
162520250228,162,2025-02-28,5,27,6,33,Eli489_T,"-37.80740397, 144.95987909"
1431120250713,143,2025-07-13,11,213,316,529,Spencer_T,"-37.821728, 144.95557015"
1321220240624,132,2024-06-24,12,209,156,365,King335_T,"-37.81267639, 144.95386444"
1321920241030,132,2024-10-30,19,177,158,335,King335_T,"-37.81267639, 144.95386444"
131420250506,131,2025-05-06,4,7,0,7,King2_T,"-37.82009057, 144.95758725"
67620241204,67,2024-12-04,6,151,72,223,FLDegS_T,"-37.81688755, 144.96562569"
85520250316,85,2025-03-16,5,1,0,1,488Mac_T,"-37.79432415, 144.92973378"
17820250305,17,2025-03-05,8,1232,160,1392,Col15_T,"-37.81362543, 144.97323591"
1720250507,1,2025-05-07,7,112,97,209,Bou292_T,"-37.81349441, 144.96515323"
671420241030,67,2024-10-30,14,437,750,1187,FLDegS_T,"-37.81688755, 144.96562569"
671220250310,67,2025-03-10,12,388,604,992,FLDegS_T,"-37.81688755, 144.96562569"
182020240517,18,2024-05-17,20,1,4,5,Col12_T,"-37.81344862, 144.97305353"
712120241009,71,2024-10-09,21,5,3,8,WestWP_T,"-37.81235775, 144.97136962"
65520240825,65,2024-08-25,5,37,21,58,SwaCs_T,"-37.81569416, 144.9668064"
651120231228,65,2023-12-28,11,381,352,733,SwaCs_T,"-37.81569416, 144.9668064"
78420240114,78,2024-01-14,4,1,0,1,HarEsB_T,"-37.81471642, 144.9446508"
28120251004,28,2025-10-04,1,22,11,33,VAC_T,"-37.82129925, 144.96879309"
29120250529,29,2025-05-29,1,3,13,16,AG_T,"-37.8199817, 144.96872865"
401220231125,40,2023-11-25,12,128,188,316,Spr201_T,"-37.80999341, 144.97227587"
361220250420,36,2025-04-20,12,79,83,162,Que85_T,"-37.81652527, 144.96121062"
36620250709,36,2025-07-09,6,36,10,46,Que85_T,"-37.81652527, 144.96121062"
361920250110,36,2025-01-10,19,178,141,319,Que85_T,"-37.81652527, 144.96121062"
50820250705,50,2025-07-05,8,27,30,57,Lyg309_T,"-37.79808192, 144.96721013"
501220241004,50,2024-10-04,12,206,297,503,Lyg309_T,"-37.79808192, 144.96721013"
441720241219,44,2024-12-19,17,63,60,123,UM3_T,"-37.79698741, 144.96441306"
431320250802,43,2025-08-02,13,129,179,308,UM2_T,"-37.79844526, 144.96411782"
45620240729,45,2024-07-29,6,31,51,82,Swa148_T,"-37.81414075, 144.96609379"
451320241119,45,2024-11-19,13,525,832,1357,Swa148_T,"-37.81414075, 144.96609379"
51820241026,5,2024-10-26,18,1432,1917,3349,PriNW_T,"-37.81874249, 144.96787656"
211720231210,21,2023-12-10,17,575,470,1045,Bourke155_T,"-37.81267313, 144.96788288"
162520251007,162,2025-10-07,5,41,21,62,Eli489_T,"-37.80740397, 144.95987909"
143720250206,143,2025-02-06,7,113,104,217,Spencer_T,"-37.821728, 144.95557015"
143420250911,143,2025-09-11,4,12,5,17,Spencer_T,"-37.821728, 144.95557015"
1341820250306,134,2025-03-06,18,550,414,964,Spen201_T,"-37.81694221, 144.95303935"
1331320231130,133,2023-11-30,13,648,571,1219,Spen229_T,"-37.81531435, 144.95227769"
1331120250217,133,2025-02-17,11,377,375,752,Spen229_T,"-37.81531435, 144.95227769"
1332220250403,133,2025-04-03,22,259,149,408,Spen229_T,"-37.81531435, 144.95227769"
1081320250822,108,2025-08-22,13,582,453,1035,261Will_T,"-37.81295822, 144.95678789"
1181120231206,118,2023-12-06,11,13,16,29,Fli114C_T,"-37.81632783, 144.97090512"
871720240306,87,2024-03-06,17,154,124,278,Errol23_T,"-37.80454949, 144.94921863"
1841820250818,184,2025-08-18,18,554,748,1302,Eli124_T,"-37.81512416, 144.96371988"
166920250701,166,2025-07-01,9,13,26,39,Spen484_T,"-37.80896733, 144.94931703"
672020250109,67,2025-01-09,20,221,339,560,FLDegS_T,"-37.81688755, 144.96562569"
852220240724,85,2024-07-24,22,7,2,9,488Mac_T,"-37.79432415, 144.92973378"
17320241014,17,2024-10-14,3,5,4,9,Col15_T,"-37.81362543, 144.97323591"
181320240329,18,2024-03-29,13,79,70,149,Col12_T,"-37.81344862, 144.97305353"
1820250618,1,2025-06-18,8,218,213,431,Bou292_T,"-37.81349441, 144.96515323"
621320240106,62,2024-01-06,13,420,453,873,Lat224_T,"-37.80996494, 144.96216521"
11620240428,11,2024-04-28,6,6,8,14,WatCit_T,"-37.81564989, 144.93970694"
112020250617,11,2025-06-17,20,47,49,96,WatCit_T,"-37.81564989, 144.93970694"
11220250803,11,2025-08-03,2,0,3,3,WatCit_T,"-37.81564989, 144.93970694"
862320240717,86,2024-07-17,23,0,3,3,574Qub_T,"-37.80309992, 144.94908064"
241520250922,24,2025-09-22,15,434,1132,1566,Col620_T,"-37.81887963, 144.95449198"
2720240106,2,2024-01-06,7,13,24,37,Bou283_T,"-37.81380668, 144.96516718"
21020240218,2,2024-02-18,10,533,755,1288,Bou283_T,"-37.81380668, 144.96516718"
2320240812,2,2024-08-12,3,4,4,8,Bou283_T,"-37.81380668, 144.96516718"
56920250708,56,2025-07-08,9,154,128,282,Lon364_T,"-37.81234775, 144.96153311"
58720241116,58,2024-11-16,7,129,63,192,Bou688_T,"-37.81686075, 144.95358075"
35420240122,35,2024-01-22,4,23,12,35,SouthB_T,"-37.82018685, 144.96508508"
58120251009,58,2025-10-09,1,29,49,78,Bou688_T,"-37.81686075, 144.95358075"
58020251014,58,2025-10-14,0,73,60,133,Bou688_T,"-37.81686075, 144.95358075"
9820240502,9,2024-05-02,8,116,3646,3762,Col700_T,"-37.81982992, 144.95102555"
692120250924,69,2025-09-24,21,13,51,64,FLDegC_T,"-37.81687226, 144.96559144"
42320231102,4,2023-11-02,23,150,155,305,Swa123_T,"-37.81487988, 144.9660878"
781820250410,78,2025-04-10,18,6,42,48,HarEsB_T,"-37.81471642, 144.9446508"
42920240701,42,2024-07-01,9,114,59,173,UM1_T,"-37.80008566, 144.96386412"
14420250922,14,2025-09-22,4,10,1,11,SanBri_T,"-37.82011242, 144.96291897"
142220250226,14,2025-02-26,22,213,67,280,SanBri_T,"-37.82011242, 144.96291897"
71120240110,71,2024-01-10,1,2,3,5,WestWP_T,"-37.81235775, 144.97136962"
711520240519,71,2024-05-19,15,48,26,74,WestWP_T,"-37.81235775, 144.97136962"
71220250618,71,2025-06-18,2,1,0,1,WestWP_T,"-37.81235775, 144.97136962"
401220240106,40,2024-01-06,12,98,171,269,Spr201_T,"-37.80999341, 144.97227587"
401620250816,40,2025-08-16,16,431,179,610,Spr201_T,"-37.80999341, 144.97227587"
311320231030,31,2023-10-30,13,142,157,299,Lyg161_T,"-37.80169681, 144.96658911"
472020250824,47,2025-08-24,20,542,463,1005,Eli250_T,"-37.81258467, 144.9625775"
108120231213,108,2023-12-13,1,13,19,32,261Will_T,"-37.81295822, 144.95678789"
61020250210,61,2025-02-10,0,68,20,88,RMIT14_T,"-37.80767455, 144.96309114"
441920250520,44,2025-05-20,19,43,80,123,UM3_T,"-37.79698741, 144.96441306"
502220240217,50,2024-02-17,22,255,119,374,Lyg309_T,"-37.79808192, 144.96721013"
441720240622,44,2024-06-22,17,17,55,72,UM3_T,"-37.79698741, 144.96441306"
1792120250616,179,2025-06-16,21,28,34,62,Pow61_T,"-37.82392385, 144.96299677"
1661720250207,166,2025-02-07,17,67,84,151,Spen484_T,"-37.80896733, 144.94931703"
167320250923,167,2025-09-23,3,0,2,2,Lat526_T,"-37.81304149, 144.95155955"
140820240218,140,2024-02-18,8,71,18,89,Boyd2837_T,"-37.82590962, 144.96185972"
1821320250929,182,2025-09-29,13,316,287,603,King163_T,"-37.81627451, 144.95550503"
132420250918,132,2025-09-18,4,2,4,6,King335_T,"-37.81267639, 144.95386444"
1341620240206,134,2024-02-06,16,450,469,919,Spen201_T,"-37.81694221, 144.95303935"
107220241007,107,2024-10-07,2,8,4,12,280Will_T,"-37.81246271, 144.95690188"
133620240610,133,2024-06-10,6,112,136,248,Spen229_T,"-37.81531435, 144.95227769"
1351520250303,135,2025-03-03,15,432,444,876,Spen161_T,"-37.8172861, 144.95319102"
1352220240608,135,2024-06-08,22,121,721,842,Spen161_T,"-37.8172861, 144.95319102"
1331820241230,133,2024-12-30,18,756,616,1372,Spen229_T,"-37.81531435, 144.95227769"
85620240509,85,2024-05-09,6,29,17,46,488Mac_T,"-37.79432415, 144.92973378"
12220240928,1,2024-09-28,22,238,194,432,Bou292_T,"-37.81349441, 144.96515323"
181720250601,18,2025-06-01,17,14,31,45,Col12_T,"-37.81344862, 144.97305353"
632320250519,63,2025-05-19,23,1,23,24,Bou231_T,"-37.81333081, 144.96675571"
561920250106,56,2025-01-06,19,241,389,630,Lon364_T,"-37.81234775, 144.96153311"
111120241004,11,2024-10-04,11,52,68,120,WatCit_T,"-37.81564989, 144.93970694"
12820240809,12,2024-08-09,8,116,115,231,NewQ_T,"-37.81457988, 144.94292398"
242020241014,24,2024-10-14,20,211,394,605,Col620_T,"-37.81887963, 144.95449198"
35720231204,35,2023-12-04,7,430,607,1037,SouthB_T,"-37.82018685, 144.96508508"
58520250701,58,2025-07-01,5,56,26,82,Bou688_T,"-37.81686075, 144.95358075"
581720250724,58,2025-07-24,17,913,1299,2212,Bou688_T,"-37.81686075, 144.95358075"
581820231218,58,2023-12-18,18,462,404,866,Bou688_T,"-37.81686075, 144.95358075"
582220240209,58,2024-02-09,22,251,235,486,Bou688_T,"-37.81686075, 144.95358075"
35720240731,35,2024-07-31,7,466,749,1215,SouthB_T,"-37.82018685, 144.96508508"
272220240121,27,2024-01-21,22,68,16,84,Vic_T,"-37.80606888, 144.95644692"
92020240825,9,2024-08-25,20,34,34,68,Col700_T,"-37.81982992, 144.95102555"
9220231107,9,2023-11-07,2,6,13,19,Col700_T,"-37.81982992, 144.95102555"
9820231203,9,2023-12-03,8,45,22,67,Col700_T,"-37.81982992, 144.95102555"
791020240508,79,2024-05-08,10,325,241,566,FliSS_T,"-37.81794046, 144.96616678"
791220240709,79,2024-07-09,12,411,301,712,FliSS_T,"-37.81794046, 144.96616678"
23620250307,23,2025-03-07,6,73,75,148,Col623_T,"-37.81909256, 144.95452748"
25220240903,25,2024-09-03,2,8,5,13,MCEC_T,"-37.82401776, 144.95604426"
461520240425,46,2024-04-25,15,38,50,88,Pel147_T,"-37.80240719, 144.9615673"
521820250713,52,2025-07-13,18,221,312,533,Eli263_T,"-37.81252157, 144.9619401"
161420250801,161,2025-08-01,4,1,0,1,BirArt1109_T,"-37.81851276, 144.97131336"
1231320240906,123,2024-09-06,13,19,4,23,BirBridge_T,"-37.81753741, 144.97329734"
19120250223,19,2025-02-23,1,175,277,452,LtB210_T,"-37.81237202, 144.96550671"
192220240415,19,2024-04-15,22,156,199,355,LtB210_T,"-37.81237202, 144.96550671"
1362120240210,136,2024-02-10,21,8,0,8,BirFed1120_T,"-37.8184141, 144.97357915"
136820240302,136,2024-03-02,8,64,49,113,BirFed1120_T,"-37.8184141, 144.97357915"
142420240628,142,2024-06-28,4,1,2,3,Hammer1584_T,"-37.81970749, 144.96795734"
66920250331,66,2025-03-31,9,327,501,828,QVN_T,"-37.81057846, 144.96444294"
842320231116,84,2023-11-16,23,394,361,755,ElFi_T,"-37.81798049, 144.96503383"
391520240103,39,2024-01-03,15,81,70,151,AlfPl_T,"-37.81379749, 144.96995745"
751820240920,75,2024-09-20,18,16,9,25,SprFli_T,"-37.81515276, 144.97467661"
411920250318,41,2025-03-18,19,976,1492,2468,Swa31,"-37.81668634, 144.96689733"
78320240226,78,2024-02-26,3,1,0,1,HarEsB_T,"-37.81471642, 144.9446508"
421520250919,42,2025-09-19,15,221,352,573,UM1_T,"-37.80008566, 144.96386412"
781520250812,78,2025-08-12,15,24,84,108,HarEsB_T,"-37.81471642, 144.9446508"
291820240816,29,2024-08-16,18,173,359,532,AG_T,"-37.8199817, 144.96872865"
291820241215,29,2024-12-15,18,416,513,929,AG_T,"-37.8199817, 144.96872865"
291320250123,29,2025-01-23,13,545,462,1007,AG_T,"-37.8199817, 144.96872865"
291020240106,29,2024-01-06,10,132,258,390,AG_T,"-37.8199817, 144.96872865"
141420240804,14,2024-08-04,14,465,177,642,SanBri_T,"-37.82011242, 144.96291897"
281320250721,28,2025-07-21,13,581,584,1165,VAC_T,"-37.82129925, 144.96879309"
401020250322,40,2025-03-22,10,105,92,197,Spr201_T,"-37.80999341, 144.97227587"
401120250910,40,2025-09-10,11,264,266,530,Spr201_T,"-37.80999341, 144.97227587"
37920250902,37,2025-09-02,9,37,37,74,Lyg260_T,"-37.80107122, 144.96704554"
47420250529,47,2025-05-29,4,8,23,31,Eli250_T,"-37.81258467, 144.9625775"
45120240709,45,2024-07-09,1,17,31,48,Swa148_T,"-37.81414075, 144.96609379"
871420250325,87,2025-03-25,14,114,104,218,Errol23_T,"-37.80454949, 144.94921863"
611720240705,61,2024-07-05,17,386,505,891,RMIT14_T,"-37.80767455, 144.96309114"
502220250105,50,2025-01-05,22,88,54,142,Lyg309_T,"-37.79808192, 144.96721013"
442220250723,44,2025-07-23,22,13,16,29,UM3_T,"-37.79698741, 144.96441306"
431020240303,43,2024-03-03,10,98,52,150,UM2_T,"-37.79844526, 144.96411782"
441220240511,44,2024-05-11,12,85,54,139,UM3_T,"-37.79698741, 144.96441306"
1651420250420,165,2025-04-20,14,21,22,43,Spen475_T,"-37.80953359, 144.94939004"
1651520250428,165,2025-04-28,15,41,27,68,Spen475_T,"-37.80953359, 144.94939004"
1311120240731,131,2024-07-31,11,91,160,251,King2_T,"-37.82009057, 144.95758725"
1671520250617,167,2025-06-17,15,56,56,112,Lat526_T,"-37.81304149, 144.95155955"
621520240212,62,2024-02-12,15,167,109,276,Lat224_T,"-37.80996494, 144.96216521"
561920240208,56,2024-02-08,19,323,329,652,Lon364_T,"-37.81234775, 144.96153311"
11520240210,11,2024-02-10,5,4,2,6,WatCit_T,"-37.81564989, 144.93970694"
12420231230,12,2023-12-30,4,6,5,11,NewQ_T,"-37.81457988, 144.94292398"
56420250529,56,2025-05-29,4,4,1,5,Lon364_T,"-37.81234775, 144.96153311"
12520250305,12,2025-03-05,5,16,13,29,NewQ_T,"-37.81457988, 144.94292398"
761120231030,76,2023-10-30,11,74,65,139,KenMac_T,"-37.79453803, 144.93036194"
761520240902,76,2024-09-02,15,36,46,82,KenMac_T,"-37.79453803, 144.93036194"
722120241201,72,2024-12-01,21,259,196,455,ACMI_T,"-37.81726338, 144.96872809"
21020240315,2,2024-03-15,10,304,394,698,Bou283_T,"-37.81380668, 144.96516718"
58020241212,58,2024-12-12,0,81,114,195,Bou688_T,"-37.81686075, 144.95358075"
581920241217,58,2024-12-17,19,347,285,632,Bou688_T,"-37.81686075, 144.95358075"
35020250404,35,2025-04-04,0,40,137,177,SouthB_T,"-37.82018685, 144.96508508"
351420240702,35,2024-07-02,14,924,1097,2021,SouthB_T,"-37.82018685, 144.96508508"
511120250221,51,2025-02-21,11,131,141,272,Fra118_T,"-37.80841815, 144.95906316"
23720240806,23,2024-08-06,7,403,203,606,Col623_T,"-37.81909256, 144.95452748"
48120240128,48,2024-01-28,1,15,27,42,QVMQ_T,"-37.80631581, 144.95866697"
137920240809,137,2024-08-09,9,42,18,60,BouHbr2353_T,"-37.81894815, 144.94612292"
1421820240102,142,2024-01-02,18,55,9,64,Hammer1584_T,"-37.81970749, 144.96795734"
123720250326,123,2025-03-26,7,47,15,62,BirBridge_T,"-37.81753741, 144.97329734"
49320250508,49,2025-05-08,3,26,35,61,Eli501_T,"-37.80730068, 144.95956055"
1092220240204,109,2024-02-04,22,38,86,124,LatWill_T,"-37.81193681, 144.95621105"
692120250217,69,2025-02-17,21,32,20,52,FLDegC_T,"-37.81687226, 144.96559144"
62220240702,6,2024-07-02,22,287,236,523,FliS_T,"-37.81911705, 144.96558255"
6720250716,6,2025-07-16,7,428,698,1126,FliS_T,"-37.81911705, 144.96558255"
4620240812,4,2024-08-12,6,111,25,136,Swa123_T,"-37.81487988, 144.9660878"
701320240402,70,2024-04-02,13,179,158,337,Errol20_T,"-37.80456984, 144.94946228"
81820241031,8,2024-10-31,18,254,205,459,WebBN_T,"-37.82293543, 144.9471751"
82220231020,8,2023-10-20,22,87,38,125,WebBN_T,"-37.82293543, 144.9471751"
39420250801,39,2025-08-01,4,1,0,1,AlfPl_T,"-37.81379749, 144.96995745"
41920250419,41,2025-04-19,9,716,545,1261,Swa31,"-37.81668634, 144.96689733"
411120250920,41,2025-09-20,11,1708,1147,2855,Swa31,"-37.81668634, 144.96689733"
591920241227,59,2024-12-27,19,353,284,637,RMIT_T,"-37.80825648, 144.96304859"
711920240104,71,2024-01-04,19,3,10,13,WestWP_T,"-37.81235775, 144.97136962"
65120240115,65,2024-01-15,1,57,11,68,SwaCs_T,"-37.81569416, 144.9668064"
29320240115,29,2024-01-15,3,5,3,8,AG_T,"-37.8199817, 144.96872865"
40020241201,40,2024-12-01,0,56,32,88,Spr201_T,"-37.80999341, 144.97227587"
40120251011,40,2025-10-11,1,36,23,59,Spr201_T,"-37.80999341, 144.97227587"
312220250302,31,2025-03-02,22,65,124,189,Lyg161_T,"-37.80169681, 144.96658911"
31820250414,31,2025-04-14,8,64,70,134,Lyg161_T,"-37.80169681, 144.96658911"
54820241029,54,2024-10-29,8,156,76,232,Swa607_T,"-37.804024, 144.96308399"
541120240203,54,2024-02-03,11,144,90,234,Swa607_T,"-37.804024, 144.96308399"
361020250721,36,2025-07-21,10,123,102,225,Que85_T,"-37.81652527, 144.96121062"
371820241025,37,2024-10-25,18,75,92,167,Lyg260_T,"-37.80107122, 144.96704554"
47420241018,47,2024-10-18,4,24,20,44,Eli250_T,"-37.81258467, 144.9625775"
47120240604,47,2024-06-04,1,19,39,58,Eli250_T,"-37.81258467, 144.9625775"
611620241101,61,2024-11-01,16,669,670,1339,RMIT14_T,"-37.80767455, 144.96309114"
441120250522,44,2025-05-22,11,101,76,177,UM3_T,"-37.79698741, 144.96441306"
44120250623,44,2025-06-23,1,2,1,3,UM3_T,"-37.79698741, 144.96441306"
45120250215,45,2025-02-15,1,34,156,190,Swa148_T,"-37.81414075, 144.96609379"
45420250701,45,2025-07-01,4,6,16,22,Swa148_T,"-37.81414075, 144.96609379"
1321620250821,132,2025-08-21,16,152,161,313,King335_T,"-37.81267639, 144.95386444"
108820240307,108,2024-03-07,8,189,2466,2655,261Will_T,"-37.81295822, 144.95678789"
118220241004,118,2024-10-04,2,0,1,1,Fli114C_T,"-37.81632783, 144.97090512"
108720250204,108,2025-02-04,7,70,841,911,261Will_T,"-37.81295822, 144.95678789"
87420250404,87,2025-04-04,4,1,0,1,Errol23_T,"-37.80454949, 144.94921863"
181220250430,181,2025-04-30,2,58,36,94,Eli368_T,"-37.81009465, 144.96143149"
17820240325,17,2024-03-25,8,1213,196,1409,Col15_T,"-37.81362543, 144.97323591"
531220240511,53,2024-05-11,12,760,629,1389,Col254_T,"-37.81564191, 144.965499"
531520240126,53,2024-01-26,15,595,488,1083,Col254_T,"-37.81564191, 144.965499"
231020241125,23,2024-11-25,10,184,217,401,Col623_T,"-37.81909256, 144.95452748"
20220240623,20,2024-06-23,2,57,90,147,LtB170_T,"-37.81172914, 144.9682466"
52220241107,52,2024-11-07,2,4,16,20,Eli263_T,"-37.81252157, 144.9619401"
491920250519,49,2025-05-19,19,188,202,390,Eli501_T,"-37.80730068, 144.95956055"
1231020250316,123,2025-03-16,10,11,3,14,BirBridge_T,"-37.81753741, 144.97329734"
1381220250421,138,2025-04-21,12,8,12,20,EntPark1671_T,"-37.81996544, 144.95981454"
117220231024,117,2023-10-24,2,6,0,6,Fli114F_T,"-37.81629332, 144.97090877"
109720240613,109,2024-06-13,7,28,265,293,LatWill_T,"-37.81193681, 144.95621105"
1092220250423,109,2025-04-23,22,56,53,109,LatWill_T,"-37.81193681, 144.95621105"
48720250807,48,2025-08-07,7,52,33,85,QVMQ_T,"-37.80631581, 144.95866697"
180620250804,180,2025-08-04,6,7,1,8,Mac330_T,"-37.79497059, 144.93530329"
1361820241208,136,2024-12-08,18,141,53,194,BirFed1120_T,"-37.8184141, 144.97357915"
751120250106,75,2025-01-06,11,2,4,6,SprFli_T,"-37.81515276, 144.97467661"
781820240425,78,2024-04-25,18,15,11,26,HarEsB_T,"-37.81471642, 144.9446508"
652020231223,65,2023-12-23,20,1006,2084,3090,SwaCs_T,"-37.81569416, 144.9668064"
591320250809,59,2025-08-09,13,701,584,1285,RMIT_T,"-37.80825648, 144.96304859"
59320241026,59,2024-10-26,3,47,10,57,RMIT_T,"-37.80825648, 144.96304859"
54520240814,54,2024-08-14,5,8,8,16,Swa607_T,"-37.804024, 144.96308399"
281820250825,28,2025-08-25,18,547,1037,1584,VAC_T,"-37.82129925, 144.96879309"
281720250525,28,2025-05-25,17,331,522,853,VAC_T,"-37.82129925, 144.96879309"
31920250924,31,2025-09-24,9,71,87,158,Lyg161_T,"-37.80169681, 144.96658911"
54420241118,54,2024-11-18,4,3,2,5,Swa607_T,"-37.804024, 144.96308399"
37020240722,37,2024-07-22,0,15,16,31,Lyg260_T,"-37.80107122, 144.96704554"
471020241222,47,2024-12-22,10,459,516,975,Eli250_T,"-37.81258467, 144.9625775"
451120231123,45,2023-11-23,11,478,513,991,Swa148_T,"-37.81414075, 144.96609379"
21120240225,21,2024-02-25,1,245,312,557,Bourke155_T,"-37.81267313, 144.96788288"
36020240918,36,2024-09-18,0,2,19,21,Que85_T,"-37.81652527, 144.96121062"
108420250715,108,2025-07-15,4,7,9,16,261Will_T,"-37.81295822, 144.95678789"
611520241018,61,2024-10-18,15,531,773,1304,RMIT14_T,"-37.80767455, 144.96309114"
431020250920,43,2025-09-20,10,84,73,157,UM2_T,"-37.79844526, 144.96411782"
179820250303,179,2025-03-03,8,73,39,112,Pow61_T,"-37.82392385, 144.96299677"
1652120241215,165,2024-12-15,21,37,10,47,Spen475_T,"-37.80953359, 144.94939004"
1311020240930,131,2024-09-30,10,96,115,211,King2_T,"-37.82009057, 144.95758725"
1311520231126,131,2023-11-26,15,76,62,138,King2_T,"-37.82009057, 144.95758725"
1352020250317,135,2025-03-17,20,151,183,334,Spen161_T,"-37.8172861, 144.95319102"
1331120250804,133,2025-08-04,11,359,392,751,Spen229_T,"-37.81531435, 144.95227769"
1331420250918,133,2025-09-18,14,408,438,846,Spen229_T,"-37.81531435, 144.95227769"
133720240705,133,2024-07-05,7,472,299,771,Spen229_T,"-37.81531435, 144.95227769"
1331920241221,133,2024-12-21,19,462,423,885,Spen229_T,"-37.81531435, 144.95227769"
1331720240124,133,2024-01-24,17,689,688,1377,Spen229_T,"-37.81531435, 144.95227769"
133920240527,133,2024-05-27,9,441,422,863,Spen229_T,"-37.81531435, 144.95227769"
12820250205,12,2025-02-05,8,139,119,258,NewQ_T,"-37.81457988, 144.94292398"
121320250509,12,2025-05-09,13,169,149,318,NewQ_T,"-37.81457988, 144.94292398"
102120241127,10,2024-11-27,21,38,27,65,BouHbr_T,"-37.81876474, 144.94710545"
762320240217,76,2024-02-17,23,1,4,5,KenMac_T,"-37.79453803, 144.93036194"
761520241124,76,2024-11-24,15,46,41,87,KenMac_T,"-37.79453803, 144.93036194"
76520250325,76,2025-03-25,5,3,1,4,KenMac_T,"-37.79453803, 144.93036194"
271920240127,27,2024-01-27,19,101,62,163,Vic_T,"-37.80606888, 144.95644692"
91520240308,9,2024-03-08,15,763,174,937,Col700_T,"-37.81982992, 144.95102555"
79520241004,79,2024-10-04,5,36,11,47,FliSS_T,"-37.81794046, 144.96616678"
52820240909,52,2024-09-09,8,140,271,411,Eli263_T,"-37.81252157, 144.9619401"
521320240915,52,2024-09-15,13,356,273,629,Eli263_T,"-37.81252157, 144.9619401"
51220240505,51,2024-05-05,2,8,12,20,Fra118_T,"-37.80841815, 144.95906316"
51720231228,51,2023-12-28,7,14,16,30,Fra118_T,"-37.80841815, 144.95906316"
251920241009,25,2024-10-09,19,296,309,605,MCEC_T,"-37.82401776, 144.95604426"
201420240620,20,2024-06-20,14,162,241,403,LtB170_T,"-37.81172914, 144.9682466"
1361720241224,136,2024-12-24,17,48,65,113,BirFed1120_T,"-37.8184141, 144.97357915"
1421420241007,142,2024-10-07,14,176,145,321,Hammer1584_T,"-37.81970749, 144.96795734"
130620241009,130,2024-10-09,6,8,6,14,Bou892T,"-37.8204637, 144.94126826"
1381120240110,138,2024-01-10,11,6,12,18,EntPark1671_T,"-37.81996544, 144.95981454"
1381720240708,138,2024-07-08,17,6,1,7,EntPark1671_T,"-37.81996544, 144.95981454"
141720241218,141,2024-12-18,7,37,25,62,474Fl_T,"-37.81997273, 144.95834911"
49520240527,49,2024-05-27,5,17,36,53,Eli501_T,"-37.80730068, 144.95956055"
492320241015,49,2024-10-15,23,76,58,134,Eli501_T,"-37.80730068, 144.95956055"
1092320250529,109,2025-05-29,23,24,36,60,LatWill_T,"-37.81193681, 144.95621105"
1171720231208,117,2023-12-08,17,233,359,592,Fli114F_T,"-37.81629332, 144.97090877"
117520240412,117,2024-04-12,5,11,9,20,Fli114F_T,"-37.81629332, 144.97090877"
109120231210,109,2023-12-10,1,16,37,53,LatWill_T,"-37.81193681, 144.95621105"
1092120250411,109,2025-04-11,21,74,120,194,LatWill_T,"-37.81193681, 144.95621105"
191420241112,19,2024-11-12,14,370,459,829,LtB210_T,"-37.81237202, 144.96550671"
1391020250614,139,2025-06-14,10,32,33,65,Signal1647_T,"-37.81959923, 144.9632832"
84620240525,84,2024-05-25,6,66,46,112,ElFi_T,"-37.81798049, 144.96503383"
41020231230,4,2023-12-30,10,1020,489,1509,Swa123_T,"-37.81487988, 144.9660878"
41520250320,4,2025-03-20,15,1554,1390,2944,Swa123_T,"-37.81487988, 144.9660878"
75720250820,75,2025-08-20,7,41,37,78,SprFli_T,"-37.81515276, 144.97467661"
75720250906,75,2025-09-06,7,15,23,38,SprFli_T,"-37.81515276, 144.97467661"
75320250927,75,2025-09-27,3,1,1,2,SprFli_T,"-37.81515276, 144.97467661"
41220241202,41,2024-12-02,2,47,41,88,Swa31,"-37.81668634, 144.96689733"
771720231202,77,2023-12-02,17,243,103,346,HarEsP_T,"-37.81441438, 144.94433026"
772220250921,77,2025-09-21,22,26,15,41,HarEsP_T,"-37.81441438, 144.94433026"
59320250102,59,2025-01-02,3,5,4,9,RMIT_T,"-37.80825648, 144.96304859"
711020241106,71,2024-11-06,10,30,29,59,WestWP_T,"-37.81235775, 144.97136962"
28920231023,28,2023-10-23,9,355,251,606,VAC_T,"-37.82129925, 144.96879309"
371320240627,37,2024-06-27,13,134,196,330,Lyg260_T,"-37.80107122, 144.96704554"
37220240629,37,2024-06-29,2,2,6,8,Lyg260_T,"-37.80107122, 144.96704554"
451520240720,45,2024-07-20,15,532,855,1387,Swa148_T,"-37.81414075, 144.96609379"
45020241112,45,2024-11-12,0,9,59,68,Swa148_T,"-37.81414075, 144.96609379"
211720250407,21,2025-04-07,17,430,360,790,Bourke155_T,"-37.81267313, 144.96788288"
107220240731,107,2024-07-31,2,7,8,15,280Will_T,"-37.81246271, 144.95690188"
133920250510,133,2025-05-10,9,269,329,598,Spen229_T,"-37.81531435, 144.95227769"
1662020241224,166,2024-12-24,20,18,20,38,Spen484_T,"-37.80896733, 144.94931703"
1652320250425,165,2025-04-25,23,3,4,7,Spen475_T,"-37.80953359, 144.94939004"
1651420250515,165,2025-05-15,14,26,26,52,Spen475_T,"-37.80953359, 144.94939004"
1431420240827,143,2024-08-27,14,144,168,312,Spencer_T,"-37.821728, 144.95557015"
134920250102,134,2025-01-02,9,279,338,617,Spen201_T,"-37.81694221, 144.95303935"
632220250718,63,2025-07-18,22,70,302,372,Bou231_T,"-37.81333081, 144.96675571"
122020240729,12,2024-07-29,20,101,102,203,NewQ_T,"-37.81457988, 144.94292398"
621520250514,62,2025-05-14,15,278,159,437,Lat224_T,"-37.80996494, 144.96216521"
111120240224,11,2024-02-24,11,138,140,278,WatCit_T,"-37.81564989, 144.93970694"
111020240317,11,2024-03-17,10,119,169,288,WatCit_T,"-37.81564989, 144.93970694"
112320241128,11,2024-11-28,23,41,32,73,WatCit_T,"-37.81564989, 144.93970694"
101120240701,10,2024-07-01,11,51,48,99,BouHbr_T,"-37.81876474, 144.94710545"
102020231103,10,2023-11-03,20,40,26,66,BouHbr_T,"-37.81876474, 144.94710545"
721020231022,72,2023-10-22,10,155,124,279,ACMI_T,"-37.81726338, 144.96872809"
242020250216,24,2025-02-16,20,357,295,652,Col620_T,"-37.81887963, 144.95449198"
721620240401,72,2024-04-01,16,153,346,499,ACMI_T,"-37.81726338, 144.96872809"
761420250723,76,2025-07-23,14,47,51,98,KenMac_T,"-37.79453803, 144.93036194"
9520240928,9,2024-09-28,5,6,4,10,Col700_T,"-37.81982992, 144.95102555"
53120241028,53,2024-10-28,1,6,11,17,Col254_T,"-37.81564191, 144.965499"
791420250531,79,2025-05-31,14,599,444,1043,FliSS_T,"-37.81794046, 144.96616678"
48820250403,48,2025-04-03,8,155,112,267,QVMQ_T,"-37.80631581, 144.95866697"
30320250624,30,2025-06-24,3,7,13,20,Lon189_T,"-37.8112185, 144.96656806"
1411820240911,141,2024-09-11,18,171,103,274,474Fl_T,"-37.81997273, 144.95834911"
1411420250328,141,2025-03-28,14,146,94,240,474Fl_T,"-37.81997273, 144.95834911"
1391820250525,139,2025-05-25,18,21,33,54,Signal1647_T,"-37.81959923, 144.9632832"
1361020241124,136,2024-11-24,10,16,9,25,BirFed1120_T,"-37.8184141, 144.97357915"
1642320241115,164,2024-11-15,23,29,38,67,Lat526_T,"-37.813005, 144.95160411"
118920241213,118,2024-12-13,9,17,9,26,Fli114C_T,"-37.81632783, 144.97090512"
871720250330,87,2025-03-30,17,92,81,173,Errol23_T,"-37.80454949, 144.94921863"
1792220250525,179,2025-05-25,22,31,25,56,Pow61_T,"-37.82392385, 144.96299677"
66920240917,66,2024-09-17,9,361,486,847,QVN_T,"-37.81057846, 144.96444294"
69620241028,69,2024-10-28,6,17,7,24,FLDegC_T,"-37.81687226, 144.96559144"
6020231212,6,2023-12-12,0,155,58,213,FliS_T,"-37.81911705, 144.96558255"
62320240228,6,2024-02-28,23,325,172,497,FliS_T,"-37.81911705, 144.96558255"
62120240930,6,2024-09-30,21,451,397,848,FliS_T,"-37.81911705, 144.96558255"
41120240120,4,2024-01-20,11,1801,1158,2959,Swa123_T,"-37.81487988, 144.9660878"
4620240605,4,2024-06-05,6,194,41,235,Swa123_T,"-37.81487988, 144.9660878"
70020240427,70,2024-04-27,0,5,1,6,Errol20_T,"-37.80456984, 144.94946228"
31120240527,3,2024-05-27,11,655,664,1319,Swa295_T,"-37.81101524, 144.96429485"
32320250318,3,2025-03-18,23,278,174,452,Swa295_T,"-37.81101524, 144.96429485"
392320240308,39,2024-03-08,23,34,50,84,AlfPl_T,"-37.81379749, 144.96995745"
751920231127,75,2023-11-27,19,28,66,94,SprFli_T,"-37.81515276, 144.97467661"
41520241204,41,2024-12-04,5,163,133,296,Swa31,"-37.81668634, 144.96689733"
592220250703,59,2025-07-03,22,254,134,388,RMIT_T,"-37.80825648, 144.96304859"
42220241030,42,2024-10-30,2,3,2,5,UM1_T,"-37.80008566, 144.96386412"
361020240822,36,2024-08-22,10,153,187,340,Que85_T,"-37.81652527, 144.96121062"
441920231125,44,2023-11-25,19,4,6,10,UM3_T,"-37.79698741, 144.96441306"
451420250108,45,2025-01-08,14,478,800,1278,Swa148_T,"-37.81414075, 144.96609379"
37520251002,37,2025-10-02,5,0,3,3,Lyg260_T,"-37.80107122, 144.96704554"
1431820250902,143,2025-09-02,18,158,178,336,Spencer_T,"-37.821728, 144.95557015"
1321220231116,132,2023-11-16,12,150,120,270,King335_T,"-37.81267639, 144.95386444"
1352020240627,135,2024-06-27,20,99,131,230,Spen161_T,"-37.8172861, 144.95319102"
67320240914,67,2024-09-14,3,10,40,50,FLDegS_T,"-37.81688755, 144.96562569"
671320240914,67,2024-09-14,13,392,587,979,FLDegS_T,"-37.81688755, 144.96562569"
181420241225,18,2024-12-25,14,37,20,57,Col12_T,"-37.81344862, 144.97305353"
631220240202,63,2024-02-02,12,327,395,722,Bou231_T,"-37.81333081, 144.96675571"
111820231211,11,2023-12-11,18,113,107,220,WatCit_T,"-37.81564989, 144.93970694"
24320240329,24,2024-03-29,3,39,74,113,Col620_T,"-37.81887963, 144.95449198"
352120231107,35,2023-11-07,21,421,795,1216,SouthB_T,"-37.82018685, 144.96508508"
762120240117,76,2024-01-17,21,10,17,27,KenMac_T,"-37.79453803, 144.93036194"
581320250506,58,2025-05-06,13,803,516,1319,Bou688_T,"-37.81686075, 144.95358075"
56820251016,56,2025-10-16,8,131,180,311,Lon364_T,"-37.81234775, 144.96153311"
272120241114,27,2024-11-14,21,116,43,159,Vic_T,"-37.80606888, 144.95644692"
531720250419,53,2025-04-19,17,667,485,1152,Col254_T,"-37.81564191, 144.965499"
27220250404,27,2025-04-04,2,1,1,2,Vic_T,"-37.80606888, 144.95644692"
461020250522,46,2025-05-22,10,115,66,181,Pel147_T,"-37.80240719, 144.9615673"
511420240329,51,2024-03-29,14,76,100,176,Fra118_T,"-37.80841815, 144.95906316"
252120250728,25,2025-07-28,21,91,114,205,MCEC_T,"-37.82401776, 144.95604426"
20920240823,20,2024-08-23,9,48,75,123,LtB170_T,"-37.81172914, 144.9682466"
201420240413,20,2024-04-13,14,270,460,730,LtB170_T,"-37.81172914, 144.9682466"
142820250726,142,2025-07-26,8,228,180,408,Hammer1584_T,"-37.81970749, 144.96795734"
1611020250207,161,2025-02-07,10,84,73,157,BirArt1109_T,"-37.81851276, 144.97131336"
1171920250708,117,2025-07-08,19,77,82,159,Fli114F_T,"-37.81629332, 144.97090877"
123720250421,123,2025-04-21,7,11,24,35,BirBridge_T,"-37.81753741, 144.97329734"
141320240420,141,2024-04-20,3,52,24,76,474Fl_T,"-37.81997273, 144.95834911"
1091220240823,109,2024-08-23,12,201,202,403,LatWill_T,"-37.81193681, 144.95621105"
109020240916,109,2024-09-16,0,14,12,26,LatWill_T,"-37.81193681, 144.95621105"
491120250922,49,2025-09-22,11,233,271,504,Eli501_T,"-37.80730068, 144.95956055"
19920241229,19,2024-12-29,9,63,98,161,LtB210_T,"-37.81237202, 144.96550671"
1392320250728,139,2025-07-28,23,2,1,3,Signal1647_T,"-37.81959923, 144.9632832"
1392220251012,139,2025-10-12,22,6,5,11,Signal1647_T,"-37.81959923, 144.9632832"
661520250307,66,2025-03-07,15,1267,1594,2861,QVN_T,"-37.81057846, 144.96444294"
691020250911,69,2025-09-11,10,264,137,401,FLDegC_T,"-37.81687226, 144.96559144"
6220231215,6,2023-12-15,2,46,51,97,FliS_T,"-37.81911705, 144.96558255"
6520250221,6,2025-02-21,5,86,91,177,FliS_T,"-37.81911705, 144.96558255"
61820250601,6,2025-06-01,18,672,577,1249,FliS_T,"-37.81911705, 144.96558255"
61820250618,6,2025-06-18,18,1069,741,1810,FliS_T,"-37.81911705, 144.96558255"
61820250911,6,2025-09-11,18,1312,892,2204,FliS_T,"-37.81911705, 144.96558255"
391620241116,39,2024-11-16,16,88,73,161,AlfPl_T,"-37.81379749, 144.96995745"
392220241225,39,2024-12-25,22,3,0,3,AlfPl_T,"-37.81379749, 144.96995745"
8320241031,8,2024-10-31,3,0,1,1,WebBN_T,"-37.82293543, 144.9471751"
82020241214,8,2024-12-14,20,101,139,240,WebBN_T,"-37.82293543, 144.9471751"
411120250530,41,2025-05-30,11,1115,770,1885,Swa31,"-37.81668634, 144.96689733"
142320231207,14,2023-12-07,23,347,71,418,SanBri_T,"-37.82011242, 144.96291897"
59120241204,59,2024-12-04,1,15,7,22,RMIT_T,"-37.80825648, 144.96304859"
711020241229,71,2024-12-29,10,9,5,14,WestWP_T,"-37.81235775, 144.97136962"
651920240126,65,2024-01-26,19,627,682,1309,SwaCs_T,"-37.81569416, 144.9668064"
772220251008,77,2025-10-08,22,92,57,149,HarEsP_T,"-37.81441438, 144.94433026"
42120250417,42,2025-04-17,1,36,15,51,UM1_T,"-37.80008566, 144.96386412"
541120231222,54,2023-12-22,11,55,69,124,Swa607_T,"-37.804024, 144.96308399"
47020240704,47,2024-07-04,0,58,40,98,Eli250_T,"-37.81258467, 144.9625775"
107920240608,107,2024-06-08,9,49,71,120,280Will_T,"-37.81246271, 144.95690188"
68720250426,68,2025-04-26,7,39,37,76,FLDegN_T,"-37.8168479, 144.96559789"
682220250814,68,2025-08-14,22,37,41,78,FLDegN_T,"-37.8168479, 144.96559789"
11120250612,1,2025-06-12,11,688,698,1386,Bou292_T,"-37.81349441, 144.96515323"
18220250208,18,2025-02-08,2,2,3,5,Col12_T,"-37.81344862, 144.97305353"
181320250907,18,2025-09-07,13,58,55,113,Col12_T,"-37.81344862, 144.97305353"
631920231120,63,2023-11-20,19,187,224,411,Bou231_T,"-37.81333081, 144.96675571"
122120240427,12,2024-04-27,21,191,209,400,NewQ_T,"-37.81457988, 144.94292398"
111620241227,11,2024-12-27,16,127,106,233,WatCit_T,"-37.81564989, 144.93970694"
722120241019,72,2024-10-19,21,183,151,334,ACMI_T,"-37.81726338, 144.96872809"
581220231209,58,2023-12-09,12,718,226,944,Bou688_T,"-37.81686075, 144.95358075"
271420240612,27,2024-06-12,14,97,107,204,Vic_T,"-37.80606888, 144.95644692"
531120241220,53,2024-12-20,11,787,588,1375,Col254_T,"-37.81564191, 144.965499"
53420231129,53,2023-11-29,4,4,3,7,Col254_T,"-37.81564191, 144.965499"
791320240320,79,2024-03-20,13,604,479,1083,FliSS_T,"-37.81794046, 144.96616678"
521120240126,52,2024-01-26,11,264,162,426,Eli263_T,"-37.81252157, 144.9619401"
51720250716,51,2025-07-16,7,26,19,45,Fra118_T,"-37.80841815, 144.95906316"
191520240108,19,2024-01-08,15,372,341,713,LtB210_T,"-37.81237202, 144.96550671"
481220250410,48,2025-04-10,12,444,378,822,QVMQ_T,"-37.80631581, 144.95866697"
301020250907,30,2025-09-07,10,89,223,312,Lon189_T,"-37.8112185, 144.96656806"
136620240711,136,2024-07-11,6,1,2,3,BirFed1120_T,"-37.8184141, 144.97357915"
130820240210,130,2024-02-10,8,29,7,36,Bou892T,"-37.8204637, 144.94126826"
1381720241206,138,2024-12-06,17,6,3,9,EntPark1671_T,"-37.81996544, 144.95981454"
1381320250814,138,2025-08-14,13,15,6,21,EntPark1671_T,"-37.81996544, 144.95981454"
1172120250819,117,2025-08-19,21,63,41,104,Fli114F_T,"-37.81629332, 144.97090877"
1171420250413,117,2025-04-13,14,203,229,432,Fli114F_T,"-37.81629332, 144.97090877"
491120241120,49,2024-11-20,11,181,215,396,Eli501_T,"-37.80730068, 144.95956055"
66420240903,66,2024-09-03,4,12,6,18,QVN_T,"-37.81057846, 144.96444294"
691020240428,69,2024-04-28,10,246,122,368,FLDegC_T,"-37.81687226, 144.96559144"
42020241116,4,2024-11-16,20,1265,812,2077,Swa123_T,"-37.81487988, 144.9660878"
4920250603,4,2025-06-03,9,529,344,873,Swa123_T,"-37.81487988, 144.9660878"
701420240522,70,2024-05-22,14,154,146,300,Errol20_T,"-37.80456984, 144.94946228"
70320240628,70,2024-06-28,3,2,2,4,Errol20_T,"-37.80456984, 144.94946228"
3020240619,3,2024-06-19,0,156,106,262,Swa295_T,"-37.81101524, 144.96429485"
702320251014,70,2025-10-14,23,9,8,17,Errol20_T,"-37.80456984, 144.94946228"
8920250718,8,2025-07-18,9,146,146,292,WebBN_T,"-37.82293543, 144.9471751"
59420240925,59,2024-09-25,4,7,19,26,RMIT_T,"-37.80825648, 144.96304859"
71620240702,71,2024-07-02,6,5,11,16,WestWP_T,"-37.81235775, 144.97136962"
421920241014,42,2024-10-14,19,139,177,316,UM1_T,"-37.80008566, 144.96386412"
28720241124,28,2024-11-24,7,6,51,57,VAC_T,"-37.82129925, 144.96879309"
281420240205,28,2024-02-05,14,560,822,1382,VAC_T,"-37.82129925, 144.96879309"
29920240210,29,2024-02-10,9,129,173,302,AG_T,"-37.8199817, 144.96872865"
402020240102,40,2024-01-02,20,49,51,100,Spr201_T,"-37.80999341, 144.97227587"
541220250504,54,2025-05-04,12,142,132,274,Swa607_T,"-37.804024, 144.96308399"
541220240408,54,2024-04-08,12,230,208,438,Swa607_T,"-37.804024, 144.96308399"
362020250528,36,2025-05-28,20,63,75,138,Que85_T,"-37.81652527, 144.96121062"
37520250128,37,2025-01-28,5,1,4,5,Lyg260_T,"-37.80107122, 144.96704554"
371420250131,37,2025-01-31,14,80,80,160,Lyg260_T,"-37.80107122, 144.96704554"
61520250708,61,2025-07-08,5,3,5,8,RMIT14_T,"-37.80767455, 144.96309114"
40020240130,40,2024-01-30,0,11,1,12,Spr201_T,"-37.80999341, 144.97227587"
51520240817,5,2024-08-17,15,1620,1178,2798,PriNW_T,"-37.81874249, 144.96787656"
1071420240102,107,2024-01-02,14,77,116,193,280Will_T,"-37.81246271, 144.95690188"
107020250530,107,2025-05-30,0,15,11,26,280Will_T,"-37.81246271, 144.95690188"
1322020250509,132,2025-05-09,20,116,137,253,King335_T,"-37.81267639, 144.95386444"
1081220241229,108,2024-12-29,12,138,115,253,261Will_T,"-37.81295822, 144.95678789"
611320240331,61,2024-03-31,13,326,466,792,RMIT14_T,"-37.80767455, 144.96309114"
431120240916,43,2024-09-16,11,126,114,240,UM2_T,"-37.79844526, 144.96411782"
1671720250112,167,2025-01-12,17,25,17,42,Lat526_T,"-37.81304149, 144.95155955"
143820240822,143,2024-08-22,8,137,364,501,Spencer_T,"-37.821728, 144.95557015"
1401520240111,140,2024-01-11,15,75,63,138,Boyd2837_T,"-37.82590962, 144.96185972"
17820250531,17,2025-05-31,8,75,57,132,Col15_T,"-37.81362543, 144.97323591"
171320250606,17,2025-06-06,13,341,366,707,Col15_T,"-37.81362543, 144.97323591"
11020250117,1,2025-01-17,10,601,635,1236,Bou292_T,"-37.81349441, 144.96515323"
182320250424,18,2025-04-24,23,9,11,20,Col12_T,"-37.81344862, 144.97305353"
86020240527,86,2024-05-27,0,1,1,2,574Qub_T,"-37.80309992, 144.94908064"
111820240116,11,2024-01-16,18,139,87,226,WatCit_T,"-37.81564989, 144.93970694"
11920250121,11,2025-01-21,9,36,51,87,WatCit_T,"-37.81564989, 144.93970694"
241720240629,24,2024-06-29,17,793,628,1421,Col620_T,"-37.81887963, 144.95449198"
10420241004,10,2024-10-04,4,0,2,2,BouHbr_T,"-37.81876474, 144.94710545"
241920250512,24,2025-05-12,19,259,442,701,Col620_T,"-37.81887963, 144.95449198"
761320240328,76,2024-03-28,13,69,57,126,KenMac_T,"-37.79453803, 144.93036194"
72620231123,72,2023-11-23,6,80,47,127,ACMI_T,"-37.81726338, 144.96872809"
721920240127,72,2024-01-27,19,262,380,642,ACMI_T,"-37.81726338, 144.96872809"
351320240430,35,2024-04-30,13,912,1001,1913,SouthB_T,"-37.82018685, 144.96508508"
581420250207,58,2025-02-07,14,826,474,1300,Bou688_T,"-37.81686075, 144.95358075"
35220241215,35,2024-12-15,2,103,133,236,SouthB_T,"-37.82018685, 144.96508508"
27820240530,27,2024-05-30,8,70,104,174,Vic_T,"-37.80606888, 144.95644692"
51820241123,51,2024-11-23,8,47,46,93,Fra118_T,"-37.80841815, 144.95906316"
25020240202,25,2024-02-02,0,30,41,71,MCEC_T,"-37.82401776, 144.95604426"
481220231110,48,2023-11-10,12,317,235,552,QVMQ_T,"-37.80631581, 144.95866697"
142820250519,142,2025-05-19,8,197,312,509,Hammer1584_T,"-37.81970749, 144.96795734"
1641120250403,164,2025-04-03,11,139,58,197,Lat526_T,"-37.813005, 144.95160411"
164420240930,164,2024-09-30,4,2,0,2,Lat526_T,"-37.813005, 144.95160411"
49820250806,49,2025-08-06,8,100,197,297,Eli501_T,"-37.80730068, 144.95956055"
1231820240330,123,2024-03-30,18,32,1,33,BirBridge_T,"-37.81753741, 144.97329734"
109920250505,109,2025-05-05,9,105,317,422,LatWill_T,"-37.81193681, 144.95621105"
191320241115,19,2024-11-15,13,450,476,926,LtB210_T,"-37.81237202, 144.96550671"
1391720240911,139,2024-09-11,17,188,21,209,Signal1647_T,"-37.81959923, 144.9632832"
691920250214,69,2025-02-14,19,136,110,246,FLDegC_T,"-37.81687226, 144.96559144"
6120241117,6,2024-11-17,1,351,201,552,FliS_T,"-37.81911705, 144.96558255"
39720241130,39,2024-11-30,7,21,12,33,AlfPl_T,"-37.81379749, 144.96995745"
75620241215,75,2024-12-15,6,14,17,31,SprFli_T,"-37.81515276, 144.97467661"
412120250819,41,2025-08-19,21,430,1020,1450,Swa31,"-37.81668634, 144.96689733"
141020250417,14,2025-04-17,10,185,115,300,SanBri_T,"-37.82011242, 144.96291897"
591420240915,59,2024-09-15,14,140,327,467,RMIT_T,"-37.80825648, 144.96304859"
141520250424,14,2025-04-24,15,419,144,563,SanBri_T,"-37.82011242, 144.96291897"
401920240601,40,2024-06-01,19,108,161,269,Spr201_T,"-37.80999341, 144.97227587"
37120240508,37,2024-05-08,1,6,7,13,Lyg260_T,"-37.80107122, 144.96704554"
37520250906,37,2025-09-06,5,0,11,11,Lyg260_T,"-37.80107122, 144.96704554"
442120240731,44,2024-07-31,21,18,19,37,UM3_T,"-37.79698741, 144.96441306"
45220231107,45,2023-11-07,2,41,53,94,Swa148_T,"-37.81414075, 144.96609379"
51220250125,5,2025-01-25,12,1079,1670,2749,PriNW_T,"-37.81874249, 144.96787656"
1331220231226,133,2023-12-26,12,540,506,1046,Spen229_T,"-37.81531435, 144.95227769"
1331920250225,133,2025-02-25,19,596,408,1004,Spen229_T,"-37.81531435, 144.95227769"
87520240703,87,2024-07-03,5,1,1,2,Errol23_T,"-37.80454949, 144.94921863"
611520240328,61,2024-03-28,15,444,761,1205,RMIT14_T,"-37.80767455, 144.96309114"
501120240705,50,2024-07-05,11,145,189,334,Lyg309_T,"-37.79808192, 144.96721013"
431220250828,43,2025-08-28,12,315,481,796,UM2_T,"-37.79844526, 144.96411782"
431320250424,43,2025-04-24,13,91,72,163,UM2_T,"-37.79844526, 144.96411782"
1821820250612,182,2025-06-12,18,308,183,491,King163_T,"-37.81627451, 144.95550503"
1652020250725,165,2025-07-25,20,27,14,41,Spen475_T,"-37.80953359, 144.94939004"
1401720240904,140,2024-09-04,17,125,179,304,Boyd2837_T,"-37.82590962, 144.96185972"
1401820241110,140,2024-11-10,18,110,125,235,Boyd2837_T,"-37.82590962, 144.96185972"
1432320241001,143,2024-10-01,23,52,44,96,Spencer_T,"-37.821728, 144.95557015"
132820231028,132,2023-10-28,8,76,49,125,King335_T,"-37.81267639, 144.95386444"
562120250816,56,2025-08-16,21,365,379,744,Lon364_T,"-37.81234775, 144.96153311"
581620240221,58,2024-02-21,16,674,1165,1839,Bou688_T,"-37.81686075, 144.95358075"
351520241225,35,2024-12-25,15,1249,1589,2838,SouthB_T,"-37.82018685, 144.96508508"
2220250527,2,2025-05-27,2,4,3,7,Bou283_T,"-37.81380668, 144.96516718"
532220250708,53,2025-07-08,22,35,73,108,Col254_T,"-37.81564191, 144.965499"
531120240428,53,2024-04-28,11,594,484,1078,Col254_T,"-37.81564191, 144.965499"
9420241007,9,2024-10-07,4,11,3,14,Col700_T,"-37.81982992, 144.95102555"
92020241101,9,2024-11-01,20,91,51,142,Col700_T,"-37.81982992, 144.95102555"
791120250702,79,2025-07-02,11,311,233,544,FliSS_T,"-37.81794046, 144.96616678"
301820241016,30,2024-10-16,18,310,372,682,Lon189_T,"-37.8112185, 144.96656806"
51820240305,51,2024-03-05,8,85,55,140,Fra118_T,"-37.80841815, 144.95906316"
521720250825,52,2025-08-25,17,343,336,679,Eli263_T,"-37.81252157, 144.9619401"
136820250302,136,2025-03-02,8,144,124,268,BirFed1120_T,"-37.8184141, 144.97357915"
1231620250821,123,2025-08-21,16,60,49,109,BirBridge_T,"-37.81753741, 144.97329734"
1301720240714,130,2024-07-14,17,2,1,3,Bou892T,"-37.8204637, 144.94126826"
1641020241026,164,2024-10-26,10,127,19,146,Lat526_T,"-37.813005, 144.95160411"
138820240516,138,2024-05-16,8,9,7,16,EntPark1671_T,"-37.81996544, 144.95981454"
491120250311,49,2025-03-11,11,209,386,595,Eli501_T,"-37.80730068, 144.95956055"
1232020250608,123,2025-06-08,20,1,0,1,BirBridge_T,"-37.81753741, 144.97329734"
141820250505,141,2025-05-05,8,90,178,268,474Fl_T,"-37.81997273, 144.95834911"
1411120250918,141,2025-09-18,11,112,95,207,474Fl_T,"-37.81997273, 144.95834911"
491320241107,49,2024-11-07,13,436,658,1094,Eli501_T,"-37.80730068, 144.95956055"
481120250717,48,2025-07-17,11,310,208,518,QVMQ_T,"-37.80631581, 144.95866697"
1372020240514,137,2024-05-14,20,2,2,4,BouHbr2353_T,"-37.81894815, 144.94612292"
851420250929,85,2025-09-29,14,57,68,125,488Mac_T,"-37.79432415, 144.92973378"
681720240813,68,2024-08-13,17,176,63,239,FLDegN_T,"-37.8168479, 144.96559789"
182020240724,18,2024-07-24,20,0,1,1,Col12_T,"-37.81344862, 144.97305353"
63720240422,63,2024-04-22,7,79,68,147,Bou231_T,"-37.81333081, 144.96675571"
62420250311,62,2025-03-11,4,9,3,12,Lat224_T,"-37.80996494, 144.96216521"
24520240406,24,2024-04-06,5,37,44,81,Col620_T,"-37.81887963, 144.95449198"
242220241006,24,2024-10-06,22,331,374,705,Col620_T,"-37.81887963, 144.95449198"
111120250829,11,2025-08-29,11,33,49,82,WatCit_T,"-37.81564989, 144.93970694"
69020240927,69,2024-09-27,0,3,4,7,FLDegC_T,"-37.81687226, 144.96559144"
4920240220,4,2024-02-20,9,742,416,1158,Swa123_T,"-37.81487988, 144.9660878"
70020240522,70,2024-05-22,0,4,4,8,Errol20_T,"-37.80456984, 144.94946228"
70720250702,70,2025-07-02,7,30,26,56,Errol20_T,"-37.80456984, 144.94946228"
391020241021,39,2024-10-21,10,64,75,139,AlfPl_T,"-37.81379749, 144.96995745"
39220231224,39,2023-12-24,2,4,5,9,AlfPl_T,"-37.81379749, 144.96995745"
391820240309,39,2024-03-09,18,86,87,173,AlfPl_T,"-37.81379749, 144.96995745"
3920250716,3,2025-07-16,9,222,356,578,Swa295_T,"-37.81101524, 144.96429485"
82320241225,8,2024-12-25,23,31,14,45,WebBN_T,"-37.82293543, 144.9471751"
82220250706,8,2025-07-06,22,9,18,27,WebBN_T,"-37.82293543, 144.9471751"
8420241014,8,2024-10-14,4,1,0,1,WebBN_T,"-37.82293543, 144.9471751"
412320250521,41,2025-05-21,23,116,100,216,Swa31,"-37.81668634, 144.96689733"
59220241129,59,2024-11-29,2,19,9,28,RMIT_T,"-37.80825648, 144.96304859"
712120250128,71,2025-01-28,21,5,5,10,WestWP_T,"-37.81235775, 144.97136962"
59920240524,59,2024-05-24,9,1026,299,1325,RMIT_T,"-37.80825648, 144.96304859"
592120240728,59,2024-07-28,21,465,172,637,RMIT_T,"-37.80825648, 144.96304859"
291820250221,29,2025-02-21,18,387,346,733,AG_T,"-37.8199817, 144.96872865"
292120240303,29,2024-03-03,21,31,108,139,AG_T,"-37.8199817, 144.96872865"
311920250211,31,2025-02-11,19,162,145,307,Lyg161_T,"-37.80169681, 144.96658911"
371520240413,37,2024-04-13,15,159,125,284,Lyg260_T,"-37.80107122, 144.96704554"
432020240302,43,2024-03-02,20,49,55,104,UM2_T,"-37.79844526, 144.96411782"
51720250628,5,2025-06-28,17,1093,1234,2327,PriNW_T,"-37.81874249, 144.96787656"
5820240218,5,2024-02-18,8,208,173,381,PriNW_T,"-37.81874249, 144.96787656"
52320240228,5,2024-02-28,23,165,169,334,PriNW_T,"-37.81874249, 144.96787656"
21920240331,21,2024-03-31,9,118,78,196,Bourke155_T,"-37.81267313, 144.96788288"
133220250329,133,2025-03-29,2,32,13,45,Spen229_T,"-37.81531435, 144.95227769"
1181820240526,118,2024-05-26,18,8,6,14,Fli114C_T,"-37.81632783, 144.97090512"
501120241103,50,2024-11-03,11,192,232,424,Lyg309_T,"-37.79808192, 144.96721013"
441220250924,44,2025-09-24,12,135,101,236,UM3_T,"-37.79698741, 144.96441306"
1792020250903,179,2025-09-03,20,38,48,86,Pow61_T,"-37.82392385, 144.96299677"
166020250430,166,2025-04-30,0,3,0,3,Spen484_T,"-37.80896733, 144.94931703"
1431120240624,143,2024-06-24,11,138,205,343,Spencer_T,"-37.821728, 144.95557015"
131320241012,131,2024-10-12,3,16,73,89,King2_T,"-37.82009057, 144.95758725"
135720240514,135,2024-05-14,7,212,193,405,Spen161_T,"-37.8172861, 144.95319102"
1351720250205,135,2025-02-05,17,583,495,1078,Spen161_T,"-37.8172861, 144.95319102"
1351720250518,135,2025-05-18,17,358,350,708,Spen161_T,"-37.8172861, 144.95319102"
85620240518,85,2024-05-18,6,7,3,10,488Mac_T,"-37.79432415, 144.92973378"
852220250620,85,2025-06-20,22,7,13,20,488Mac_T,"-37.79432415, 144.92973378"
17320240219,17,2024-02-19,3,5,5,10,Col15_T,"-37.81362543, 144.97323591"
17920250211,17,2025-02-11,9,798,260,1058,Col15_T,"-37.81362543, 144.97323591"
12120250830,1,2025-08-30,21,424,322,746,Bou292_T,"-37.81349441, 144.96515323"
67320250813,67,2025-08-13,3,1,1,2,FLDegS_T,"-37.81688755, 144.96562569"
621820250110,62,2025-01-10,18,162,112,274,Lat224_T,"-37.80996494, 144.96216521"
24420250223,24,2025-02-23,4,24,34,58,Col620_T,"-37.81887963, 144.95449198"
722020250111,72,2025-01-11,20,125,257,382,ACMI_T,"-37.81726338, 144.96872809"
35620250409,35,2025-04-09,6,331,378,709,SouthB_T,"-37.82018685, 144.96508508"
23520250312,23,2025-03-12,5,24,23,47,Col623_T,"-37.81909256, 144.95452748"
791120250303,79,2025-03-03,11,485,312,797,FliSS_T,"-37.81794046, 144.96616678"
46020240707,46,2024-07-07,0,4,11,15,Pel147_T,"-37.80240719, 144.9615673"
462120231118,46,2023-11-18,21,23,57,80,Pel147_T,"-37.80240719, 144.9615673"
23420250701,23,2025-07-01,4,0,2,2,Col623_T,"-37.81909256, 144.95452748"
25420241018,25,2024-10-18,4,11,12,23,MCEC_T,"-37.82401776, 144.95604426"
20920240124,20,2024-01-24,9,84,69,153,LtB170_T,"-37.81172914, 144.9682466"
201920240401,20,2024-04-01,19,299,381,680,LtB170_T,"-37.81172914, 144.9682466"
1361420250201,136,2025-02-01,14,320,56,376,BirFed1120_T,"-37.8184141, 144.97357915"
1361720250321,136,2025-03-21,17,884,82,966,BirFed1120_T,"-37.8184141, 144.97357915"
1301020241216,130,2024-12-16,10,34,21,55,Bou892T,"-37.8204637, 144.94126826"
1381720250117,138,2025-01-17,17,16,6,22,EntPark1671_T,"-37.81996544, 144.95981454"
138620250503,138,2025-05-03,6,2,0,2,EntPark1671_T,"-37.81996544, 144.95981454"
123020240414,123,2024-04-14,0,1,0,1,BirBridge_T,"-37.81753741, 144.97329734"
109620240419,109,2024-04-19,6,16,68,84,LatWill_T,"-37.81193681, 144.95621105"
19820240622,19,2024-06-22,8,35,40,75,LtB210_T,"-37.81237202, 144.96550671"
1802120250721,180,2025-07-21,21,1,1,2,Mac330_T,"-37.79497059, 144.93530329"
137120250308,137,2025-03-08,1,0,1,1,BouHbr2353_T,"-37.81894815, 144.94612292"
662320231020,66,2023-10-20,23,450,397,847,QVN_T,"-37.81057846, 144.96444294"
62120231129,6,2023-11-29,21,858,696,1554,FliS_T,"-37.81911705, 144.96558255"
84620240923,84,2024-09-23,6,339,117,456,ElFi_T,"-37.81798049, 144.96503383"
41920240310,4,2024-03-10,19,1014,1015,2029,Swa123_T,"-37.81487988, 144.9660878"
32320240429,3,2024-04-29,23,297,222,519,Swa295_T,"-37.81101524, 144.96429485"
75120240321,75,2024-03-21,1,0,3,3,SprFli_T,"-37.81515276, 144.97467661"
75920240427,75,2024-04-27,9,38,27,65,SprFli_T,"-37.81515276, 144.97467661"
81320231116,8,2023-11-16,13,241,283,524,WebBN_T,"-37.82293543, 144.9471751"
81020240603,8,2024-06-03,10,92,111,203,WebBN_T,"-37.82293543, 144.9471751"
751720240831,75,2024-08-31,17,42,28,70,SprFli_T,"-37.81515276, 144.97467661"
751720250521,75,2025-05-21,17,73,76,149,SprFli_T,"-37.81515276, 144.97467661"
771720231219,77,2023-12-19,17,275,185,460,HarEsP_T,"-37.81441438, 144.94433026"
78020240112,78,2024-01-12,0,3,7,10,HarEsB_T,"-37.81471642, 144.9446508"
782320250126,78,2025-01-26,23,7,29,36,HarEsB_T,"-37.81471642, 144.9446508"
42220250901,42,2025-09-01,2,2,0,2,UM1_T,"-37.80008566, 144.96386412"
292220251002,29,2025-10-02,22,22,50,72,AG_T,"-37.8199817, 144.96872865"
311520240601,31,2024-06-01,15,235,220,455,Lyg161_T,"-37.80169681, 144.96658911"
361020250711,36,2025-07-11,10,205,141,346,Que85_T,"-37.81652527, 144.96121062"
362120240703,36,2024-07-03,21,74,91,165,Que85_T,"-37.81652527, 144.96121062"
37720250813,37,2025-08-13,7,8,16,24,Lyg260_T,"-37.80107122, 144.96704554"
107720250503,107,2025-05-03,7,25,33,58,280Will_T,"-37.81246271, 144.95690188"
1331020231128,133,2023-11-28,10,387,394,781,Spen229_T,"-37.81531435, 144.95227769"
1332220240618,133,2024-06-18,22,167,147,314,Spen229_T,"-37.81531435, 144.95227769"
1181020240224,118,2024-02-24,10,1,31,32,Fli114C_T,"-37.81632783, 144.97090512"
871320250414,87,2025-04-14,13,116,155,271,Errol23_T,"-37.80454949, 144.94921863"
441220250405,44,2025-04-05,12,57,49,106,UM3_T,"-37.79698741, 144.96441306"
50520231025,50,2023-10-25,5,5,6,11,Lyg309_T,"-37.79808192, 144.96721013"
432120241206,43,2024-12-06,21,10,27,37,UM2_T,"-37.79844526, 144.96411782"
431520250402,43,2025-04-02,15,264,380,644,UM2_T,"-37.79844526, 144.96411782"
1311720241126,131,2024-11-26,17,116,176,292,King2_T,"-37.82009057, 144.95758725"
140620240421,140,2024-04-21,6,3,1,4,Boyd2837_T,"-37.82590962, 144.96185972"
1401120250921,140,2025-09-21,11,157,68,225,Boyd2837_T,"-37.82590962, 144.96185972"
1431320240621,143,2024-06-21,13,269,299,568,Spencer_T,"-37.821728, 144.95557015"
132020240526,132,2024-05-26,0,62,48,110,King335_T,"-37.81267639, 144.95386444"
1321820240909,132,2024-09-09,18,188,196,384,King335_T,"-37.81267639, 144.95386444"
1311920250427,131,2025-04-27,19,79,58,137,King2_T,"-37.82009057, 144.95758725"
1341120251004,134,2025-10-04,11,396,451,847,Spen201_T,"-37.81694221, 144.95303935"
1341020240601,134,2024-06-01,10,285,303,588,Spen201_T,"-37.81694221, 144.95303935"
131820240321,131,2024-03-21,8,203,81,284,King2_T,"-37.82009057, 144.95758725"
1351120250529,135,2025-05-29,11,264,325,589,Spen161_T,"-37.8172861, 144.95319102"
431820240227,43,2024-02-27,18,270,518,788,UM2_T,"-37.79844526, 144.96411782"
451020231119,45,2023-11-19,10,295,225,520,Swa148_T,"-37.81414075, 144.96609379"
5620241225,5,2024-12-25,6,48,40,88,PriNW_T,"-37.81874249, 144.96787656"
131220250625,131,2025-06-25,2,11,12,23,King2_T,"-37.82009057, 144.95758725"
1311220250710,131,2025-07-10,12,169,201,370,King2_T,"-37.82009057, 144.95758725"
132620240626,132,2024-06-26,6,18,12,30,King335_T,"-37.81267639, 144.95386444"
132220241002,132,2024-10-02,2,7,8,15,King335_T,"-37.81267639, 144.95386444"
1342020250419,134,2025-04-19,20,361,285,646,Spen201_T,"-37.81694221, 144.95303935"
134220240606,134,2024-06-06,2,11,18,29,Spen201_T,"-37.81694221, 144.95303935"
131320231124,131,2023-11-24,3,8,11,19,King2_T,"-37.82009057, 144.95758725"
133720240411,133,2024-04-11,7,714,396,1110,Spen229_T,"-37.81531435, 144.95227769"
1332320250526,133,2025-05-26,23,62,46,108,Spen229_T,"-37.81531435, 144.95227769"
118920250625,118,2025-06-25,9,28,8,36,Fli114C_T,"-37.81632783, 144.97090512"
1661420250430,166,2025-04-30,14,58,60,118,Spen484_T,"-37.80896733, 144.94931703"
681120250208,68,2025-02-08,11,379,385,764,FLDegN_T,"-37.8168479, 144.96559789"
111920240124,11,2024-01-24,19,202,180,382,WatCit_T,"-37.81564989, 144.93970694"
101920240531,10,2024-05-31,19,99,59,158,BouHbr_T,"-37.81876474, 144.94710545"
21520240925,2,2024-09-25,15,636,671,1307,Bou283_T,"-37.81380668, 144.96516718"
21720241112,2,2024-11-12,17,428,444,872,Bou283_T,"-37.81380668, 144.96516718"
2620250216,2,2025-02-16,6,2,12,14,Bou283_T,"-37.81380668, 144.96516718"
92220240930,9,2024-09-30,22,49,24,73,Col700_T,"-37.81982992, 144.95102555"
53420240205,53,2024-02-05,4,3,4,7,Col254_T,"-37.81564191, 144.965499"
91720250321,9,2025-03-21,17,1394,126,1520,Col700_T,"-37.81982992, 144.95102555"
791620240921,79,2024-09-21,16,969,538,1507,FliSS_T,"-37.81794046, 144.96616678"
521320240123,52,2024-01-23,13,398,385,783,Eli263_T,"-37.81252157, 144.9619401"
191420240111,19,2024-01-11,14,442,548,990,LtB210_T,"-37.81237202, 144.96550671"
202120231101,20,2023-11-01,21,115,235,350,LtB170_T,"-37.81172914, 144.9682466"
164320250529,164,2025-05-29,3,1,2,3,Lat526_T,"-37.813005, 144.95160411"
1641020250811,164,2025-08-11,10,131,42,173,Lat526_T,"-37.813005, 144.95160411"
1801920251013,180,2025-10-13,19,24,38,62,Mac330_T,"-37.79497059, 144.93530329"
19620250929,19,2025-09-29,6,34,11,45,LtB210_T,"-37.81237202, 144.96550671"
161020250323,161,2025-03-23,0,0,1,1,BirArt1109_T,"-37.81851276, 144.97131336"
1611020240909,161,2024-09-09,10,114,160,274,BirArt1109_T,"-37.81851276, 144.97131336"
123920250110,123,2025-01-10,9,19,14,33,BirBridge_T,"-37.81753741, 144.97329734"
1382120231210,138,2023-12-10,21,1,0,1,EntPark1671_T,"-37.81996544, 144.95981454"
1171420250915,117,2025-09-15,14,106,143,249,Fli114F_T,"-37.81629332, 144.97090877"
63620240920,63,2024-09-20,6,30,37,67,Bou231_T,"-37.81333081, 144.96675571"
67920240512,67,2024-05-12,9,235,242,477,FLDegS_T,"-37.81688755, 144.96562569"
66320240822,66,2024-08-22,3,9,3,12,QVN_T,"-37.81057846, 144.96444294"
69220240321,69,2024-03-21,2,1,1,2,FLDegC_T,"-37.81687226, 144.96559144"
842220240907,84,2024-09-07,22,663,655,1318,ElFi_T,"-37.81798049, 144.96503383"
4720250307,4,2025-03-07,7,280,203,483,Swa123_T,"-37.81487988, 144.9660878"
31820241215,3,2024-12-15,18,847,1022,1869,Swa295_T,"-37.81101524, 144.96429485"
82320240501,8,2024-05-01,23,6,6,12,WebBN_T,"-37.82293543, 144.9471751"
771920231204,77,2023-12-04,19,169,99,268,HarEsP_T,"-37.81441438, 144.94433026"
772320241217,77,2024-12-17,23,30,26,56,HarEsP_T,"-37.81441438, 144.94433026"
59520240105,59,2024-01-05,5,9,32,41,RMIT_T,"-37.80825648, 144.96304859"
711120240121,71,2024-01-21,11,2,5,7,WestWP_T,"-37.81235775, 144.97136962"
71320240501,71,2024-05-01,3,1,1,2,WestWP_T,"-37.81235775, 144.97136962"
124720250326,124,2025-03-26,7,1,1,2,BirBridge_T,"-37.81757416, 144.97329934"
67120231201,67,2023-12-01,1,15,10,25,FLDegS_T,"-37.81688755, 144.96562569"
681120240630,68,2024-06-30,11,241,179,420,FLDegN_T,"-37.8168479, 144.96559789"
17520241224,17,2024-12-24,5,15,10,25,Col15_T,"-37.81362543, 144.97323591"
1620231228,1,2023-12-28,6,20,46,66,Bou292_T,"-37.81349441, 144.96515323"
18220250306,18,2025-03-06,2,1,2,3,Col12_T,"-37.81344862, 144.97305353"
631920250402,63,2025-04-02,19,307,470,777,Bou231_T,"-37.81333081, 144.96675571"
851720240412,85,2024-04-12,17,101,125,226,488Mac_T,"-37.79432415, 144.92973378"
17320231230,17,2023-12-30,3,9,9,18,Col15_T,"-37.81362543, 144.97323591"
172020250207,17,2025-02-07,20,151,128,279,Col15_T,"-37.81362543, 144.97323591"
17920250409,17,2025-04-09,9,609,256,865,Col15_T,"-37.81362543, 144.97323591"
172220250621,17,2025-06-21,22,49,54,103,Col15_T,"-37.81362543, 144.97323591"
11620250212,1,2025-02-12,16,1077,874,1951,Bou292_T,"-37.81349441, 144.96515323"
631520240609,63,2024-06-09,15,487,719,1206,Bou231_T,"-37.81333081, 144.96675571"
86820240208,86,2024-02-08,8,56,30,86,574Qub_T,"-37.80309992, 144.94908064"
861020241226,86,2024-12-26,10,29,22,51,574Qub_T,"-37.80309992, 144.94908064"
241520231211,24,2023-12-11,15,403,1014,1417,Col620_T,"-37.81887963, 144.95449198"
561220250508,56,2025-05-08,12,452,356,808,Lon364_T,"-37.81234775, 144.96153311"
241820250103,24,2025-01-03,18,438,596,1034,Col620_T,"-37.81887963, 144.95449198"
10220250529,10,2025-05-29,2,1,3,4,BouHbr_T,"-37.81876474, 144.94710545"
582020250402,58,2025-04-02,20,233,229,462,Bou688_T,"-37.81686075, 144.95358075"
58220250715,58,2025-07-15,2,12,16,28,Bou688_T,"-37.81686075, 144.95358075"
2020250815,2,2025-08-15,0,14,20,34,Bou283_T,"-37.81380668, 144.96516718"
53820240130,53,2024-01-30,8,356,264,620,Col254_T,"-37.81564191, 144.965499"
301520240531,30,2024-05-31,15,225,367,592,Lon189_T,"-37.8112185, 144.96656806"
301820241007,30,2024-10-07,18,234,307,541,Lon189_T,"-37.8112185, 144.96656806"
79220241122,79,2024-11-22,2,40,27,67,FliSS_T,"-37.81794046, 144.96616678"
51220231119,51,2023-11-19,2,16,8,24,Fra118_T,"-37.80841815, 144.95906316"
23520240622,23,2024-06-22,5,6,29,35,Col623_T,"-37.81909256, 144.95452748"
201320250205,20,2025-02-05,13,238,287,525,LtB170_T,"-37.81172914, 144.9682466"
20520250711,20,2025-07-11,5,2,3,5,LtB170_T,"-37.81172914, 144.9682466"
46820250911,46,2025-09-11,8,162,42,204,Pel147_T,"-37.80240719, 144.9615673"
1411320240917,141,2024-09-17,13,198,138,336,474Fl_T,"-37.81997273, 144.95834911"
1411920240928,141,2024-09-28,19,116,216,332,474Fl_T,"-37.81997273, 144.95834911"
491920240630,49,2024-06-30,19,186,154,340,Eli501_T,"-37.80730068, 144.95956055"
1091220231204,109,2023-12-04,12,231,169,400,LatWill_T,"-37.81193681, 144.95621105"
481620250110,48,2025-01-10,16,136,136,272,QVMQ_T,"-37.80631581, 144.95866697"
48720240908,48,2024-09-08,7,47,50,97,QVMQ_T,"-37.80631581, 144.95866697"
1801120250710,180,2025-07-10,11,19,15,34,Mac330_T,"-37.79497059, 144.93530329"
180120250412,180,2025-04-12,1,0,2,2,Mac330_T,"-37.79497059, 144.93530329"
1371720250327,137,2025-03-27,17,19,242,261,BouHbr2353_T,"-37.81894815, 144.94612292"
1371120240726,137,2024-07-26,11,23,41,64,BouHbr2353_T,"-37.81894815, 144.94612292"
139420250310,139,2025-03-10,4,5,2,7,Signal1647_T,"-37.81959923, 144.9632832"
1301320241011,130,2024-10-11,13,67,41,108,Bou892T,"-37.8204637, 144.94126826"
6620240429,6,2024-04-29,6,217,303,520,FliS_T,"-37.81911705, 144.96558255"
6520250601,6,2025-06-01,5,40,68,108,FliS_T,"-37.81911705, 144.96558255"
781820240512,78,2024-05-12,18,3,14,17,HarEsB_T,"-37.81471642, 144.9446508"
781820240910,78,2024-09-10,18,12,44,56,HarEsB_T,"-37.81471642, 144.9446508"
59320250629,59,2025-06-29,3,79,15,94,RMIT_T,"-37.80825648, 144.96304859"
42720250327,42,2025-03-27,7,65,82,147,UM1_T,"-37.80008566, 144.96386412"
141420251012,14,2025-10-12,14,428,156,584,SanBri_T,"-37.82011242, 144.96291897"
47020240204,47,2024-02-04,0,162,205,367,Eli250_T,"-37.81258467, 144.9625775"
431220250923,43,2025-09-23,12,316,384,700,UM2_T,"-37.79844526, 144.96411782"
44020240328,44,2024-03-28,0,29,2,31,UM3_T,"-37.79698741, 144.96441306"
451120240703,45,2024-07-03,11,653,464,1117,Swa148_T,"-37.81414075, 144.96609379"
451720240813,45,2024-08-13,17,886,978,1864,Swa148_T,"-37.81414075, 144.96609379"
45420240314,45,2024-03-14,4,12,46,58,Swa148_T,"-37.81414075, 144.96609379"
5320240412,5,2024-04-12,3,16,8,24,PriNW_T,"-37.81874249, 144.96787656"
131120250505,131,2025-05-05,1,19,11,30,King2_T,"-37.82009057, 144.95758725"
143520240625,143,2024-06-25,5,10,22,32,Spencer_T,"-37.821728, 144.95557015"
1321520241203,132,2024-12-03,15,117,170,287,King335_T,"-37.81267639, 144.95386444"
134120240416,134,2024-04-16,1,13,22,35,Spen201_T,"-37.81694221, 144.95303935"
1341020240714,134,2024-07-14,10,232,244,476,Spen201_T,"-37.81694221, 144.95303935"
1311420240708,131,2024-07-08,14,188,146,334,King2_T,"-37.82009057, 144.95758725"
871020250605,87,2025-06-05,10,64,58,122,Errol23_T,"-37.80454949, 144.94921863"
1651220250225,165,2025-02-25,12,38,46,84,Spen475_T,"-37.80953359, 144.94939004"
1662320250130,166,2025-01-30,23,6,2,8,Spen484_T,"-37.80896733, 144.94931703"
1811420250410,181,2025-04-10,14,698,1061,1759,Eli368_T,"-37.81009465, 144.96143149"
672120241116,67,2024-11-16,21,229,337,566,FLDegS_T,"-37.81688755, 144.96562569"
681520250215,68,2025-02-15,15,352,291,643,FLDegN_T,"-37.8168479, 144.96559789"
171020240408,17,2024-04-08,10,370,258,628,Col15_T,"-37.81362543, 144.97323591"
172120250126,17,2025-01-26,21,91,56,147,Col15_T,"-37.81362543, 144.97323591"
632120241101,63,2024-11-01,21,162,351,513,Bou231_T,"-37.81333081, 144.96675571"
671220240715,67,2024-07-15,12,424,640,1064,FLDegS_T,"-37.81688755, 144.96562569"
1520250905,1,2025-09-05,5,8,9,17,Bou292_T,"-37.81349441, 144.96515323"
562120240331,56,2024-03-31,21,230,364,594,Lon364_T,"-37.81234775, 144.96153311"
861820240609,86,2024-06-09,18,35,42,77,574Qub_T,"-37.80309992, 144.94908064"
111020240109,11,2024-01-09,10,52,48,100,WatCit_T,"-37.81564989, 144.93970694"
122020250714,12,2025-07-14,20,61,51,112,NewQ_T,"-37.81457988, 144.94292398"
762320240331,76,2024-03-31,23,0,2,2,KenMac_T,"-37.79453803, 144.93036194"
72220250309,72,2025-03-09,2,9,17,26,ACMI_T,"-37.81726338, 144.96872809"
22220250308,2,2025-03-08,22,125,283,408,Bou283_T,"-37.81380668, 144.96516718"
581920250821,58,2025-08-21,19,406,343,749,Bou688_T,"-37.81686075, 144.95358075"
35120250706,35,2025-07-06,1,88,138,226,SouthB_T,"-37.82018685, 144.96508508"
2620231031,2,2023-10-31,6,14,23,37,Bou283_T,"-37.81380668, 144.96516718"
761420241101,76,2024-11-01,14,46,50,96,KenMac_T,"-37.79453803, 144.93036194"
272320250131,27,2025-01-31,23,41,12,53,Vic_T,"-37.80606888, 144.95644692"
46920240826,46,2024-08-26,9,115,43,158,Pel147_T,"-37.80240719, 144.9615673"
231420241222,23,2024-12-22,14,100,118,218,Col623_T,"-37.81909256, 144.95452748"
231120241021,23,2024-10-21,11,246,267,513,Col623_T,"-37.81909256, 144.95452748"
231020240307,23,2024-03-07,10,272,249,521,Col623_T,"-37.81909256, 144.95452748"
251520250628,25,2025-06-28,15,1097,1097,2194,MCEC_T,"-37.82401776, 144.95604426"
191320240408,19,2024-04-08,13,540,569,1109,LtB210_T,"-37.81237202, 144.96550671"
192120240515,19,2024-05-15,21,229,435,664,LtB210_T,"-37.81237202, 144.96550671"
48920251009,48,2025-10-09,9,240,308,548,QVMQ_T,"-37.80631581, 144.95866697"
1641020250604,164,2025-06-04,10,83,42,125,Lat526_T,"-37.813005, 144.95160411"
164620250801,164,2025-08-01,6,27,23,50,Lat526_T,"-37.813005, 144.95160411"
1820250714,1,2025-07-14,8,217,220,437,Bou292_T,"-37.81349441, 144.96515323"
632320250131,63,2025-01-31,23,44,197,241,Bou231_T,"-37.81333081, 144.96675571"
62020240823,62,2024-08-23,0,61,54,115,Lat224_T,"-37.80996494, 144.96216521"
861420251009,86,2025-10-09,14,46,49,95,574Qub_T,"-37.80309992, 144.94908064"
121120250423,12,2025-04-23,11,139,171,310,NewQ_T,"-37.81457988, 144.94292398"
581620240621,58,2024-06-21,16,786,803,1589,Bou688_T,"-37.81686075, 144.95358075"
2620250803,2,2025-08-03,6,14,13,27,Bou283_T,"-37.81380668, 144.96516718"
53020250311,53,2025-03-11,0,12,22,34,Col254_T,"-37.81564191, 144.965499"
91020241225,9,2024-12-25,10,36,51,87,Col700_T,"-37.81982992, 144.95102555"
23920250603,23,2025-06-03,9,522,283,805,Col623_T,"-37.81909256, 144.95452748"
79520240726,79,2024-07-26,5,29,26,55,FliSS_T,"-37.81794046, 144.96616678"
301420240326,30,2024-03-26,14,278,322,600,Lon189_T,"-37.8112185, 144.96656806"
46320240424,46,2024-04-24,3,1,1,2,Pel147_T,"-37.80240719, 144.9615673"
461920250105,46,2025-01-05,19,14,17,31,Pel147_T,"-37.80240719, 144.9615673"
511220250523,51,2025-05-23,12,184,153,337,Fra118_T,"-37.80841815, 144.95906316"
511720241212,51,2024-12-12,17,105,71,176,Fra118_T,"-37.80841815, 144.95906316"
252320250807,25,2025-08-07,23,77,107,184,MCEC_T,"-37.82401776, 144.95604426"
521520250309,52,2025-03-09,15,221,254,475,Eli263_T,"-37.81252157, 144.9619401"
52020250717,52,2025-07-17,0,14,15,29,Eli263_T,"-37.81252157, 144.9619401"
1421120250513,142,2025-05-13,11,233,287,520,Hammer1584_T,"-37.81970749, 144.96795734"
1642320241002,164,2024-10-02,23,13,43,56,Lat526_T,"-37.813005, 144.95160411"
1611720240716,161,2024-07-16,17,129,77,206,BirArt1109_T,"-37.81851276, 144.97131336"
1611820240904,161,2024-09-04,18,77,25,102,BirArt1109_T,"-37.81851276, 144.97131336"
1611720250127,161,2025-01-27,17,22,39,61,BirArt1109_T,"-37.81851276, 144.97131336"
161720250528,161,2025-05-28,7,92,131,223,BirArt1109_T,"-37.81851276, 144.97131336"
1412120241223,141,2024-12-23,21,145,224,369,474Fl_T,"-37.81997273, 144.95834911"
191020240614,19,2024-06-14,10,185,120,305,LtB210_T,"-37.81237202, 144.96550671"
1392220250925,139,2025-09-25,22,15,14,29,Signal1647_T,"-37.81959923, 144.9632832"
662220240810,66,2024-08-10,22,785,740,1525,QVN_T,"-37.81057846, 144.96444294"
692120231213,69,2023-12-13,21,35,22,57,FLDegC_T,"-37.81687226, 144.96559144"
6120240506,6,2024-05-06,1,13,19,32,FliS_T,"-37.81911705, 144.96558255"
69320240102,69,2024-01-02,3,0,1,1,FLDegC_T,"-37.81687226, 144.96559144"
841720250508,84,2025-05-08,17,1076,2364,3440,ElFi_T,"-37.81798049, 144.96503383"
31920231113,3,2023-11-13,19,938,978,1916,Swa295_T,"-37.81101524, 144.96429485"
662320231227,66,2023-12-27,23,210,178,388,QVN_T,"-37.81057846, 144.96444294"
701220240428,70,2024-04-28,12,136,194,330,Errol20_T,"-37.80456984, 144.94946228"
3420240708,3,2024-07-08,4,38,53,91,Swa295_T,"-37.81101524, 144.96429485"
391220240722,39,2024-07-22,12,230,145,375,AlfPl_T,"-37.81379749, 144.96995745"
41420240117,41,2024-01-17,4,32,58,90,Swa31,"-37.81668634, 144.96689733"
141120240810,14,2024-08-10,11,419,136,555,SanBri_T,"-37.82011242, 144.96291897"
71220250601,71,2025-06-01,2,0,8,8,WestWP_T,"-37.81235775, 144.97136962"
71020240115,71,2024-01-15,0,15,3,18,WestWP_T,"-37.81235775, 144.97136962"
59220240311,59,2024-03-11,2,60,36,96,RMIT_T,"-37.80825648, 144.96304859"
591920240313,59,2024-03-13,19,673,1015,1688,RMIT_T,"-37.80825648, 144.96304859"
541120251003,54,2025-10-03,11,102,70,172,Swa607_T,"-37.804024, 144.96308399"
31320231213,31,2023-12-13,3,2,3,5,Lyg161_T,"-37.80169681, 144.96658911"
36420240106,36,2024-01-06,4,11,6,17,Que85_T,"-37.81652527, 144.96121062"
37520241008,37,2024-10-08,5,5,9,14,Lyg260_T,"-37.80107122, 144.96704554"
371620250730,37,2025-07-30,16,98,54,152,Lyg260_T,"-37.80107122, 144.96704554"
45020240905,45,2024-09-05,0,31,32,63,Swa148_T,"-37.81414075, 144.96609379"
45020250317,45,2025-03-17,0,15,50,65,Swa148_T,"-37.81414075, 144.96609379"
541520231212,54,2023-12-12,15,81,142,223,Swa607_T,"-37.804024, 144.96308399"
281520250211,28,2025-02-11,15,385,666,1051,VAC_T,"-37.82129925, 144.96879309"
37720231118,37,2023-11-18,7,9,7,16,Lyg260_T,"-37.80107122, 144.96704554"
371120240224,37,2024-02-24,11,85,97,182,Lyg260_T,"-37.80107122, 144.96704554"
471020250825,47,2025-08-25,10,426,475,901,Eli250_T,"-37.81258467, 144.9625775"
471820250322,47,2025-03-22,18,1003,897,1900,Eli250_T,"-37.81258467, 144.9625775"
451920231023,45,2023-10-23,19,276,463,739,Swa148_T,"-37.81414075, 144.96609379"
51420240614,5,2024-06-14,14,829,869,1698,PriNW_T,"-37.81874249, 144.96787656"
51420231202,5,2023-12-02,14,530,672,1202,PriNW_T,"-37.81874249, 144.96787656"
5920240412,5,2024-04-12,9,327,583,910,PriNW_T,"-37.81874249, 144.96787656"
211620231218,21,2023-12-18,16,414,396,810,Bourke155_T,"-37.81267313, 144.96788288"
87920250804,87,2025-08-04,9,59,52,111,Errol23_T,"-37.80454949, 144.94921863"
108320240722,108,2024-07-22,3,1,2,3,261Will_T,"-37.81295822, 144.95678789"
872020250213,87,2025-02-13,20,74,94,168,Errol23_T,"-37.80454949, 144.94921863"
61420231227,61,2023-12-27,4,3,7,10,RMIT14_T,"-37.80767455, 144.96309114"
50820240417,50,2024-04-17,8,32,72,104,Lyg309_T,"-37.79808192, 144.96721013"
432120240412,43,2024-04-12,21,113,76,189,UM2_T,"-37.79844526, 144.96411782"
43120250322,43,2025-03-22,1,7,5,12,UM2_T,"-37.79844526, 144.96411782"
441020231027,44,2023-10-27,10,53,69,122,UM3_T,"-37.79698741, 144.96441306"
162420250725,162,2025-07-25,4,24,11,35,Eli489_T,"-37.80740397, 144.95987909"
167020250510,167,2025-05-10,0,0,9,9,Lat526_T,"-37.81304149, 144.95155955"
1401820231113,140,2023-11-13,18,103,105,208,Boyd2837_T,"-37.82590962, 144.96185972"
1622220240830,162,2024-08-30,22,195,128,323,Eli489_T,"-37.80740397, 144.95987909"
1351820250814,135,2025-08-14,18,313,395,708,Spen161_T,"-37.8172861, 144.95319102"
135920240802,135,2024-08-02,9,212,270,482,Spen161_T,"-37.8172861, 144.95319102"
1331120231118,133,2023-11-18,11,472,479,951,Spen229_T,"-37.81531435, 144.95227769"
133420240624,133,2024-06-24,4,5,11,16,Spen229_T,"-37.81531435, 144.95227769"
691820250406,69,2025-04-06,18,48,50,98,FLDegC_T,"-37.81687226, 144.96559144"
6820240523,6,2024-05-23,8,972,2446,3418,FliS_T,"-37.81911705, 144.96558255"
61720250301,6,2025-03-01,17,1174,1144,2318,FliS_T,"-37.81911705, 144.96558255"
841520240922,84,2024-09-22,15,1079,1433,2512,ElFi_T,"-37.81798049, 144.96503383"
78920250222,78,2025-02-22,9,41,100,141,HarEsB_T,"-37.81471642, 144.9446508"
771620241123,77,2024-11-23,16,106,66,172,HarEsP_T,"-37.81441438, 144.94433026"
771620250518,77,2025-05-18,16,180,142,322,HarEsP_T,"-37.81441438, 144.94433026"
141420231202,14,2023-12-02,14,255,93,348,SanBri_T,"-37.82011242, 144.96291897"
28020240804,28,2024-08-04,0,46,29,75,VAC_T,"-37.82129925, 144.96879309"
40520240316,40,2024-03-16,5,7,8,15,Spr201_T,"-37.80999341, 144.97227587"
451820250104,45,2025-01-04,18,325,620,945,Swa148_T,"-37.81414075, 144.96609379"
871720240402,87,2024-04-02,17,81,70,151,Errol23_T,"-37.80454949, 144.94921863"
61620231129,61,2023-11-29,6,64,60,124,RMIT14_T,"-37.80767455, 144.96309114"
50720241124,50,2024-11-24,7,3,3,6,Lyg309_T,"-37.79808192, 144.96721013"
44920240820,44,2024-08-20,9,86,102,188,UM3_T,"-37.79698741, 144.96441306"
44420250216,44,2025-02-16,4,1,0,1,UM3_T,"-37.79698741, 144.96441306"
166220250114,166,2025-01-14,2,0,1,1,Spen484_T,"-37.80896733, 144.94931703"
162820251012,162,2025-10-12,8,202,196,398,Eli489_T,"-37.80740397, 144.95987909"
132820250518,132,2025-05-18,8,75,37,112,King335_T,"-37.81267639, 144.95386444"
136820240413,136,2024-04-13,8,139,66,205,BirFed1120_T,"-37.8184141, 144.97357915"
1302120240921,130,2024-09-21,21,9,2,11,Bou892T,"-37.8204637, 144.94126826"
1611220241204,161,2024-12-04,12,156,153,309,BirArt1109_T,"-37.81851276, 144.97131336"
842120231029,84,2023-10-29,21,418,528,946,ElFi_T,"-37.81798049, 144.96503383"
66420240610,66,2024-06-10,4,36,6,42,QVN_T,"-37.81057846, 144.96444294"
702120231029,70,2023-10-29,21,74,72,146,Errol20_T,"-37.80456984, 144.94946228"
701520240604,70,2024-06-04,15,119,97,216,Errol20_T,"-37.80456984, 144.94946228"
39320250818,39,2025-08-18,3,2,2,4,AlfPl_T,"-37.81379749, 144.96995745"
75920250926,75,2025-09-26,9,25,126,151,SprFli_T,"-37.81515276, 144.97467661"
391420240520,39,2024-05-20,14,100,83,183,AlfPl_T,"-37.81379749, 144.96995745"
41520250616,41,2025-06-16,5,105,64,169,Swa31,"-37.81668634, 144.96689733"
142020240419,14,2024-04-19,20,367,125,492,SanBri_T,"-37.82011242, 144.96291897"
281520240609,28,2024-06-09,15,735,793,1528,VAC_T,"-37.82129925, 144.96879309"
29220240903,29,2024-09-03,2,0,5,5,AG_T,"-37.8199817, 144.96872865"
31820240726,31,2024-07-26,8,56,74,130,Lyg161_T,"-37.80169681, 144.96658911"
471420240704,47,2024-07-04,14,1054,996,2050,Eli250_T,"-37.81258467, 144.9625775"
50020240821,50,2024-08-21,0,9,2,11,Lyg309_T,"-37.79808192, 144.96721013"
431220240623,43,2024-06-23,12,41,113,154,UM2_T,"-37.79844526, 144.96411782"
44320240305,44,2024-03-05,3,1,0,1,UM3_T,"-37.79698741, 144.96441306"
452320250825,45,2025-08-25,23,42,128,170,Swa148_T,"-37.81414075, 144.96609379"
451720250504,45,2025-05-04,17,377,723,1100,Swa148_T,"-37.81414075, 144.96609379"
45920250101,45,2025-01-01,9,116,101,217,Swa148_T,"-37.81414075, 144.96609379"
52220240218,5,2024-02-18,22,424,449,873,PriNW_T,"-37.81874249, 144.96787656"
52320240411,5,2024-04-11,23,251,297,548,PriNW_T,"-37.81874249, 144.96787656"
51920240628,5,2024-06-28,19,476,789,1265,PriNW_T,"-37.81874249, 144.96787656"
132020250606,132,2025-06-06,0,28,22,50,King335_T,"-37.81267639, 144.95386444"
1341020250612,134,2025-06-12,10,225,346,571,Spen201_T,"-37.81694221, 144.95303935"
134120250803,134,2025-08-03,1,86,37,123,Spen201_T,"-37.81694221, 144.95303935"
1331120250426,133,2025-04-26,11,503,519,1022,Spen229_T,"-37.81531435, 144.95227769"
107620240507,107,2024-05-07,6,13,27,40,280Will_T,"-37.81246271, 144.95690188"
118720250105,118,2025-01-05,7,1,3,4,Fli114C_T,"-37.81632783, 144.97090512"
118820250522,118,2025-05-22,8,31,14,45,Fli114C_T,"-37.81632783, 144.97090512"
118720250717,118,2025-07-17,7,10,5,15,Fli114C_T,"-37.81632783, 144.97090512"
871720250623,87,2025-06-23,17,102,110,212,Errol23_T,"-37.80454949, 144.94921863"
1081920240617,108,2024-06-17,19,61,113,174,261Will_T,"-37.81295822, 144.95678789"
67220251017,67,2025-10-17,2,2,8,10,FLDegS_T,"-37.81688755, 144.96562569"
852120231026,85,2023-10-26,21,8,6,14,488Mac_T,"-37.79432415, 144.92973378"
172020250112,17,2025-01-12,20,68,68,136,Col15_T,"-37.81362543, 144.97323591"
63320241205,63,2024-12-05,3,0,9,9,Bou231_T,"-37.81333081, 144.96675571"
672020240211,67,2024-02-11,20,132,171,303,FLDegS_T,"-37.81688755, 144.96562569"
181720240410,18,2024-04-10,17,616,88,704,Col12_T,"-37.81344862, 144.97305353"
182120250611,18,2025-06-11,21,18,14,32,Col12_T,"-37.81344862, 144.97305353"
121520240908,12,2024-09-08,15,177,187,364,NewQ_T,"-37.81457988, 144.94292398"
62320240124,62,2024-01-24,3,22,20,42,Lat224_T,"-37.80996494, 144.96216521"
101020250203,10,2025-02-03,10,56,58,114,BouHbr_T,"-37.81876474, 144.94710545"
11720250325,11,2025-03-25,7,76,48,124,WatCit_T,"-37.81564989, 144.93970694"
761920240410,76,2024-04-10,19,26,35,61,KenMac_T,"-37.79453803, 144.93036194"
72320240705,72,2024-07-05,3,2,1,3,ACMI_T,"-37.81726338, 144.96872809"
582220250815,58,2025-08-15,22,1338,345,1683,Bou688_T,"-37.81686075, 144.95358075"
762320240803,76,2024-08-03,23,1,4,5,KenMac_T,"-37.79453803, 144.93036194"
1311820240204,131,2024-02-04,18,90,69,159,King2_T,"-37.82009057, 144.95758725"
1352120231118,135,2023-11-18,21,114,172,286,Spen161_T,"-37.8172861, 144.95319102"
1071620251012,107,2025-10-12,16,109,130,239,280Will_T,"-37.81246271, 144.95690188"
11920250206,1,2025-02-06,19,743,596,1339,Bou292_T,"-37.81349441, 144.96515323"
181120250326,18,2025-03-26,11,237,224,461,Col12_T,"-37.81344862, 144.97305353"
63220231204,63,2023-12-04,2,15,28,43,Bou231_T,"-37.81333081, 144.96675571"
62120231203,62,2023-12-03,1,86,47,133,Lat224_T,"-37.80996494, 144.96216521"
861620250522,86,2025-05-22,16,48,60,108,574Qub_T,"-37.80309992, 144.94908064"
101420250826,10,2025-08-26,14,78,39,117,BouHbr_T,"-37.81876474, 144.94710545"
121420241213,12,2024-12-13,14,159,146,305,NewQ_T,"-37.81457988, 144.94292398"
721520250526,72,2025-05-26,15,92,201,293,ACMI_T,"-37.81726338, 144.96872809"
581420241005,58,2024-10-05,14,507,247,754,Bou688_T,"-37.81686075, 144.95358075"
351420240813,35,2024-08-13,14,981,1064,2045,SouthB_T,"-37.82018685, 144.96508508"
762120250514,76,2025-05-14,21,5,10,15,KenMac_T,"-37.79453803, 144.93036194"
301720240624,30,2024-06-24,17,290,365,655,Lon189_T,"-37.8112185, 144.96656806"
231220241128,23,2024-11-28,12,566,625,1191,Col623_T,"-37.81909256, 144.95452748"
461520240512,46,2024-05-12,15,68,67,135,Pel147_T,"-37.80240719, 144.9615673"
25420231105,25,2023-11-05,4,0,0,0,MCEC_T,"-37.82401776, 144.95604426"
20420250806,20,2025-08-06,4,12,2,14,LtB170_T,"-37.81172914, 144.9682466"
461920240906,46,2024-09-06,19,6,1,7,Pel147_T,"-37.80240719, 144.9615673"
461520250225,46,2025-02-25,15,73,103,176,Pel147_T,"-37.80240719, 144.9615673"
164820250821,164,2025-08-21,8,140,89,229,Lat526_T,"-37.813005, 144.95160411"
164220250927,164,2025-09-27,2,6,5,11,Lat526_T,"-37.813005, 144.95160411"
1231020250715,123,2025-07-15,10,33,24,57,BirBridge_T,"-37.81753741, 144.97329734"
1301920240212,130,2024-02-12,19,15,17,32,Bou892T,"-37.8204637, 144.94126826"
130920240911,130,2024-09-11,9,46,18,64,Bou892T,"-37.8204637, 144.94126826"
141520240730,141,2024-07-30,5,9,2,11,474Fl_T,"-37.81997273, 144.95834911"
1091320231220,109,2023-12-20,13,165,198,363,LatWill_T,"-37.81193681, 144.95621105"
109320240116,109,2024-01-16,3,4,1,5,LatWill_T,"-37.81193681, 144.95621105"
191620240410,19,2024-04-10,16,519,508,1027,LtB210_T,"-37.81237202, 144.96550671"
661320241025,66,2024-10-25,13,1013,1110,2123,QVN_T,"-37.81057846, 144.96444294"
691320240222,69,2024-02-22,13,161,206,367,FLDegC_T,"-37.81687226, 144.96559144"
69920250516,69,2025-05-16,9,302,183,485,FLDegC_T,"-37.81687226, 144.96559144"
70820250723,70,2025-07-23,8,71,72,143,Errol20_T,"-37.80456984, 144.94946228"
3920241207,3,2024-12-07,9,163,189,352,Swa295_T,"-37.81101524, 144.96429485"
29120240615,29,2024-06-15,1,10,29,39,AG_T,"-37.8199817, 144.96872865"
71420241028,71,2024-10-28,4,3,4,7,WestWP_T,"-37.81235775, 144.97136962"
59220250708,59,2025-07-08,2,15,9,24,RMIT_T,"-37.80825648, 144.96304859"
28220250218,28,2025-02-18,2,8,11,19,VAC_T,"-37.82129925, 144.96879309"
29320250823,29,2025-08-23,3,8,7,15,AG_T,"-37.8199817, 144.96872865"
40420241026,40,2024-10-26,4,7,0,7,Spr201_T,"-37.80999341, 144.97227587"
211020250714,21,2025-07-14,10,157,157,314,Bourke155_T,"-37.81267313, 144.96788288"
107820240531,107,2024-05-31,8,52,168,220,280Will_T,"-37.81246271, 144.95690188"
107120231203,107,2023-12-03,1,11,16,27,280Will_T,"-37.81246271, 144.95690188"
133120231021,133,2023-10-21,1,49,38,87,Spen229_T,"-37.81531435, 144.95227769"
612320250927,61,2025-09-27,23,113,80,193,RMIT14_T,"-37.80767455, 144.96309114"
43620250909,43,2025-09-09,6,9,4,13,UM2_T,"-37.79844526, 144.96411782"
1792220250218,179,2025-02-18,22,32,43,75,Pow61_T,"-37.82392385, 144.96299677"
162720250120,162,2025-01-20,7,101,80,181,Eli489_T,"-37.80740397, 144.95987909"
143420240429,143,2024-04-29,4,17,3,20,Spencer_T,"-37.821728, 144.95557015"
132620231103,132,2023-11-03,6,30,13,43,King335_T,"-37.81267639, 144.95386444"
134020231209,134,2023-12-09,0,85,136,221,Spen201_T,"-37.81694221, 144.95303935"
134620240117,134,2024-01-17,6,88,107,195,Spen201_T,"-37.81694221, 144.95303935"
361720241130,36,2024-11-30,17,121,96,217,Que85_T,"-37.81652527, 144.96121062"
37520250820,37,2025-08-20,5,2,8,10,Lyg260_T,"-37.80107122, 144.96704554"
36720240308,36,2024-03-08,7,67,62,129,Que85_T,"-37.81652527, 144.96121062"
472320250628,47,2025-06-28,23,294,243,537,Eli250_T,"-37.81258467, 144.9625775"
451820241028,45,2024-10-28,18,371,526,897,Swa148_T,"-37.81414075, 144.96609379"
1331020241007,133,2024-10-07,10,436,428,864,Spen229_T,"-37.81531435, 144.95227769"
1241820231123,124,2023-11-23,18,0,4,4,BirBridge_T,"-37.81757416, 144.97329934"
872120250525,87,2025-05-25,21,36,64,100,Errol23_T,"-37.80454949, 144.94921863"
871120250208,87,2025-02-08,11,139,160,299,Errol23_T,"-37.80454949, 144.94921863"
1662120241031,166,2024-10-31,21,9,8,17,Spen484_T,"-37.80896733, 144.94931703"
166920241124,166,2024-11-24,9,13,19,32,Spen484_T,"-37.80896733, 144.94931703"
179820250525,179,2025-05-25,8,14,16,30,Pow61_T,"-37.82392385, 144.96299677"
184520250922,184,2025-09-22,5,16,39,55,Eli124_T,"-37.81512416, 144.96371988"
1351620240304,135,2024-03-04,16,443,484,927,Spen161_T,"-37.8172861, 144.95319102"
1352020240806,135,2024-08-06,20,97,135,232,Spen161_T,"-37.8172861, 144.95319102"
63220250919,63,2025-09-19,2,3,11,14,Bou231_T,"-37.81333081, 144.96675571"
63020240521,63,2024-05-21,0,18,36,54,Bou231_T,"-37.81333081, 144.96675571"
68620240729,68,2024-07-29,6,3,0,3,FLDegN_T,"-37.8168479, 144.96559789"
86720240915,86,2024-09-15,7,17,6,23,574Qub_T,"-37.80309992, 144.94908064"
112320241102,11,2024-11-02,23,56,270,326,WatCit_T,"-37.81564989, 144.93970694"
10320250923,10,2025-09-23,3,1,1,2,BouHbr_T,"-37.81876474, 144.94710545"
581520250802,58,2025-08-02,15,766,401,1167,Bou688_T,"-37.81686075, 144.95358075"
58920240527,58,2024-05-27,9,900,199,1099,Bou688_T,"-37.81686075, 144.95358075"
581520250121,58,2025-01-21,15,548,487,1035,Bou688_T,"-37.81686075, 144.95358075"
351220250117,35,2025-01-17,12,1522,1330,2852,SouthB_T,"-37.82018685, 144.96508508"
53420250201,53,2025-02-01,4,1,1,2,Col254_T,"-37.81564191, 144.965499"
53320250216,53,2025-02-16,3,15,8,23,Col254_T,"-37.81564191, 144.965499"
53020250222,53,2025-02-22,0,52,72,124,Col254_T,"-37.81564191, 144.965499"
23420250209,23,2025-02-09,4,7,12,19,Col623_T,"-37.81909256, 144.95452748"
792120250908,79,2025-09-08,21,144,130,274,FliSS_T,"-37.81794046, 144.96616678"
401520231102,40,2023-11-02,15,180,139,319,Spr201_T,"-37.80999341, 144.97227587"
31220240131,31,2024-01-31,2,7,3,10,Lyg161_T,"-37.80169681, 144.96658911"
472220240425,47,2024-04-25,22,290,254,544,Eli250_T,"-37.81258467, 144.9625775"
45320231115,45,2023-11-15,3,1,11,12,Swa148_T,"-37.81414075, 144.96609379"
211220241009,21,2024-10-09,12,587,419,1006,Bourke155_T,"-37.81267313, 144.96788288"
871320251011,87,2025-10-11,13,120,154,274,Errol23_T,"-37.80454949, 144.94921863"
108320231125,108,2023-11-25,3,17,8,25,261Will_T,"-37.81295822, 144.95678789"
50020250528,50,2025-05-28,0,5,0,5,Lyg309_T,"-37.79808192, 144.96721013"
143620241214,143,2024-12-14,6,41,79,120,Spencer_T,"-37.821728, 144.95557015"
107420231019,107,2023-10-19,4,0,3,3,280Will_T,"-37.81246271, 144.95690188"
1342120250211,134,2025-02-11,21,328,245,573,Spen201_T,"-37.81694221, 144.95303935"
1332120250602,133,2025-06-02,21,289,281,570,Spen229_T,"-37.81531435, 144.95227769"
1182320241218,118,2024-12-18,23,10,5,15,Fli114C_T,"-37.81632783, 144.97090512"
1181920250524,118,2025-05-24,19,42,16,58,Fli114C_T,"-37.81632783, 144.97090512"
118420240101,118,2024-01-01,4,1,0,1,Fli114C_T,"-37.81632783, 144.97090512"
1241720250216,124,2025-02-16,17,2,6,8,BirBridge_T,"-37.81757416, 144.97329934"
11220240129,1,2024-01-29,12,1213,1161,2374,Bou292_T,"-37.81349441, 144.96515323"
681320240212,68,2024-02-12,13,298,268,566,FLDegN_T,"-37.8168479, 144.96559789"
562020240610,56,2024-06-10,20,146,178,324,Lon364_T,"-37.81234775, 144.96153311"
101820231101,10,2023-11-01,18,103,51,154,BouHbr_T,"-37.81876474, 144.94710545"
10520240908,10,2024-09-08,5,1,0,1,BouHbr_T,"-37.81876474, 144.94710545"
722120250804,72,2025-08-04,21,20,39,59,ACMI_T,"-37.81726338, 144.96872809"
721620240912,72,2024-09-12,16,169,480,649,ACMI_T,"-37.81726338, 144.96872809"
58420240513,58,2024-05-13,4,9,17,26,Bou688_T,"-37.81686075, 144.95358075"
351320240928,35,2024-09-28,13,1219,1343,2562,SouthB_T,"-37.82018685, 144.96508508"
301520240617,30,2024-06-17,15,162,328,490,Lon189_T,"-37.8112185, 144.96656806"
23020241101,23,2024-11-01,0,21,30,51,Col623_T,"-37.81909256, 144.95452748"
25720250504,25,2025-05-04,7,101,90,191,MCEC_T,"-37.82401776, 144.95604426"
521820250723,52,2025-07-23,18,277,281,558,Eli263_T,"-37.81252157, 144.9619401"
161720250614,161,2025-06-14,7,50,39,89,BirArt1109_T,"-37.81851276, 144.97131336"
1231820250729,123,2025-07-29,18,1,0,1,BirBridge_T,"-37.81753741, 144.97329734"
1301420240904,130,2024-09-04,14,7,7,14,Bou892T,"-37.8204637, 144.94126826"
1381520240517,138,2024-05-17,15,8,4,12,EntPark1671_T,"-37.81996544, 144.95981454"
49720240520,49,2024-05-20,7,37,75,112,Eli501_T,"-37.80730068, 144.95956055"
192020240708,19,2024-07-08,20,364,524,888,LtB210_T,"-37.81237202, 144.96550671"
139920250324,139,2025-03-24,9,27,113,140,Signal1647_T,"-37.81959923, 144.9632832"
136920240310,136,2024-03-10,9,64,75,139,BirFed1120_T,"-37.8184141, 144.97357915"
27420240302,27,2024-03-02,4,5,1,6,Vic_T,"-37.80606888, 144.95644692"
91520250927,9,2025-09-27,15,58,49,107,Col700_T,"-37.81982992, 144.95102555"
9620240211,9,2024-02-11,6,14,11,25,Col700_T,"-37.81982992, 144.95102555"
531120250425,53,2025-04-25,11,738,423,1161,Col254_T,"-37.81564191, 144.965499"
92320250129,9,2025-01-29,23,30,13,43,Col700_T,"-37.81982992, 144.95102555"
791020250421,79,2025-04-21,10,463,261,724,FliSS_T,"-37.81794046, 144.96616678"
521720240220,52,2024-02-20,17,456,398,854,Eli263_T,"-37.81252157, 144.9619401"
46920250725,46,2025-07-25,9,64,19,83,Pel147_T,"-37.80240719, 144.9615673"
23420250114,23,2025-01-14,4,7,4,11,Col623_T,"-37.81909256, 144.95452748"
192020240501,19,2024-05-01,20,413,509,922,LtB210_T,"-37.81237202, 144.96550671"
201620250207,20,2025-02-07,16,224,225,449,LtB170_T,"-37.81172914, 144.9682466"
201520240314,20,2024-03-14,15,172,220,392,LtB170_T,"-37.81172914, 144.9682466"
52020250521,52,2025-05-21,0,12,19,31,Eli263_T,"-37.81252157, 144.9619401"
164120251002,164,2025-10-02,1,2,4,6,Lat526_T,"-37.813005, 144.95160411"
1392020240130,139,2024-01-30,20,30,34,64,Signal1647_T,"-37.81959923, 144.9632832"
1362020250217,136,2025-02-17,20,27,14,41,BirFed1120_T,"-37.8184141, 144.97357915"
1421020231210,142,2023-12-10,10,408,313,721,Hammer1584_T,"-37.81970749, 144.96795734"
1301920250126,130,2025-01-26,19,33,10,43,Bou892T,"-37.8204637, 144.94126826"
164020240829,164,2024-08-29,0,4,5,9,Lat526_T,"-37.813005, 144.95160411"
1231320241113,123,2024-11-13,13,13,2,15,BirBridge_T,"-37.81753741, 144.97329734"
117120231128,117,2023-11-28,1,20,2,22,Fli114F_T,"-37.81629332, 144.97090877"
66220250409,66,2025-04-09,2,28,24,52,QVN_T,"-37.81057846, 144.96444294"
691520240105,69,2024-01-05,15,187,237,424,FLDegC_T,"-37.81687226, 144.96559144"
61520250211,6,2025-02-11,15,966,558,1524,FliS_T,"-37.81911705, 144.96558255"
42120250613,4,2025-06-13,21,1026,1186,2212,Swa123_T,"-37.81487988, 144.9660878"
39320250525,39,2025-05-25,3,1,1,2,AlfPl_T,"-37.81379749, 144.96995745"
3220240705,3,2024-07-05,2,80,74,154,Swa295_T,"-37.81101524, 144.96429485"
81520240531,8,2024-05-31,15,141,248,389,WebBN_T,"-37.82293543, 144.9471751"
82120240118,8,2024-01-18,21,33,47,80,WebBN_T,"-37.82293543, 144.9471751"
751720241204,75,2024-12-04,17,98,100,198,SprFli_T,"-37.81515276, 144.97467661"
411520241013,41,2024-10-13,15,252,210,462,Swa31,"-37.81668634, 144.96689733"
81620250830,8,2025-08-30,16,178,219,397,WebBN_T,"-37.82293543, 144.9471751"
77520241022,77,2024-10-22,5,7,11,18,HarEsP_T,"-37.81441438, 144.94433026"
771420250106,77,2025-01-06,14,50,27,77,HarEsP_T,"-37.81441438, 144.94433026"
411220250709,41,2025-07-09,12,2161,1384,3545,Swa31,"-37.81668634, 144.96689733"
65620240611,65,2024-06-11,6,20,19,39,SwaCs_T,"-37.81569416, 144.9668064"
422320241130,42,2024-11-30,23,16,15,31,UM1_T,"-37.80008566, 144.96386412"
42520250626,42,2025-06-26,5,1,2,3,UM1_T,"-37.80008566, 144.96386412"
421520250713,42,2025-07-13,15,70,52,122,UM1_T,"-37.80008566, 144.96386412"
291820240508,29,2024-05-08,18,144,226,370,AG_T,"-37.8199817, 144.96872865"
401820231216,40,2023-12-16,18,81,164,245,Spr201_T,"-37.80999341, 144.97227587"
311320250422,31,2025-04-22,13,176,171,347,Lyg161_T,"-37.80169681, 144.96658911"
54520251006,54,2025-10-06,5,11,3,14,Swa607_T,"-37.804024, 144.96308399"
31620240116,31,2024-01-16,6,17,11,28,Lyg161_T,"-37.80169681, 144.96658911"
36720250305,36,2025-03-05,7,123,64,187,Que85_T,"-37.81652527, 144.96121062"
37120240412,37,2024-04-12,1,22,9,31,Lyg260_T,"-37.80107122, 144.96704554"
37620240614,37,2024-06-14,6,7,3,10,Lyg260_T,"-37.80107122, 144.96704554"
61320250818,61,2025-08-18,3,8,5,13,RMIT14_T,"-37.80767455, 144.96309114"
50920240229,50,2024-02-29,9,66,114,180,Lyg309_T,"-37.79808192, 144.96721013"
43620240705,43,2024-07-05,6,25,8,33,UM2_T,"-37.79844526, 144.96411782"
442320240319,44,2024-03-19,23,6,0,6,UM3_T,"-37.79698741, 144.96441306"
431520240131,43,2024-01-31,15,130,131,261,UM2_T,"-37.79844526, 144.96411782"
45820250329,45,2025-03-29,8,71,114,185,Swa148_T,"-37.81414075, 144.96609379"
131020250527,131,2025-05-27,0,10,4,14,King2_T,"-37.82009057, 144.95758725"
1321320240406,132,2024-04-06,13,214,138,352,King335_T,"-37.81267639, 144.95386444"
1341620250303,134,2025-03-03,16,599,547,1146,Spen201_T,"-37.81694221, 144.95303935"
131120231125,131,2023-11-25,1,17,57,74,King2_T,"-37.82009057, 144.95758725"
511320250121,51,2025-01-21,13,100,105,205,Fra118_T,"-37.80841815, 144.95906316"
252020241123,25,2024-11-23,20,432,470,902,MCEC_T,"-37.82401776, 144.95604426"
481520231121,48,2023-11-21,15,300,155,455,QVMQ_T,"-37.80631581, 144.95866697"
20320250121,20,2025-01-21,3,8,11,19,LtB170_T,"-37.81172914, 144.9682466"
301920250602,30,2025-06-02,19,223,317,540,Lon189_T,"-37.8112185, 144.96656806"
117920250115,117,2025-01-15,9,208,144,352,Fli114F_T,"-37.81629332, 144.97090877"
1411520251016,141,2025-10-16,15,121,108,229,474Fl_T,"-37.81997273, 144.95834911"
109420241229,109,2024-12-29,4,0,5,5,LatWill_T,"-37.81193681, 144.95621105"
48920250705,48,2025-07-05,9,192,226,418,QVMQ_T,"-37.80631581, 144.95866697"
69620240915,69,2024-09-15,6,2,2,4,FLDegC_T,"-37.81687226, 144.96559144"
841120240707,84,2024-07-07,11,979,790,1769,ElFi_T,"-37.81798049, 144.96503383"
66820240629,66,2024-06-29,8,50,112,162,QVN_T,"-37.81057846, 144.96444294"
4020250713,4,2025-07-13,0,280,384,664,Swa123_T,"-37.81487988, 144.9660878"
702220241003,70,2024-10-03,22,133,53,186,Errol20_T,"-37.80456984, 144.94946228"
70520241209,70,2024-12-09,5,1,0,1,Errol20_T,"-37.80456984, 144.94946228"
412320240622,41,2024-06-22,23,77,72,149,Swa31,"-37.81668634, 144.96689733"
14620250320,14,2025-03-20,6,101,154,255,SanBri_T,"-37.82011242, 144.96291897"
14120231110,14,2023-11-10,1,40,11,51,SanBri_T,"-37.82011242, 144.96291897"
141120240605,14,2024-06-05,11,204,135,339,SanBri_T,"-37.82011242, 144.96291897"
14220240725,14,2024-07-25,2,4,1,5,SanBri_T,"-37.82011242, 144.96291897"
141020250925,14,2025-09-25,10,241,97,338,SanBri_T,"-37.82011242, 144.96291897"
652320240313,65,2024-03-13,23,54,98,152,SwaCs_T,"-37.81569416, 144.9668064"
66520250606,66,2025-06-06,5,10,19,29,QVN_T,"-37.81057846, 144.96444294"
69120240524,69,2024-05-24,1,4,2,6,FLDegC_T,"-37.81687226, 144.96559144"
6820240123,6,2024-01-23,8,898,2460,3358,FliS_T,"-37.81911705, 144.96558255"
701520240422,70,2024-04-22,15,119,103,222,Errol20_T,"-37.80456984, 144.94946228"
701720240510,70,2024-05-10,17,172,141,313,Errol20_T,"-37.80456984, 144.94946228"
702220250710,70,2025-07-10,22,125,62,187,Errol20_T,"-37.80456984, 144.94946228"
8420250212,8,2025-02-12,4,1,3,4,WebBN_T,"-37.82293543, 144.9471751"
41620250816,41,2025-08-16,6,157,81,238,Swa31,"-37.81668634, 144.96689733"
78020240914,78,2024-09-14,0,3,1,4,HarEsB_T,"-37.81471642, 144.9446508"
14520250407,14,2025-04-07,5,31,40,71,SanBri_T,"-37.82011242, 144.96291897"
59220241216,59,2024-12-16,2,16,10,26,RMIT_T,"-37.80825648, 144.96304859"
71520241113,71,2024-11-13,5,10,19,29,WestWP_T,"-37.81235775, 144.97136962"
712320250911,71,2025-09-11,23,2,4,6,WestWP_T,"-37.81235775, 144.97136962"
42320250710,42,2025-07-10,3,2,1,3,UM1_T,"-37.80008566, 144.96386412"
281120250310,28,2025-03-10,11,1171,852,2023,VAC_T,"-37.82129925, 144.96879309"
45620240322,45,2024-03-22,6,31,53,84,Swa148_T,"-37.81414075, 144.96609379"
107120241012,107,2024-10-12,1,35,16,51,280Will_T,"-37.81246271, 144.95690188"
1071720241108,107,2024-11-08,17,236,177,413,280Will_T,"-37.81246271, 144.95690188"
107020250616,107,2025-06-16,0,5,5,10,280Will_T,"-37.81246271, 144.95690188"
133520240615,133,2024-06-15,5,26,48,74,Spen229_T,"-37.81531435, 144.95227769"
87920241114,87,2024-11-14,9,57,57,114,Errol23_T,"-37.80454949, 144.94921863"
50120250131,50,2025-01-31,1,2,1,3,Lyg309_T,"-37.79808192, 144.96721013"
107820250124,107,2025-01-24,8,51,188,239,280Will_T,"-37.81246271, 144.95690188"
1331620250709,133,2025-07-09,16,884,799,1683,Spen229_T,"-37.81531435, 144.95227769"
1241920240121,124,2024-01-21,19,0,2,2,BirBridge_T,"-37.81757416, 144.97329934"
87820241106,87,2024-11-06,8,97,53,150,Errol23_T,"-37.80454949, 144.94921863"
167120240913,167,2024-09-13,1,0,1,1,Lat526_T,"-37.81304149, 144.95155955"
281620250506,28,2025-05-06,16,392,1048,1440,VAC_T,"-37.82129925, 144.96879309"
292120241027,29,2024-10-27,21,575,270,845,AG_T,"-37.8199817, 144.96872865"
291020240415,29,2024-04-15,10,116,175,291,AG_T,"-37.8199817, 144.96872865"
292120240415,29,2024-04-15,21,53,67,120,AG_T,"-37.8199817, 144.96872865"
40620250601,40,2025-06-01,6,47,27,74,Spr201_T,"-37.80999341, 144.97227587"
542120240601,54,2024-06-01,21,104,120,224,Swa607_T,"-37.804024, 144.96308399"
36420250922,36,2025-09-22,4,1,4,5,Que85_T,"-37.81652527, 144.96121062"
37320250309,37,2025-03-09,3,13,10,23,Lyg260_T,"-37.80107122, 144.96704554"
47920240420,47,2024-04-20,9,330,418,748,Eli250_T,"-37.81258467, 144.9625775"
45620250208,45,2025-02-08,6,13,43,56,Swa148_T,"-37.81414075, 144.96609379"
451320250406,45,2025-04-06,13,770,1364,2134,Swa148_T,"-37.81414075, 144.96609379"
45920231124,45,2023-11-24,9,312,285,597,Swa148_T,"-37.81414075, 144.96609379"
108120250425,108,2025-04-25,1,56,39,95,261Will_T,"-37.81295822, 144.95678789"
143320250511,143,2025-05-11,3,50,18,68,Spencer_T,"-37.821728, 144.95557015"
1401320240117,140,2024-01-17,13,55,43,98,Boyd2837_T,"-37.82590962, 144.96185972"
134720231205,134,2023-12-05,7,380,258,638,Spen201_T,"-37.81694221, 144.95303935"
1311620240718,131,2024-07-18,16,140,107,247,King2_T,"-37.82009057, 144.95758725"
1331920251006,133,2025-10-06,19,510,413,923,Spen229_T,"-37.81531435, 144.95227769"
1331520240325,133,2024-03-25,15,566,715,1281,Spen229_T,"-37.81531435, 144.95227769"
1332120240524,133,2024-05-24,21,391,235,626,Spen229_T,"-37.81531435, 144.95227769"
107820240713,107,2024-07-13,8,35,38,73,280Will_T,"-37.81246271, 144.95690188"
871820240202,87,2024-02-02,18,142,101,243,Errol23_T,"-37.80454949, 144.94921863"
165920241123,165,2024-11-23,9,18,45,63,Spen475_T,"-37.80953359, 144.94939004"
17520240610,17,2024-06-10,5,19,13,32,Col15_T,"-37.81362543, 144.97323591"
1420240115,1,2024-01-15,4,3,2,5,Bou292_T,"-37.81349441, 144.96515323"
68320240622,68,2024-06-22,3,1,0,1,FLDegN_T,"-37.8168479, 144.96559789"
63320240107,63,2024-01-07,3,20,91,111,Bou231_T,"-37.81333081, 144.96675571"
11320250612,11,2025-06-12,3,1,1,2,WatCit_T,"-37.81564989, 144.93970694"
101820240513,10,2024-05-13,18,57,21,78,BouHbr_T,"-37.81876474, 144.94710545"
761320250810,76,2025-08-10,13,60,61,121,KenMac_T,"-37.79453803, 144.93036194"
761620241027,76,2024-10-27,16,54,25,79,KenMac_T,"-37.79453803, 144.93036194"
9620250530,9,2025-05-30,6,41,194,235,Col700_T,"-37.81982992, 144.95102555"
9320250814,9,2025-08-14,3,1,2,3,Col700_T,"-37.81982992, 144.95102555"
791320240722,79,2024-07-22,13,414,387,801,FliSS_T,"-37.81794046, 144.96616678"
79820251016,79,2025-10-16,8,446,305,751,FliSS_T,"-37.81794046, 144.96616678"
302220241018,30,2024-10-18,22,345,509,854,Lon189_T,"-37.8112185, 144.96656806"
51320250323,51,2025-03-23,3,8,5,13,Fra118_T,"-37.80841815, 144.95906316"
461720241210,46,2024-12-10,17,72,105,177,Pel147_T,"-37.80240719, 144.9615673"
521220231115,52,2023-11-15,12,469,452,921,Eli263_T,"-37.81252157, 144.9619401"
521620240115,52,2024-01-15,16,306,257,563,Eli263_T,"-37.81252157, 144.9619401"
251720250412,25,2025-04-12,17,1416,683,2099,MCEC_T,"-37.82401776, 144.95604426"
20320250530,20,2025-05-30,3,22,23,45,LtB170_T,"-37.81172914, 144.9682466"
481320240720,48,2024-07-20,13,439,290,729,QVMQ_T,"-37.80631581, 144.95866697"
482020241105,48,2024-11-05,20,114,88,202,QVMQ_T,"-37.80631581, 144.95866697"
301220250115,30,2025-01-15,12,300,450,750,Lon189_T,"-37.8112185, 144.96656806"
1371320250204,137,2025-02-04,13,24,96,120,BouHbr2353_T,"-37.81894815, 144.94612292"
661120250313,66,2025-03-13,11,834,1151,1985,QVN_T,"-37.81057846, 144.96444294"
66620250601,66,2025-06-01,6,15,28,43,QVN_T,"-37.81057846, 144.96444294"
84220240721,84,2024-07-21,2,99,164,263,ElFi_T,"-37.81798049, 144.96503383"
701020241202,70,2024-12-02,10,82,92,174,Errol20_T,"-37.80456984, 144.94946228"
391520240326,39,2024-03-26,15,119,118,237,AlfPl_T,"-37.81379749, 144.96995745"
411420241026,41,2024-10-26,14,1921,1560,3481,Swa31,"-37.81668634, 144.96689733"
782220240427,78,2024-04-27,22,4,14,18,HarEsB_T,"-37.81471642, 144.9446508"
78620241109,78,2024-11-09,6,5,6,11,HarEsB_T,"-37.81471642, 144.9446508"
412120250317,41,2025-03-17,21,411,830,1241,Swa31,"-37.81668634, 144.96689733"
42420250126,42,2025-01-26,4,1,1,2,UM1_T,"-37.80008566, 144.96386412"
42820241012,42,2024-10-12,8,28,29,57,UM1_T,"-37.80008566, 144.96386412"
421420240620,42,2024-06-20,14,123,158,281,UM1_T,"-37.80008566, 144.96386412"
711620250818,71,2025-08-18,16,28,11,39,WestWP_T,"-37.81235775, 144.97136962"
711020231107,71,2023-11-07,10,5,5,10,WestWP_T,"-37.81235775, 144.97136962"
592020240124,59,2024-01-24,20,372,294,666,RMIT_T,"-37.80825648, 144.96304859"
59020241101,59,2024-11-01,0,87,71,158,RMIT_T,"-37.80825648, 144.96304859"
311920241116,31,2024-11-16,19,443,328,771,Lyg161_T,"-37.80169681, 144.96658911"
45120241111,45,2024-11-11,1,20,40,60,Swa148_T,"-37.81414075, 144.96609379"
211220250828,21,2025-08-28,12,489,429,918,Bourke155_T,"-37.81267313, 144.96788288"
108620250405,108,2025-04-05,6,19,27,46,261Will_T,"-37.81295822, 144.95678789"
43120250725,43,2025-07-25,1,2,2,4,UM2_T,"-37.79844526, 144.96411782"
1841020251002,184,2025-10-02,10,607,529,1136,Eli124_T,"-37.81512416, 144.96371988"
167020241018,167,2024-10-18,0,1,9,10,Lat526_T,"-37.81304149, 144.95155955"
140720241027,140,2024-10-27,7,44,12,56,Boyd2837_T,"-37.82590962, 144.96185972"
131020250510,131,2025-05-10,0,128,90,218,King2_T,"-37.82009057, 144.95758725"
131920240506,131,2024-05-06,9,97,66,163,King2_T,"-37.82009057, 144.95758725"
1072320250720,107,2025-07-20,23,23,23,46,280Will_T,"-37.81246271, 144.95690188"
1071820251015,107,2025-10-15,18,177,145,322,280Will_T,"-37.81246271, 144.95690188"
1182020250424,118,2025-04-24,20,2,8,10,Fli114C_T,"-37.81632783, 144.97090512"
681720240520,68,2024-05-20,17,102,32,134,FLDegN_T,"-37.8168479, 144.96559789"
171620241222,17,2024-12-22,16,183,82,265,Col15_T,"-37.81362543, 144.97323591"
171920250102,17,2025-01-02,19,91,128,219,Col15_T,"-37.81362543, 144.97323591"
17120250704,17,2025-07-04,1,7,6,13,Col15_T,"-37.81362543, 144.97323591"
111120250417,11,2025-04-17,11,42,71,113,WatCit_T,"-37.81564989, 144.93970694"
24320231208,24,2023-12-08,3,8,26,34,Col620_T,"-37.81887963, 144.95449198"
10820250829,10,2025-08-29,8,49,106,155,BouHbr_T,"-37.81876474, 144.94710545"
121520250322,12,2025-03-22,15,269,286,555,NewQ_T,"-37.81457988, 144.94292398"
121520250624,12,2025-06-24,15,59,88,147,NewQ_T,"-37.81457988, 144.94292398"
761920231111,76,2023-11-11,19,55,44,99,KenMac_T,"-37.79453803, 144.93036194"
721620250412,72,2025-04-12,16,299,470,769,ACMI_T,"-37.81726338, 144.96872809"
1231320250526,123,2025-05-26,13,111,41,152,BirBridge_T,"-37.81753741, 144.97329734"
1172320251006,117,2025-10-06,23,49,61,110,Fli114F_T,"-37.81629332, 144.97090877"
1171020250123,117,2025-01-23,10,131,191,322,Fli114F_T,"-37.81629332, 144.97090877"
66020240216,66,2024-02-16,0,85,29,114,QVN_T,"-37.81057846, 144.96444294"
661620250120,66,2025-01-20,16,1026,1062,2088,QVN_T,"-37.81057846, 144.96444294"
661220241120,66,2024-11-20,12,941,1210,2151,QVN_T,"-37.81057846, 144.96444294"
692020240916,69,2024-09-16,20,40,28,68,FLDegC_T,"-37.81687226, 144.96559144"
69020241109,69,2024-11-09,0,6,8,14,FLDegC_T,"-37.81687226, 144.96559144"
61320231202,6,2023-12-02,13,665,605,1270,FliS_T,"-37.81911705, 144.96558255"
841120250302,84,2025-03-02,11,899,709,1608,ElFi_T,"-37.81798049, 144.96503383"
841220250825,84,2025-08-25,12,1030,1114,2144,ElFi_T,"-37.81798049, 144.96503383"
701820240813,70,2024-08-13,18,197,214,411,Errol20_T,"-37.80456984, 144.94946228"
702320241030,70,2024-10-30,23,5,21,26,Errol20_T,"-37.80456984, 144.94946228"
31120240929,3,2024-09-29,11,369,288,657,Swa295_T,"-37.81101524, 144.96429485"
3020250504,3,2025-05-04,0,366,395,761,Swa295_T,"-37.81101524, 144.96429485"
8820241227,8,2024-12-27,8,70,141,211,WebBN_T,"-37.82293543, 144.9471751"
751020250421,75,2025-04-21,10,38,52,90,SprFli_T,"-37.81515276, 144.97467661"
41420231222,41,2023-12-22,4,29,90,119,Swa31,"-37.81668634, 144.96689733"
77620240115,77,2024-01-15,6,28,67,95,HarEsP_T,"-37.81441438, 144.94433026"
711320250730,71,2025-07-30,13,17,19,36,WestWP_T,"-37.81235775, 144.97136962"
662120241119,66,2024-11-19,21,765,475,1240,QVN_T,"-37.81057846, 144.96444294"
692320241102,69,2024-11-02,23,15,18,33,FLDegC_T,"-37.81687226, 144.96559144"
61420240802,6,2024-08-02,14,813,664,1477,FliS_T,"-37.81911705, 144.96558255"
62020241123,6,2024-11-23,20,792,831,1623,FliS_T,"-37.81911705, 144.96558255"
31520231217,3,2023-12-17,15,1747,1570,3317,Swa295_T,"-37.81101524, 144.96429485"
70720240217,70,2024-02-17,7,21,15,36,Errol20_T,"-37.80456984, 144.94946228"
14020241015,14,2024-10-15,0,25,10,35,SanBri_T,"-37.82011242, 144.96291897"
592220240719,59,2024-07-19,22,236,205,441,RMIT_T,"-37.80825648, 144.96304859"
77320250701,77,2025-07-01,3,2,5,7,HarEsP_T,"-37.81441438, 144.94433026"
281320231023,28,2023-10-23,13,453,408,861,VAC_T,"-37.82129925, 144.96879309"
14720250401,14,2025-04-01,7,175,257,432,SanBri_T,"-37.82011242, 144.96291897"
312320240123,31,2024-01-23,23,15,65,80,Lyg161_T,"-37.80169681, 144.96658911"
43920231116,43,2023-11-16,9,133,49,182,UM2_T,"-37.79844526, 144.96411782"
452320231112,45,2023-11-12,23,61,119,180,Swa148_T,"-37.81414075, 144.96609379"
1622320250313,162,2025-03-13,23,171,67,238,Eli489_T,"-37.80740397, 144.95987909"
162920241118,162,2024-11-18,9,194,162,356,Eli489_T,"-37.80740397, 144.95987909"
1322120250427,132,2025-04-27,21,80,79,159,King335_T,"-37.81267639, 144.95386444"
1322220231028,132,2023-10-28,22,101,111,212,King335_T,"-37.81267639, 144.95386444"
1341220240328,134,2024-03-28,12,457,443,900,Spen201_T,"-37.81694221, 144.95303935"
134020240508,134,2024-05-08,0,39,29,68,Spen201_T,"-37.81694221, 144.95303935"
1312320240703,131,2024-07-03,23,15,25,40,King2_T,"-37.82009057, 144.95758725"
135120240429,135,2024-04-29,1,13,21,34,Spen161_T,"-37.8172861, 144.95319102"
1241620231202,124,2023-12-02,16,1,2,3,BirBridge_T,"-37.81757416, 144.97329934"
182020250420,182,2025-04-20,0,174,148,322,King163_T,"-37.81627451, 144.95550503"
1791420250513,179,2025-05-13,14,39,37,76,Pow61_T,"-37.82392385, 144.96299677"
165720241008,165,2024-10-08,7,14,30,44,Spen475_T,"-37.80953359, 144.94939004"
131320241204,131,2024-12-04,3,11,12,23,King2_T,"-37.82009057, 144.95758725"
162920250920,162,2025-09-20,9,324,346,670,Eli489_T,"-37.80740397, 144.95987909"
1671720250622,167,2025-06-22,17,23,55,78,Lat526_T,"-37.81304149, 144.95155955"
682220231128,68,2023-11-28,22,24,8,32,FLDegN_T,"-37.8168479, 144.96559789"
851420231201,85,2023-12-01,14,59,76,135,488Mac_T,"-37.79432415, 144.92973378"
85920250728,85,2025-07-28,9,71,52,123,488Mac_T,"-37.79432415, 144.92973378"
171520231119,17,2023-11-19,15,383,215,598,Col15_T,"-37.81362543, 144.97323591"
68520240923,68,2024-09-23,5,2,0,2,FLDegN_T,"-37.8168479, 144.96559789"
18720240223,18,2024-02-23,7,25,298,323,Col12_T,"-37.81344862, 144.97305353"
181920240921,18,2024-09-21,19,5,25,30,Col12_T,"-37.81344862, 144.97305353"
62320240418,62,2024-04-18,3,14,15,29,Lat224_T,"-37.80996494, 144.96216521"
112020240619,11,2024-06-19,20,31,35,66,WatCit_T,"-37.81564989, 144.93970694"
24420240728,24,2024-07-28,4,42,41,83,Col620_T,"-37.81887963, 144.95449198"
241820240925,24,2024-09-25,18,466,1247,1713,Col620_T,"-37.81887963, 144.95449198"
241720231115,24,2023-11-15,17,653,2514,3167,Col620_T,"-37.81887963, 144.95449198"
12120241225,12,2024-12-25,1,25,25,50,NewQ_T,"-37.81457988, 144.94292398"
762320231211,76,2023-12-11,23,2,2,4,KenMac_T,"-37.79453803, 144.93036194"
76820240529,76,2024-05-29,8,97,61,158,KenMac_T,"-37.79453803, 144.93036194"
721620250326,72,2025-03-26,16,170,663,833,ACMI_T,"-37.81726338, 144.96872809"
72720240113,72,2024-01-13,7,25,32,57,ACMI_T,"-37.81726338, 144.96872809"
21720231020,2,2023-10-20,17,713,596,1309,Bou283_T,"-37.81380668, 144.96516718"
351220250920,35,2025-09-20,12,962,1157,2119,SouthB_T,"-37.82018685, 144.96508508"
21920250512,2,2025-05-12,19,126,166,292,Bou283_T,"-37.81380668, 144.96516718"
21420250909,2,2025-09-09,14,635,646,1281,Bou283_T,"-37.81380668, 144.96516718"
792020241220,79,2024-12-20,20,737,502,1239,FliSS_T,"-37.81794046, 144.96616678"
79220250129,79,2025-01-29,2,8,14,22,FliSS_T,"-37.81794046, 144.96616678"
231820240530,23,2024-05-30,18,141,324,465,Col623_T,"-37.81909256, 144.95452748"
512020240526,51,2024-05-26,20,68,67,135,Fra118_T,"-37.80841815, 144.95906316"
201320241129,20,2024-11-29,13,149,263,412,LtB170_T,"-37.81172914, 144.9682466"
1381720240118,138,2024-01-18,17,16,5,21,EntPark1671_T,"-37.81996544, 144.95981454"
1611520240613,161,2024-06-13,15,55,38,93,BirArt1109_T,"-37.81851276, 144.97131336"
1172120250112,117,2025-01-12,21,150,102,252,Fli114F_T,"-37.81629332, 144.97090877"
123720241221,123,2024-12-21,7,8,7,15,BirBridge_T,"-37.81753741, 144.97329734"
141520240921,141,2024-09-21,5,24,41,65,474Fl_T,"-37.81997273, 144.95834911"
491220231224,49,2023-12-24,12,382,692,1074,Eli501_T,"-37.80730068, 144.95956055"
1391920250404,139,2025-04-04,19,37,27,64,Signal1647_T,"-37.81959923, 144.9632832"
139820240109,139,2024-01-09,8,24,282,306,Signal1647_T,"-37.81959923, 144.9632832"
702220250916,70,2025-09-16,22,72,66,138,Errol20_T,"-37.80456984, 144.94946228"
81420231025,8,2023-10-25,14,126,108,234,WebBN_T,"-37.82293543, 144.9471751"
8720250628,8,2025-06-28,7,22,39,61,WebBN_T,"-37.82293543, 144.9471751"
411120250125,41,2025-01-25,11,1884,1118,3002,Swa31,"-37.81668634, 144.96689733"
77220231106,77,2023-11-06,2,6,2,8,HarEsP_T,"-37.81441438, 144.94433026"
71220250411,71,2025-04-11,2,18,20,38,WestWP_T,"-37.81235775, 144.97136962"
71520240820,71,2024-08-20,5,10,8,18,WestWP_T,"-37.81235775, 144.97136962"
712320241013,71,2024-10-13,23,12,6,18,WestWP_T,"-37.81235775, 144.97136962"
291120240807,29,2024-08-07,11,130,232,362,AG_T,"-37.8199817, 144.96872865"
47320240421,47,2024-04-21,3,87,66,153,Eli250_T,"-37.81258467, 144.9625775"
1401820250117,140,2025-01-17,18,105,83,188,Boyd2837_T,"-37.82590962, 144.96185972"
1401320250614,140,2025-06-14,13,92,57,149,Boyd2837_T,"-37.82590962, 144.96185972"
17520231129,17,2023-11-29,5,55,19,74,Col15_T,"-37.81362543, 144.97323591"
171320240609,17,2024-06-09,13,175,101,276,Col15_T,"-37.81362543, 144.97323591"
1120250422,1,2025-04-22,1,4,7,11,Bou292_T,"-37.81349441, 144.96515323"
671320241217,67,2024-12-17,13,499,752,1251,FLDegS_T,"-37.81688755, 144.96562569"
68720240611,68,2024-06-11,7,15,6,21,FLDegN_T,"-37.8168479, 144.96559789"
671220240312,67,2024-03-12,12,491,662,1153,FLDegS_T,"-37.81688755, 144.96562569"
561920240306,56,2024-03-06,19,273,316,589,Lon364_T,"-37.81234775, 144.96153311"
11520241212,11,2024-12-12,5,9,9,18,WatCit_T,"-37.81564989, 144.93970694"
63020250501,63,2025-05-01,0,0,11,11,Bou231_T,"-37.81333081, 144.96675571"
101020240723,10,2024-07-23,10,65,54,119,BouHbr_T,"-37.81876474, 144.94710545"
241220241001,24,2024-10-01,12,892,852,1744,Col620_T,"-37.81887963, 144.95449198"
111120250720,11,2025-07-20,11,96,114,210,WatCit_T,"-37.81564989, 144.93970694"
721920240101,72,2024-01-01,19,106,135,241,ACMI_T,"-37.81726338, 144.96872809"
2420240615,2,2024-06-15,4,12,7,19,Bou283_T,"-37.81380668, 144.96516718"
58720250529,58,2025-05-29,7,758,96,854,Bou688_T,"-37.81686075, 144.95358075"
351920240703,35,2024-07-03,19,683,904,1587,SouthB_T,"-37.82018685, 144.96508508"
761920241228,76,2024-12-28,19,22,21,43,KenMac_T,"-37.79453803, 144.93036194"
53520231212,53,2023-12-12,5,11,12,23,Col254_T,"-37.81564191, 144.965499"
251420240202,25,2024-02-02,14,623,518,1141,MCEC_T,"-37.82401776, 144.95604426"
191920231023,19,2023-10-23,19,579,513,1092,LtB210_T,"-37.81237202, 144.96550671"
521420250126,52,2025-01-26,14,335,320,655,Eli263_T,"-37.81252157, 144.9619401"
521520250626,52,2025-06-26,15,469,268,737,Eli263_T,"-37.81252157, 144.9619401"
180420251005,180,2025-10-05,4,1,0,1,Mac330_T,"-37.79497059, 144.93530329"
136120231223,136,2023-12-23,1,1,0,1,BirFed1120_T,"-37.8184141, 144.97357915"
1422120231223,142,2023-12-23,21,3672,2141,5813,Hammer1584_T,"-37.81970749, 144.96795734"
1301220240729,130,2024-07-29,12,4,8,12,Bou892T,"-37.8204637, 144.94126826"
491220250209,49,2025-02-09,12,463,774,1237,Eli501_T,"-37.80730068, 144.95956055"
1172020231106,117,2023-11-06,20,165,216,381,Fli114F_T,"-37.81629332, 144.97090877"
681420250202,68,2025-02-02,14,186,210,396,FLDegN_T,"-37.8168479, 144.96559789"
17120240530,17,2024-05-30,1,8,11,19,Col15_T,"-37.81362543, 144.97323591"
682120240711,68,2024-07-11,21,20,9,29,FLDegN_T,"-37.8168479, 144.96559789"
181420241112,18,2024-11-12,14,334,175,509,Col12_T,"-37.81344862, 144.97305353"
631420250610,63,2025-06-10,14,248,364,612,Bou231_T,"-37.81333081, 144.96675571"
121920241218,12,2024-12-18,19,479,294,773,NewQ_T,"-37.81457988, 144.94292398"
12220251007,1,2025-10-07,22,101,94,195,Bou292_T,"-37.81349441, 144.96515323"
561220231115,56,2023-11-15,12,390,168,558,Lon364_T,"-37.81234775, 144.96153311"
62920240706,62,2024-07-06,9,70,76,146,Lat224_T,"-37.80996494, 144.96216521"
621420250109,62,2025-01-09,14,213,116,329,Lat224_T,"-37.80996494, 144.96216521"
24820240204,24,2024-02-04,8,161,171,332,Col620_T,"-37.81887963, 144.95449198"
241520240314,24,2024-03-14,15,624,1166,1790,Col620_T,"-37.81887963, 144.95449198"
111120250513,11,2025-05-13,11,67,64,131,WatCit_T,"-37.81564989, 144.93970694"
86420250517,86,2025-05-17,4,0,2,2,574Qub_T,"-37.80309992, 144.94908064"
12320250622,12,2025-06-22,3,0,1,1,NewQ_T,"-37.81457988, 144.94292398"
721220231207,72,2023-12-07,12,331,381,712,ACMI_T,"-37.81726338, 144.96872809"
2020231129,2,2023-11-29,0,7,27,34,Bou283_T,"-37.81380668, 144.96516718"
35820240422,35,2024-04-22,8,599,1867,2466,SouthB_T,"-37.82018685, 144.96508508"
761720241106,76,2024-11-06,17,52,66,118,KenMac_T,"-37.79453803, 144.93036194"
53120240624,53,2024-06-24,1,8,3,11,Col254_T,"-37.81564191, 144.965499"
531120241013,53,2024-10-13,11,552,446,998,Col254_T,"-37.81564191, 144.965499"
9520241023,9,2024-10-23,5,28,47,75,Col700_T,"-37.81982992, 144.95102555"
27020250218,27,2025-02-18,0,11,5,16,Vic_T,"-37.80606888, 144.95644692"
30520250201,30,2025-02-01,5,39,55,94,Lon189_T,"-37.8112185, 144.96656806"
46420240605,46,2024-06-05,4,3,0,3,Pel147_T,"-37.80240719, 144.9615673"
461720250414,46,2025-04-14,17,119,174,293,Pel147_T,"-37.80240719, 144.9615673"
117120240610,117,2024-06-10,1,46,8,54,Fli114F_T,"-37.81629332, 144.97090877"
109820250925,109,2025-09-25,8,98,489,587,LatWill_T,"-37.81193681, 144.95621105"
191120241118,19,2024-11-18,11,374,226,600,LtB210_T,"-37.81237202, 144.96550671"
1362020241109,136,2024-11-09,20,188,16,204,BirFed1120_T,"-37.8184141, 144.97357915"
1361420241125,136,2024-11-25,14,27,64,91,BirFed1120_T,"-37.8184141, 144.97357915"
84520240430,84,2024-04-30,5,69,38,107,ElFi_T,"-37.81798049, 144.96503383"
841820241127,84,2024-11-27,18,873,1408,2281,ElFi_T,"-37.81798049, 144.96503383"
842120250906,84,2025-09-06,21,567,696,1263,ElFi_T,"-37.81798049, 144.96503383"
66520240402,66,2024-04-02,5,2,16,18,QVN_T,"-37.81057846, 144.96444294"
70520240810,70,2024-08-10,5,2,2,4,Errol20_T,"-37.80456984, 144.94946228"
3320250403,3,2025-04-03,3,17,11,28,Swa295_T,"-37.81101524, 144.96429485"
3620240331,3,2024-03-31,6,46,55,101,Swa295_T,"-37.81101524, 144.96429485"
41420231112,41,2023-11-12,4,74,93,167,Swa31,"-37.81668634, 144.96689733"
772320250223,77,2025-02-23,23,36,23,59,HarEsP_T,"-37.81441438, 144.94433026"
591120240630,59,2024-06-30,11,439,330,769,RMIT_T,"-37.80825648, 144.96304859"
54120231228,54,2023-12-28,1,11,6,17,Swa607_T,"-37.804024, 144.96308399"
541820240220,54,2024-02-20,18,205,245,450,Swa607_T,"-37.804024, 144.96308399"
28020250623,28,2025-06-23,0,11,3,14,VAC_T,"-37.82129925, 144.96879309"
401320231211,40,2023-12-11,13,305,261,566,Spr201_T,"-37.80999341, 144.97227587"
402220250509,40,2025-05-09,22,211,37,248,Spr201_T,"-37.80999341, 144.97227587"
40520250202,40,2025-02-02,5,12,2,14,Spr201_T,"-37.80999341, 144.97227587"
542120250516,54,2025-05-16,21,131,172,303,Swa607_T,"-37.804024, 144.96308399"
541920250624,54,2025-06-24,19,124,123,247,Swa607_T,"-37.804024, 144.96308399"
45820240527,45,2024-05-27,8,280,231,511,Swa148_T,"-37.81414075, 144.96609379"
36220240129,36,2024-01-29,2,5,1,6,Que85_T,"-37.81652527, 144.96121062"
871020250312,87,2025-03-12,10,125,113,238,Errol23_T,"-37.80454949, 144.94921863"
108620240117,108,2024-01-17,6,35,251,286,261Will_T,"-37.81295822, 144.95678789"
43520240115,43,2024-01-15,5,3,5,8,UM2_T,"-37.79844526, 144.96411782"
1661520250624,166,2025-06-24,15,44,32,76,Spen484_T,"-37.80896733, 144.94931703"
140720240805,140,2024-08-05,7,77,19,96,Boyd2837_T,"-37.82590962, 144.96185972"
140720240406,140,2024-04-06,7,15,3,18,Boyd2837_T,"-37.82590962, 144.96185972"
162320240721,162,2024-07-21,3,37,42,79,Eli489_T,"-37.80740397, 144.95987909"
132720250311,132,2025-03-11,7,68,51,119,King335_T,"-37.81267639, 144.95386444"
1342120250125,134,2025-01-25,21,311,270,581,Spen201_T,"-37.81694221, 144.95303935"
1321820250507,132,2025-05-07,18,170,219,389,King335_T,"-37.81267639, 144.95386444"
1331320250622,133,2025-06-22,13,417,470,887,Spen229_T,"-37.81531435, 144.95227769"
1331520250625,133,2025-06-25,15,381,406,787,Spen229_T,"-37.81531435, 144.95227769"
1331620240408,133,2024-04-08,16,491,590,1081,Spen229_T,"-37.81531435, 144.95227769"
1181920231119,118,2023-11-19,19,16,11,27,Fli114C_T,"-37.81632783, 144.97090512"
1241120250623,124,2025-06-23,11,1,4,5,BirBridge_T,"-37.81757416, 144.97329934"
67820240820,67,2024-08-20,8,372,313,685,FLDegS_T,"-37.81688755, 144.96562569"
181620240607,18,2024-06-07,16,250,85,335,Col12_T,"-37.81344862, 144.97305353"
631620240805,63,2024-08-05,16,248,333,581,Bou231_T,"-37.81333081, 144.96675571"
58220240604,58,2024-06-04,2,15,7,22,Bou688_T,"-37.81686075, 144.95358075"
76520250909,76,2025-09-09,5,1,2,3,KenMac_T,"-37.79453803, 144.93036194"
521020240303,52,2024-03-03,10,183,131,314,Eli263_T,"-37.81252157, 144.9619401"
231920240726,23,2024-07-26,19,164,293,457,Col623_T,"-37.81909256, 144.95452748"
191420250412,19,2025-04-12,14,648,640,1288,LtB210_T,"-37.81237202, 144.96550671"
251320240220,25,2024-02-20,13,507,561,1068,MCEC_T,"-37.82401776, 144.95604426"
201520250808,20,2025-08-08,15,222,239,461,LtB170_T,"-37.81172914, 144.9682466"
302020241216,30,2024-12-16,20,169,271,440,Lon189_T,"-37.8112185, 144.96656806"
201820240730,20,2024-07-30,18,346,249,595,LtB170_T,"-37.81172914, 144.9682466"
139720250806,139,2025-08-06,7,18,139,157,Signal1647_T,"-37.81959923, 144.9632832"
49020241227,49,2024-12-27,0,42,48,90,Eli501_T,"-37.80730068, 144.95956055"
491920241105,49,2024-11-05,19,229,223,452,Eli501_T,"-37.80730068, 144.95956055"
1091720240323,109,2024-03-23,17,136,142,278,LatWill_T,"-37.81193681, 144.95621105"
661420251016,66,2025-10-16,14,996,1176,2172,QVN_T,"-37.81057846, 144.96444294"
661220240106,66,2024-01-06,12,761,752,1513,QVN_T,"-37.81057846, 144.96444294"
391220240817,39,2024-08-17,12,65,61,126,AlfPl_T,"-37.81379749, 144.96995745"
41420241118,41,2024-11-18,4,33,42,75,Swa31,"-37.81668634, 144.96689733"
71320250801,71,2025-08-01,3,9,9,18,WestWP_T,"-37.81235775, 144.97136962"
71720240424,71,2024-04-24,7,21,16,37,WestWP_T,"-37.81235775, 144.97136962"
712220250330,71,2025-03-30,22,0,1,1,WestWP_T,"-37.81235775, 144.97136962"
651720241013,65,2024-10-13,17,784,550,1334,SwaCs_T,"-37.81569416, 144.9668064"
771620250311,77,2025-03-11,16,146,80,226,HarEsP_T,"-37.81441438, 144.94433026"
28920241102,28,2024-11-02,9,142,160,302,VAC_T,"-37.82129925, 144.96879309"
282220240106,28,2024-01-06,22,263,191,454,VAC_T,"-37.82129925, 144.96879309"
401020240225,40,2024-02-25,10,72,113,185,Spr201_T,"-37.80999341, 144.97227587"
371020250315,37,2025-03-15,10,60,100,160,Lyg260_T,"-37.80107122, 144.96704554"
361820240612,36,2024-06-12,18,180,182,362,Que85_T,"-37.81652527, 144.96121062"
47620240528,47,2024-05-28,6,48,179,227,Eli250_T,"-37.81258467, 144.9625775"
442320250215,44,2025-02-15,23,6,1,7,UM3_T,"-37.79698741, 144.96441306"
441520250218,44,2025-02-18,15,63,53,116,UM3_T,"-37.79698741, 144.96441306"
44820250929,44,2025-09-29,8,32,37,69,UM3_T,"-37.79698741, 144.96441306"
43620231224,43,2023-12-24,6,6,0,6,UM2_T,"-37.79844526, 144.96411782"
452020250428,45,2025-04-28,20,103,360,463,Swa148_T,"-37.81414075, 144.96609379"
45420231222,45,2023-12-22,4,7,54,61,Swa148_T,"-37.81414075, 144.96609379"
182620250923,182,2025-09-23,6,32,49,81,King163_T,"-37.81627451, 144.95550503"
135320250327,135,2025-03-27,3,22,14,36,Spen161_T,"-37.8172861, 144.95319102"
1181120240617,118,2024-06-17,11,14,12,26,Fli114C_T,"-37.81632783, 144.97090512"
63920240927,63,2024-09-27,9,127,136,263,Bou231_T,"-37.81333081, 144.96675571"
632120250627,63,2025-06-27,21,62,250,312,Bou231_T,"-37.81333081, 144.96675571"
622320250104,62,2025-01-04,23,49,34,83,Lat224_T,"-37.80996494, 144.96216521"
861820240316,86,2024-03-16,18,58,55,113,574Qub_T,"-37.80309992, 144.94908064"
86320240428,86,2024-04-28,3,0,1,1,574Qub_T,"-37.80309992, 144.94908064"
242120241220,24,2024-12-20,21,285,560,845,Col620_T,"-37.81887963, 144.95449198"
242120240821,24,2024-08-21,21,268,404,672,Col620_T,"-37.81887963, 144.95449198"
35420231210,35,2023-12-10,4,28,38,66,SouthB_T,"-37.82018685, 144.96508508"
91620250312,9,2025-03-12,16,2583,126,2709,Col700_T,"-37.81982992, 144.95102555"
532220250203,53,2025-02-03,22,47,102,149,Col254_T,"-37.81564191, 144.965499"
511320250207,51,2025-02-07,13,83,84,167,Fra118_T,"-37.80841815, 144.95906316"
512120240904,51,2024-09-04,21,47,70,117,Fra118_T,"-37.80841815, 144.95906316"
23820250716,23,2025-07-16,8,889,466,1355,Col623_T,"-37.81909256, 144.95452748"
252220250805,25,2025-08-05,22,376,78,454,MCEC_T,"-37.82401776, 144.95604426"
52220240917,52,2024-09-17,2,4,4,8,Eli263_T,"-37.81252157, 144.9619401"
46920250906,46,2025-09-06,9,22,15,37,Pel147_T,"-37.80240719, 144.9615673"
1612120250821,161,2025-08-21,21,6,38,44,BirArt1109_T,"-37.81851276, 144.97131336"
1171320250307,117,2025-03-07,13,179,181,360,Fli114F_T,"-37.81629332, 144.97090877"
481120250826,48,2025-08-26,11,266,150,416,QVMQ_T,"-37.80631581, 144.95866697"
1421020240716,142,2024-07-16,10,178,86,264,Hammer1584_T,"-37.81970749, 144.96795734"
661720250114,66,2025-01-14,17,1220,1161,2381,QVN_T,"-37.81057846, 144.96444294"
84120240626,84,2024-06-26,1,16,26,42,ElFi_T,"-37.81798049, 144.96503383"
701320240125,70,2024-01-25,13,162,172,334,Errol20_T,"-37.80456984, 144.94946228"
31120250605,3,2025-06-05,11,485,570,1055,Swa295_T,"-37.81101524, 144.96429485"
31020240228,3,2024-02-28,10,445,535,980,Swa295_T,"-37.81101524, 144.96429485"
411620240721,41,2024-07-21,16,269,231,500,Swa31,"-37.81668634, 144.96689733"
81720240618,8,2024-06-18,17,230,351,581,WebBN_T,"-37.82293543, 144.9471751"
78420241020,78,2024-10-20,4,2,5,7,HarEsB_T,"-37.81471642, 144.9446508"
772120250806,77,2025-08-06,21,90,61,151,HarEsP_T,"-37.81441438, 144.94433026"
14920250825,14,2025-08-25,9,202,206,408,SanBri_T,"-37.82011242, 144.96291897"
652120240723,65,2024-07-23,21,217,215,432,SwaCs_T,"-37.81569416, 144.9668064"
28420240508,28,2024-05-08,4,1,20,21,VAC_T,"-37.82129925, 144.96879309"
472220250225,47,2025-02-25,22,219,186,405,Eli250_T,"-37.81258467, 144.9625775"
211220240120,21,2024-01-20,12,422,467,889,Bourke155_T,"-37.81267313, 144.96788288"
211220240206,21,2024-02-06,12,575,465,1040,Bourke155_T,"-37.81267313, 144.96788288"
1171620240315,117,2024-03-15,16,201,330,531,Fli114F_T,"-37.81629332, 144.97090877"
492220240624,49,2024-06-24,22,113,56,169,Eli501_T,"-37.80730068, 144.95956055"
492020240726,49,2024-07-26,20,202,178,380,Eli501_T,"-37.80730068, 144.95956055"
19120241021,19,2024-10-21,1,31,37,68,LtB210_T,"-37.81237202, 144.96550671"
19220250512,19,2025-05-12,2,31,15,46,LtB210_T,"-37.81237202, 144.96550671"
482020241201,48,2024-12-01,20,86,74,160,QVMQ_T,"-37.80631581, 144.95866697"
482220240418,48,2024-04-18,22,51,56,107,QVMQ_T,"-37.80631581, 144.95866697"
681420240220,68,2024-02-20,14,268,172,440,FLDegN_T,"-37.8168479, 144.96559789"
1620240114,1,2024-01-14,6,8,9,17,Bou292_T,"-37.81349441, 144.96515323"
118120250113,118,2025-01-13,1,2,4,6,Fli114C_T,"-37.81632783, 144.97090512"
1181120250307,118,2025-03-07,11,10,13,23,Fli114C_T,"-37.81632783, 144.97090512"
611420250128,61,2025-01-28,14,431,412,843,RMIT14_T,"-37.80767455, 144.96309114"
691420240721,69,2024-07-21,14,241,204,445,FLDegC_T,"-37.81687226, 144.96559144"
61920240725,6,2024-07-25,19,555,520,1075,FliS_T,"-37.81911705, 144.96558255"
842120240302,84,2024-03-02,21,878,909,1787,ElFi_T,"-37.81798049, 144.96503383"
702220240907,70,2024-09-07,22,179,93,272,Errol20_T,"-37.80456984, 144.94946228"
701320250911,70,2025-09-11,13,154,160,314,Errol20_T,"-37.80456984, 144.94946228"
81920231112,8,2023-11-12,19,70,85,155,WebBN_T,"-37.82293543, 144.9471751"
772020240403,77,2024-04-03,20,121,121,242,HarEsP_T,"-37.81441438, 144.94433026"
141820240930,14,2024-09-30,18,443,192,635,SanBri_T,"-37.82011242, 144.96291897"
71220240204,71,2024-02-04,2,3,2,5,WestWP_T,"-37.81235775, 144.97136962"
711420240727,71,2024-07-27,14,1,5,6,WestWP_T,"-37.81235775, 144.97136962"
281920240809,28,2024-08-09,19,794,589,1383,VAC_T,"-37.82129925, 144.96879309"
29220250524,29,2025-05-24,2,5,13,18,AG_T,"-37.8199817, 144.96872865"
31020240727,31,2024-07-27,0,26,71,97,Lyg161_T,"-37.80169681, 144.96658911"
311020250709,31,2025-07-09,10,75,74,149,Lyg161_T,"-37.80169681, 144.96658911"
40320241125,40,2024-11-25,3,0,2,2,Spr201_T,"-37.80999341, 144.97227587"
37020240902,37,2024-09-02,0,26,33,59,Lyg260_T,"-37.80107122, 144.96704554"
501120240506,50,2024-05-06,11,146,154,300,Lyg309_T,"-37.79808192, 144.96721013"
612120250312,61,2025-03-12,21,383,421,804,RMIT14_T,"-37.80767455, 144.96309114"
431120250316,43,2025-03-16,11,24,21,45,UM2_T,"-37.79844526, 144.96411782"
1622220250119,162,2025-01-19,22,219,97,316,Eli489_T,"-37.80740397, 144.95987909"
1341720250113,134,2025-01-13,17,656,481,1137,Spen201_T,"-37.81694221, 144.95303935"
1311320240812,131,2024-08-12,13,172,209,381,King2_T,"-37.82009057, 144.95758725"
135620240506,135,2024-05-06,6,35,42,77,Spen161_T,"-37.8172861, 144.95319102"
135020240725,135,2024-07-25,0,16,19,35,Spen161_T,"-37.8172861, 144.95319102"
133620250117,133,2025-01-17,6,315,213,528,Spen229_T,"-37.81531435, 144.95227769"
1181020250120,118,2025-01-20,10,9,49,58,Fli114C_T,"-37.81632783, 144.97090512"
87920240616,87,2024-06-16,9,48,57,105,Errol23_T,"-37.80454949, 144.94921863"
165120250527,165,2025-05-27,1,3,1,4,Spen475_T,"-37.80953359, 144.94939004"
682120241004,68,2024-10-04,21,122,43,165,FLDegN_T,"-37.8168479, 144.96559789"
1720240109,1,2024-01-09,7,54,54,108,Bou292_T,"-37.81349441, 144.96515323"
11220241113,1,2024-11-13,12,927,595,1522,Bou292_T,"-37.81349441, 144.96515323"
1020241224,1,2024-12-24,0,35,68,103,Bou292_T,"-37.81349441, 144.96515323"
671020250514,67,2025-05-14,10,352,466,818,FLDegS_T,"-37.81688755, 144.96562569"
681020250106,68,2025-01-06,10,49,35,84,FLDegN_T,"-37.8168479, 144.96559789"
68020250108,68,2025-01-08,0,3,1,4,FLDegN_T,"-37.8168479, 144.96559789"
18520250327,18,2025-03-27,5,2,13,15,Col12_T,"-37.81344862, 144.97305353"
11720250709,1,2025-07-09,17,1515,1090,2605,Bou292_T,"-37.81349441, 144.96515323"
561020240316,56,2024-03-16,10,241,135,376,Lon364_T,"-37.81234775, 144.96153311"
86620231216,86,2023-12-16,6,5,8,13,574Qub_T,"-37.80309992, 144.94908064"
24720240902,24,2024-09-02,7,632,182,814,Col620_T,"-37.81887963, 144.95449198"
11520250624,11,2025-06-24,5,6,3,9,WatCit_T,"-37.81564989, 144.93970694"
24120250310,24,2025-03-10,1,44,32,76,Col620_T,"-37.81887963, 144.95449198"
72320250619,72,2025-06-19,3,4,1,5,ACMI_T,"-37.81726338, 144.96872809"
721320241229,72,2024-12-29,13,232,430,662,ACMI_T,"-37.81726338, 144.96872809"
1120240508,1,2024-05-08,1,8,18,26,Bou292_T,"-37.81349441, 144.96515323"
681720240503,68,2024-05-03,17,182,54,236,FLDegN_T,"-37.8168479, 144.96559789"
56220241026,56,2024-10-26,2,43,30,73,Lon364_T,"-37.81234775, 144.96153311"
86020231019,86,2023-10-19,0,1,2,3,574Qub_T,"-37.80309992, 144.94908064"
862220240301,86,2024-03-01,22,5,55,60,574Qub_T,"-37.80309992, 144.94908064"
111520241228,11,2024-12-28,15,72,41,113,WatCit_T,"-37.81564989, 144.93970694"
241720250119,24,2025-01-19,17,398,557,955,Col620_T,"-37.81887963, 144.95449198"
58220240213,58,2024-02-13,2,20,31,51,Bou688_T,"-37.81686075, 144.95358075"
531220240622,53,2024-06-22,12,793,538,1331,Col254_T,"-37.81564191, 144.965499"
531220240424,53,2024-04-24,12,943,794,1737,Col254_T,"-37.81564191, 144.965499"
91720231107,9,2023-11-07,17,427,64,491,Col700_T,"-37.81982992, 144.95102555"
792120241123,79,2024-11-23,21,341,419,760,FliSS_T,"-37.81794046, 144.96616678"
53520250106,53,2025-01-06,5,6,3,9,Col254_T,"-37.81564191, 144.965499"
512220240131,51,2024-01-31,22,53,57,110,Fra118_T,"-37.80841815, 144.95906316"
512120240205,51,2024-02-05,21,44,47,91,Fra118_T,"-37.80841815, 144.95906316"
23020240612,23,2024-06-12,0,18,9,27,Col623_T,"-37.81909256, 144.95452748"
251220240317,25,2024-03-17,12,682,645,1327,MCEC_T,"-37.82401776, 144.95604426"
25120240405,25,2024-04-05,1,5,10,15,MCEC_T,"-37.82401776, 144.95604426"
25320250817,25,2025-08-17,3,4,26,30,MCEC_T,"-37.82401776, 144.95604426"
201220240527,20,2024-05-27,12,215,227,442,LtB170_T,"-37.81172914, 144.9682466"
20220250104,20,2025-01-04,2,18,45,63,LtB170_T,"-37.81172914, 144.9682466"
522020250826,52,2025-08-26,20,221,133,354,Eli263_T,"-37.81252157, 144.9619401"
502320240730,50,2024-07-30,23,9,1,10,Lyg309_T,"-37.79808192, 144.96721013"
1621920250819,162,2025-08-19,19,239,219,458,Eli489_T,"-37.80740397, 144.95987909"
143720240628,143,2024-06-28,7,90,180,270,Spencer_T,"-37.821728, 144.95557015"
1322220250311,132,2025-03-11,22,100,84,184,King335_T,"-37.81267639, 144.95386444"
1181920240920,118,2024-09-20,19,8,13,21,Fli114C_T,"-37.81632783, 144.97090512"
851820241111,85,2024-11-11,18,67,73,140,488Mac_T,"-37.79432415, 144.92973378"
85120251011,85,2025-10-11,1,0,1,1,488Mac_T,"-37.79432415, 144.92973378"
171920240214,17,2024-02-14,19,157,181,338,Col15_T,"-37.81362543, 144.97323591"
63620231025,63,2023-10-25,6,29,49,78,Bou231_T,"-37.81333081, 144.96675571"
681720250322,68,2025-03-22,17,319,286,605,FLDegN_T,"-37.8168479, 144.96559789"
56720241109,56,2024-11-09,7,51,26,77,Lon364_T,"-37.81234775, 144.96153311"
861820240427,86,2024-04-27,18,57,48,105,574Qub_T,"-37.80309992, 144.94908064"
241220231130,24,2023-11-30,12,756,726,1482,Col620_T,"-37.81887963, 144.95449198"
102020240419,10,2024-04-19,20,27,18,45,BouHbr_T,"-37.81876474, 144.94710545"
121420250504,12,2025-05-04,14,243,214,457,NewQ_T,"-37.81457988, 144.94292398"
761420231024,76,2023-10-24,14,41,38,79,KenMac_T,"-37.79453803, 144.93036194"
722320250114,72,2025-01-14,23,57,280,337,ACMI_T,"-37.81726338, 144.96872809"
721420250302,72,2025-03-02,14,288,303,591,ACMI_T,"-37.81726338, 144.96872809"
47220231201,47,2023-12-01,2,21,19,40,Eli250_T,"-37.81258467, 144.9625775"
31020240105,31,2024-01-05,0,20,41,61,Lyg161_T,"-37.80169681, 144.96658911"
54020241017,54,2024-10-17,0,35,57,92,Swa607_T,"-37.804024, 144.96308399"
362220240316,36,2024-03-16,22,112,188,300,Que85_T,"-37.81652527, 144.96121062"
442320240205,44,2024-02-05,23,48,1,49,UM3_T,"-37.79698741, 144.96441306"
45720250516,45,2025-05-16,7,102,93,195,Swa148_T,"-37.81414075, 144.96609379"
45520250726,45,2025-07-26,5,6,25,31,Swa148_T,"-37.81414075, 144.96609379"
51820250621,5,2025-06-21,18,784,823,1607,PriNW_T,"-37.81874249, 144.96787656"
1072320231230,107,2023-12-30,23,25,46,71,280Will_T,"-37.81246271, 144.95690188"
1071720240427,107,2024-04-27,17,101,107,208,280Will_T,"-37.81246271, 144.95690188"
1071120240525,107,2024-05-25,11,87,139,226,280Will_T,"-37.81246271, 144.95690188"
1332220250308,133,2025-03-08,22,342,291,633,Spen229_T,"-37.81531435, 144.95227769"
118920250806,118,2025-08-06,9,23,16,39,Fli114C_T,"-37.81632783, 144.97090512"
1241620250904,124,2025-09-04,16,3,2,5,BirBridge_T,"-37.81757416, 144.97329934"
1241720231226,124,2023-12-26,17,0,2,2,BirBridge_T,"-37.81757416, 144.97329934"
108020240224,108,2024-02-24,0,59,43,102,261Will_T,"-37.81295822, 144.95678789"
108520250201,108,2025-02-01,5,19,19,38,261Will_T,"-37.81295822, 144.95678789"
872020250714,87,2025-07-14,20,31,39,70,Errol23_T,"-37.80454949, 144.94921863"
871620250306,87,2025-03-06,16,81,95,176,Errol23_T,"-37.80454949, 144.94921863"
431720250718,43,2025-07-18,17,160,174,334,UM2_T,"-37.79844526, 144.96411782"
1311720241213,131,2024-12-13,17,163,165,328,King2_T,"-37.82009057, 144.95758725"
167620250917,167,2025-09-17,6,12,26,38,Lat526_T,"-37.81304149, 144.95155955"
162520241009,162,2024-10-09,5,12,14,26,Eli489_T,"-37.80740397, 144.95987909"
1322020250825,132,2025-08-25,20,103,120,223,King335_T,"-37.81267639, 144.95386444"
1341120241124,134,2024-11-24,11,316,375,691,Spen201_T,"-37.81694221, 144.95303935"
134220250811,134,2025-08-11,2,13,17,30,Spen201_T,"-37.81694221, 144.95303935"
131020241018,131,2024-10-18,0,32,30,62,King2_T,"-37.82009057, 144.95758725"
1422020240508,142,2024-05-08,20,106,94,200,Hammer1584_T,"-37.81970749, 144.96795734"
1171320231110,117,2023-11-10,13,219,212,431,Fli114F_T,"-37.81629332, 144.97090877"
1371920251011,137,2025-10-11,19,11,28,39,BouHbr2353_T,"-37.81894815, 144.94612292"
139520241231,139,2024-12-31,5,4,0,4,Signal1647_T,"-37.81959923, 144.9632832"
85520240523,85,2024-05-23,5,4,2,6,488Mac_T,"-37.79432415, 144.92973378"
17020240505,17,2024-05-05,0,32,27,59,Col15_T,"-37.81362543, 144.97323591"
17120250925,17,2025-09-25,1,3,1,4,Col15_T,"-37.81362543, 144.97323591"
63820250718,63,2025-07-18,8,136,151,287,Bou231_T,"-37.81333081, 144.96675571"
18220241228,18,2024-12-28,2,1,1,2,Col12_T,"-37.81344862, 144.97305353"
621020250529,62,2025-05-29,10,121,74,195,Lat224_T,"-37.80996494, 144.96216521"
561220231225,56,2023-12-25,12,111,120,231,Lon364_T,"-37.81234775, 144.96153311"
561720240624,56,2024-06-24,17,413,401,814,Lon364_T,"-37.81234775, 144.96153311"
10120250405,10,2025-04-05,1,2,4,6,BouHbr_T,"-37.81876474, 144.94710545"
722120250405,72,2025-04-05,21,408,345,753,ACMI_T,"-37.81726338, 144.96872809"
271120250420,27,2025-04-20,11,208,192,400,Vic_T,"-37.80606888, 144.95644692"
231220240904,23,2024-09-04,12,431,531,962,Col623_T,"-37.81909256, 144.95452748"
512020240802,51,2024-08-02,20,58,61,119,Fra118_T,"-37.80841815, 144.95906316"
201220250923,20,2025-09-23,12,252,312,564,LtB170_T,"-37.81172914, 144.9682466"
302320250925,30,2025-09-25,23,312,407,719,Lon189_T,"-37.8112185, 144.96656806"
1421520250610,142,2025-06-10,15,240,184,424,Hammer1584_T,"-37.81970749, 144.96795734"
61620240118,6,2024-01-18,16,1790,1064,2854,FliS_T,"-37.81911705, 144.96558255"
352120241117,35,2024-11-17,21,585,973,1558,SouthB_T,"-37.82018685, 144.96508508"
35420250510,35,2025-05-10,4,16,18,34,SouthB_T,"-37.82018685, 144.96508508"
271220240618,27,2024-06-18,12,179,142,321,Vic_T,"-37.80606888, 144.95644692"
91720240506,9,2024-05-06,17,2595,157,2752,Col700_T,"-37.81982992, 144.95102555"
91520241013,9,2024-10-13,15,68,69,137,Col700_T,"-37.81982992, 144.95102555"
791320240527,79,2024-05-27,13,408,314,722,FliSS_T,"-37.81794046, 144.96616678"
791320250411,79,2025-04-11,13,622,530,1152,FliSS_T,"-37.81794046, 144.96616678"
232120250916,23,2025-09-16,21,62,124,186,Col623_T,"-37.81909256, 144.95452748"
25820231206,25,2023-12-06,8,292,818,1110,MCEC_T,"-37.82401776, 144.95604426"
251920250828,25,2025-08-28,19,301,330,631,MCEC_T,"-37.82401776, 144.95604426"
481120250117,48,2025-01-17,11,275,236,511,QVMQ_T,"-37.80631581, 144.95866697"
19920250419,19,2025-04-19,9,94,94,188,LtB210_T,"-37.81237202, 144.96550671"
1361520241009,136,2024-10-09,15,113,95,208,BirFed1120_T,"-37.8184141, 144.97357915"
1421720240608,142,2024-06-08,17,462,369,831,Hammer1584_T,"-37.81970749, 144.96795734"
1301920250807,130,2025-08-07,19,8,12,20,Bou892T,"-37.8204637, 144.94126826"
1381520240127,138,2024-01-27,15,18,9,27,EntPark1671_T,"-37.81996544, 144.95981454"
1171020250528,117,2025-05-28,10,136,108,244,Fli114F_T,"-37.81629332, 144.97090877"
66320240210,66,2024-02-10,3,31,20,51,QVN_T,"-37.81057846, 144.96444294"
4220240801,4,2024-08-01,2,15,6,21,Swa123_T,"-37.81487988, 144.9660878"
4520251009,4,2025-10-09,5,42,27,69,Swa123_T,"-37.81487988, 144.9660878"
39520231214,39,2023-12-14,5,13,9,22,AlfPl_T,"-37.81379749, 144.96995745"
41420231026,41,2023-10-26,4,27,56,83,Swa31,"-37.81668634, 144.96689733"
78320250502,78,2025-05-02,3,0,4,4,HarEsB_T,"-37.81471642, 144.9446508"
14320241009,14,2024-10-09,3,1,0,1,SanBri_T,"-37.82011242, 144.96291897"
591920231105,59,2023-11-05,19,583,370,953,RMIT_T,"-37.80825648, 144.96304859"
711320231126,71,2023-11-26,13,2,2,4,WestWP_T,"-37.81235775, 144.97136962"
54120240331,54,2024-03-31,1,26,18,44,Swa607_T,"-37.804024, 144.96308399"
36520250101,36,2025-01-01,5,28,13,41,Que85_T,"-37.81652527, 144.96121062"
36220250223,36,2025-02-23,2,133,106,239,Que85_T,"-37.81652527, 144.96121062"
441320240303,44,2024-03-03,13,17,16,33,UM3_T,"-37.79698741, 144.96441306"
451320240717,45,2024-07-17,13,819,909,1728,Swa148_T,"-37.81414075, 144.96609379"
52020251011,5,2025-10-11,20,1048,885,1933,PriNW_T,"-37.81874249, 144.96787656"
5820240417,5,2024-04-17,8,382,1082,1464,PriNW_T,"-37.81874249, 144.96787656"
51320240728,5,2024-07-28,13,956,1024,1980,PriNW_T,"-37.81874249, 144.96787656"
1321320241226,132,2024-12-26,13,89,89,178,King335_T,"-37.81267639, 144.95386444"
1331820231205,133,2023-12-05,18,745,595,1340,Spen229_T,"-37.81531435, 144.95227769"
872320240311,87,2024-03-11,23,3,8,11,Errol23_T,"-37.80454949, 144.94921863"
70120240629,70,2024-06-29,1,2,4,6,Errol20_T,"-37.80456984, 144.94946228"
391120240929,39,2024-09-29,11,46,60,106,AlfPl_T,"-37.81379749, 144.96995745"
81120240317,8,2024-03-17,11,139,540,679,WebBN_T,"-37.82293543, 144.9471751"
781520241204,78,2024-12-04,15,28,97,125,HarEsB_T,"-37.81471642, 144.9446508"
78320250614,78,2025-06-14,3,0,1,1,HarEsB_T,"-37.81471642, 144.9446508"
78420240225,78,2024-02-25,4,0,3,3,HarEsB_T,"-37.81471642, 144.9446508"
14420250224,14,2025-02-24,4,23,0,23,SanBri_T,"-37.82011242, 144.96291897"
14020250929,14,2025-09-29,0,19,4,23,SanBri_T,"-37.82011242, 144.96291897"
282020250216,28,2025-02-16,20,186,525,711,VAC_T,"-37.82129925, 144.96879309"
312020241213,31,2024-12-13,20,285,302,587,Lyg161_T,"-37.80169681, 144.96658911"
471920250425,47,2025-04-25,19,652,600,1252,Eli250_T,"-37.81258467, 144.9625775"
471220250621,47,2025-06-21,12,946,1025,1971,Eli250_T,"-37.81258467, 144.9625775"
51120250309,5,2025-03-09,11,916,1465,2381,PriNW_T,"-37.81874249, 144.96787656"
611120240612,61,2024-06-12,11,243,378,621,RMIT14_T,"-37.80767455, 144.96309114"
501920250930,50,2025-09-30,19,174,131,305,Lyg309_T,"-37.79808192, 144.96721013"
50220240212,50,2024-02-12,2,1,0,1,Lyg309_T,"-37.79808192, 144.96721013"
441420240505,44,2024-05-05,14,53,38,91,UM3_T,"-37.79698741, 144.96441306"
44820250723,44,2025-07-23,8,43,55,98,UM3_T,"-37.79698741, 144.96441306"
143020250905,143,2025-09-05,0,44,26,70,Spencer_T,"-37.821728, 144.95557015"
1401420231130,140,2023-11-30,14,53,50,103,Boyd2837_T,"-37.82590962, 144.96185972"
132320241117,132,2024-11-17,3,32,15,47,King335_T,"-37.81267639, 144.95386444"
1342020240227,134,2024-02-27,20,312,265,577,Spen201_T,"-37.81694221, 144.95303935"
134920250214,134,2025-02-14,9,263,357,620,Spen201_T,"-37.81694221, 144.95303935"
135920240620,135,2024-06-20,9,270,309,579,Spen161_T,"-37.8172861, 144.95319102"
1331120241028,133,2024-10-28,11,370,361,731,Spen229_T,"-37.81531435, 144.95227769"
1081520241014,108,2024-10-14,15,376,168,544,261Will_T,"-37.81295822, 144.95678789"
166020250820,166,2025-08-20,0,1,2,3,Spen484_T,"-37.80896733, 144.94931703"
166520240928,166,2024-09-28,5,1,2,3,Spen484_T,"-37.80896733, 144.94931703"
1791720250407,179,2025-04-07,17,77,93,170,Pow61_T,"-37.82392385, 144.96299677"
167420250822,167,2025-08-22,4,0,3,3,Lat526_T,"-37.81304149, 144.95155955"
681320231206,68,2023-12-06,13,370,139,509,FLDegN_T,"-37.8168479, 144.96559789"
852320240512,85,2024-05-12,23,1,5,6,488Mac_T,"-37.79432415, 144.92973378"
85620240604,85,2024-06-04,6,27,14,41,488Mac_T,"-37.79432415, 144.92973378"
851820240808,85,2024-08-08,18,50,84,134,488Mac_T,"-37.79432415, 144.92973378"
171920240509,17,2024-05-09,19,106,139,245,Col15_T,"-37.81362543, 144.97323591"
172320241028,17,2024-10-28,23,19,18,37,Col15_T,"-37.81362543, 144.97323591"
17420250828,17,2025-08-28,4,5,3,8,Col15_T,"-37.81362543, 144.97323591"
1820231114,1,2023-11-14,8,233,280,513,Bou292_T,"-37.81349441, 144.96515323"
68720240904,68,2024-09-04,7,58,26,84,FLDegN_T,"-37.8168479, 144.96559789"
182120241102,18,2024-11-02,21,11,21,32,Col12_T,"-37.81344862, 144.97305353"
63620250124,63,2025-01-24,6,9,17,26,Bou231_T,"-37.81333081, 144.96675571"
631420250817,63,2025-08-17,14,371,455,826,Bou231_T,"-37.81333081, 144.96675571"
631320250906,63,2025-09-06,13,421,539,960,Bou231_T,"-37.81333081, 144.96675571"
671720250406,67,2025-04-06,17,232,354,586,FLDegS_T,"-37.81688755, 144.96562569"
621120240205,62,2024-02-05,11,148,135,283,Lat224_T,"-37.80996494, 144.96216521"
621120240817,62,2024-08-17,11,216,119,335,Lat224_T,"-37.80996494, 144.96216521"
561320241224,56,2024-12-24,13,380,316,696,Lon364_T,"-37.81234775, 144.96153311"
102020240723,10,2024-07-23,20,18,15,33,BouHbr_T,"-37.81876474, 144.94710545"
72420250519,72,2025-05-19,4,1,4,5,ACMI_T,"-37.81726338, 144.96872809"
272020240615,27,2024-06-15,20,146,77,223,Vic_T,"-37.80606888, 144.95644692"
91220240521,9,2024-05-21,12,781,641,1422,Col700_T,"-37.81982992, 144.95102555"
79120250220,79,2025-02-20,1,12,20,32,FliSS_T,"-37.81794046, 144.96616678"
1791420250417,179,2025-04-17,14,39,45,84,Pow61_T,"-37.82392385, 144.96299677"
1791620250606,179,2025-06-06,16,52,53,105,Pow61_T,"-37.82392385, 144.96299677"
1662020241214,166,2024-12-14,20,28,10,38,Spen484_T,"-37.80896733, 144.94931703"
1401720250430,140,2025-04-30,17,95,114,209,Boyd2837_T,"-37.82590962, 144.96185972"
63820240305,63,2024-03-05,8,192,205,397,Bou231_T,"-37.81333081, 144.96675571"
1820250911,1,2025-09-11,8,195,256,451,Bou292_T,"-37.81349441, 144.96515323"
111120231203,11,2023-12-03,11,138,177,315,WatCit_T,"-37.81564989, 144.93970694"
10120240827,10,2024-08-27,1,1,1,2,BouHbr_T,"-37.81876474, 144.94710545"
102120250108,10,2025-01-08,21,42,38,80,BouHbr_T,"-37.81876474, 144.94710545"
10020250414,10,2025-04-14,0,3,1,4,BouHbr_T,"-37.81876474, 144.94710545"
112120250909,11,2025-09-09,21,43,32,75,WatCit_T,"-37.81564989, 144.93970694"
10920231107,10,2023-11-07,9,24,19,43,BouHbr_T,"-37.81876474, 144.94710545"
24820241023,24,2024-10-23,8,2177,309,2486,Col620_T,"-37.81887963, 144.95449198"
761320231029,76,2023-10-29,13,45,53,98,KenMac_T,"-37.79453803, 144.93036194"
76120240305,76,2024-03-05,1,1,1,2,KenMac_T,"-37.79453803, 144.93036194"
241420250909,24,2025-09-09,14,405,846,1251,Col620_T,"-37.81887963, 144.95449198"
271120240827,27,2024-08-27,11,166,142,308,Vic_T,"-37.80606888, 144.95644692"
21320250816,2,2025-08-16,13,1372,1490,2862,Bou283_T,"-37.81380668, 144.96516718"
531320250103,53,2025-01-03,13,801,604,1405,Col254_T,"-37.81564191, 144.965499"
522020240509,52,2024-05-09,20,276,189,465,Eli263_T,"-37.81252157, 144.9619401"
51120241229,51,2024-12-29,1,15,9,24,Fra118_T,"-37.80841815, 144.95906316"
511720250317,51,2025-03-17,17,114,92,206,Fra118_T,"-37.80841815, 144.95906316"
462020241029,46,2024-10-29,20,24,44,68,Pel147_T,"-37.80240719, 144.9615673"
191020240710,19,2024-07-10,10,174,145,319,LtB210_T,"-37.81237202, 144.96550671"
1641620250417,164,2025-04-17,16,165,134,299,Lat526_T,"-37.813005, 144.95160411"
1371420240330,137,2024-03-30,14,6,34,40,BouHbr2353_T,"-37.81894815, 144.94612292"
1372120241013,137,2024-10-13,21,1,2,3,BouHbr2353_T,"-37.81894815, 144.94612292"
1371020241204,137,2024-12-04,10,15,31,46,BouHbr2353_T,"-37.81894815, 144.94612292"
130520251008,130,2025-10-08,5,2,2,4,Bou892T,"-37.8204637, 144.94126826"
1231120240225,123,2024-02-25,11,20,5,25,BirBridge_T,"-37.81753741, 144.97329734"
491820250706,49,2025-07-06,18,158,171,329,Eli501_T,"-37.80730068, 144.95956055"
117520250604,117,2025-06-04,5,17,8,25,Fli114F_T,"-37.81629332, 144.97090877"
66420241013,66,2024-10-13,4,30,24,54,QVN_T,"-37.81057846, 144.96444294"
661920240705,66,2024-07-05,19,1153,913,2066,QVN_T,"-37.81057846, 144.96444294"
39220240818,39,2024-08-18,2,5,6,11,AlfPl_T,"-37.81379749, 144.96995745"
39620240829,39,2024-08-29,6,35,27,62,AlfPl_T,"-37.81379749, 144.96995745"
391720240913,39,2024-09-13,17,100,42,142,AlfPl_T,"-37.81379749, 144.96995745"
702120250908,70,2025-09-08,21,36,46,82,Errol20_T,"-37.80456984, 144.94946228"
752320250830,75,2025-08-30,23,4,7,11,SprFli_T,"-37.81515276, 144.97467661"
591120240423,59,2024-04-23,11,1187,1213,2400,RMIT_T,"-37.80825648, 144.96304859"
65620240108,65,2024-01-08,6,24,39,63,SwaCs_T,"-37.81569416, 144.9668064"
72520231128,72,2023-11-28,5,15,24,39,ACMI_T,"-37.81726338, 144.96872809"
351520250803,35,2025-08-03,15,1527,1722,3249,SouthB_T,"-37.82018685, 144.96508508"
582120250625,58,2025-06-25,21,135,181,316,Bou688_T,"-37.81686075, 144.95358075"
2620231117,2,2023-11-17,6,11,54,65,Bou283_T,"-37.81380668, 144.96516718"
58720240210,58,2024-02-10,7,140,62,202,Bou688_T,"-37.81686075, 144.95358075"
35520250328,35,2025-03-28,5,73,48,121,SouthB_T,"-37.82018685, 144.96508508"
27620241215,27,2024-12-15,6,14,14,28,Vic_T,"-37.80606888, 144.95644692"
27720231106,27,2023-11-06,7,23,26,49,Vic_T,"-37.80606888, 144.95644692"
271220250403,27,2025-04-03,12,166,171,337,Vic_T,"-37.80606888, 144.95644692"
302320250527,30,2025-05-27,23,100,156,256,Lon189_T,"-37.8112185, 144.96656806"
302020240329,30,2024-03-29,20,482,649,1131,Lon189_T,"-37.8112185, 144.96656806"
792120240704,79,2024-07-04,21,190,281,471,FliSS_T,"-37.81794046, 144.96616678"
79520240917,79,2024-09-17,5,40,36,76,FliSS_T,"-37.81794046, 144.96616678"
531020250820,53,2025-08-20,10,464,274,738,Col254_T,"-37.81564191, 144.965499"
532220250912,53,2025-09-12,22,124,146,270,Col254_T,"-37.81564191, 144.965499"
25420240708,25,2024-07-08,4,6,6,12,MCEC_T,"-37.82401776, 144.95604426"
251020250131,25,2025-01-31,10,202,426,628,MCEC_T,"-37.82401776, 144.95604426"
461520240624,46,2024-06-24,15,53,43,96,Pel147_T,"-37.80240719, 144.9615673"
52320250107,52,2025-01-07,3,1,5,6,Eli263_T,"-37.81252157, 144.9619401"
461120231203,46,2023-12-03,11,41,26,67,Pel147_T,"-37.80240719, 144.9615673"
123820240605,123,2024-06-05,8,36,3,39,BirBridge_T,"-37.81753741, 144.97329734"
1411620250124,141,2025-01-24,16,133,131,264,474Fl_T,"-37.81997273, 144.95834911"
1091120250624,109,2025-06-24,11,103,119,222,LatWill_T,"-37.81193681, 144.95621105"
191220250821,19,2025-08-21,12,587,424,1011,LtB210_T,"-37.81237202, 144.96550671"
1091420240204,109,2024-02-04,14,27,58,85,LatWill_T,"-37.81193681, 144.95621105"
191420240403,19,2024-04-03,14,456,545,1001,LtB210_T,"-37.81237202, 144.96550671"
1421920240818,142,2024-08-18,19,163,178,341,Hammer1584_T,"-37.81970749, 144.96795734"
84120241004,84,2024-10-04,1,47,59,106,ElFi_T,"-37.81798049, 144.96503383"
842020250701,84,2025-07-01,20,429,663,1092,ElFi_T,"-37.81798049, 144.96503383"
4020241202,4,2024-12-02,0,116,84,200,Swa123_T,"-37.81487988, 144.9660878"
39920250317,39,2025-03-17,9,125,112,237,AlfPl_T,"-37.81379749, 144.96995745"
391720240620,39,2024-06-20,17,135,86,221,AlfPl_T,"-37.81379749, 144.96995745"
412220250101,41,2025-01-01,22,392,379,771,Swa31,"-37.81668634, 144.96689733"
8520240901,8,2024-09-01,5,0,4,4,WebBN_T,"-37.82293543, 144.9471751"
751420240229,75,2024-02-29,14,45,85,130,SprFli_T,"-37.81515276, 144.97467661"
782220241117,78,2024-11-17,22,4,10,14,HarEsB_T,"-37.81471642, 144.9446508"
411920250404,41,2025-04-04,19,1809,1943,3752,Swa31,"-37.81668634, 144.96689733"
65020240120,65,2024-01-20,0,155,213,368,SwaCs_T,"-37.81569416, 144.9668064"
422220240826,42,2024-08-26,22,40,68,108,UM1_T,"-37.80008566, 144.96386412"
711720240303,71,2024-03-03,17,16,11,27,WestWP_T,"-37.81235775, 144.97136962"
591820231211,59,2023-12-11,18,626,466,1092,RMIT_T,"-37.80825648, 144.96304859"
59620250501,59,2025-05-01,6,38,47,85,RMIT_T,"-37.80825648, 144.96304859"
651920240317,65,2024-03-17,19,471,474,945,SwaCs_T,"-37.81569416, 144.9668064"
28520250825,28,2025-08-25,5,29,23,52,VAC_T,"-37.82129925, 144.96879309"
28320241007,28,2024-10-07,3,7,14,21,VAC_T,"-37.82129925, 144.96879309"
281320250322,28,2025-03-22,13,1927,1891,3818,VAC_T,"-37.82129925, 144.96879309"
401920250810,40,2025-08-10,19,70,70,140,Spr201_T,"-37.80999341, 144.97227587"
40720250222,40,2025-02-22,7,18,28,46,Spr201_T,"-37.80999341, 144.97227587"
311320240215,31,2024-02-15,13,224,191,415,Lyg161_T,"-37.80169681, 144.96658911"
311120240428,31,2024-04-28,11,192,141,333,Lyg161_T,"-37.80169681, 144.96658911"
542020241126,54,2024-11-26,20,93,128,221,Swa607_T,"-37.804024, 144.96308399"
54920250726,54,2025-07-26,9,50,54,104,Swa607_T,"-37.804024, 144.96308399"
47520240503,47,2024-05-03,5,19,64,83,Eli250_T,"-37.81258467, 144.9625775"
5820250131,5,2025-01-31,8,260,544,804,PriNW_T,"-37.81874249, 144.96787656"
1081020250207,108,2025-02-07,10,258,350,608,261Will_T,"-37.81295822, 144.95678789"
61620250603,61,2025-06-03,6,9,16,25,RMIT14_T,"-37.80767455, 144.96309114"
612220231106,61,2023-11-06,22,154,137,291,RMIT14_T,"-37.80767455, 144.96309114"
50920241117,50,2024-11-17,9,62,75,137,Lyg309_T,"-37.79808192, 144.96721013"
52320240705,5,2024-07-05,23,214,509,723,PriNW_T,"-37.81874249, 144.96787656"
5120241220,5,2024-12-20,1,64,100,164,PriNW_T,"-37.81874249, 144.96787656"
21720241215,21,2024-12-15,7,18,16,34,Bourke155_T,"-37.81267313, 144.96788288"
1621120241009,162,2024-10-09,11,279,355,634,Eli489_T,"-37.80740397, 144.95987909"
162620241226,162,2024-12-26,6,25,34,59,Eli489_T,"-37.80740397, 144.95987909"
1431420240715,143,2024-07-15,14,111,133,244,Spencer_T,"-37.821728, 144.95557015"
132220240322,132,2024-03-22,2,12,4,16,King335_T,"-37.81267639, 144.95386444"
1322320240907,132,2024-09-07,23,93,98,191,King335_T,"-37.81267639, 144.95386444"
134420250523,134,2025-05-23,4,12,13,25,Spen201_T,"-37.81694221, 144.95303935"
1311220231106,131,2023-11-06,12,161,175,336,King2_T,"-37.82009057, 144.95758725"
135320240913,135,2024-09-13,3,12,8,20,Spen161_T,"-37.8172861, 144.95319102"
108520240315,108,2024-03-15,5,14,86,100,261Will_T,"-37.81295822, 144.95678789"
1072120231208,107,2023-12-08,21,102,109,211,280Will_T,"-37.81246271, 144.95690188"
118820231212,118,2023-12-12,8,38,16,54,Fli114C_T,"-37.81632783, 144.97090512"
1182220240216,118,2024-02-16,22,12,7,19,Fli114C_T,"-37.81632783, 144.97090512"
1082220250301,108,2025-03-01,22,127,103,230,261Will_T,"-37.81295822, 144.95678789"
1651620250608,165,2025-06-08,16,34,30,64,Spen475_T,"-37.80953359, 144.94939004"
1671720250122,167,2025-01-22,17,68,57,125,Lat526_T,"-37.81304149, 144.95155955"
67420250522,67,2025-05-22,4,3,2,5,FLDegS_T,"-37.81688755, 144.96562569"
67820250622,67,2025-06-22,8,69,111,180,FLDegS_T,"-37.81688755, 144.96562569"
68620231204,68,2023-12-04,6,20,6,26,FLDegN_T,"-37.8168479, 144.96559789"
68820240818,68,2024-08-18,8,55,45,100,FLDegN_T,"-37.8168479, 144.96559789"
17820250207,17,2025-02-07,8,912,163,1075,Col15_T,"-37.81362543, 144.97323591"
63020240616,63,2024-06-16,0,131,201,332,Bou231_T,"-37.81333081, 144.96675571"
681920240503,68,2024-05-03,19,99,22,121,FLDegN_T,"-37.8168479, 144.96559789"
11920250720,1,2025-07-20,19,506,289,795,Bou292_T,"-37.81349441, 144.96515323"
62620250126,62,2025-01-26,6,21,22,43,Lat224_T,"-37.80996494, 144.96216521"
862220231226,86,2023-12-26,22,1,1,2,574Qub_T,"-37.80309992, 144.94908064"
11120241102,11,2024-11-02,1,2,5,7,WatCit_T,"-37.81564989, 144.93970694"
581820250804,58,2025-08-04,18,517,451,968,Bou688_T,"-37.81686075, 144.95358075"
35220231028,35,2023-10-28,2,71,82,153,SouthB_T,"-37.82018685, 144.96508508"
58920240204,58,2024-02-04,9,318,135,453,Bou688_T,"-37.81686075, 144.95358075"
22220250711,2,2025-07-11,22,94,203,297,Bou283_T,"-37.81380668, 144.96516718"
9320250201,9,2025-02-01,3,4,6,10,Col700_T,"-37.81982992, 144.95102555"
791720240207,79,2024-02-07,17,787,662,1449,FliSS_T,"-37.81794046, 144.96616678"
301720240607,30,2024-06-07,17,347,465,812,Lon189_T,"-37.8112185, 144.96656806"
461120250930,46,2025-09-30,11,64,57,121,Pel147_T,"-37.80240719, 144.9615673"
521620251013,52,2025-10-13,16,351,290,641,Eli263_T,"-37.81252157, 144.9619401"
191320240811,19,2024-08-11,13,723,658,1381,LtB210_T,"-37.81237202, 144.96550671"
48220240705,48,2024-07-05,2,5,6,11,QVMQ_T,"-37.80631581, 144.95866697"
19920250529,19,2025-05-29,9,108,88,196,LtB210_T,"-37.81237202, 144.96550671"
1391720241007,139,2024-10-07,17,235,28,263,Signal1647_T,"-37.81959923, 144.9632832"
136620231230,136,2023-12-30,6,17,12,29,BirFed1120_T,"-37.8184141, 144.97357915"
164520250124,164,2025-01-24,5,7,4,11,Lat526_T,"-37.813005, 144.95160411"
66120250708,66,2025-07-08,1,30,16,46,QVN_T,"-37.81057846, 144.96444294"
691420250701,69,2025-07-01,14,204,247,451,FLDegC_T,"-37.81687226, 144.96559144"
41920240924,4,2024-09-24,19,885,941,1826,Swa123_T,"-37.81487988, 144.9660878"
75820250530,75,2025-05-30,8,45,53,98,SprFli_T,"-37.81515276, 144.97467661"
41620240905,41,2024-09-05,6,62,46,108,Swa31,"-37.81668634, 144.96689733"
771620240621,77,2024-06-21,16,193,110,303,HarEsP_T,"-37.81441438, 144.94433026"
231320240213,23,2024-02-13,13,257,432,689,Col623_T,"-37.81909256, 144.95452748"
231620231224,23,2023-12-24,16,81,185,266,Col623_T,"-37.81909256, 144.95452748"
48220241025,48,2024-10-25,2,5,9,14,QVMQ_T,"-37.80631581, 144.95866697"
48920231019,48,2023-10-19,9,163,97,260,QVMQ_T,"-37.80631581, 144.95866697"
302020250420,30,2025-04-20,20,315,586,901,Lon189_T,"-37.8112185, 144.96656806"
202020250102,20,2025-01-02,20,231,387,618,LtB170_T,"-37.81172914, 144.9682466"
46220231217,46,2023-12-17,2,7,2,9,Pel147_T,"-37.80240719, 144.9615673"
137420241211,137,2024-12-11,4,1,1,2,BouHbr2353_T,"-37.81894815, 144.94612292"
141620250801,141,2025-08-01,6,30,19,49,474Fl_T,"-37.81997273, 144.95834911"
139220240716,139,2024-07-16,2,0,1,1,Signal1647_T,"-37.81959923, 144.9632832"
1361920240502,136,2024-05-02,19,139,3,142,BirFed1120_T,"-37.8184141, 144.97357915"
136720240610,136,2024-06-10,7,13,11,24,BirFed1120_T,"-37.8184141, 144.97357915"
1361620240717,136,2024-07-17,16,137,51,188,BirFed1120_T,"-37.8184141, 144.97357915"
1361720241017,136,2024-10-17,17,212,70,282,BirFed1120_T,"-37.8184141, 144.97357915"
1232320240922,123,2024-09-22,23,1,1,2,BirBridge_T,"-37.81753741, 144.97329734"
481220251007,48,2025-10-07,12,533,519,1052,QVMQ_T,"-37.80631581, 144.95866697"
1171320240117,117,2024-01-17,13,190,183,373,Fli114F_T,"-37.81629332, 144.97090877"
1091820240706,109,2024-07-06,18,66,94,160,LatWill_T,"-37.81193681, 144.95621105"
69420241115,69,2024-11-15,4,2,3,5,FLDegC_T,"-37.81687226, 144.96559144"
61020240206,6,2024-02-06,10,497,415,912,FliS_T,"-37.81911705, 144.96558255"
391120240708,39,2024-07-08,11,91,56,147,AlfPl_T,"-37.81379749, 144.96995745"
8920250131,8,2025-01-31,9,172,177,349,WebBN_T,"-37.82293543, 144.9471751"
421620241229,42,2024-12-29,16,50,33,83,UM1_T,"-37.80008566, 144.96386412"
772120250901,77,2025-09-01,21,68,54,122,HarEsP_T,"-37.81441438, 144.94433026"
292220241104,29,2024-11-04,22,89,69,158,AG_T,"-37.8199817, 144.96872865"
28920241214,28,2024-12-14,9,233,352,585,VAC_T,"-37.82129925, 144.96879309"
291620250529,29,2025-05-29,16,765,622,1387,AG_T,"-37.8199817, 144.96872865"
401620250911,40,2025-09-11,16,154,254,408,Spr201_T,"-37.80999341, 144.97227587"
37820241109,37,2024-11-09,8,22,16,38,Lyg260_T,"-37.80107122, 144.96704554"
472120240721,47,2024-07-21,21,288,292,580,Eli250_T,"-37.81258467, 144.9625775"
45220250822,45,2025-08-22,2,6,27,33,Swa148_T,"-37.81414075, 144.96609379"
5320240815,5,2024-08-15,3,16,10,26,PriNW_T,"-37.81874249, 144.96787656"
50220231121,50,2023-11-21,2,1,0,1,Lyg309_T,"-37.79808192, 144.96721013"
50320240926,50,2024-09-26,3,11,0,11,Lyg309_T,"-37.79808192, 144.96721013"
442120250809,44,2025-08-09,21,10,6,16,UM3_T,"-37.79698741, 144.96441306"
1342120250323,134,2025-03-23,21,284,218,502,Spen201_T,"-37.81694221, 144.95303935"
1181920241224,118,2024-12-24,19,30,20,50,Fli114C_T,"-37.81632783, 144.97090512"
165120250831,165,2025-08-31,1,3,1,4,Spen475_T,"-37.80953359, 144.94939004"
1402020250830,140,2025-08-30,20,0,1,1,Boyd2837_T,"-37.82590962, 144.96185972"
182320240218,18,2024-02-18,23,7,86,93,Col12_T,"-37.81344862, 144.97305353"
63020240504,63,2024-05-04,0,75,203,278,Bou231_T,"-37.81333081, 144.96675571"
63520250715,63,2025-07-15,5,0,5,5,Bou231_T,"-37.81333081, 144.96675571"
862020240516,86,2024-05-16,20,31,52,83,574Qub_T,"-37.80309992, 144.94908064"
621520240517,62,2024-05-17,15,193,134,327,Lat224_T,"-37.80996494, 144.96216521"
42820240830,42,2024-08-30,8,451,106,557,UM1_T,"-37.80008566, 144.96386412"
281220250928,28,2025-09-28,12,973,1425,2398,VAC_T,"-37.82129925, 144.96879309"
291120241128,29,2024-11-28,11,188,228,416,AG_T,"-37.8199817, 144.96872865"
311720231124,31,2023-11-24,17,160,85,245,Lyg161_T,"-37.80169681, 144.96658911"
371620240910,37,2024-09-10,16,56,68,124,Lyg260_T,"-37.80107122, 144.96704554"
611920240415,61,2024-04-15,19,347,404,751,RMIT14_T,"-37.80767455, 144.96309114"
441320241122,44,2024-11-22,13,50,50,100,UM3_T,"-37.79698741, 144.96441306"
431320250330,43,2025-03-30,13,55,100,155,UM2_T,"-37.79844526, 144.96411782"
44120240430,44,2024-04-30,1,1,1,2,UM3_T,"-37.79698741, 144.96441306"
211020240508,21,2024-05-08,10,173,156,329,Bourke155_T,"-37.81267313, 144.96788288"
211020250601,21,2025-06-01,10,104,102,206,Bourke155_T,"-37.81267313, 144.96788288"
182420250526,182,2025-05-26,4,11,18,29,King163_T,"-37.81627451, 144.95550503"
1081220250307,108,2025-03-07,12,465,395,860,261Will_T,"-37.81295822, 144.95678789"
1351020231231,135,2023-12-31,10,274,251,525,Spen161_T,"-37.8172861, 144.95319102"
1651520250624,165,2025-06-24,15,36,29,65,Spen475_T,"-37.80953359, 144.94939004"
1671120250307,167,2025-03-07,11,53,87,140,Lat526_T,"-37.81304149, 144.95155955"
672320241025,67,2024-10-25,23,72,171,243,FLDegS_T,"-37.81688755, 144.96562569"
672120231024,67,2023-10-24,21,106,259,365,FLDegS_T,"-37.81688755, 144.96562569"
682120231229,68,2023-12-29,21,75,21,96,FLDegN_T,"-37.8168479, 144.96559789"
85820250513,85,2025-05-13,8,170,63,233,488Mac_T,"-37.79432415, 144.92973378"
1420240728,1,2024-07-28,4,7,12,19,Bou292_T,"-37.81349441, 144.96515323"
63220240910,63,2024-09-10,2,2,7,9,Bou231_T,"-37.81333081, 144.96675571"
62020250712,62,2025-07-12,0,78,75,153,Lat224_T,"-37.80996494, 144.96216521"
86720240613,86,2024-06-13,7,11,16,27,574Qub_T,"-37.80309992, 144.94908064"
86220250625,86,2025-06-25,2,1,1,2,574Qub_T,"-37.80309992, 144.94908064"
111520231124,11,2023-11-24,15,125,91,216,WatCit_T,"-37.81564989, 144.93970694"
10120250603,10,2025-06-03,1,6,0,6,BouHbr_T,"-37.81876474, 144.94710545"
72620250109,72,2025-01-09,6,43,32,75,ACMI_T,"-37.81726338, 144.96872809"
24820250730,24,2025-07-30,8,2455,259,2714,Col620_T,"-37.81887963, 144.95449198"
581020240324,58,2024-03-24,10,413,225,638,Bou688_T,"-37.81686075, 144.95358075"
581220240911,58,2024-09-11,12,710,448,1158,Bou688_T,"-37.81686075, 144.95358075"
351520241129,35,2024-11-29,15,1099,1117,2216,SouthB_T,"-37.82018685, 144.96508508"
35520250509,35,2025-05-09,5,63,51,114,SouthB_T,"-37.82018685, 144.96508508"
35220240301,35,2024-03-01,2,18,42,60,SouthB_T,"-37.82018685, 144.96508508"
271420250527,27,2025-05-27,14,154,107,261,Vic_T,"-37.80606888, 144.95644692"
92220231102,9,2023-11-02,22,80,26,106,Col700_T,"-37.81982992, 144.95102555"
531920240301,53,2024-03-01,19,450,298,748,Col254_T,"-37.81564191, 144.965499"
30520240808,30,2024-08-08,5,14,15,29,Lon189_T,"-37.8112185, 144.96656806"
461620250309,46,2025-03-09,16,38,44,82,Pel147_T,"-37.80240719, 144.9615673"
19220241003,19,2024-10-03,2,17,30,47,LtB210_T,"-37.81237202, 144.96550671"
19620240612,19,2024-06-12,6,16,10,26,LtB210_T,"-37.81237202, 144.96550671"
481620250610,48,2025-06-10,16,113,120,233,QVMQ_T,"-37.80631581, 144.95866697"
30220250522,30,2025-05-22,2,20,21,41,Lon189_T,"-37.8112185, 144.96656806"
20520240210,20,2024-02-10,5,5,14,19,LtB170_T,"-37.81172914, 144.9682466"
522120250825,52,2025-08-25,21,133,140,273,Eli263_T,"-37.81252157, 144.9619401"
1371320250801,137,2025-08-01,13,31,62,93,BouHbr2353_T,"-37.81894815, 144.94612292"
1411420240914,141,2024-09-14,14,156,98,254,474Fl_T,"-37.81997273, 144.95834911"
1392220250622,139,2025-06-22,22,3,2,5,Signal1647_T,"-37.81959923, 144.9632832"
1392320241221,139,2024-12-21,23,66,69,135,Signal1647_T,"-37.81959923, 144.9632832"
1301020240701,130,2024-07-01,10,14,12,26,Bou892T,"-37.8204637, 144.94126826"
123920240630,123,2024-06-30,9,4,1,5,BirBridge_T,"-37.81753741, 144.97329734"
1381420251003,138,2025-10-03,14,7,0,7,EntPark1671_T,"-37.81996544, 144.95981454"
1172320241108,117,2024-11-08,23,120,117,237,Fli114F_T,"-37.81629332, 144.97090877"
69720240204,69,2024-02-04,7,12,9,21,FLDegC_T,"-37.81687226, 144.96559144"
61520240525,6,2024-05-25,15,1057,1113,2170,FliS_T,"-37.81911705, 144.96558255"
702320250403,70,2025-04-03,23,3,10,13,Errol20_T,"-37.80456984, 144.94946228"
31020250325,3,2025-03-25,10,485,456,941,Swa295_T,"-37.81101524, 144.96429485"
8720240826,8,2024-08-26,7,142,80,222,WebBN_T,"-37.82293543, 144.9471751"
391920231028,39,2023-10-28,19,71,63,134,AlfPl_T,"-37.81379749, 144.96995745"
8120251012,8,2025-10-12,1,7,0,7,WebBN_T,"-37.82293543, 144.9471751"
59020241126,59,2024-11-26,0,25,39,64,RMIT_T,"-37.80825648, 144.96304859"
771920250305,77,2025-03-05,19,223,197,420,HarEsP_T,"-37.81441438, 144.94433026"
281620241024,28,2024-10-24,16,257,673,930,VAC_T,"-37.82129925, 144.96879309"
29020250409,29,2025-04-09,0,11,23,34,AG_T,"-37.8199817, 144.96872865"
142120250320,14,2025-03-20,21,167,67,234,SanBri_T,"-37.82011242, 144.96291897"
671720251004,67,2025-10-04,17,348,422,770,FLDegS_T,"-37.81688755, 144.96562569"
851120240816,85,2024-08-16,11,84,81,165,488Mac_T,"-37.79432415, 144.92973378"
681720250529,68,2025-05-29,17,235,146,381,FLDegN_T,"-37.8168479, 144.96559789"
18820231118,18,2023-11-18,8,22,31,53,Col12_T,"-37.81344862, 144.97305353"
632220240207,63,2024-02-07,22,73,197,270,Bou231_T,"-37.81333081, 144.96675571"
63620250222,63,2025-02-22,6,4,12,16,Bou231_T,"-37.81333081, 144.96675571"
12120240627,12,2024-06-27,1,1,9,10,NewQ_T,"-37.81457988, 144.94292398"
62520241207,62,2024-12-07,5,24,10,34,Lat224_T,"-37.80996494, 144.96216521"
621820250205,62,2025-02-05,18,253,197,450,Lat224_T,"-37.80996494, 144.96216521"
861820240219,86,2024-02-19,18,37,55,92,574Qub_T,"-37.80309992, 144.94908064"
111220240904,11,2024-09-04,12,76,108,184,WatCit_T,"-37.81564989, 144.93970694"
11020231114,11,2023-11-14,0,1,2,3,WatCit_T,"-37.81564989, 144.93970694"
101620241217,10,2024-12-17,16,266,57,323,BouHbr_T,"-37.81876474, 144.94710545"
24320240716,24,2024-07-16,3,13,12,25,Col620_T,"-37.81887963, 144.95449198"
10720231214,10,2023-12-14,7,26,167,193,BouHbr_T,"-37.81876474, 144.94710545"
58020250403,58,2025-04-03,0,70,71,141,Bou688_T,"-37.81686075, 144.95358075"
58320250619,58,2025-06-19,3,4,2,6,Bou688_T,"-37.81686075, 144.95358075"
791020240202,79,2024-02-02,10,324,237,561,FliSS_T,"-37.81794046, 144.96616678"
79320250707,79,2025-07-07,3,11,9,20,FliSS_T,"-37.81794046, 144.96616678"
531920250823,53,2025-08-23,19,355,302,657,Col254_T,"-37.81564191, 144.965499"
51320240213,51,2024-02-13,3,8,13,21,Fra118_T,"-37.80841815, 144.95906316"
191820240525,19,2024-05-25,18,1057,667,1724,LtB210_T,"-37.81237202, 144.96550671"
48620241217,48,2024-12-17,6,33,28,61,QVMQ_T,"-37.80631581, 144.95866697"
46020250705,46,2025-07-05,0,1,0,1,Pel147_T,"-37.80240719, 144.9615673"
164520251013,164,2025-10-13,5,1,6,7,Lat526_T,"-37.813005, 144.95160411"
1371620250308,137,2025-03-08,16,10,26,36,BouHbr2353_T,"-37.81894815, 144.94612292"
1421820241116,142,2024-11-16,18,1083,715,1798,Hammer1584_T,"-37.81970749, 144.96795734"
1301220250208,130,2025-02-08,12,57,68,125,Bou892T,"-37.8204637, 144.94126826"
161620250503,161,2025-05-03,6,16,11,27,BirArt1109_T,"-37.81851276, 144.97131336"
1381520250110,138,2025-01-10,15,6,21,27,EntPark1671_T,"-37.81996544, 144.95981454"
1171320250727,117,2025-07-27,13,359,202,561,Fli114F_T,"-37.81629332, 144.97090877"
117920241203,117,2024-12-03,9,218,102,320,Fli114F_T,"-37.81629332, 144.97090877"
401720240508,40,2024-05-08,17,151,273,424,Spr201_T,"-37.80999341, 144.97227587"
542020240919,54,2024-09-19,20,121,136,257,Swa607_T,"-37.804024, 144.96308399"
47620250424,47,2025-04-24,6,30,128,158,Eli250_T,"-37.81258467, 144.9625775"
61020250824,61,2025-08-24,0,75,40,115,RMIT14_T,"-37.80767455, 144.96309114"
50320240620,50,2024-06-20,3,3,2,5,Lyg309_T,"-37.79808192, 144.96721013"
44820250804,44,2025-08-04,8,46,68,114,UM3_T,"-37.79698741, 144.96441306"
431020250422,43,2025-04-22,10,50,49,99,UM2_T,"-37.79844526, 144.96411782"
143120250831,143,2025-08-31,1,124,36,160,Spencer_T,"-37.821728, 144.95557015"
1322120231102,132,2023-11-02,21,85,95,180,King335_T,"-37.81267639, 144.95386444"
1811520250701,181,2025-07-01,15,539,859,1398,Eli368_T,"-37.81009465, 144.96143149"
1791720250811,179,2025-08-11,17,75,106,181,Pow61_T,"-37.82392385, 144.96299677"
165820241227,165,2024-12-27,8,9,16,25,Spen475_T,"-37.80953359, 144.94939004"
1651920250824,165,2025-08-24,19,14,6,20,Spen475_T,"-37.80953359, 144.94939004"
1662120241213,166,2024-12-13,21,10,8,18,Spen484_T,"-37.80896733, 144.94931703"
166520250130,166,2025-01-30,5,0,2,2,Spen484_T,"-37.80896733, 144.94931703"
1401620250114,140,2025-01-14,16,112,84,196,Boyd2837_T,"-37.82590962, 144.96185972"
672320251009,67,2025-10-09,23,37,36,73,FLDegS_T,"-37.81688755, 144.96562569"
85820231203,85,2023-12-03,8,47,35,82,488Mac_T,"-37.79432415, 144.92973378"
171320240106,17,2024-01-06,13,144,112,256,Col15_T,"-37.81362543, 144.97323591"
682320240619,68,2024-06-19,23,8,1,9,FLDegN_T,"-37.8168479, 144.96559789"
56820240619,56,2024-06-19,8,112,155,267,Lon364_T,"-37.81234775, 144.96153311"
24120240828,24,2024-08-28,1,22,21,43,Col620_T,"-37.81887963, 144.95449198"
72720231201,72,2023-12-01,7,157,57,214,ACMI_T,"-37.81726338, 144.96872809"
722020250415,72,2025-04-15,20,220,244,464,ACMI_T,"-37.81726338, 144.96872809"
72120240624,72,2024-06-24,1,4,6,10,ACMI_T,"-37.81726338, 144.96872809"
9620240715,9,2024-07-15,6,22,283,305,Col700_T,"-37.81982992, 144.95102555"
53420240817,53,2024-08-17,4,7,4,11,Col254_T,"-37.81564191, 144.965499"
461420250315,46,2025-03-15,14,45,30,75,Pel147_T,"-37.80240719, 144.9615673"
232320241205,23,2024-12-05,23,103,114,217,Col623_T,"-37.81909256, 144.95452748"
19720250215,19,2025-02-15,7,14,20,34,LtB210_T,"-37.81237202, 144.96550671"
20720241010,20,2024-10-10,7,32,27,59,LtB170_T,"-37.81172914, 144.9682466"
52020250812,52,2025-08-12,0,4,23,27,Eli263_T,"-37.81252157, 144.9619401"
141920250806,141,2025-08-06,9,124,82,206,474Fl_T,"-37.81997273, 144.95834911"
1362320250125,136,2025-01-25,23,6,12,18,BirFed1120_T,"-37.8184141, 144.97357915"
1301120240525,130,2024-05-25,11,25,28,53,Bou892T,"-37.8204637, 144.94126826"
491420240225,49,2024-02-25,14,420,586,1006,Eli501_T,"-37.80730068, 144.95956055"
492020240630,49,2024-06-30,20,114,98,212,Eli501_T,"-37.80730068, 144.95956055"
621320250227,62,2025-02-27,13,336,246,582,Lat224_T,"-37.80996494, 144.96216521"
111420241107,11,2024-11-07,14,73,69,142,WatCit_T,"-37.81564989, 144.93970694"
241420240331,24,2024-03-31,14,414,474,888,Col620_T,"-37.81887963, 144.95449198"
10820250103,10,2025-01-03,8,29,42,71,BouHbr_T,"-37.81876474, 144.94710545"
122220251014,12,2025-10-14,22,20,23,43,NewQ_T,"-37.81457988, 144.94292398"
561420250506,56,2025-05-06,14,308,302,610,Lon364_T,"-37.81234775, 144.96153311"
481320250131,48,2025-01-31,13,395,232,627,QVMQ_T,"-37.80631581, 144.95866697"
1412320231205,141,2023-12-05,23,63,112,175,474Fl_T,"-37.81997273, 144.95834911"
1412320250418,141,2025-04-18,23,117,85,202,474Fl_T,"-37.81997273, 144.95834911"
1301120250825,130,2025-08-25,11,55,29,84,Bou892T,"-37.8204637, 144.94126826"
1801020250318,180,2025-03-18,10,39,21,60,Mac330_T,"-37.79497059, 144.93530329"
1231220250414,123,2025-04-14,12,78,62,140,BirBridge_T,"-37.81753741, 144.97329734"
109920250530,109,2025-05-30,9,86,252,338,LatWill_T,"-37.81193681, 144.95621105"
19220250402,19,2025-04-02,2,32,20,52,LtB210_T,"-37.81237202, 144.96550671"
192220240510,19,2024-05-10,22,387,523,910,LtB210_T,"-37.81237202, 144.96550671"
691020240220,69,2024-02-20,10,163,155,318,FLDegC_T,"-37.81687226, 144.96559144"
61720240516,6,2024-05-16,17,2588,1111,3699,FliS_T,"-37.81911705, 144.96558255"
842320240308,84,2024-03-08,23,636,725,1361,ElFi_T,"-37.81798049, 144.96503383"
84320250831,84,2025-08-31,3,45,111,156,ElFi_T,"-37.81798049, 144.96503383"
31220240817,3,2024-08-17,12,851,1189,2040,Swa295_T,"-37.81101524, 144.96429485"
3920250119,3,2025-01-19,9,192,219,411,Swa295_T,"-37.81101524, 144.96429485"
3020250225,3,2025-02-25,0,100,77,177,Swa295_T,"-37.81101524, 144.96429485"
391120241110,39,2024-11-10,11,61,54,115,AlfPl_T,"-37.81379749, 144.96995745"
78120250906,78,2025-09-06,1,2,11,13,HarEsB_T,"-37.81471642, 144.9446508"
651420240120,65,2024-01-20,14,524,808,1332,SwaCs_T,"-37.81569416, 144.9668064"
292220240715,29,2024-07-15,22,23,28,51,AG_T,"-37.8199817, 144.96872865"
291320250218,29,2025-02-18,13,323,291,614,AG_T,"-37.8199817, 144.96872865"
591320231025,59,2023-10-25,13,715,482,1197,RMIT_T,"-37.80825648, 144.96304859"
281020240208,28,2024-02-08,10,468,335,803,VAC_T,"-37.82129925, 144.96879309"
40120240902,40,2024-09-02,1,8,6,14,Spr201_T,"-37.80999341, 144.97227587"
372320250823,37,2025-08-23,23,127,185,312,Lyg260_T,"-37.80107122, 144.96704554"
372220231126,37,2023-11-26,22,91,95,186,Lyg260_T,"-37.80107122, 144.96704554"
47220250621,47,2025-06-21,2,63,43,106,Eli250_T,"-37.81258467, 144.9625775"
61120241212,61,2024-12-12,1,52,16,68,RMIT14_T,"-37.80767455, 144.96309114"
502120250205,50,2025-02-05,21,122,81,203,Lyg309_T,"-37.79808192, 144.96721013"
501620250521,50,2025-05-21,16,145,118,263,Lyg309_T,"-37.79808192, 144.96721013"
140720240529,140,2024-05-29,7,91,17,108,Boyd2837_T,"-37.82590962, 144.96185972"
1331220250314,133,2025-03-14,12,549,583,1132,Spen229_T,"-37.81531435, 144.95227769"
1081320250209,108,2025-02-09,13,135,140,275,261Will_T,"-37.81295822, 144.95678789"
1091420250801,109,2025-08-01,14,183,135,318,LatWill_T,"-37.81193681, 144.95621105"
1091820251006,109,2025-10-06,18,182,126,308,LatWill_T,"-37.81193681, 144.95621105"
661320250827,66,2025-08-27,13,1231,1267,2498,QVN_T,"-37.81057846, 144.96444294"
69420250111,69,2025-01-11,4,0,1,1,FLDegC_T,"-37.81687226, 144.96559144"
6420250930,6,2025-09-30,4,22,10,32,FliS_T,"-37.81911705, 144.96558255"
41320241203,4,2024-12-03,13,1736,1481,3217,Swa123_T,"-37.81487988, 144.9660878"
751520240823,75,2024-08-23,15,40,51,91,SprFli_T,"-37.81515276, 144.97467661"
41620250721,41,2025-07-21,6,223,102,325,Swa31,"-37.81668634, 144.96689733"
711520250708,71,2025-07-08,15,5,1,6,WestWP_T,"-37.81235775, 144.97136962"
711920240801,71,2024-08-01,19,3,12,15,WestWP_T,"-37.81235775, 144.97136962"
28220240212,28,2024-02-12,2,7,6,13,VAC_T,"-37.82129925, 144.96879309"
37420240702,37,2024-07-02,4,1,0,1,Lyg260_T,"-37.80107122, 144.96704554"
472020250910,47,2025-09-10,20,468,414,882,Eli250_T,"-37.81258467, 144.9625775"
611120240221,61,2024-02-21,11,386,547,933,RMIT14_T,"-37.80767455, 144.96309114"
502020240822,50,2024-08-22,20,177,104,281,Lyg309_T,"-37.79808192, 144.96721013"
212320250818,21,2025-08-18,23,15,45,60,Bourke155_T,"-37.81267313, 144.96788288"
1622320240830,162,2024-08-30,23,156,93,249,Eli489_T,"-37.80740397, 144.95987909"
1321020251008,132,2025-10-08,10,112,98,210,King335_T,"-37.81267639, 144.95386444"
1311920250123,131,2025-01-23,19,111,96,207,King2_T,"-37.82009057, 144.95758725"
1071320250410,107,2025-04-10,13,244,253,497,280Will_T,"-37.81246271, 144.95690188"
1241120250718,124,2025-07-18,11,2,4,6,BirBridge_T,"-37.81757416, 144.97329934"
70520250526,70,2025-05-26,5,3,0,3,Errol20_T,"-37.80456984, 144.94946228"
681820240207,68,2024-02-07,18,158,124,282,FLDegN_T,"-37.8168479, 144.96559789"
18220240314,18,2024-03-14,2,1,2,3,Col12_T,"-37.81344862, 144.97305353"
63820250622,63,2025-06-22,8,26,63,89,Bou231_T,"-37.81333081, 144.96675571"
561020240913,56,2024-09-13,10,234,164,398,Lon364_T,"-37.81234775, 144.96153311"
861020240517,86,2024-05-17,10,35,27,62,574Qub_T,"-37.80309992, 144.94908064"
72920250210,72,2025-02-10,9,291,79,370,ACMI_T,"-37.81726338, 144.96872809"
58420250813,58,2025-08-13,4,5,17,22,Bou688_T,"-37.81686075, 144.95358075"
581220240620,58,2024-06-20,12,815,447,1262,Bou688_T,"-37.81686075, 144.95358075"
35820240601,35,2024-06-01,8,405,364,769,SouthB_T,"-37.82018685, 144.96508508"
761020250220,76,2025-02-20,10,38,38,76,KenMac_T,"-37.79453803, 144.93036194"
91620231114,9,2023-11-14,16,2375,204,2579,Col700_T,"-37.81982992, 144.95102555"
51420250722,51,2025-07-22,4,2,1,3,Fra118_T,"-37.80841815, 144.95906316"
46820231226,46,2023-12-26,8,1,5,6,Pel147_T,"-37.80240719, 144.9615673"
51520240507,51,2024-05-07,5,7,10,17,Fra118_T,"-37.80841815, 144.95906316"
191120241006,19,2024-10-06,11,347,258,605,LtB210_T,"-37.81237202, 144.96550671"
252020240105,25,2024-01-05,20,877,489,1366,MCEC_T,"-37.82401776, 144.95604426"
48520241028,48,2024-10-28,5,21,10,31,QVMQ_T,"-37.80631581, 144.95866697"
1081920240824,108,2024-08-24,19,45,122,167,261Will_T,"-37.81295822, 144.95678789"
87220240530,87,2024-05-30,2,3,2,5,Errol23_T,"-37.80454949, 144.94921863"
166420250617,166,2025-06-17,4,0,1,1,Spen484_T,"-37.80896733, 144.94931703"
1401020250831,140,2025-08-31,10,111,56,167,Boyd2837_T,"-37.82590962, 144.96185972"
1621520250828,162,2025-08-28,15,195,404,599,Eli489_T,"-37.80740397, 144.95987909"
852320231101,85,2023-11-01,23,2,4,6,488Mac_T,"-37.79432415, 144.92973378"
85420241025,85,2024-10-25,4,0,1,1,488Mac_T,"-37.79432415, 144.92973378"
851220250614,85,2025-06-14,12,108,113,221,488Mac_T,"-37.79432415, 144.92973378"
17920231212,17,2023-12-12,9,885,301,1186,Col15_T,"-37.81362543, 144.97323591"
182320241220,18,2024-12-20,23,14,18,32,Col12_T,"-37.81344862, 144.97305353"
181320250726,18,2025-07-26,13,124,109,233,Col12_T,"-37.81344862, 144.97305353"
11020250427,1,2025-04-27,10,429,565,994,Bou292_T,"-37.81349441, 144.96515323"
86120240217,86,2024-02-17,1,0,4,4,574Qub_T,"-37.80309992, 144.94908064"
62820241004,62,2024-10-04,8,83,107,190,Lat224_T,"-37.80996494, 144.96216521"
621920250310,62,2025-03-10,19,255,176,431,Lat224_T,"-37.80996494, 144.96216521"
56120231121,56,2023-11-21,1,12,3,15,Lon364_T,"-37.81234775, 144.96153311"
24320240827,24,2024-08-27,3,12,5,17,Col620_T,"-37.81887963, 144.95449198"
101820231127,10,2023-11-27,18,92,43,135,BouHbr_T,"-37.81876474, 144.94710545"
101420240901,10,2024-09-01,14,32,24,56,BouHbr_T,"-37.81876474, 144.94710545"
241520250407,24,2025-04-07,15,458,1161,1619,Col620_T,"-37.81887963, 144.95449198"
76220231221,76,2023-12-21,2,0,1,1,KenMac_T,"-37.79453803, 144.93036194"
721420250526,72,2025-05-26,14,107,214,321,ACMI_T,"-37.81726338, 144.96872809"
72820241014,72,2024-10-14,8,636,106,742,ACMI_T,"-37.81726338, 144.96872809"
2420250513,2,2025-05-13,4,3,8,11,Bou283_T,"-37.81380668, 144.96516718"
35220231224,35,2023-12-24,2,133,145,278,SouthB_T,"-37.82018685, 144.96508508"
9920250728,9,2025-07-28,9,140,1508,1648,Col700_T,"-37.81982992, 144.95102555"
91020231120,9,2023-11-20,10,157,368,525,Col700_T,"-37.81982992, 144.95102555"
27120250131,27,2025-01-31,1,8,5,13,Vic_T,"-37.80606888, 144.95644692"
301020240215,30,2024-02-15,10,143,186,329,Lon189_T,"-37.8112185, 144.96656806"
23520240925,23,2024-09-25,5,27,10,37,Col623_T,"-37.81909256, 144.95452748"
23320240718,23,2024-07-18,3,3,11,14,Col623_T,"-37.81909256, 144.95452748"
231520250813,23,2025-08-13,15,189,369,558,Col623_T,"-37.81909256, 144.95452748"
252020240815,25,2024-08-15,20,455,268,723,MCEC_T,"-37.82401776, 144.95604426"
201220240124,20,2024-01-24,12,229,212,441,LtB170_T,"-37.81172914, 144.9682466"
25320231105,25,2023-11-05,3,0,0,0,MCEC_T,"-37.82401776, 144.95604426"
521720250228,52,2025-02-28,17,444,383,827,Eli263_T,"-37.81252157, 144.9619401"
521920240928,52,2024-09-28,19,326,345,671,Eli263_T,"-37.81252157, 144.9619401"
46320240605,46,2024-06-05,3,0,2,2,Pel147_T,"-37.80240719, 144.9615673"
1421820250918,142,2025-09-18,18,283,276,559,Hammer1584_T,"-37.81970749, 144.96795734"
1301620250315,130,2025-03-15,16,24,23,47,Bou892T,"-37.8204637, 144.94126826"
1611120250116,161,2025-01-16,11,2414,153,2567,BirArt1109_T,"-37.81851276, 144.97131336"
1231320250319,123,2025-03-19,13,90,34,124,BirBridge_T,"-37.81753741, 144.97329734"
117020241004,117,2024-10-04,0,34,22,56,Fli114F_T,"-37.81629332, 144.97090877"
662020241230,66,2024-12-30,20,1069,797,1866,QVN_T,"-37.81057846, 144.96444294"
701620231231,70,2023-12-31,16,145,145,290,Errol20_T,"-37.80456984, 144.94946228"
3920231102,3,2023-11-02,9,253,348,601,Swa295_T,"-37.81101524, 144.96429485"
3520240821,3,2024-08-21,5,18,48,66,Swa295_T,"-37.81101524, 144.96429485"
81020241215,8,2024-12-15,10,102,209,311,WebBN_T,"-37.82293543, 144.9471751"
65620231101,65,2023-11-01,6,66,48,114,SwaCs_T,"-37.81569416, 144.9668064"
771320251016,77,2025-10-16,13,425,421,846,HarEsP_T,"-37.81441438, 144.94433026"
29820240315,29,2024-03-15,8,111,166,277,AG_T,"-37.8199817, 144.96872865"
591020250121,59,2025-01-21,10,250,184,434,RMIT_T,"-37.80825648, 144.96304859"
591120250614,59,2025-06-14,11,264,251,515,RMIT_T,"-37.80825648, 144.96304859"
712220241030,71,2024-10-30,22,14,7,21,WestWP_T,"-37.81235775, 144.97136962"
401720251004,40,2025-10-04,17,154,197,351,Spr201_T,"-37.80999341, 144.97227587"
311820241030,31,2024-10-30,18,205,124,329,Lyg161_T,"-37.80169681, 144.96658911"
312120240617,31,2024-06-17,21,81,100,181,Lyg161_T,"-37.80169681, 144.96658911"
1661520250721,166,2025-07-21,15,38,41,79,Spen484_T,"-37.80896733, 144.94931703"
1401720250918,140,2025-09-18,17,119,146,265,Boyd2837_T,"-37.82590962, 144.96185972"
1322120241223,132,2024-12-23,21,88,98,186,King335_T,"-37.81267639, 144.95386444"
1071420231026,107,2023-10-26,14,153,145,298,280Will_T,"-37.81246271, 144.95690188"
1351320241009,135,2024-10-09,13,478,518,996,Spen161_T,"-37.8172861, 144.95319102"
135220250224,135,2025-02-24,2,11,10,21,Spen161_T,"-37.8172861, 144.95319102"
1181020250314,118,2025-03-14,10,9,15,24,Fli114C_T,"-37.81632783, 144.97090512"
118620250610,118,2025-06-10,6,1,0,1,Fli114C_T,"-37.81632783, 144.97090512"
851820231231,85,2023-12-31,18,47,50,97,488Mac_T,"-37.79432415, 144.92973378"
171220250702,17,2025-07-02,12,216,243,459,Col15_T,"-37.81362543, 144.97323591"
671720240925,67,2024-09-25,17,374,650,1024,FLDegS_T,"-37.81688755, 144.96562569"
861220240210,86,2024-02-10,12,69,50,119,574Qub_T,"-37.80309992, 144.94908064"
861520240221,86,2024-02-21,15,61,62,123,574Qub_T,"-37.80309992, 144.94908064"
11020240110,11,2024-01-10,0,9,4,13,WatCit_T,"-37.81564989, 144.93970694"
12820241129,12,2024-11-29,8,128,156,284,NewQ_T,"-37.81457988, 144.94292398"
10920240615,10,2024-06-15,9,26,31,57,BouHbr_T,"-37.81876474, 144.94710545"
241820240831,24,2024-08-31,18,354,491,845,Col620_T,"-37.81887963, 144.95449198"
721720240212,72,2024-02-12,17,171,794,965,ACMI_T,"-37.81726338, 144.96872809"
21920240914,2,2024-09-14,19,210,228,438,Bou283_T,"-37.81380668, 144.96516718"
58120250716,58,2025-07-16,1,33,35,68,Bou688_T,"-37.81686075, 144.95358075"
27920240927,27,2024-09-27,9,102,114,216,Vic_T,"-37.80606888, 144.95644692"
531820241030,53,2024-10-30,18,421,356,777,Col254_T,"-37.81564191, 144.965499"
30320240615,30,2024-06-15,3,87,115,202,Lon189_T,"-37.8112185, 144.96656806"
791020240910,79,2024-09-10,10,328,296,624,FliSS_T,"-37.81794046, 144.96616678"
53020250501,53,2025-05-01,0,7,12,19,Col254_T,"-37.81564191, 144.965499"
231620241008,23,2024-10-08,16,230,630,860,Col623_T,"-37.81909256, 144.95452748"
481620240222,48,2024-02-22,16,118,127,245,QVMQ_T,"-37.80631581, 144.95866697"
25420231019,25,2023-10-19,4,12,8,20,MCEC_T,"-37.82401776, 144.95604426"
20620250427,20,2025-04-27,6,12,16,28,LtB170_T,"-37.81172914, 144.9682466"
20420250720,20,2025-07-20,4,46,73,119,LtB170_T,"-37.81172914, 144.9682466"
52520250706,52,2025-07-06,5,40,11,51,Eli263_T,"-37.81252157, 144.9619401"
1611320241203,161,2024-12-03,13,98,130,228,BirArt1109_T,"-37.81851276, 144.97131336"
492320241222,49,2024-12-22,23,66,47,113,Eli501_T,"-37.80730068, 144.95956055"
117620240113,117,2024-01-13,6,8,23,31,Fli114F_T,"-37.81629332, 144.97090877"
1171020240821,117,2024-08-21,10,108,103,211,Fli114F_T,"-37.81629332, 144.97090877"
1371520250907,137,2025-09-07,15,5,6,11,BouHbr2353_T,"-37.81894815, 144.94612292"
1371120240310,137,2024-03-10,11,9,18,27,BouHbr2353_T,"-37.81894815, 144.94612292"
1392020250613,139,2025-06-13,20,7,16,23,Signal1647_T,"-37.81959923, 144.9632832"
66820250319,66,2025-03-19,8,331,651,982,QVN_T,"-37.81057846, 144.96444294"
661420250723,66,2025-07-23,14,1160,1113,2273,QVN_T,"-37.81057846, 144.96444294"
69420240822,69,2024-08-22,4,1,0,1,FLDegC_T,"-37.81687226, 144.96559144"
62320240425,6,2024-04-25,23,417,147,564,FliS_T,"-37.81911705, 144.96558255"
841620240101,84,2024-01-01,16,820,1031,1851,ElFi_T,"-37.81798049, 144.96503383"
42020240909,4,2024-09-09,20,304,401,705,Swa123_T,"-37.81487988, 144.9660878"
701020240314,70,2024-03-14,10,84,100,184,Errol20_T,"-37.80456984, 144.94946228"
701920240319,70,2024-03-19,19,150,189,339,Errol20_T,"-37.80456984, 144.94946228"
39120231204,39,2023-12-04,1,4,5,9,AlfPl_T,"-37.81379749, 144.96995745"
751420241231,75,2024-12-31,14,25,30,55,SprFli_T,"-37.81515276, 144.97467661"
41920240617,41,2024-06-17,9,1350,481,1831,Swa31,"-37.81668634, 144.96689733"
291120240221,29,2024-02-21,11,120,205,325,AG_T,"-37.8199817, 144.96872865"
292120240320,29,2024-03-20,21,72,110,182,AG_T,"-37.8199817, 144.96872865"
201020250117,20,2025-01-17,10,145,96,241,LtB170_T,"-37.81172914, 144.9682466"
52920250330,52,2025-03-30,9,83,61,144,Eli263_T,"-37.81252157, 144.9619401"
1641720250523,164,2025-05-23,17,125,103,228,Lat526_T,"-37.813005, 144.95160411"
1411020231113,141,2023-11-13,10,136,117,253,474Fl_T,"-37.81997273, 144.95834911"
1362320250824,136,2025-08-24,23,6,190,196,BirFed1120_T,"-37.8184141, 144.97357915"
1361320250108,136,2025-01-08,13,180,192,372,BirFed1120_T,"-37.8184141, 144.97357915"
1421720250227,142,2025-02-27,17,532,513,1045,Hammer1584_T,"-37.81970749, 144.96795734"
130320250926,130,2025-09-26,3,1,0,1,Bou892T,"-37.8204637, 144.94126826"
1232220250420,123,2025-04-20,22,1,0,1,BirBridge_T,"-37.81753741, 144.97329734"
66720250713,66,2025-07-13,7,20,67,87,QVN_T,"-37.81057846, 144.96444294"
6720250509,6,2025-05-09,7,377,460,837,FliS_T,"-37.81911705, 144.96558255"
661820240601,66,2024-06-01,18,1210,1322,2532,QVN_T,"-37.81057846, 144.96444294"
841220240607,84,2024-06-07,12,886,957,1843,ElFi_T,"-37.81798049, 144.96503383"
391820231206,39,2023-12-06,18,130,94,224,AlfPl_T,"-37.81379749, 144.96995745"
751620240822,75,2024-08-22,16,73,50,123,SprFli_T,"-37.81515276, 144.97467661"
77220250123,77,2025-01-23,2,3,3,6,HarEsP_T,"-37.81441438, 144.94433026"
592320250212,59,2025-02-12,23,68,54,122,RMIT_T,"-37.80825648, 144.96304859"
771620250604,77,2025-06-04,16,202,104,306,HarEsP_T,"-37.81441438, 144.94433026"
421920250912,42,2025-09-12,19,89,138,227,UM1_T,"-37.80008566, 144.96386412"
471420250114,47,2025-01-14,14,769,946,1715,Eli250_T,"-37.81258467, 144.9625775"
43020240105,43,2024-01-05,0,4,7,11,UM2_T,"-37.79844526, 144.96411782"
51820240403,5,2024-04-03,18,846,965,1811,PriNW_T,"-37.81874249, 144.96787656"
131120250923,131,2025-09-23,1,14,9,23,King2_T,"-37.82009057, 144.95758725"
118520231110,118,2023-11-10,5,1,1,2,Fli114C_T,"-37.81632783, 144.97090512"
1081420240820,108,2024-08-20,14,173,181,354,261Will_T,"-37.81295822, 144.95678789"
871120231204,87,2023-12-04,11,92,81,173,Errol23_T,"-37.80454949, 144.94921863"
1662320250828,166,2025-08-28,23,3,0,3,Spen484_T,"-37.80896733, 144.94931703"
1671020241001,167,2024-10-01,10,19,60,79,Lat526_T,"-37.81304149, 144.95155955"
140920250308,140,2025-03-08,9,116,42,158,Boyd2837_T,"-37.82590962, 144.96185972"
851720240507,85,2024-05-07,17,62,100,162,488Mac_T,"-37.79432415, 144.92973378"
24920241214,24,2024-12-14,9,440,345,785,Col620_T,"-37.81887963, 144.95449198"
2720241220,2,2024-12-20,7,45,52,97,Bou283_T,"-37.81380668, 144.96516718"
35320240208,35,2024-02-08,3,18,28,46,SouthB_T,"-37.82018685, 144.96508508"
35720240602,35,2024-06-02,7,201,126,327,SouthB_T,"-37.82018685, 144.96508508"
76920240815,76,2024-08-15,9,68,57,125,KenMac_T,"-37.79453803, 144.93036194"
91520250704,9,2025-07-04,15,610,147,757,Col700_T,"-37.81982992, 144.95102555"
9120240218,9,2024-02-18,1,12,11,23,Col700_T,"-37.81982992, 144.95102555"
9620250109,9,2025-01-09,6,24,170,194,Col700_T,"-37.81982992, 144.95102555"
79120231121,79,2023-11-21,1,29,33,62,FliSS_T,"-37.81794046, 144.96616678"
1391420250707,139,2025-07-07,14,49,52,101,Signal1647_T,"-37.81959923, 144.9632832"
1391620250315,139,2025-03-15,16,69,24,93,Signal1647_T,"-37.81959923, 144.9632832"
137120240228,137,2024-02-28,1,0,2,2,BouHbr2353_T,"-37.81894815, 144.94612292"
1361020240929,136,2024-09-29,10,31,67,98,BirFed1120_T,"-37.8184141, 144.97357915"
136420241201,136,2024-12-01,4,1,0,1,BirFed1120_T,"-37.8184141, 144.97357915"
1421620240225,142,2024-02-25,16,709,708,1417,Hammer1584_T,"-37.81970749, 144.96795734"
1421420240509,142,2024-05-09,14,233,217,450,Hammer1584_T,"-37.81970749, 144.96795734"
130020240908,130,2024-09-08,0,6,0,6,Bou892T,"-37.8204637, 144.94126826"
1641120241211,164,2024-12-11,11,115,63,178,Lat526_T,"-37.813005, 144.95160411"
1381320240929,138,2024-09-29,13,7,7,14,EntPark1671_T,"-37.81996544, 144.95981454"
1381420241019,138,2024-10-19,14,3,6,9,EntPark1671_T,"-37.81996544, 144.95981454"
1381120250524,138,2025-05-24,11,11,7,18,EntPark1671_T,"-37.81996544, 144.95981454"
1171320240409,117,2024-04-09,13,140,135,275,Fli114F_T,"-37.81629332, 144.97090877"
109320231109,109,2023-11-09,3,3,9,12,LatWill_T,"-37.81193681, 144.95621105"
109520240201,109,2024-02-01,5,13,17,30,LatWill_T,"-37.81193681, 144.95621105"
662120240910,66,2024-09-10,21,601,489,1090,QVN_T,"-37.81057846, 144.96444294"
692020240428,69,2024-04-28,20,27,19,46,FLDegC_T,"-37.81687226, 144.96559144"
691920240916,69,2024-09-16,19,44,31,75,FLDegC_T,"-37.81687226, 144.96559144"
691320250723,69,2025-07-23,13,239,296,535,FLDegC_T,"-37.81687226, 144.96559144"
841220240331,84,2024-03-31,12,912,888,1800,ElFi_T,"-37.81798049, 144.96503383"
842020240717,84,2024-07-17,20,458,850,1308,ElFi_T,"-37.81798049, 144.96503383"
84720250224,84,2025-02-24,7,621,240,861,ElFi_T,"-37.81798049, 144.96503383"
3420231115,3,2023-11-15,4,34,29,63,Swa295_T,"-37.81101524, 144.96429485"
4820240530,4,2024-05-30,8,554,395,949,Swa123_T,"-37.81487988, 144.9660878"
3720250907,3,2025-09-07,7,48,68,116,Swa295_T,"-37.81101524, 144.96429485"
32320241223,3,2024-12-23,23,389,242,631,Swa295_T,"-37.81101524, 144.96429485"
31520250404,3,2025-04-04,15,1016,1098,2114,Swa295_T,"-37.81101524, 144.96429485"
8720231207,8,2023-12-07,7,171,107,278,WebBN_T,"-37.82293543, 144.9471751"
751420250309,75,2025-03-09,14,33,44,77,SprFli_T,"-37.81515276, 144.97467661"
41520231222,41,2023-12-22,5,85,85,170,Swa31,"-37.81668634, 144.96689733"
8620250517,8,2025-05-17,6,3,6,9,WebBN_T,"-37.82293543, 144.9471751"
772320240120,77,2024-01-20,23,128,48,176,HarEsP_T,"-37.81441438, 144.94433026"
78920240422,78,2024-04-22,9,46,38,84,HarEsB_T,"-37.81471642, 144.9446508"
78220241112,78,2024-11-12,2,0,1,1,HarEsB_T,"-37.81471642, 144.9446508"
591020250901,59,2025-09-01,10,353,291,644,RMIT_T,"-37.80825648, 144.96304859"
71120250926,71,2025-09-26,1,6,4,10,WestWP_T,"-37.81235775, 144.97136962"
651520240507,65,2024-05-07,15,415,519,934,SwaCs_T,"-37.81569416, 144.9668064"
65320240617,65,2024-06-17,3,3,2,5,SwaCs_T,"-37.81569416, 144.9668064"
28220250723,28,2025-07-23,2,11,3,14,VAC_T,"-37.82129925, 144.96879309"
291720250704,29,2025-07-04,17,332,325,657,AG_T,"-37.8199817, 144.96872865"
401320241107,40,2024-11-07,13,398,284,682,Spr201_T,"-37.80999341, 144.97227587"
311920231207,31,2023-12-07,19,192,113,305,Lyg161_T,"-37.80169681, 144.96658911"
471720240821,47,2024-08-21,17,1254,833,2087,Eli250_T,"-37.81258467, 144.9625775"
61920240626,61,2024-06-26,9,264,338,602,RMIT14_T,"-37.80767455, 144.96309114"
611620231205,61,2023-12-05,16,271,447,718,RMIT14_T,"-37.80767455, 144.96309114"
501720250109,50,2025-01-09,17,223,213,436,Lyg309_T,"-37.79808192, 144.96721013"
43120240922,43,2024-09-22,1,11,0,11,UM2_T,"-37.79844526, 144.96411782"
43020231113,43,2023-11-13,0,4,1,5,UM2_T,"-37.79844526, 144.96411782"
45220231219,45,2023-12-19,2,4,7,11,Swa148_T,"-37.81414075, 144.96609379"
1621320241006,162,2024-10-06,13,728,920,1648,Eli489_T,"-37.80740397, 144.95987909"
1312320250518,131,2025-05-18,23,27,14,41,King2_T,"-37.82009057, 144.95758725"
1312020250524,131,2025-05-24,20,132,107,239,King2_T,"-37.82009057, 144.95758725"
132420240420,132,2024-04-20,4,10,4,14,King335_T,"-37.81267639, 144.95386444"
135720250722,135,2025-07-22,7,114,133,247,Spen161_T,"-37.8172861, 144.95319102"
1332320250819,133,2025-08-19,23,67,55,122,Spen229_T,"-37.81531435, 144.95227769"
1072220241017,107,2024-10-17,22,53,49,102,280Will_T,"-37.81246271, 144.95690188"
1671820250606,167,2025-06-06,18,35,45,80,Lat526_T,"-37.81304149, 144.95155955"
541820240624,54,2024-06-24,18,84,103,187,Swa607_T,"-37.804024, 144.96308399"
28520241006,28,2024-10-06,5,12,7,19,VAC_T,"-37.82129925, 144.96879309"
281120240628,28,2024-06-28,11,673,415,1088,VAC_T,"-37.82129925, 144.96879309"
311020250818,31,2025-08-18,10,90,87,177,Lyg161_T,"-37.80169681, 144.96658911"
312120251014,31,2025-10-14,21,90,138,228,Lyg161_T,"-37.80169681, 144.96658911"
471120250430,47,2025-04-30,11,717,808,1525,Eli250_T,"-37.81258467, 144.9625775"
451620250312,45,2025-03-12,16,383,792,1175,Swa148_T,"-37.81414075, 144.96609379"
21220240513,21,2024-05-13,2,26,7,33,Bourke155_T,"-37.81267313, 144.96788288"
108220251014,108,2025-10-14,2,7,13,20,261Will_T,"-37.81295822, 144.95678789"
611820240602,61,2024-06-02,18,208,270,478,RMIT14_T,"-37.80767455, 144.96309114"
61020240813,61,2024-08-13,0,64,7,71,RMIT14_T,"-37.80767455, 144.96309114"
50320241108,50,2024-11-08,3,3,0,3,Lyg309_T,"-37.79808192, 144.96721013"
431020240508,43,2024-05-08,10,231,175,406,UM2_T,"-37.79844526, 144.96411782"
1311720241006,131,2024-10-06,17,166,50,216,King2_T,"-37.82009057, 144.95758725"
1671220250623,167,2025-06-23,12,37,58,95,Lat526_T,"-37.81304149, 144.95155955"
181620250329,181,2025-03-29,6,56,98,154,Eli368_T,"-37.81009465, 144.96143149"
1321220240224,132,2024-02-24,12,149,151,300,King335_T,"-37.81267639, 144.95386444"
132320241227,132,2024-12-27,3,9,6,15,King335_T,"-37.81267639, 144.95386444"
1081620250520,108,2025-05-20,16,1190,293,1483,261Will_T,"-37.81295822, 144.95678789"
1341820240408,134,2024-04-08,18,169,90,259,Spen201_T,"-37.81694221, 144.95303935"
1311320231123,131,2023-11-23,13,51,105,156,King2_T,"-37.82009057, 144.95758725"
1311220240701,131,2024-07-01,12,138,171,309,King2_T,"-37.82009057, 144.95758725"
1331120250121,133,2025-01-21,11,358,407,765,Spen229_T,"-37.81531435, 144.95227769"
17420240501,17,2024-05-01,4,10,6,16,Col15_T,"-37.81362543, 144.97323591"
18520231129,18,2023-11-29,5,1,9,10,Col12_T,"-37.81344862, 144.97305353"
631020240725,63,2024-07-25,10,220,220,440,Bou231_T,"-37.81333081, 144.96675571"
631120250918,63,2025-09-18,11,291,367,658,Bou231_T,"-37.81333081, 144.96675571"
671720250728,67,2025-07-28,17,266,551,817,FLDegS_T,"-37.81688755, 144.96562569"
562320240309,56,2024-03-09,23,186,233,419,Lon364_T,"-37.81234775, 144.96153311"
862320250406,86,2025-04-06,23,1,3,4,574Qub_T,"-37.80309992, 144.94908064"
241020240403,24,2024-04-03,10,769,347,1116,Col620_T,"-37.81887963, 144.95449198"
24920250527,24,2025-05-27,9,1221,292,1513,Col620_T,"-37.81887963, 144.95449198"
351920240121,35,2024-01-21,19,1311,1742,3053,SouthB_T,"-37.82018685, 144.96508508"
761620250120,76,2025-01-20,16,36,55,91,KenMac_T,"-37.79453803, 144.93036194"
761920250601,76,2025-06-01,19,10,13,23,KenMac_T,"-37.79453803, 144.93036194"
22020250506,2,2025-05-06,20,63,161,224,Bou283_T,"-37.81380668, 144.96516718"
271120250922,27,2025-09-22,11,70,96,166,Vic_T,"-37.80606888, 144.95644692"
9020231104,9,2023-11-04,0,8,21,29,Col700_T,"-37.81982992, 144.95102555"
91420240111,9,2024-01-11,14,383,230,613,Col700_T,"-37.81982992, 144.95102555"
232320250920,23,2025-09-20,23,68,65,133,Col623_T,"-37.81909256, 144.95452748"
231220240327,23,2024-03-27,12,418,533,951,Col623_T,"-37.81909256, 144.95452748"
512220240830,51,2024-08-30,22,43,37,80,Fra118_T,"-37.80841815, 144.95906316"
23120240329,23,2024-03-29,1,28,42,70,Col623_T,"-37.81909256, 144.95452748"
522120250911,52,2025-09-11,21,184,162,346,Eli263_T,"-37.81252157, 144.9619401"
52020250923,52,2025-09-23,0,5,22,27,Eli263_T,"-37.81252157, 144.9619401"
20420231103,20,2023-11-03,4,3,3,6,LtB170_T,"-37.81172914, 144.9682466"
521820241119,52,2024-11-19,18,328,366,694,Eli263_T,"-37.81252157, 144.9619401"
141520241128,141,2024-11-28,5,14,8,22,474Fl_T,"-37.81997273, 144.95834911"
138920250730,138,2025-07-30,9,4,15,19,EntPark1671_T,"-37.81996544, 144.95981454"
171420240906,17,2024-09-06,14,274,293,567,Col15_T,"-37.81362543, 144.97323591"
17920250116,17,2025-01-16,9,692,240,932,Col15_T,"-37.81362543, 144.97323591"
11120250207,1,2025-02-07,11,904,865,1769,Bou292_T,"-37.81349441, 144.96515323"
11720250320,1,2025-03-20,17,1129,730,1859,Bou292_T,"-37.81349441, 144.96515323"
12120251012,1,2025-10-12,21,136,175,311,Bou292_T,"-37.81349441, 144.96515323"
621920240620,62,2024-06-20,19,197,138,335,Lat224_T,"-37.80996494, 144.96216521"
242320240506,24,2024-05-06,23,80,126,206,Col620_T,"-37.81887963, 144.95449198"
722220231226,72,2023-12-26,22,46,120,166,ACMI_T,"-37.81726338, 144.96872809"
351920250811,35,2025-08-11,19,557,490,1047,SouthB_T,"-37.82018685, 144.96508508"
761620251010,76,2025-10-10,16,57,90,147,KenMac_T,"-37.79453803, 144.93036194"
351420240227,35,2024-02-27,14,857,1083,1940,SouthB_T,"-37.82018685, 144.96508508"
35120240405,35,2024-04-05,1,22,56,78,SouthB_T,"-37.82018685, 144.96508508"
9220241228,9,2024-12-28,2,3,7,10,Col700_T,"-37.81982992, 144.95102555"
79720240229,79,2024-02-29,7,331,175,506,FliSS_T,"-37.81794046, 144.96616678"
522020240302,52,2024-03-02,20,340,347,687,Eli263_T,"-37.81252157, 144.9619401"
481820250820,48,2025-08-20,18,217,838,1055,QVMQ_T,"-37.80631581, 144.95866697"
461320240518,46,2024-05-18,13,59,63,122,Pel147_T,"-37.80240719, 144.9615673"
191120250903,19,2025-09-03,11,281,188,469,LtB210_T,"-37.81237202, 144.96550671"
141920240419,141,2024-04-19,9,117,163,280,474Fl_T,"-37.81997273, 144.95834911"
142820240521,142,2024-05-21,8,163,176,339,Hammer1584_T,"-37.81970749, 144.96795734"
1301220240313,130,2024-03-13,12,57,64,121,Bou892T,"-37.8204637, 144.94126826"
1382020250906,138,2025-09-06,20,0,1,1,EntPark1671_T,"-37.81996544, 144.95981454"
1172020240225,117,2024-02-25,20,111,109,220,Fli114F_T,"-37.81629332, 144.97090877"
117720250304,117,2025-03-04,7,131,59,190,Fli114F_T,"-37.81629332, 144.97090877"
1092120250609,109,2025-06-09,21,22,69,91,LatWill_T,"-37.81193681, 144.95621105"
611520250919,61,2025-09-19,15,446,685,1131,RMIT14_T,"-37.80767455, 144.96309114"
1851020250831,185,2025-08-31,10,286,270,556,Eli197_T,"-37.81374643, 144.96276183"
61220231118,6,2023-11-18,12,815,872,1687,FliS_T,"-37.81911705, 144.96558255"
3720240202,3,2024-02-02,7,66,110,176,Swa295_T,"-37.81101524, 144.96429485"
771020241015,77,2024-10-15,10,58,83,141,HarEsP_T,"-37.81441438, 144.94433026"
591920250709,59,2025-07-09,19,495,359,854,RMIT_T,"-37.80825648, 144.96304859"
141320231025,14,2023-10-25,13,270,102,372,SanBri_T,"-37.82011242, 144.96291897"
71820240127,71,2024-01-27,8,1,3,4,WestWP_T,"-37.81235775, 144.97136962"
712220240917,71,2024-09-17,22,3,0,3,WestWP_T,"-37.81235775, 144.97136962"
282220241219,28,2024-12-19,22,226,301,527,VAC_T,"-37.82129925, 144.96879309"
31420250910,31,2025-09-10,4,12,4,16,Lyg161_T,"-37.80169681, 144.96658911"
36520240217,36,2024-02-17,5,7,8,15,Que85_T,"-37.81652527, 144.96121062"
37720241028,37,2024-10-28,7,13,16,29,Lyg260_T,"-37.80107122, 144.96704554"
471920251010,47,2025-10-10,19,1016,858,1874,Eli250_T,"-37.81258467, 144.9625775"
47420240615,47,2024-06-15,4,35,35,70,Eli250_T,"-37.81258467, 144.9625775"
47420240822,47,2024-08-22,4,16,17,33,Eli250_T,"-37.81258467, 144.9625775"
44320240820,44,2024-08-20,3,0,1,1,UM3_T,"-37.79698741, 144.96441306"
442320250119,44,2025-01-19,23,5,3,8,UM3_T,"-37.79698741, 144.96441306"
1431820240504,143,2024-05-04,18,313,362,675,Spencer_T,"-37.821728, 144.95557015"
132820240607,132,2024-06-07,8,149,88,237,King335_T,"-37.81267639, 144.95386444"
132720250214,132,2025-02-14,7,66,27,93,King335_T,"-37.81267639, 144.95386444"
132120251003,132,2025-10-03,1,4,18,22,King335_T,"-37.81267639, 144.95386444"
131120240926,131,2024-09-26,1,12,16,28,King2_T,"-37.82009057, 144.95758725"
118620240613,118,2024-06-13,6,2,0,2,Fli114C_T,"-37.81632783, 144.97090512"
1071420250220,107,2025-02-20,14,180,149,329,280Will_T,"-37.81246271, 144.95690188"
166420250212,166,2025-02-12,4,1,2,3,Spen484_T,"-37.80896733, 144.94931703"
181220250112,18,2025-01-12,12,36,22,58,Col12_T,"-37.81344862, 144.97305353"
631420231201,63,2023-12-01,14,293,460,753,Bou231_T,"-37.81333081, 144.96675571"
631120241203,63,2024-12-03,11,259,316,575,Bou231_T,"-37.81333081, 144.96675571"
63920250225,63,2025-02-25,9,163,189,352,Bou231_T,"-37.81333081, 144.96675571"
562020241220,56,2024-12-20,20,383,349,732,Lon364_T,"-37.81234775, 144.96153311"
121720240622,12,2024-06-22,17,216,209,425,NewQ_T,"-37.81457988, 144.94292398"
10720250912,10,2025-09-12,7,19,73,92,BouHbr_T,"-37.81876474, 144.94710545"
761120240106,76,2024-01-06,11,66,60,126,KenMac_T,"-37.79453803, 144.93036194"
762320240915,76,2024-09-15,23,0,1,1,KenMac_T,"-37.79453803, 144.93036194"
72220240214,72,2024-02-14,2,12,3,15,ACMI_T,"-37.81726338, 144.96872809"
2020240205,2,2024-02-05,0,5,43,48,Bou283_T,"-37.81380668, 144.96516718"
272320240816,27,2024-08-16,23,58,30,88,Vic_T,"-37.80606888, 144.95644692"
27820241126,27,2024-11-26,8,89,123,212,Vic_T,"-37.80606888, 144.95644692"
791320250202,79,2025-02-02,13,405,253,658,FliSS_T,"-37.81794046, 144.96616678"
79820240716,79,2024-07-16,8,560,278,838,FliSS_T,"-37.81794046, 144.96616678"
511420240622,51,2024-06-22,14,161,122,283,Fra118_T,"-37.80841815, 144.95906316"
481420250711,48,2025-07-11,14,399,227,626,QVMQ_T,"-37.80631581, 144.95866697"
1371020240817,137,2024-08-17,10,11,28,39,BouHbr2353_T,"-37.81894815, 144.94612292"
1371220250118,137,2025-01-18,12,11,26,37,BouHbr2353_T,"-37.81894815, 144.94612292"
1411220240209,141,2024-02-09,12,155,154,309,474Fl_T,"-37.81997273, 144.95834911"
1391620240430,139,2024-04-30,16,122,26,148,Signal1647_T,"-37.81959923, 144.9632832"
1361920250121,136,2025-01-21,19,130,151,281,BirFed1120_T,"-37.8184141, 144.97357915"
1421120250202,142,2025-02-02,11,281,340,621,Hammer1584_T,"-37.81970749, 144.96795734"
1422120241024,142,2024-10-24,21,14,9,23,Hammer1584_T,"-37.81970749, 144.96795734"
49520240915,49,2024-09-15,5,26,22,48,Eli501_T,"-37.80730068, 144.95956055"
492320240220,49,2024-02-20,23,96,61,157,Eli501_T,"-37.80730068, 144.95956055"
49020240325,49,2024-03-25,0,56,57,113,Eli501_T,"-37.80730068, 144.95956055"
662020250712,66,2025-07-12,20,1231,1004,2235,QVN_T,"-37.81057846, 144.96444294"
61420250313,6,2025-03-13,14,942,796,1738,FliS_T,"-37.81911705, 144.96558255"
841720240427,84,2024-04-27,17,1049,1384,2433,ElFi_T,"-37.81798049, 144.96503383"
21220231114,21,2023-11-14,2,14,10,24,Bourke155_T,"-37.81267313, 144.96788288"
107020231108,107,2023-11-08,0,11,10,21,280Will_T,"-37.81246271, 144.95690188"
1072320231116,107,2023-11-16,23,27,25,52,280Will_T,"-37.81246271, 144.95690188"
1312220250117,131,2025-01-17,22,209,63,272,King2_T,"-37.82009057, 144.95758725"
1331920231030,133,2023-10-30,19,454,425,879,Spen229_T,"-37.81531435, 144.95227769"
1332220240506,133,2024-05-06,22,174,148,322,Spen229_T,"-37.81531435, 144.95227769"
124920251010,124,2025-10-10,9,1,1,2,BirBridge_T,"-37.81757416, 144.97329934"
671020250109,67,2025-01-09,10,338,373,711,FLDegS_T,"-37.81688755, 144.96562569"
67120250302,67,2025-03-02,1,36,62,98,FLDegS_T,"-37.81688755, 144.96562569"
17520240222,17,2024-02-22,5,49,18,67,Col15_T,"-37.81362543, 144.97323591"
171020250323,17,2025-03-23,10,147,121,268,Col15_T,"-37.81362543, 144.97323591"
181520250201,18,2025-02-01,15,71,59,130,Col12_T,"-37.81344862, 144.97305353"
632320241219,63,2024-12-19,23,28,63,91,Bou231_T,"-37.81333081, 144.96675571"
63420250922,63,2025-09-22,4,1,4,5,Bou231_T,"-37.81333081, 144.96675571"
561120231202,56,2023-12-02,11,257,147,404,Lon364_T,"-37.81234775, 144.96153311"
561620241129,56,2024-11-29,16,356,337,693,Lon364_T,"-37.81234775, 144.96153311"
561120241225,56,2024-12-25,11,168,108,276,Lon364_T,"-37.81234775, 144.96153311"
24220240612,24,2024-06-12,2,17,10,27,Col620_T,"-37.81887963, 144.95449198"
10420241116,10,2024-11-16,4,3,0,3,BouHbr_T,"-37.81876474, 144.94710545"
24720250315,24,2025-03-15,7,167,399,566,Col620_T,"-37.81887963, 144.95449198"
722220250829,72,2025-08-29,22,91,222,313,ACMI_T,"-37.81726338, 144.96872809"
35220250810,35,2025-08-10,2,28,42,70,SouthB_T,"-37.82018685, 144.96508508"
581120240413,58,2024-04-13,11,772,304,1076,Bou688_T,"-37.81686075, 144.95358075"
761320250408,76,2025-04-08,13,71,76,147,KenMac_T,"-37.79453803, 144.93036194"
35620250504,35,2025-05-04,6,70,44,114,SouthB_T,"-37.82018685, 144.96508508"
352120240925,35,2024-09-25,21,328,594,922,SouthB_T,"-37.82018685, 144.96508508"
27720240225,27,2024-02-25,7,10,27,37,Vic_T,"-37.80606888, 144.95644692"
79920250120,79,2025-01-20,9,510,239,749,FliSS_T,"-37.81794046, 144.96616678"
532020250724,53,2025-07-24,20,132,149,281,Col254_T,"-37.81564191, 144.965499"
461020250704,46,2025-07-04,10,49,56,105,Pel147_T,"-37.80240719, 144.9615673"
481920240216,48,2024-02-16,19,101,153,254,QVMQ_T,"-37.80631581, 144.95866697"
202320240225,20,2024-02-25,23,52,79,131,LtB170_T,"-37.81172914, 144.9682466"
180820250509,180,2025-05-09,8,80,38,118,Mac330_T,"-37.79497059, 144.93530329"
1371420250224,137,2025-02-24,14,15,68,83,BouHbr2353_T,"-37.81894815, 144.94612292"
141820240316,141,2024-03-16,8,51,34,85,474Fl_T,"-37.81997273, 144.95834911"
1411720240807,141,2024-08-07,17,129,110,239,474Fl_T,"-37.81997273, 144.95834911"
139820241127,139,2024-11-27,8,3,289,292,Signal1647_T,"-37.81959923, 144.9632832"
1421720240401,142,2024-04-01,17,70,128,198,Hammer1584_T,"-37.81970749, 144.96795734"
142520250513,142,2025-05-13,5,2,0,2,Hammer1584_T,"-37.81970749, 144.96795734"
1301820240404,130,2024-04-04,18,15,27,42,Bou892T,"-37.8204637, 144.94126826"
491120250213,49,2025-02-13,11,231,268,499,Eli501_T,"-37.80730068, 144.95956055"
138820250404,138,2025-04-04,8,4,2,6,EntPark1671_T,"-37.81996544, 144.95981454"
117920240731,117,2024-07-31,9,172,81,253,Fli114F_T,"-37.81629332, 144.97090877"
6120240410,6,2024-04-10,1,11,25,36,FliS_T,"-37.81911705, 144.96558255"
62020240916,6,2024-09-16,20,534,498,1032,FliS_T,"-37.81911705, 144.96558255"
662320231201,66,2023-12-01,23,496,457,953,QVN_T,"-37.81057846, 144.96444294"
42020250530,4,2025-05-30,20,963,1084,2047,Swa123_T,"-37.81487988, 144.9660878"
701020240927,70,2024-09-27,10,115,113,228,Errol20_T,"-37.80456984, 144.94946228"
75220240609,75,2024-06-09,2,1,2,3,SprFli_T,"-37.81515276, 144.97467661"
39620231209,39,2023-12-09,6,9,8,17,AlfPl_T,"-37.81379749, 144.96995745"
392320231214,39,2023-12-14,23,23,24,47,AlfPl_T,"-37.81379749, 144.96995745"
81520250831,8,2025-08-31,15,153,156,309,WebBN_T,"-37.82293543, 144.9471751"
142020250513,14,2025-05-13,20,222,77,299,SanBri_T,"-37.82011242, 144.96291897"
71020240227,71,2024-02-27,0,5,9,14,WestWP_T,"-37.81235775, 144.97136962"
291720240806,29,2024-08-06,17,305,342,647,AG_T,"-37.8199817, 144.96872865"
142220250104,14,2025-01-04,22,378,121,499,SanBri_T,"-37.82011242, 144.96291897"
40620250111,40,2025-01-11,6,9,12,21,Spr201_T,"-37.80999341, 144.97227587"
40220231109,40,2023-11-09,2,6,5,11,Spr201_T,"-37.80999341, 144.97227587"
40120240220,40,2024-02-20,1,4,3,7,Spr201_T,"-37.80999341, 144.97227587"
36220250404,36,2025-04-04,2,12,5,17,Que85_T,"-37.81652527, 144.96121062"
471920240623,47,2024-06-23,19,521,444,965,Eli250_T,"-37.81258467, 144.9625775"
501120241008,50,2024-10-08,11,133,145,278,Lyg309_T,"-37.79808192, 144.96721013"
441420240227,44,2024-02-27,14,39,53,92,UM3_T,"-37.79698741, 144.96441306"
432020240119,43,2024-01-19,20,35,44,79,UM2_T,"-37.79844526, 144.96411782"
1082120250319,108,2025-03-19,21,212,106,318,261Will_T,"-37.81295822, 144.95678789"
1322320240701,132,2024-07-01,23,36,45,81,King335_T,"-37.81267639, 144.95386444"
1341820250528,134,2025-05-28,18,236,185,421,Spen201_T,"-37.81694221, 144.95303935"
179720250430,179,2025-04-30,7,48,22,70,Pow61_T,"-37.82392385, 144.96299677"
1402020250302,140,2025-03-02,20,10,14,24,Boyd2837_T,"-37.82590962, 144.96185972"
681920241113,68,2024-11-13,19,169,103,272,FLDegN_T,"-37.8168479, 144.96559789"
121520241018,12,2024-10-18,15,365,382,747,NewQ_T,"-37.81457988, 144.94292398"
562020240107,56,2024-01-07,20,187,202,389,Lon364_T,"-37.81234775, 144.96153311"
56820240412,56,2024-04-12,8,112,142,254,Lon364_T,"-37.81234775, 144.96153311"
561520240729,56,2024-07-29,15,260,224,484,Lon364_T,"-37.81234775, 144.96153311"
861120240116,86,2024-01-16,11,27,17,44,574Qub_T,"-37.80309992, 144.94908064"
86720240820,86,2024-08-20,7,18,17,35,574Qub_T,"-37.80309992, 144.94908064"
11120240508,11,2024-05-08,1,1,2,3,WatCit_T,"-37.81564989, 144.93970694"
111920240805,11,2024-08-05,19,44,48,92,WatCit_T,"-37.81564989, 144.93970694"
241020250117,24,2025-01-17,10,880,435,1315,Col620_T,"-37.81887963, 144.95449198"
351920250129,35,2025-01-29,19,950,1075,2025,SouthB_T,"-37.82018685, 144.96508508"
352120250615,35,2025-06-15,21,191,304,495,SouthB_T,"-37.82018685, 144.96508508"
76020240603,76,2024-06-03,0,2,0,2,KenMac_T,"-37.79453803, 144.93036194"
761320240719,76,2024-07-19,13,59,51,110,KenMac_T,"-37.79453803, 144.93036194"
91120240426,9,2024-04-26,11,236,305,541,Col700_T,"-37.81982992, 144.95102555"
9120250716,9,2025-07-16,1,3,6,9,Col700_T,"-37.81982992, 144.95102555"
92320240304,9,2024-03-04,23,17,23,40,Col700_T,"-37.81982992, 144.95102555"
531420240101,53,2024-01-01,14,398,326,724,Col254_T,"-37.81564191, 144.965499"
79220240512,79,2024-05-12,2,72,83,155,FliSS_T,"-37.81794046, 144.96616678"
792120241106,79,2024-11-06,21,180,225,405,FliSS_T,"-37.81794046, 144.96616678"
46720231101,46,2023-11-01,7,27,28,55,Pel147_T,"-37.80240719, 144.9615673"
25020241204,25,2024-12-04,0,19,14,33,MCEC_T,"-37.82401776, 144.95604426"
19220231107,19,2023-11-07,2,58,68,126,LtB210_T,"-37.81237202, 144.96550671"
1801820250719,180,2025-07-19,18,4,5,9,Mac330_T,"-37.79497059, 144.93530329"
1372020250227,137,2025-02-27,20,5,10,15,BouHbr2353_T,"-37.81894815, 144.94612292"
491620240706,49,2024-07-06,16,251,495,746,Eli501_T,"-37.80730068, 144.95956055"
1091020250605,109,2025-06-05,10,86,179,265,LatWill_T,"-37.81193681, 144.95621105"
1092120250722,109,2025-07-22,21,40,72,112,LatWill_T,"-37.81193681, 144.95621105"
1091820240315,109,2024-03-15,18,207,192,399,LatWill_T,"-37.81193681, 144.95621105"
19020250104,19,2025-01-04,0,169,209,378,LtB210_T,"-37.81237202, 144.96550671"
481920241105,48,2024-11-05,19,94,86,180,QVMQ_T,"-37.80631581, 144.95866697"
137920240101,137,2024-01-01,9,6,14,20,BouHbr2353_T,"-37.81894815, 144.94612292"
139120231215,139,2023-12-15,1,3,7,10,Signal1647_T,"-37.81959923, 144.9632832"
661020231122,66,2023-11-22,10,346,418,764,QVN_T,"-37.81057846, 144.96444294"
39520231102,39,2023-11-02,5,19,7,26,AlfPl_T,"-37.81379749, 144.96995745"
39520231119,39,2023-11-19,5,1,7,8,AlfPl_T,"-37.81379749, 144.96995745"
77920240130,77,2024-01-30,9,98,136,234,HarEsP_T,"-37.81441438, 144.94433026"
29320250209,29,2025-02-09,3,7,21,28,AG_T,"-37.8199817, 144.96872865"
401020240906,40,2024-09-06,10,146,197,343,Spr201_T,"-37.80999341, 144.97227587"
311620250605,31,2025-06-05,16,153,108,261,Lyg161_T,"-37.80169681, 144.96658911"
371720250320,37,2025-03-20,17,102,116,218,Lyg260_T,"-37.80107122, 144.96704554"
371520241120,37,2024-11-20,15,78,110,188,Lyg260_T,"-37.80107122, 144.96704554"
471620250319,47,2025-03-19,16,993,802,1795,Eli250_T,"-37.81258467, 144.9625775"
52120241112,5,2024-11-12,21,518,345,863,PriNW_T,"-37.81874249, 144.96787656"
108720241209,108,2024-12-09,7,51,642,693,261Will_T,"-37.81295822, 144.95678789"
871120250721,87,2025-07-21,11,104,73,177,Errol23_T,"-37.80454949, 144.94921863"
1852220250727,185,2025-07-27,22,118,121,239,Eli197_T,"-37.81374643, 144.96276183"
1661420250124,166,2025-01-24,14,42,31,73,Spen484_T,"-37.80896733, 144.94931703"
1622320251005,162,2025-10-05,23,127,84,211,Eli489_T,"-37.80740397, 144.95987909"
1811620250613,181,2025-06-13,16,705,1038,1743,Eli368_T,"-37.81009465, 144.96143149"
1621720240730,162,2024-07-30,17,287,339,626,Eli489_T,"-37.80740397, 144.95987909"
1321420250523,132,2025-05-23,14,133,120,253,King335_T,"-37.81267639, 144.95386444"
131420250307,131,2025-03-07,4,4,9,13,King2_T,"-37.82009057, 144.95758725"
1312320250423,131,2025-04-23,23,62,21,83,King2_T,"-37.82009057, 144.95758725"
1311620250909,131,2025-09-09,16,205,156,361,King2_T,"-37.82009057, 144.95758725"
1351620240415,135,2024-04-15,16,497,428,925,Spen161_T,"-37.8172861, 144.95319102"
1071620250122,107,2025-01-22,16,143,100,243,280Will_T,"-37.81246271, 144.95690188"
1071520240601,107,2024-06-01,15,85,123,208,280Will_T,"-37.81246271, 144.95690188"
851620250910,85,2025-09-10,16,72,83,155,488Mac_T,"-37.79432415, 144.92973378"
11020240918,1,2024-09-18,10,592,467,1059,Bou292_T,"-37.81349441, 144.96515323"
12320241103,1,2024-11-03,23,471,66,537,Bou292_T,"-37.81349441, 144.96515323"
671920250806,67,2025-08-06,19,222,238,460,FLDegS_T,"-37.81688755, 144.96562569"
681320240920,68,2024-09-20,13,324,232,556,FLDegN_T,"-37.8168479, 144.96559789"
621020250906,62,2025-09-06,10,128,113,241,Lat224_T,"-37.80996494, 144.96216521"
11420250410,1,2025-04-10,14,1351,1323,2674,Bou292_T,"-37.81349441, 144.96515323"
1371320241111,137,2024-11-11,13,29,54,83,BouHbr2353_T,"-37.81894815, 144.94612292"
1391120240619,139,2024-06-19,11,37,30,67,Signal1647_T,"-37.81959923, 144.9632832"
136520240521,136,2024-05-21,5,7,3,10,BirFed1120_T,"-37.8184141, 144.97357915"
142920240625,142,2024-06-25,9,141,129,270,Hammer1584_T,"-37.81970749, 144.96795734"
142820250614,142,2025-06-14,8,226,229,455,Hammer1584_T,"-37.81970749, 144.96795734"
130920250410,130,2025-04-10,9,55,36,91,Bou892T,"-37.8204637, 144.94126826"
123720240427,123,2024-04-27,7,6,3,9,BirBridge_T,"-37.81753741, 144.97329734"
681920231023,68,2023-10-23,19,113,37,150,FLDegN_T,"-37.8168479, 144.96559789"
171320250424,17,2025-04-24,13,580,546,1126,Col15_T,"-37.81362543, 144.97323591"
1220250318,1,2025-03-18,2,6,14,20,Bou292_T,"-37.81349441, 144.96515323"
66620240204,66,2024-02-04,6,17,59,76,QVN_T,"-37.81057846, 144.96444294"
42320231127,4,2023-11-27,23,387,136,523,Swa123_T,"-37.81487988, 144.9660878"
4520240622,4,2024-06-22,5,29,10,39,Swa123_T,"-37.81487988, 144.9660878"
4320240818,4,2024-08-18,3,38,45,83,Swa123_T,"-37.81487988, 144.9660878"
41020240824,4,2024-08-24,10,841,584,1425,Swa123_T,"-37.81487988, 144.9660878"
42220241028,4,2024-10-28,22,256,157,413,Swa123_T,"-37.81487988, 144.9660878"
3120250902,3,2025-09-02,1,79,40,119,Swa295_T,"-37.81101524, 144.96429485"
81820231204,8,2023-12-04,18,156,206,362,WebBN_T,"-37.82293543, 144.9471751"
751020241217,75,2024-12-17,10,56,45,101,SprFli_T,"-37.81515276, 144.97467661"
781620240701,78,2024-07-01,16,29,161,190,HarEsB_T,"-37.81471642, 144.9446508"
711220240816,71,2024-08-16,12,32,30,62,WestWP_T,"-37.81235775, 144.97136962"
65120240311,65,2024-03-11,1,26,58,84,SwaCs_T,"-37.81569416, 144.9668064"
541920250417,54,2025-04-17,19,181,294,475,Swa607_T,"-37.804024, 144.96308399"
44720240714,44,2024-07-14,7,5,4,9,UM3_T,"-37.79698741, 144.96441306"
452120240420,45,2024-04-20,21,659,1289,1948,Swa148_T,"-37.81414075, 144.96609379"
51720231025,5,2023-10-25,17,1190,986,2176,PriNW_T,"-37.81874249, 144.96787656"
21220250409,21,2025-04-09,2,2,2,4,Bourke155_T,"-37.81267313, 144.96788288"
1311920250401,131,2025-04-01,19,80,72,152,King2_T,"-37.82009057, 144.95758725"
1322220240911,132,2024-09-11,22,50,44,94,King335_T,"-37.81267639, 144.95386444"
1342220231230,134,2023-12-30,22,185,211,396,Spen201_T,"-37.81694221, 144.95303935"
1401220240212,140,2024-02-12,12,71,34,105,Boyd2837_T,"-37.82590962, 144.96185972"
67720241212,67,2024-12-12,7,189,174,363,FLDegS_T,"-37.81688755, 144.96562569"
681320250626,68,2025-06-26,13,456,446,902,FLDegN_T,"-37.8168479, 144.96559789"
851520240308,85,2024-03-08,15,78,118,196,488Mac_T,"-37.79432415, 144.92973378"
12120240208,1,2024-02-08,21,345,235,580,Bou292_T,"-37.81349441, 144.96515323"
67720231119,67,2023-11-19,7,38,50,88,FLDegS_T,"-37.81688755, 144.96562569"
621620250926,62,2025-09-26,16,306,242,548,Lat224_T,"-37.80996494, 144.96216521"
631620240219,63,2024-02-19,16,341,352,693,Bou231_T,"-37.81333081, 144.96675571"
681520240303,68,2024-03-03,15,172,181,353,FLDegN_T,"-37.8168479, 144.96559789"
62220241107,62,2024-11-07,2,25,17,42,Lat224_T,"-37.80996494, 144.96216521"
24320240424,24,2024-04-24,3,18,6,24,Col620_T,"-37.81887963, 144.95449198"
762120240212,76,2024-02-12,21,14,11,25,KenMac_T,"-37.79453803, 144.93036194"
2420250306,2,2025-03-06,4,9,5,14,Bou283_T,"-37.81380668, 144.96516718"
35820231119,35,2023-11-19,8,319,296,615,SouthB_T,"-37.82018685, 144.96508508"
24620231212,24,2023-12-12,6,273,124,397,Col620_T,"-37.81887963, 144.95449198"
102120240420,10,2024-04-20,21,24,21,45,BouHbr_T,"-37.81876474, 144.94710545"
101120250416,10,2025-04-16,11,101,80,181,BouHbr_T,"-37.81876474, 144.94710545"
101120250503,10,2025-05-03,11,37,37,74,BouHbr_T,"-37.81876474, 144.94710545"
12920241224,12,2024-12-24,9,112,92,204,NewQ_T,"-37.81457988, 144.94292398"
761520240722,76,2024-07-22,15,52,65,117,KenMac_T,"-37.79453803, 144.93036194"
22020240217,2,2024-02-17,20,187,328,515,Bou283_T,"-37.81380668, 144.96516718"
35120250412,35,2025-04-12,1,92,180,272,SouthB_T,"-37.82018685, 144.96508508"
762220250509,76,2025-05-09,22,1,10,11,KenMac_T,"-37.79453803, 144.93036194"
9720241112,9,2024-11-12,7,70,1430,1500,Col700_T,"-37.81982992, 144.95102555"
91920241230,9,2024-12-30,19,54,59,113,Col700_T,"-37.81982992, 144.95102555"
792220240420,79,2024-04-20,22,321,385,706,FliSS_T,"-37.81794046, 144.96616678"
791620240312,79,2024-03-12,16,533,499,1032,FliSS_T,"-37.81794046, 144.96616678"
531920250226,53,2025-02-26,19,238,196,434,Col254_T,"-37.81564191, 144.965499"
511220250305,51,2025-03-05,12,173,144,317,Fra118_T,"-37.80841815, 144.95906316"
512320231204,51,2023-12-04,23,28,17,45,Fra118_T,"-37.80841815, 144.95906316"
46720250731,46,2025-07-31,7,19,8,27,Pel147_T,"-37.80240719, 144.9615673"
491820250912,49,2025-09-12,18,283,267,550,Eli501_T,"-37.80730068, 144.95956055"
1412320250323,141,2025-03-23,23,26,38,64,474Fl_T,"-37.81997273, 144.95834911"
492120241104,49,2024-11-04,21,145,105,250,Eli501_T,"-37.80730068, 144.95956055"
1171220240522,117,2024-05-22,12,199,350,549,Fli114F_T,"-37.81629332, 144.97090877"
1091520231223,109,2023-12-23,15,66,76,142,LatWill_T,"-37.81193681, 144.95621105"
109220240125,109,2024-01-25,2,5,6,11,LatWill_T,"-37.81193681, 144.95621105"
482320241222,48,2024-12-22,23,2,2,4,QVMQ_T,"-37.80631581, 144.95866697"
1422020241121,142,2024-11-21,20,375,249,624,Hammer1584_T,"-37.81970749, 144.96795734"
41420240322,4,2024-03-22,14,1795,1518,3313,Swa123_T,"-37.81487988, 144.9660878"
78720250301,78,2025-03-01,7,25,37,62,HarEsB_T,"-37.81471642, 144.9446508"
41120250131,41,2025-01-31,1,52,90,142,Swa31,"-37.81668634, 144.96689733"
781520231109,78,2023-11-09,15,88,133,221,HarEsB_T,"-37.81471642, 144.9446508"
781420231126,78,2023-11-26,14,67,113,180,HarEsB_T,"-37.81471642, 144.9446508"
41520240706,41,2024-07-06,5,55,40,95,Swa31,"-37.81668634, 144.96689733"
421120250917,42,2025-09-17,11,227,260,487,UM1_T,"-37.80008566, 144.96386412"
42920241003,42,2024-10-03,9,303,113,416,UM1_T,"-37.80008566, 144.96386412"
29420240101,29,2024-01-01,4,39,25,64,AG_T,"-37.8199817, 144.96872865"
292120240207,29,2024-02-07,21,117,133,250,AG_T,"-37.8199817, 144.96872865"
711920231112,71,2023-11-12,19,6,12,18,WestWP_T,"-37.81235775, 144.97136962"
591220250219,59,2025-02-19,12,406,400,806,RMIT_T,"-37.80825648, 144.96304859"
541220240215,54,2024-02-15,12,213,246,459,Swa607_T,"-37.804024, 144.96308399"
28220240505,28,2024-05-05,2,16,14,30,VAC_T,"-37.82129925, 144.96879309"
401120240205,40,2024-02-05,11,189,240,429,Spr201_T,"-37.80999341, 144.97227587"
401620250730,40,2025-07-30,16,232,233,465,Spr201_T,"-37.80999341, 144.97227587"
31120231020,31,2023-10-20,1,14,32,46,Lyg161_T,"-37.80169681, 144.96658911"
311720240217,31,2024-02-17,17,341,211,552,Lyg161_T,"-37.80169681, 144.96658911"
37120240816,37,2024-08-16,1,6,6,12,Lyg260_T,"-37.80107122, 144.96704554"
51120240325,5,2024-03-25,11,730,1160,1890,PriNW_T,"-37.81874249, 144.96787656"
212320240614,21,2024-06-14,23,230,332,562,Bourke155_T,"-37.81267313, 144.96788288"
108620250319,108,2025-03-19,6,37,287,324,261Will_T,"-37.81295822, 144.95678789"
50120250314,50,2025-03-14,1,11,1,12,Lyg309_T,"-37.79808192, 144.96721013"
43120240503,43,2024-05-03,1,2,5,7,UM2_T,"-37.79844526, 144.96411782"
1311820241024,131,2024-10-24,18,120,161,281,King2_T,"-37.82009057, 144.95758725"
1622120250707,162,2025-07-07,21,110,86,196,Eli489_T,"-37.80740397, 144.95987909"
11520250915,11,2025-09-15,5,5,4,9,WatCit_T,"-37.81564989, 144.93970694"
102320241215,10,2024-12-15,23,15,1,16,BouHbr_T,"-37.81876474, 144.94710545"
121420250417,12,2025-04-17,14,133,149,282,NewQ_T,"-37.81457988, 144.94292398"
24720250226,24,2025-02-26,7,972,236,1208,Col620_T,"-37.81887963, 144.95449198"
762020240103,76,2024-01-03,20,9,19,28,KenMac_T,"-37.79453803, 144.93036194"
762120240310,76,2024-03-10,21,8,7,15,KenMac_T,"-37.79453803, 144.93036194"
72820240711,72,2024-07-11,8,621,93,714,ACMI_T,"-37.81726338, 144.96872809"
721220240118,72,2024-01-18,12,285,352,637,ACMI_T,"-37.81726338, 144.96872809"
72720240407,72,2024-04-07,7,18,17,35,ACMI_T,"-37.81726338, 144.96872809"
582320250202,58,2025-02-02,23,59,89,148,Bou688_T,"-37.81686075, 144.95358075"
58420231028,58,2023-10-28,4,21,30,51,Bou688_T,"-37.81686075, 144.95358075"
58720240227,58,2024-02-27,7,880,147,1027,Bou688_T,"-37.81686075, 144.95358075"
351120241106,35,2024-11-06,11,1161,947,2108,SouthB_T,"-37.82018685, 144.96508508"
76220240729,76,2024-07-29,2,1,0,1,KenMac_T,"-37.79453803, 144.93036194"
2720250616,2,2025-06-16,7,45,85,130,Bou283_T,"-37.81380668, 144.96516718"
27820240220,27,2024-02-20,8,60,111,171,Vic_T,"-37.80606888, 144.95644692"
271820231129,27,2023-11-29,18,141,89,230,Vic_T,"-37.80606888, 144.95644692"
91320231122,9,2023-11-22,13,505,494,999,Col700_T,"-37.81982992, 144.95102555"
53620250715,53,2025-07-15,6,22,24,46,Col254_T,"-37.81564191, 144.965499"
51320250515,51,2025-05-15,3,0,1,1,Fra118_T,"-37.80841815, 144.95906316"
201820250308,20,2025-03-08,18,551,451,1002,LtB170_T,"-37.81172914, 144.9682466"
201420250327,20,2025-03-27,14,181,255,436,LtB170_T,"-37.81172914, 144.9682466"
1411720231213,141,2023-12-13,17,216,140,356,474Fl_T,"-37.81997273, 144.95834911"
141320240714,141,2024-07-14,3,36,46,82,474Fl_T,"-37.81997273, 144.95834911"
117520240429,117,2024-04-29,5,8,9,17,Fli114F_T,"-37.81629332, 144.97090877"
192020240613,19,2024-06-13,20,415,590,1005,LtB210_T,"-37.81237202, 144.96550671"
1421720250506,142,2025-05-06,17,434,342,776,Hammer1584_T,"-37.81970749, 144.96795734"
142320240308,142,2024-03-08,3,3,2,5,Hammer1584_T,"-37.81970749, 144.96795734"
1421620240824,142,2024-08-24,16,1110,652,1762,Hammer1584_T,"-37.81970749, 144.96795734"
671720250111,67,2025-01-11,17,338,472,810,FLDegS_T,"-37.81688755, 144.96562569"
56520241030,56,2024-10-30,5,9,1,10,Lon364_T,"-37.81234775, 144.96153311"
56220250104,56,2025-01-04,2,37,45,82,Lon364_T,"-37.81234775, 144.96153311"
86120240105,86,2024-01-05,1,3,0,3,574Qub_T,"-37.80309992, 144.94908064"
862120250913,86,2025-09-13,21,14,78,92,574Qub_T,"-37.80309992, 144.94908064"
861920250927,86,2025-09-27,19,24,31,55,574Qub_T,"-37.80309992, 144.94908064"
112120240218,11,2024-02-18,21,112,107,219,WatCit_T,"-37.81564989, 144.93970694"
8220240331,8,2024-03-31,2,2,2,4,WebBN_T,"-37.82293543, 144.9471751"
59520231029,59,2023-10-29,5,34,17,51,RMIT_T,"-37.80825648, 144.96304859"
541720240727,54,2024-07-27,17,146,153,299,Swa607_T,"-37.804024, 144.96308399"
541520231229,54,2023-12-29,15,70,95,165,Swa607_T,"-37.804024, 144.96308399"
40920250225,40,2025-02-25,9,308,284,592,Spr201_T,"-37.80999341, 144.97227587"
30720240717,30,2024-07-17,7,45,47,92,Lon189_T,"-37.8112185, 144.96656806"
302320240113,30,2024-01-13,23,382,388,770,Lon189_T,"-37.8112185, 144.96656806"
521320240417,52,2024-04-17,13,435,351,786,Eli263_T,"-37.81252157, 144.9619401"
461920241029,46,2024-10-29,19,105,101,206,Pel147_T,"-37.80240719, 144.9615673"
251120240208,25,2024-02-08,11,0,0,0,MCEC_T,"-37.82401776, 144.95604426"
1801020250611,180,2025-06-11,10,24,13,37,Mac330_T,"-37.79497059, 144.93530329"
1801820250925,180,2025-09-25,18,27,47,74,Mac330_T,"-37.79497059, 144.93530329"
1361520250702,136,2025-07-02,15,40,31,71,BirFed1120_T,"-37.8184141, 144.97357915"
1421020240330,142,2024-03-30,10,324,201,525,Hammer1584_T,"-37.81970749, 144.96795734"
123920250319,123,2025-03-19,9,24,23,47,BirBridge_T,"-37.81753741, 144.97329734"
138820240715,138,2024-07-15,8,2,4,6,EntPark1671_T,"-37.81996544, 144.95981454"
138920241221,138,2024-12-21,9,5,5,10,EntPark1671_T,"-37.81996544, 144.95981454"
117720241226,117,2024-12-26,7,29,23,52,Fli114F_T,"-37.81629332, 144.97090877"
1231820240511,123,2024-05-11,18,10,0,10,BirBridge_T,"-37.81753741, 144.97329734"
691220241016,69,2024-10-16,12,377,322,699,FLDegC_T,"-37.81687226, 144.96559144"
61420240121,6,2024-01-21,14,860,968,1828,FliS_T,"-37.81911705, 144.96558255"
841420240311,84,2024-03-11,14,738,978,1716,ElFi_T,"-37.81798049, 144.96503383"
31420250208,3,2025-02-08,14,1117,1095,2212,Swa295_T,"-37.81101524, 144.96429485"
31920250311,3,2025-03-11,19,883,918,1801,Swa295_T,"-37.81101524, 144.96429485"
78520241227,78,2024-12-27,5,2,4,6,HarEsB_T,"-37.81471642, 144.9446508"
781720250513,78,2025-05-13,17,18,146,164,HarEsB_T,"-37.81471642, 144.9446508"
652320240811,65,2024-08-11,23,116,83,199,SwaCs_T,"-37.81569416, 144.9668064"
651920231214,65,2023-12-14,19,486,701,1187,SwaCs_T,"-37.81569416, 144.9668064"
422220240801,42,2024-08-01,22,43,77,120,UM1_T,"-37.80008566, 144.96386412"
31120250606,31,2025-06-06,1,6,3,9,Lyg161_T,"-37.80169681, 144.96658911"
31220231222,31,2023-12-22,2,20,15,35,Lyg161_T,"-37.80169681, 144.96658911"
54720240627,54,2024-06-27,7,26,15,41,Swa607_T,"-37.804024, 144.96308399"
361420250608,36,2025-06-08,14,137,110,247,Que85_T,"-37.81652527, 144.96121062"
47020250909,47,2025-09-09,0,48,48,96,Eli250_T,"-37.81258467, 144.9625775"
50920251016,50,2025-10-16,9,52,98,150,Lyg309_T,"-37.79808192, 144.96721013"
1821620250626,182,2025-06-26,16,225,195,420,King163_T,"-37.81627451, 144.95550503"
1322020250327,132,2025-03-27,20,175,158,333,King335_T,"-37.81267639, 144.95386444"
135820250803,135,2025-08-03,8,114,152,266,Spen161_T,"-37.8172861, 144.95319102"
1071220250713,107,2025-07-13,12,107,190,297,280Will_T,"-37.81246271, 144.95690188"
118020250331,118,2025-03-31,0,0,3,3,Fli114C_T,"-37.81632783, 144.97090512"
1082320241010,108,2024-10-10,23,35,47,82,261Will_T,"-37.81295822, 144.95678789"
87720250103,87,2025-01-03,7,20,11,31,Errol23_T,"-37.80454949, 144.94921863"
1671120250918,167,2025-09-18,11,21,53,74,Lat526_T,"-37.81304149, 144.95155955"
471320250412,47,2025-04-12,13,988,1120,2108,Eli250_T,"-37.81258467, 144.9625775"
471420231124,47,2023-11-24,14,1191,1297,2488,Eli250_T,"-37.81258467, 144.9625775"
471020240220,47,2024-02-20,10,457,595,1052,Eli250_T,"-37.81258467, 144.9625775"
45820240127,45,2024-01-27,8,98,96,194,Swa148_T,"-37.81414075, 144.96609379"
21620250228,21,2025-02-28,6,15,25,40,Bourke155_T,"-37.81267313, 144.96788288"
362020250107,36,2025-01-07,20,105,106,211,Que85_T,"-37.81652527, 144.96121062"
361420231204,36,2023-12-04,14,174,213,387,Que85_T,"-37.81652527, 144.96121062"
1321420231223,132,2023-12-23,14,128,93,221,King335_T,"-37.81267639, 144.95386444"
1342120241023,134,2024-10-23,21,328,308,636,Spen201_T,"-37.81694221, 144.95303935"
135520250702,135,2025-07-02,5,32,23,55,Spen161_T,"-37.8172861, 144.95319102"
1351020250903,135,2025-09-03,10,246,337,583,Spen161_T,"-37.8172861, 144.95319102"
1332120240817,133,2024-08-17,21,324,266,590,Spen229_T,"-37.81531435, 144.95227769"
1181620240926,118,2024-09-26,16,23,43,66,Fli114C_T,"-37.81632783, 144.97090512"
118520231223,118,2023-12-23,5,1,1,2,Fli114C_T,"-37.81632783, 144.97090512"
691120231219,69,2023-12-19,11,206,140,346,FLDegC_T,"-37.81687226, 144.96559144"
84420231114,84,2023-11-14,4,18,25,43,ElFi_T,"-37.81798049, 144.96503383"
84620241104,84,2024-11-04,6,187,82,269,ElFi_T,"-37.81798049, 144.96503383"
701620250526,70,2025-05-26,16,151,133,284,Errol20_T,"-37.80456984, 144.94946228"
39420250328,39,2025-03-28,4,2,1,3,AlfPl_T,"-37.81379749, 144.96995745"
82120250308,8,2025-03-08,21,31,30,61,WebBN_T,"-37.82293543, 144.9471751"
412120241224,41,2024-12-24,21,1943,3004,4947,Swa31,"-37.81668634, 144.96689733"
8620231112,8,2023-11-12,6,9,18,27,WebBN_T,"-37.82293543, 144.9471751"
852220240707,85,2024-07-07,22,2,7,9,488Mac_T,"-37.79432415, 144.92973378"
85420250325,85,2025-03-25,4,2,0,2,488Mac_T,"-37.79432415, 144.92973378"
112220231222,11,2023-12-22,22,57,55,112,WatCit_T,"-37.81564989, 144.93970694"
761820240306,76,2024-03-06,18,57,66,123,KenMac_T,"-37.79453803, 144.93036194"
721720250713,72,2025-07-13,17,99,298,397,ACMI_T,"-37.81726338, 144.96872809"
272020240519,27,2024-05-19,20,56,48,104,Vic_T,"-37.80606888, 144.95644692"
272120241003,27,2024-10-03,21,110,51,161,Vic_T,"-37.80606888, 144.95644692"
92320250509,9,2025-05-09,23,29,30,59,Col700_T,"-37.81982992, 144.95102555"
27820250928,27,2025-09-28,8,47,83,130,Vic_T,"-37.80606888, 144.95644692"
792320250414,79,2025-04-14,23,71,103,174,FliSS_T,"-37.81794046, 144.96616678"
512120240222,51,2024-02-22,21,55,55,110,Fra118_T,"-37.80841815, 144.95906316"
251920240206,25,2024-02-06,19,305,232,537,MCEC_T,"-37.82401776, 144.95604426"
201120240713,20,2024-07-13,11,326,218,544,LtB170_T,"-37.81172914, 144.9682466"
20220240918,20,2024-09-18,2,1,9,10,LtB170_T,"-37.81172914, 144.9682466"
46820250825,46,2025-08-25,8,151,34,185,Pel147_T,"-37.80240719, 144.9615673"
52420231102,52,2023-11-02,4,4,2,6,Eli263_T,"-37.81252157, 144.9619401"
1412320240703,141,2024-07-03,23,39,30,69,474Fl_T,"-37.81997273, 144.95834911"
141220241004,141,2024-10-04,2,9,14,23,474Fl_T,"-37.81997273, 144.95834911"
1412120250203,141,2025-02-03,21,60,97,157,474Fl_T,"-37.81997273, 144.95834911"
1411520250809,141,2025-08-09,15,177,184,361,474Fl_T,"-37.81997273, 144.95834911"
49520240820,49,2024-08-20,5,23,16,39,Eli501_T,"-37.80730068, 144.95956055"
1171920250109,117,2025-01-09,19,126,130,256,Fli114F_T,"-37.81629332, 144.97090877"
1092220240914,109,2024-09-14,22,29,63,92,LatWill_T,"-37.81193681, 144.95621105"
1372120251010,137,2025-10-10,21,1,4,5,BouHbr2353_T,"-37.81894815, 144.94612292"
1371220240222,137,2024-02-22,12,53,119,172,BouHbr2353_T,"-37.81894815, 144.94612292"
67020250110,67,2025-01-10,0,9,28,37,FLDegS_T,"-37.81688755, 144.96562569"
671820240321,67,2024-03-21,18,395,516,911,FLDegS_T,"-37.81688755, 144.96562569"
851520231118,85,2023-11-18,15,105,103,208,488Mac_T,"-37.79432415, 144.92973378"
851420240407,85,2024-04-07,14,78,77,155,488Mac_T,"-37.79432415, 144.92973378"
851420250220,85,2025-02-20,14,54,61,115,488Mac_T,"-37.79432415, 144.92973378"
85820250915,85,2025-09-15,8,117,46,163,488Mac_T,"-37.79432415, 144.92973378"
17320250426,17,2025-04-26,3,6,2,8,Col15_T,"-37.81362543, 144.97323591"
17120250830,17,2025-08-30,1,1,5,6,Col15_T,"-37.81362543, 144.97323591"
631520241111,63,2024-11-11,15,295,359,654,Bou231_T,"-37.81333081, 144.96675571"
671620250413,67,2025-04-13,16,297,462,759,FLDegS_T,"-37.81688755, 144.96562569"
181120231112,18,2023-11-12,11,72,64,136,Col12_T,"-37.81344862, 144.97305353"
182220250718,18,2025-07-18,22,20,10,30,Col12_T,"-37.81344862, 144.97305353"
631220250321,63,2025-03-21,12,388,488,876,Bou231_T,"-37.81333081, 144.96675571"
121020240523,12,2024-05-23,10,103,87,190,NewQ_T,"-37.81457988, 144.94292398"
561420240816,56,2024-08-16,14,340,337,677,Lon364_T,"-37.81234775, 144.96153311"
862020250203,86,2025-02-03,20,31,37,68,574Qub_T,"-37.80309992, 144.94908064"
861120250711,86,2025-07-11,11,53,45,98,574Qub_T,"-37.80309992, 144.94908064"
11620240623,11,2024-06-23,6,4,3,7,WatCit_T,"-37.81564989, 144.93970694"
121820250613,12,2025-06-13,18,84,71,155,NewQ_T,"-37.81457988, 144.94292398"
722020250206,72,2025-02-06,20,240,510,750,ACMI_T,"-37.81726338, 144.96872809"
561720250830,56,2025-08-30,17,415,422,837,Lon364_T,"-37.81234775, 144.96153311"
761320250603,76,2025-06-03,13,38,44,82,KenMac_T,"-37.79453803, 144.93036194"
272220231114,27,2023-11-14,22,44,23,67,Vic_T,"-37.80606888, 144.95644692"
9620250306,9,2025-03-06,6,31,284,315,Col700_T,"-37.81982992, 144.95102555"
791320240515,79,2024-05-15,13,380,264,644,FliSS_T,"-37.81794046, 144.96616678"
791420240425,79,2024-04-25,14,812,345,1157,FliSS_T,"-37.81794046, 144.96616678"
30720240105,30,2024-01-05,7,27,49,76,Lon189_T,"-37.8112185, 144.96656806"
231620240120,23,2024-01-20,16,125,223,348,Col623_T,"-37.81909256, 144.95452748"
19320240813,19,2024-08-13,3,5,14,19,LtB210_T,"-37.81237202, 144.96550671"
482020250727,48,2025-07-27,20,89,64,153,QVMQ_T,"-37.80631581, 144.95866697"
19120231124,19,2023-11-24,1,29,62,91,LtB210_T,"-37.81237202, 144.96550671"
48820240310,48,2024-03-10,8,95,82,177,QVMQ_T,"-37.80631581, 144.95866697"
46020240611,46,2024-06-11,0,13,11,24,Pel147_T,"-37.80240719, 144.9615673"
20320241226,20,2024-12-26,3,32,28,60,LtB170_T,"-37.81172914, 144.9682466"
20320240407,20,2024-04-07,3,23,47,70,LtB170_T,"-37.81172914, 144.9682466"
137820250517,137,2025-05-17,8,0,9,9,BouHbr2353_T,"-37.81894815, 144.94612292"
139920250714,139,2025-07-14,9,9,113,122,Signal1647_T,"-37.81959923, 144.9632832"
491420250527,49,2025-05-27,14,267,412,679,Eli501_T,"-37.80730068, 144.95956055"
1381120241025,138,2024-10-25,11,6,5,11,EntPark1671_T,"-37.81996544, 144.95981454"
49620240811,49,2024-08-11,6,43,28,71,Eli501_T,"-37.80730068, 144.95956055"
661220240302,66,2024-03-02,12,945,1122,2067,QVN_T,"-37.81057846, 144.96444294"
70920240112,70,2024-01-12,9,77,55,132,Errol20_T,"-37.80456984, 144.94946228"
41320241106,41,2024-11-06,3,17,39,56,Swa31,"-37.81668634, 144.96689733"
41020240917,41,2024-09-17,0,17,17,34,Swa31,"-37.81668634, 144.96689733"
651120240114,65,2024-01-14,11,541,445,986,SwaCs_T,"-37.81569416, 144.9668064"
65320240324,65,2024-03-24,3,12,102,114,SwaCs_T,"-37.81569416, 144.9668064"
291520250310,29,2025-03-10,15,1834,1278,3112,AG_T,"-37.8199817, 144.96872865"
291320250401,29,2025-04-01,13,309,317,626,AG_T,"-37.8199817, 144.96872865"
292220240328,29,2024-03-28,22,156,196,352,AG_T,"-37.8199817, 144.96872865"
36320250923,36,2025-09-23,3,8,1,9,Que85_T,"-37.81652527, 144.96121062"
36120240818,36,2024-08-18,1,119,110,229,Que85_T,"-37.81652527, 144.96121062"
612220241020,61,2024-10-20,22,208,111,319,RMIT14_T,"-37.80767455, 144.96309114"
50220240116,50,2024-01-16,2,5,2,7,Lyg309_T,"-37.79808192, 144.96721013"
431120240418,43,2024-04-18,11,238,204,442,UM2_T,"-37.79844526, 144.96411782"
432120250101,43,2025-01-01,21,7,16,23,UM2_T,"-37.79844526, 144.96411782"
1322220250809,132,2025-08-09,22,70,88,158,King335_T,"-37.81267639, 144.95386444"
1352220240721,135,2024-07-21,22,50,84,134,Spen161_T,"-37.8172861, 144.95319102"
1241220250731,124,2025-07-31,12,4,5,9,BirBridge_T,"-37.81757416, 144.97329934"
1082320250908,108,2025-09-08,23,29,27,56,261Will_T,"-37.81295822, 144.95678789"
1791620250414,179,2025-04-14,16,43,50,93,Pow61_T,"-37.82392385, 144.96299677"
1661020241128,166,2024-11-28,10,29,39,68,Spen484_T,"-37.80896733, 144.94931703"
291720231117,29,2023-11-17,17,394,346,740,AG_T,"-37.8199817, 144.96872865"
312220240612,31,2024-06-12,22,33,90,123,Lyg161_T,"-37.80169681, 144.96658911"
54820250302,54,2025-03-02,8,19,37,56,Swa607_T,"-37.804024, 144.96308399"
36520250605,36,2025-06-05,5,17,4,21,Que85_T,"-37.81652527, 144.96121062"
36020250721,36,2025-07-21,0,5,6,11,Que85_T,"-37.81652527, 144.96121062"
372320250114,37,2025-01-14,23,30,20,50,Lyg260_T,"-37.80107122, 144.96704554"
472120231211,47,2023-12-11,21,520,331,851,Eli250_T,"-37.81258467, 144.9625775"
501820250228,50,2025-02-28,18,217,273,490,Lyg309_T,"-37.79808192, 144.96721013"
211020241118,21,2024-11-18,10,204,145,349,Bourke155_T,"-37.81267313, 144.96788288"
21920250217,21,2025-02-17,9,74,82,156,Bourke155_T,"-37.81267313, 144.96788288"
143420240525,143,2024-05-25,4,27,9,36,Spencer_T,"-37.821728, 144.95557015"
1432220240613,143,2024-06-13,22,105,66,171,Spencer_T,"-37.821728, 144.95557015"
1321620231109,132,2023-11-09,16,152,138,290,King335_T,"-37.81267639, 144.95386444"
1341220250715,134,2025-07-15,12,437,515,952,Spen201_T,"-37.81694221, 144.95303935"
1341720240424,134,2024-04-24,17,557,574,1131,Spen201_T,"-37.81694221, 144.95303935"
1351420241211,135,2024-12-11,14,410,425,835,Spen161_T,"-37.8172861, 144.95319102"
1331220241027,133,2024-10-27,12,402,375,777,Spen229_T,"-37.81531435, 144.95227769"
1071620231215,107,2023-12-15,16,215,170,385,280Will_T,"-37.81246271, 144.95690188"
179820241225,179,2024-12-25,8,27,15,42,Pow61_T,"-37.82392385, 144.96299677"
851420250903,85,2025-09-03,14,78,66,144,488Mac_T,"-37.79432415, 144.92973378"
85420250922,85,2025-09-22,4,1,0,1,488Mac_T,"-37.79432415, 144.92973378"
1320241218,1,2024-12-18,3,4,12,16,Bou292_T,"-37.81349441, 144.96515323"
181320231109,18,2023-11-09,13,259,262,521,Col12_T,"-37.81344862, 144.97305353"
12620240511,12,2024-05-11,6,15,11,26,NewQ_T,"-37.81457988, 144.94292398"
562320240920,56,2024-09-20,23,129,151,280,Lon364_T,"-37.81234775, 144.96153311"
861720240920,86,2024-09-20,17,39,39,78,574Qub_T,"-37.80309992, 144.94908064"
24320240104,24,2024-01-04,3,10,23,33,Col620_T,"-37.81887963, 144.95449198"
10720240220,10,2024-02-20,7,32,153,185,BouHbr_T,"-37.81876474, 144.94710545"
10320240315,10,2024-03-15,3,2,0,2,BouHbr_T,"-37.81876474, 144.94710545"
122220250917,12,2025-09-17,22,34,29,63,NewQ_T,"-37.81457988, 144.94292398"
241820241107,24,2024-11-07,18,592,1177,1769,Col620_T,"-37.81887963, 144.95449198"
722320250131,72,2025-01-31,23,80,99,179,ACMI_T,"-37.81726338, 144.96872809"
72520240912,72,2024-09-12,5,22,17,39,ACMI_T,"-37.81726338, 144.96872809"
351420251014,35,2025-10-14,14,769,813,1582,SouthB_T,"-37.82018685, 144.96508508"
561820250519,56,2025-05-19,18,311,401,712,Lon364_T,"-37.81234775, 144.96153311"
35620240329,35,2024-03-29,6,66,56,122,SouthB_T,"-37.82018685, 144.96508508"
271520250302,27,2025-03-02,15,241,176,417,Vic_T,"-37.80606888, 144.95644692"
91520231117,9,2023-11-17,15,599,149,748,Col700_T,"-37.81982992, 144.95102555"
53020250406,53,2025-04-06,0,64,98,162,Col254_T,"-37.81564191, 144.965499"
792020241107,79,2024-11-07,20,257,274,531,FliSS_T,"-37.81794046, 144.96616678"
30720240313,30,2024-03-13,7,43,63,106,Lon189_T,"-37.8112185, 144.96656806"
108120231217,108,2023-12-17,1,32,42,74,261Will_T,"-37.81295822, 144.95678789"
85520250818,85,2025-08-18,5,5,0,5,488Mac_T,"-37.79432415, 144.92973378"
17420241216,17,2024-12-16,4,11,8,19,Col15_T,"-37.81362543, 144.97323591"
11020240815,1,2024-08-15,10,467,554,1021,Bou292_T,"-37.81349441, 144.96515323"
1420240111,1,2024-01-11,4,0,3,3,Bou292_T,"-37.81349441, 144.96515323"
621620250321,62,2025-03-21,16,360,294,654,Lat224_T,"-37.80996494, 144.96216521"
86820250713,86,2025-07-13,8,23,15,38,574Qub_T,"-37.80309992, 144.94908064"
121320240712,12,2024-07-12,13,245,233,478,NewQ_T,"-37.81457988, 144.94292398"
102120251007,10,2025-10-07,21,23,45,68,BouHbr_T,"-37.81876474, 144.94710545"
24120240708,24,2024-07-08,1,16,35,51,Col620_T,"-37.81887963, 144.95449198"
241920240912,24,2024-09-12,19,365,547,912,Col620_T,"-37.81887963, 144.95449198"
721520240425,72,2024-04-25,15,265,460,725,ACMI_T,"-37.81726338, 144.96872809"
352120240822,35,2024-08-22,21,446,812,1258,SouthB_T,"-37.82018685, 144.96508508"
2820250801,2,2025-08-01,8,97,171,268,Bou283_T,"-37.81380668, 144.96516718"
79620240127,79,2024-01-27,6,51,40,91,FliSS_T,"-37.81794046, 144.96616678"
79520240609,79,2024-06-09,5,35,39,74,FliSS_T,"-37.81794046, 144.96616678"
301220240227,30,2024-02-27,12,331,473,804,Lon189_T,"-37.8112185, 144.96656806"
52020250803,52,2025-08-03,0,215,237,452,Eli263_T,"-37.81252157, 144.9619401"
52320250814,52,2025-08-14,3,5,7,12,Eli263_T,"-37.81252157, 144.9619401"
201520240919,20,2024-09-19,15,141,193,334,LtB170_T,"-37.81172914, 144.9682466"
201020231108,20,2023-11-08,10,93,95,188,LtB170_T,"-37.81172914, 144.9682466"
51020240605,51,2024-06-05,0,15,5,20,Fra118_T,"-37.80841815, 144.95906316"
231020250326,23,2025-03-26,10,208,192,400,Col623_T,"-37.81909256, 144.95452748"
491120240505,49,2024-05-05,11,382,622,1004,Eli501_T,"-37.80730068, 144.95956055"
201820250926,20,2025-09-26,18,580,473,1053,LtB170_T,"-37.81172914, 144.9682466"
137620240906,137,2024-09-06,6,4,1,5,BouHbr2353_T,"-37.81894815, 144.94612292"
139120240505,139,2024-05-05,1,7,9,16,Signal1647_T,"-37.81959923, 144.9632832"
142420231112,142,2023-11-12,4,1,1,2,Hammer1584_T,"-37.81970749, 144.96795734"
1171920240927,117,2024-09-27,19,220,146,366,Fli114F_T,"-37.81629332, 144.97090877"
79220250108,79,2025-01-08,2,10,18,28,FliSS_T,"-37.81794046, 144.96616678"
462320250705,46,2025-07-05,23,1,1,2,Pel147_T,"-37.80240719, 144.9615673"
49720240403,49,2024-04-03,7,49,63,112,Eli501_T,"-37.80730068, 144.95956055"
1091220231208,109,2023-12-08,12,220,153,373,LatWill_T,"-37.81193681, 144.95621105"
109320231226,109,2023-12-26,3,7,14,21,LatWill_T,"-37.81193681, 144.95621105"
491920240919,49,2024-09-19,19,166,153,319,Eli501_T,"-37.80730068, 144.95956055"
252320250828,25,2025-08-28,23,89,50,139,MCEC_T,"-37.82401776, 144.95604426"
481120250126,48,2025-01-26,11,414,338,752,QVMQ_T,"-37.80631581, 144.95866697"
1391920250425,139,2025-04-25,19,20,7,27,Signal1647_T,"-37.81959923, 144.9632832"
1422320241025,142,2024-10-25,23,2,7,9,Hammer1584_T,"-37.81970749, 144.96795734"
1301120240408,130,2024-04-08,11,23,30,53,Bou892T,"-37.8204637, 144.94126826"
164220250906,164,2025-09-06,2,2,8,10,Lat526_T,"-37.813005, 144.95160411"
1381420240816,138,2024-08-16,14,7,3,10,EntPark1671_T,"-37.81996544, 144.95981454"
117020240619,117,2024-06-19,0,17,7,24,Fli114F_T,"-37.81629332, 144.97090877"
691020250530,69,2025-05-30,10,272,201,473,FLDegC_T,"-37.81687226, 144.96559144"
841920240628,84,2024-06-28,19,807,1090,1897,ElFi_T,"-37.81798049, 144.96503383"
41020240512,4,2024-05-12,10,1037,375,1412,Swa123_T,"-37.81487988, 144.9660878"
3720240125,3,2024-01-25,7,81,175,256,Swa295_T,"-37.81101524, 144.96429485"
4320251002,4,2025-10-02,3,10,12,22,Swa123_T,"-37.81487988, 144.9660878"
701120241104,70,2024-11-04,11,125,144,269,Errol20_T,"-37.80456984, 144.94946228"
81220240308,8,2024-03-08,12,175,282,457,WebBN_T,"-37.82293543, 144.9471751"
59120250902,59,2025-09-02,1,53,18,71,RMIT_T,"-37.80825648, 144.96304859"
591320240929,59,2024-09-29,13,568,360,928,RMIT_T,"-37.80825648, 144.96304859"
541820250224,54,2025-02-24,18,124,186,310,Swa607_T,"-37.804024, 144.96308399"
36220250202,36,2025-02-02,2,110,88,198,Que85_T,"-37.81652527, 144.96121062"
361520240117,36,2024-01-17,15,157,166,323,Que85_T,"-37.81652527, 144.96121062"
471020250903,47,2025-09-03,10,397,520,917,Eli250_T,"-37.81258467, 144.9625775"
432120231023,43,2023-10-23,21,40,49,89,UM2_T,"-37.79844526, 144.96411782"
431020250108,43,2025-01-08,10,58,38,96,UM2_T,"-37.79844526, 144.96411782"
431720250821,43,2025-08-21,17,294,540,834,UM2_T,"-37.79844526, 144.96411782"
21820241123,21,2024-11-23,8,50,43,93,Bourke155_T,"-37.81267313, 144.96788288"
1351420240314,135,2024-03-14,14,393,433,826,Spen161_T,"-37.8172861, 144.95319102"
1181520231023,118,2023-10-23,15,10,22,32,Fli114C_T,"-37.81632783, 144.97090512"
1081620250403,108,2025-04-03,16,1120,251,1371,261Will_T,"-37.81295822, 144.95678789"
87020240908,87,2024-09-08,0,8,10,18,Errol23_T,"-37.80454949, 144.94921863"
87620231026,87,2023-10-26,6,29,21,50,Errol23_T,"-37.80454949, 144.94921863"
1651220250305,165,2025-03-05,12,37,42,79,Spen475_T,"-37.80953359, 144.94939004"
131920240528,131,2024-05-28,9,106,31,137,King2_T,"-37.82009057, 144.95758725"
1401620241211,140,2024-12-11,16,86,90,176,Boyd2837_T,"-37.82590962, 144.96185972"
1311420250808,131,2025-08-08,14,106,139,245,King2_T,"-37.82009057, 144.95758725"
143220250623,143,2025-06-23,2,14,9,23,Spencer_T,"-37.821728, 144.95557015"
1321820241030,132,2024-10-30,18,216,187,403,King335_T,"-37.81267639, 144.95386444"
1431120240421,143,2024-04-21,11,200,451,651,Spencer_T,"-37.821728, 144.95557015"
1342320250208,134,2025-02-08,23,1235,811,2046,Spen201_T,"-37.81694221, 144.95303935"
681120231019,68,2023-10-19,11,196,128,324,FLDegN_T,"-37.8168479, 144.96559789"
851920240221,85,2024-02-21,19,42,55,97,488Mac_T,"-37.79432415, 144.92973378"
171820250102,17,2025-01-02,18,162,192,354,Col15_T,"-37.81362543, 144.97323591"
171220250429,17,2025-04-29,12,811,733,1544,Col15_T,"-37.81362543, 144.97323591"
452220240423,45,2024-04-23,22,66,163,229,Swa148_T,"-37.81414075, 144.96609379"
51520250516,5,2025-05-16,15,899,690,1589,PriNW_T,"-37.81874249, 144.96787656"
1661020241025,166,2024-10-25,10,32,30,62,Spen484_T,"-37.80896733, 144.94931703"
179020250425,179,2025-04-25,0,13,23,36,Pow61_T,"-37.82392385, 144.96299677"
1811220250603,181,2025-06-03,12,492,627,1119,Eli368_T,"-37.81009465, 144.96143149"
131120231022,131,2023-10-22,1,138,171,309,King2_T,"-37.82009057, 144.95758725"
1401520240116,140,2024-01-16,15,45,50,95,Boyd2837_T,"-37.82590962, 144.96185972"
143120241229,143,2024-12-29,1,100,38,138,Spencer_T,"-37.821728, 144.95557015"
108920250429,108,2025-04-29,9,305,1210,1515,261Will_T,"-37.81295822, 144.95678789"
108020240512,108,2024-05-12,0,12,41,53,261Will_T,"-37.81295822, 144.95678789"
172220240229,17,2024-02-29,22,100,144,244,Col15_T,"-37.81362543, 144.97323591"
171420250423,17,2025-04-23,14,336,285,621,Col15_T,"-37.81362543, 144.97323591"
17720250523,17,2025-05-23,7,292,78,370,Col15_T,"-37.81362543, 144.97323591"
182220231024,18,2023-10-24,22,8,6,14,Col12_T,"-37.81344862, 144.97305353"
18420251011,18,2025-10-11,4,0,2,2,Col12_T,"-37.81344862, 144.97305353"
632120240109,63,2024-01-09,21,106,235,341,Bou231_T,"-37.81333081, 144.96675571"
631620240520,63,2024-05-20,16,222,323,545,Bou231_T,"-37.81333081, 144.96675571"
56720250204,56,2025-02-04,7,81,59,140,Lon364_T,"-37.81234775, 144.96153311"
861420250601,86,2025-06-01,14,50,65,115,574Qub_T,"-37.80309992, 144.94908064"
351220240126,35,2024-01-26,12,1459,1513,2972,SouthB_T,"-37.82018685, 144.96508508"
352020240318,35,2024-03-18,20,778,1002,1780,SouthB_T,"-37.82018685, 144.96508508"
791720240923,79,2024-09-23,17,551,615,1166,FliSS_T,"-37.81794046, 144.96616678"
461220231111,46,2023-11-11,12,44,49,93,Pel147_T,"-37.80240719, 144.9615673"
20320250215,20,2025-02-15,3,52,65,117,LtB170_T,"-37.81172914, 144.9682466"
52920251005,52,2025-10-05,9,78,57,135,Eli263_T,"-37.81252157, 144.9619401"
201420240404,20,2024-04-04,14,205,281,486,LtB170_T,"-37.81172914, 144.9682466"
521820240305,52,2024-03-05,18,384,370,754,Eli263_T,"-37.81252157, 144.9619401"
522020240323,52,2024-03-23,20,426,420,846,Eli263_T,"-37.81252157, 144.9619401"
51520250704,51,2025-07-04,5,11,9,20,Fra118_T,"-37.80841815, 144.95906316"
164520250424,164,2025-04-24,5,4,8,12,Lat526_T,"-37.813005, 144.95160411"
117620240720,117,2024-07-20,6,8,15,23,Fli114F_T,"-37.81629332, 144.97090877"
1171920250301,117,2025-03-01,19,182,177,359,Fli114F_T,"-37.81629332, 144.97090877"
491320240626,49,2024-06-26,13,235,301,536,Eli501_T,"-37.80730068, 144.95956055"
19120240502,19,2024-05-02,1,20,54,74,LtB210_T,"-37.81237202, 144.96550671"
481320241101,48,2024-11-01,13,398,306,704,QVMQ_T,"-37.80631581, 144.95866697"
1391220240529,139,2024-05-29,12,51,53,104,Signal1647_T,"-37.81959923, 144.9632832"
1361320241010,136,2024-10-10,13,157,172,329,BirFed1120_T,"-37.8184141, 144.97357915"
1361920250309,136,2025-03-09,19,336,309,645,BirFed1120_T,"-37.8184141, 144.97357915"
66820250522,66,2025-05-22,8,277,682,959,QVN_T,"-37.81057846, 144.96444294"
661320241103,66,2024-11-03,13,1257,2037,3294,QVN_T,"-37.81057846, 144.96444294"
6720231108,6,2023-11-08,7,443,564,1007,FliS_T,"-37.81911705, 144.96558255"
6120240307,6,2024-03-07,1,51,32,83,FliS_T,"-37.81911705, 144.96558255"
66020240113,66,2024-01-13,0,173,182,355,QVN_T,"-37.81057846, 144.96444294"
39920241103,39,2024-11-03,9,75,42,117,AlfPl_T,"-37.81379749, 144.96995745"
392320250630,39,2025-06-30,23,0,1,1,AlfPl_T,"-37.81379749, 144.96995745"
8520240827,8,2024-08-27,5,6,8,14,WebBN_T,"-37.82293543, 144.9471751"
411020250727,41,2025-07-27,10,998,578,1576,Swa31,"-37.81668634, 144.96689733"
772120240106,77,2024-01-06,21,162,130,292,HarEsP_T,"-37.81441438, 144.94433026"
781320250311,78,2025-03-11,13,31,57,88,HarEsB_T,"-37.81471642, 144.9446508"
771720250606,77,2025-06-06,17,188,87,275,HarEsP_T,"-37.81441438, 144.94433026"
292220240206,29,2024-02-06,22,52,116,168,AG_T,"-37.8199817, 144.96872865"
142320240821,14,2024-08-21,23,111,22,133,SanBri_T,"-37.82011242, 144.96291897"
1172020250406,117,2025-04-06,20,116,138,254,Fli114F_T,"-37.81629332, 144.97090877"
1171220250622,117,2025-06-22,12,100,139,239,Fli114F_T,"-37.81629332, 144.97090877"
31020231203,3,2023-12-03,10,388,464,852,Swa295_T,"-37.81101524, 144.96429485"
75520250627,75,2025-06-27,5,12,6,18,SprFli_T,"-37.81515276, 144.97467661"
75920231124,75,2023-11-24,9,46,42,88,SprFli_T,"-37.81515276, 144.97467661"
771420250918,77,2025-09-18,14,105,68,173,HarEsP_T,"-37.81441438, 144.94433026"
771320240317,77,2024-03-17,13,306,206,512,HarEsP_T,"-37.81441438, 144.94433026"
291920240229,29,2024-02-29,19,6,7,13,AG_T,"-37.8199817, 144.96872865"
291220240717,29,2024-07-17,12,231,344,575,AG_T,"-37.8199817, 144.96872865"
711520240831,71,2024-08-31,15,6,12,18,WestWP_T,"-37.81235775, 144.97136962"
592020240427,59,2024-04-27,20,434,351,785,RMIT_T,"-37.80825648, 144.96304859"
54320250418,54,2025-04-18,3,19,19,38,Swa607_T,"-37.804024, 144.96308399"
29020250915,29,2025-09-15,0,1,9,10,AG_T,"-37.8199817, 144.96872865"
40920250331,40,2025-03-31,9,195,265,460,Spr201_T,"-37.80999341, 144.97227587"
47520240524,47,2024-05-24,5,18,73,91,Eli250_T,"-37.81258467, 144.9625775"
501720250925,50,2025-09-25,17,221,205,426,Lyg309_T,"-37.79808192, 144.96721013"
502320241111,50,2024-11-11,23,16,6,22,Lyg309_T,"-37.79808192, 144.96721013"
441820250824,44,2025-08-24,18,33,37,70,UM3_T,"-37.79698741, 144.96441306"
211720250515,21,2025-05-15,17,423,322,745,Bourke155_T,"-37.81267313, 144.96788288"
1312020231220,131,2023-12-20,20,82,102,184,King2_T,"-37.82009057, 144.95758725"
1622220250805,162,2025-08-05,22,101,66,167,Eli489_T,"-37.80740397, 144.95987909"
162020250128,162,2025-01-28,0,46,40,86,Eli489_T,"-37.80740397, 144.95987909"
143920240604,143,2024-06-04,9,121,397,518,Spencer_T,"-37.821728, 144.95557015"
1431220250527,143,2025-05-27,12,101,139,240,Spencer_T,"-37.821728, 144.95557015"
1341020231229,134,2023-12-29,10,275,400,675,Spen201_T,"-37.81694221, 144.95303935"
1331520250330,133,2025-03-30,15,475,444,919,Spen229_T,"-37.81531435, 144.95227769"
107320250714,107,2025-07-14,3,2,2,4,280Will_T,"-37.81246271, 144.95690188"
1071920231217,107,2023-12-17,19,65,48,113,280Will_T,"-37.81246271, 144.95690188"
107220240903,107,2024-09-03,2,1,6,7,280Will_T,"-37.81246271, 144.95690188"
1331520250729,133,2025-07-29,15,498,641,1139,Spen229_T,"-37.81531435, 144.95227769"
1792220241229,179,2024-12-29,22,45,45,90,Pow61_T,"-37.82392385, 144.96299677"
68820240727,68,2024-07-27,8,68,50,118,FLDegN_T,"-37.8168479, 144.96559789"
171820231111,17,2023-11-11,18,184,130,314,Col15_T,"-37.81362543, 144.97323591"
17720241206,17,2024-12-06,7,282,100,382,Col15_T,"-37.81362543, 144.97323591"
1620231211,1,2023-12-11,6,31,61,92,Bou292_T,"-37.81349441, 144.96515323"
18120251013,18,2025-10-13,1,2,0,2,Col12_T,"-37.81344862, 144.97305353"
632020250508,63,2025-05-08,20,60,227,287,Bou231_T,"-37.81333081, 144.96675571"
671720250814,67,2025-08-14,17,445,707,1152,FLDegS_T,"-37.81688755, 144.96562569"
861520240131,86,2024-01-31,15,64,83,147,574Qub_T,"-37.80309992, 144.94908064"
861920250201,86,2025-02-01,19,42,58,100,574Qub_T,"-37.80309992, 144.94908064"
111120250112,11,2025-01-12,11,106,92,198,WatCit_T,"-37.81564989, 144.93970694"
12920240422,12,2024-04-22,9,103,95,198,NewQ_T,"-37.81457988, 144.94292398"
242020240615,24,2024-06-15,20,343,678,1021,Col620_T,"-37.81887963, 144.95449198"
24720240726,24,2024-07-26,7,680,200,880,Col620_T,"-37.81887963, 144.95449198"
721220240414,72,2024-04-14,12,299,486,785,ACMI_T,"-37.81726338, 144.96872809"
721920241219,72,2024-12-19,19,230,464,694,ACMI_T,"-37.81726338, 144.96872809"
2820241128,2,2024-11-28,8,115,228,343,Bou283_T,"-37.81380668, 144.96516718"
581820240104,58,2024-01-04,18,536,562,1098,Bou688_T,"-37.81686075, 144.95358075"
272120241024,27,2024-10-24,21,85,41,126,Vic_T,"-37.80606888, 144.95644692"
27320241031,27,2024-10-31,3,5,4,9,Vic_T,"-37.80606888, 144.95644692"
58320250809,58,2025-08-09,3,13,40,53,Bou688_T,"-37.81686075, 144.95358075"
58120250823,58,2025-08-23,1,81,116,197,Bou688_T,"-37.81686075, 144.95358075"
91620241215,9,2024-12-15,16,49,52,101,Col700_T,"-37.81982992, 144.95102555"
9920250511,9,2025-05-11,9,41,42,83,Col700_T,"-37.81982992, 144.95102555"
671820231208,67,2023-12-08,18,469,518,987,FLDegS_T,"-37.81688755, 144.96562569"
861220250508,86,2025-05-08,12,83,89,172,574Qub_T,"-37.80309992, 144.94908064"
62520250209,62,2025-02-09,5,31,22,53,Lat224_T,"-37.80996494, 144.96216521"
621320250402,62,2025-04-02,13,292,217,509,Lat224_T,"-37.80996494, 144.96216521"
121820250717,12,2025-07-17,18,100,51,151,NewQ_T,"-37.81457988, 144.94292398"
121720250819,12,2025-08-19,17,257,382,639,NewQ_T,"-37.81457988, 144.94292398"
24520250425,24,2025-04-25,5,39,42,81,Col620_T,"-37.81887963, 144.95449198"
72320241129,72,2024-11-29,3,0,6,6,ACMI_T,"-37.81726338, 144.96872809"
21720240214,2,2024-02-14,17,843,759,1602,Bou283_T,"-37.81380668, 144.96516718"
53720250523,53,2025-05-23,7,119,65,184,Col254_T,"-37.81564191, 144.965499"
9220250926,9,2025-09-26,2,11,12,23,Col700_T,"-37.81982992, 144.95102555"
461320240414,46,2024-04-14,13,68,61,129,Pel147_T,"-37.80240719, 144.9615673"
521220240825,52,2024-08-25,12,331,283,614,Eli263_T,"-37.81252157, 144.9619401"
52420241119,52,2024-11-19,4,3,0,3,Eli263_T,"-37.81252157, 144.9619401"
231520250821,23,2025-08-21,15,216,408,624,Col623_T,"-37.81909256, 144.95452748"
1231720241008,123,2024-10-08,17,5,5,10,BirBridge_T,"-37.81753741, 144.97329734"
130120250111,130,2025-01-11,1,0,1,1,Bou892T,"-37.8204637, 144.94126826"
491720250413,49,2025-04-13,17,165,196,361,Eli501_T,"-37.80730068, 144.95956055"
141820250108,141,2025-01-08,8,101,85,186,474Fl_T,"-37.81997273, 144.95834911"
1412120251016,141,2025-10-16,21,60,102,162,474Fl_T,"-37.81997273, 144.95834911"
117620241122,117,2024-11-22,6,52,35,87,Fli114F_T,"-37.81629332, 144.97090877"
491020241221,49,2024-12-21,10,292,379,671,Eli501_T,"-37.80730068, 144.95956055"
1091620241126,109,2024-11-26,16,408,120,528,LatWill_T,"-37.81193681, 144.95621105"
19720250112,19,2025-01-12,7,13,9,22,LtB210_T,"-37.81237202, 144.96550671"
19920240929,19,2024-09-29,9,92,62,154,LtB210_T,"-37.81237202, 144.96550671"
1371620250214,137,2025-02-14,16,14,149,163,BouHbr2353_T,"-37.81894815, 144.94612292"
1391820240606,139,2024-06-06,18,44,22,66,Signal1647_T,"-37.81959923, 144.9632832"
142920240910,142,2024-09-10,9,148,139,287,Hammer1584_T,"-37.81970749, 144.96795734"
661020240125,66,2024-01-25,10,390,425,815,QVN_T,"-37.81057846, 144.96444294"
66120241205,66,2024-12-05,1,67,28,95,QVN_T,"-37.81057846, 144.96444294"
701920250403,70,2025-04-03,19,154,223,377,Errol20_T,"-37.80456984, 144.94946228"
3020250331,3,2025-03-31,0,118,67,185,Swa295_T,"-37.81101524, 144.96429485"
751620240106,75,2024-01-06,16,43,21,64,SprFli_T,"-37.81515276, 144.97467661"
391120240422,39,2024-04-22,11,132,67,199,AlfPl_T,"-37.81379749, 144.96995745"
781020240102,78,2024-01-02,10,38,51,89,HarEsB_T,"-37.81471642, 144.9446508"
771720250507,77,2025-05-07,17,333,147,480,HarEsP_T,"-37.81441438, 144.94433026"
591420240117,59,2024-01-17,14,365,430,795,RMIT_T,"-37.80825648, 144.96304859"
281220250812,28,2025-08-12,12,625,598,1223,VAC_T,"-37.82129925, 144.96879309"
281120240707,28,2024-07-07,11,945,711,1656,VAC_T,"-37.82129925, 144.96879309"
471220241104,47,2024-11-04,12,894,1022,1916,Eli250_T,"-37.81258467, 144.9625775"
31320240729,31,2024-07-29,3,4,2,6,Lyg161_T,"-37.80169681, 144.96658911"
31220240820,31,2024-08-20,2,5,4,9,Lyg161_T,"-37.80169681, 144.96658911"
54020250102,54,2025-01-02,0,6,14,20,Swa607_T,"-37.804024, 144.96308399"
452220250918,45,2025-09-18,22,138,329,467,Swa148_T,"-37.81414075, 144.96609379"
1331120241201,133,2024-12-01,11,390,487,877,Spen229_T,"-37.81531435, 144.95227769"
1182120250713,118,2025-07-13,21,2,11,13,Fli114C_T,"-37.81632783, 144.97090512"
27020250328,27,2025-03-28,0,14,16,30,Vic_T,"-37.80606888, 144.95644692"
301620250716,30,2025-07-16,16,232,507,739,Lon189_T,"-37.8112185, 144.96656806"
30020240309,30,2024-03-09,0,308,325,633,Lon189_T,"-37.8112185, 144.96656806"
53220251011,53,2025-10-11,2,20,23,43,Col254_T,"-37.81564191, 144.965499"
792220240330,79,2024-03-30,22,305,394,699,FliSS_T,"-37.81794046, 144.96616678"
20120250730,20,2025-07-30,1,7,6,13,LtB170_T,"-37.81172914, 144.9682466"
23120240129,23,2024-01-29,1,17,24,41,Col623_T,"-37.81909256, 144.95452748"
481020250801,48,2025-08-01,10,238,159,397,QVMQ_T,"-37.80631581, 144.95866697"
48320240131,48,2024-01-31,3,6,13,19,QVMQ_T,"-37.80631581, 144.95866697"
1371720250820,137,2025-08-20,17,11,173,184,BouHbr2353_T,"-37.81894815, 144.94612292"
1391220231230,139,2023-12-30,12,22,25,47,Signal1647_T,"-37.81959923, 144.9632832"
1361220250518,136,2025-05-18,12,2105,75,2180,BirFed1120_T,"-37.8184141, 144.97357915"
1301920250717,130,2025-07-17,19,26,23,49,Bou892T,"-37.8204637, 144.94126826"
841320240309,84,2024-03-09,13,960,1223,2183,ElFi_T,"-37.81798049, 144.96503383"
84520250808,84,2025-08-08,5,57,33,90,ElFi_T,"-37.81798049, 144.96503383"
701520240218,70,2024-02-18,15,127,110,237,Errol20_T,"-37.80456984, 144.94946228"
3420250307,3,2025-03-07,4,24,11,35,Swa295_T,"-37.81101524, 144.96429485"
751120240505,75,2024-05-05,11,71,45,116,SprFli_T,"-37.81515276, 144.97467661"
411020250226,41,2025-02-26,10,1255,912,2167,Swa31,"-37.81668634, 144.96689733"
781320250410,78,2025-04-10,13,38,52,90,HarEsB_T,"-37.81471642, 144.9446508"
421420251002,42,2025-10-02,14,123,111,234,UM1_T,"-37.80008566, 144.96386412"
71620240503,71,2024-05-03,6,14,15,29,WestWP_T,"-37.81235775, 144.97136962"
28820250419,28,2025-04-19,8,350,87,437,VAC_T,"-37.82129925, 144.96879309"
29620250920,29,2025-09-20,6,22,35,57,AG_T,"-37.8199817, 144.96872865"
37920250816,37,2025-08-16,9,37,23,60,Lyg260_T,"-37.80107122, 144.96704554"
37820240326,37,2024-03-26,8,26,65,91,Lyg260_T,"-37.80107122, 144.96704554"
371120240719,37,2024-07-19,11,68,62,130,Lyg260_T,"-37.80107122, 144.96704554"
432120231118,43,2023-11-18,21,17,31,48,UM2_T,"-37.79844526, 144.96411782"
45320250218,45,2025-02-18,3,3,12,15,Swa148_T,"-37.81414075, 144.96609379"
451120240113,45,2024-01-13,11,575,516,1091,Swa148_T,"-37.81414075, 144.96609379"
45820240510,45,2024-05-10,8,212,235,447,Swa148_T,"-37.81414075, 144.96609379"
211020231019,21,2023-10-19,10,128,215,343,Bourke155_T,"-37.81267313, 144.96788288"
1821820250513,182,2025-05-13,18,325,218,543,King163_T,"-37.81627451, 144.95550503"
1311920250311,131,2025-03-11,19,88,108,196,King2_T,"-37.82009057, 144.95758725"
131420250706,131,2025-07-06,4,15,47,62,King2_T,"-37.82009057, 144.95758725"
1311420240811,131,2024-08-11,14,198,126,324,King2_T,"-37.82009057, 144.95758725"
1342220240706,134,2024-07-06,22,161,154,315,Spen201_T,"-37.81694221, 144.95303935"
1332020240504,133,2024-05-04,20,315,248,563,Spen229_T,"-37.81531435, 144.95227769"
1241320250515,124,2025-05-15,13,10,13,23,BirBridge_T,"-37.81757416, 144.97329934"
70520240831,70,2024-08-31,5,4,0,4,Errol20_T,"-37.80456984, 144.94946228"
81620250825,8,2025-08-25,16,173,285,458,WebBN_T,"-37.82293543, 144.9471751"
78120231212,78,2023-12-12,1,1,1,2,HarEsB_T,"-37.81471642, 144.9446508"
291420240615,29,2024-06-15,14,381,500,881,AG_T,"-37.8199817, 144.96872865"
1081720240901,108,2024-09-01,17,49,72,121,261Will_T,"-37.81295822, 144.95678789"
87320231101,87,2023-11-01,3,1,0,1,Errol23_T,"-37.80454949, 144.94921863"
441720240613,44,2024-06-13,17,70,43,113,UM3_T,"-37.79698741, 144.96441306"
1311120240916,131,2024-09-16,11,80,122,202,King2_T,"-37.82009057, 144.95758725"
1621720250411,162,2025-04-11,17,381,483,864,Eli489_T,"-37.80740397, 144.95987909"
1322120240131,132,2024-01-31,21,122,141,263,King335_T,"-37.81267639, 144.95386444"
1341120240726,134,2024-07-26,11,317,340,657,Spen201_T,"-37.81694221, 144.95303935"
134420241102,134,2024-11-02,4,64,34,98,Spen201_T,"-37.81694221, 144.95303935"
1352120250618,135,2025-06-18,21,98,121,219,Spen161_T,"-37.8172861, 144.95319102"
1351320250815,135,2025-08-15,13,423,460,883,Spen161_T,"-37.8172861, 144.95319102"
681620250205,68,2025-02-05,16,273,205,478,FLDegN_T,"-37.8168479, 144.96559789"
85320240714,85,2024-07-14,3,0,1,1,488Mac_T,"-37.79432415, 144.92973378"
17020250105,17,2025-01-05,0,12,11,23,Col15_T,"-37.81362543, 144.97323591"
17320250517,17,2025-05-17,3,3,8,11,Col15_T,"-37.81362543, 144.97323591"
11220240316,1,2024-03-16,12,1459,1265,2724,Bou292_T,"-37.81349441, 144.96515323"
621020240805,62,2024-08-05,10,140,126,266,Lat224_T,"-37.80996494, 144.96216521"
101720241010,10,2024-10-10,17,196,70,266,BouHbr_T,"-37.81876474, 144.94710545"
10620250921,10,2025-09-21,6,3,3,6,BouHbr_T,"-37.81876474, 144.94710545"
242120250614,24,2025-06-14,21,181,329,510,Col620_T,"-37.81887963, 144.95449198"
72920250107,72,2025-01-07,9,215,118,333,ACMI_T,"-37.81726338, 144.96872809"
722220250530,72,2025-05-30,22,61,718,779,ACMI_T,"-37.81726338, 144.96872809"
241620250816,24,2025-08-16,16,859,717,1576,Col620_T,"-37.81887963, 144.95449198"
35020241125,35,2024-11-25,0,83,141,224,SouthB_T,"-37.82018685, 144.96508508"
21220231109,2,2023-11-09,12,769,863,1632,Bou283_T,"-37.81380668, 144.96516718"
761520250727,76,2025-07-27,15,25,39,64,KenMac_T,"-37.79453803, 144.93036194"
271120231229,27,2023-12-29,11,168,229,397,Vic_T,"-37.80606888, 144.95644692"
91120240530,9,2024-05-30,11,254,317,571,Col700_T,"-37.81982992, 144.95102555"
531820250520,53,2025-05-20,18,347,230,577,Col254_T,"-37.81564191, 144.965499"
53820240121,53,2024-01-21,8,90,64,154,Col254_T,"-37.81564191, 144.965499"
301020241126,30,2024-11-26,10,103,190,293,Lon189_T,"-37.8112185, 144.96656806"
30020240208,30,2024-02-08,0,106,96,202,Lon189_T,"-37.8112185, 144.96656806"
461420250821,46,2025-08-21,14,129,91,220,Pel147_T,"-37.80240719, 144.9615673"
252320241121,25,2024-11-21,23,144,83,227,MCEC_T,"-37.82401776, 144.95604426"
25120250227,25,2025-02-27,1,7,13,20,MCEC_T,"-37.82401776, 144.95604426"
521520240901,52,2024-09-01,15,331,303,634,Eli263_T,"-37.81252157, 144.9619401"
51220240911,51,2024-09-11,2,6,5,11,Fra118_T,"-37.80841815, 144.95906316"
164320250228,164,2025-02-28,3,2,1,3,Lat526_T,"-37.813005, 144.95160411"
49220250525,49,2025-05-25,2,76,93,169,Eli501_T,"-37.80730068, 144.95956055"
1381020240403,138,2024-04-03,10,2,1,3,EntPark1671_T,"-37.81996544, 144.95981454"
1172020250908,117,2025-09-08,20,57,56,113,Fli114F_T,"-37.81629332, 144.97090877"
481120241214,48,2024-12-14,11,415,374,789,QVMQ_T,"-37.80631581, 144.95866697"
191420240909,19,2024-09-09,14,323,438,761,LtB210_T,"-37.81237202, 144.96550671"
48220241115,48,2024-11-15,2,10,6,16,QVMQ_T,"-37.80631581, 144.95866697"
1391120250513,139,2025-05-13,11,93,37,130,Signal1647_T,"-37.81959923, 144.9632832"
1422020241113,142,2024-11-13,20,217,129,346,Hammer1584_T,"-37.81970749, 144.96795734"
1421520250411,142,2025-04-11,15,440,492,932,Hammer1584_T,"-37.81970749, 144.96795734"
1361620231201,136,2023-12-01,16,92,58,150,BirFed1120_T,"-37.8184141, 144.97357915"
661520250410,66,2025-04-10,15,1458,1754,3212,QVN_T,"-37.81057846, 144.96444294"
62220250317,6,2025-03-17,22,450,312,762,FliS_T,"-37.81911705, 144.96558255"
41220231229,4,2023-12-29,12,2178,1341,3519,Swa123_T,"-37.81487988, 144.9660878"
66520240605,66,2024-06-05,5,17,19,36,QVN_T,"-37.81057846, 144.96444294"
70720250218,70,2025-02-18,7,46,25,71,Errol20_T,"-37.80456984, 144.94946228"
32020240821,3,2024-08-21,20,926,990,1916,Swa295_T,"-37.81101524, 144.96429485"
542120250922,54,2025-09-22,21,108,148,256,Swa607_T,"-37.804024, 144.96308399"
471520241016,47,2024-10-16,15,879,753,1632,Eli250_T,"-37.81258467, 144.9625775"
311620250821,31,2025-08-21,16,160,125,285,Lyg161_T,"-37.80169681, 144.96658911"
361520250920,36,2025-09-20,15,94,156,250,Que85_T,"-37.81652527, 144.96121062"
36320250416,36,2025-04-16,3,1,4,5,Que85_T,"-37.81652527, 144.96121062"
501120250120,50,2025-01-20,11,141,188,329,Lyg309_T,"-37.79808192, 144.96721013"
45620231213,45,2023-12-13,6,36,54,90,Swa148_T,"-37.81414075, 144.96609379"
5120250610,5,2025-06-10,1,6,22,28,PriNW_T,"-37.81874249, 144.96787656"
1311220250520,131,2025-05-20,12,181,211,392,King2_T,"-37.82009057, 144.95758725"
1341320250623,134,2025-06-23,13,294,330,624,Spen201_T,"-37.81694221, 144.95303935"
851320231228,85,2023-12-28,13,79,60,139,488Mac_T,"-37.79432415, 144.92973378"
851920240820,85,2024-08-20,19,47,51,98,488Mac_T,"-37.79432415, 144.92973378"
17820240914,17,2024-09-14,8,52,35,87,Col15_T,"-37.81362543, 144.97323591"
63120250306,63,2025-03-06,1,1,26,27,Bou231_T,"-37.81333081, 144.96675571"
56420240731,56,2024-07-31,4,4,6,10,Lon364_T,"-37.81234775, 144.96153311"
861120240723,86,2024-07-23,11,71,66,137,574Qub_T,"-37.80309992, 144.94908064"
101920240217,10,2024-02-17,19,35,58,93,BouHbr_T,"-37.81876474, 144.94710545"
242220250705,24,2025-07-05,22,971,424,1395,Col620_T,"-37.81887963, 144.95449198"
762220240425,76,2024-04-25,22,3,6,9,KenMac_T,"-37.79453803, 144.93036194"
722120250117,72,2025-01-17,21,138,275,413,ACMI_T,"-37.81726338, 144.96872809"
11320240207,11,2024-02-07,3,0,1,1,WatCit_T,"-37.81564989, 144.93970694"
21020240310,2,2024-03-10,10,231,309,540,Bou283_T,"-37.81380668, 144.96516718"
76520250321,76,2025-03-21,5,1,0,1,KenMac_T,"-37.79453803, 144.93036194"
272020250521,27,2025-05-21,20,98,61,159,Vic_T,"-37.80606888, 144.95644692"
231520231218,23,2023-12-18,15,150,263,413,Col623_T,"-37.81909256, 144.95452748"
791420240322,79,2024-03-22,14,522,484,1006,FliSS_T,"-37.81794046, 144.96616678"
791920250205,79,2025-02-05,19,457,288,745,FliSS_T,"-37.81794046, 144.96616678"
201920250222,20,2025-02-22,19,470,470,940,LtB170_T,"-37.81172914, 144.9682466"
52020250902,52,2025-09-02,0,6,19,25,Eli263_T,"-37.81252157, 144.9619401"
231520250808,23,2025-08-08,15,166,280,446,Col623_T,"-37.81909256, 144.95452748"
23720240716,23,2024-07-16,7,396,197,593,Col623_T,"-37.81909256, 144.95452748"
232320241015,23,2024-10-15,23,33,47,80,Col623_T,"-37.81909256, 144.95452748"
1171420250603,117,2025-06-03,14,116,139,255,Fli114F_T,"-37.81629332, 144.97090877"
117020250716,117,2025-07-16,0,8,6,14,Fli114F_T,"-37.81629332, 144.97090877"
48920241215,48,2024-12-15,9,225,273,498,QVMQ_T,"-37.80631581, 144.95866697"
1421920250624,142,2025-06-24,19,0,2,2,Hammer1584_T,"-37.81970749, 144.96795734"
691920240409,69,2024-04-09,19,15,8,23,FLDegC_T,"-37.81687226, 144.96559144"
6820231021,6,2023-10-21,8,313,250,563,FliS_T,"-37.81911705, 144.96558255"
61620250801,6,2025-08-01,16,1256,962,2218,FliS_T,"-37.81911705, 144.96558255"
391420250413,39,2025-04-13,14,51,33,84,AlfPl_T,"-37.81379749, 144.96995745"
771320231130,77,2023-11-30,13,149,139,288,HarEsP_T,"-37.81441438, 144.94433026"
711720250806,71,2025-08-06,17,38,24,62,WestWP_T,"-37.81235775, 144.97136962"
59420240127,59,2024-01-27,4,52,7,59,RMIT_T,"-37.80825648, 144.96304859"
592320240820,59,2024-08-20,23,66,143,209,RMIT_T,"-37.80825648, 144.96304859"
541820240329,54,2024-03-29,18,140,150,290,Swa607_T,"-37.804024, 144.96308399"
281320250301,28,2025-03-01,13,1318,1102,2420,VAC_T,"-37.82129925, 144.96879309"
54320240712,54,2024-07-12,3,1,5,6,Swa607_T,"-37.804024, 144.96308399"
21420250417,21,2025-04-17,4,9,5,14,Bourke155_T,"-37.81267313, 144.96788288"
471720240911,47,2024-09-11,17,947,691,1638,Eli250_T,"-37.81258467, 144.9625775"
50920240416,50,2024-04-16,9,67,116,183,Lyg309_T,"-37.79808192, 144.96721013"
50820240508,50,2024-05-08,8,41,83,124,Lyg309_T,"-37.79808192, 144.96721013"
50320250203,50,2025-02-03,3,7,0,7,Lyg309_T,"-37.79808192, 144.96721013"
50120250626,50,2025-06-26,1,4,0,4,Lyg309_T,"-37.79808192, 144.96721013"
451720250525,45,2025-05-25,17,1068,1011,2079,Swa148_T,"-37.81414075, 144.96609379"
5620241221,5,2024-12-21,6,37,53,90,PriNW_T,"-37.81874249, 144.96787656"
211820250521,21,2025-05-21,18,359,348,707,Bourke155_T,"-37.81267313, 144.96788288"
1812020250504,181,2025-05-04,20,769,630,1399,Eli368_T,"-37.81009465, 144.96143149"
1082120250509,108,2025-05-09,21,216,135,351,261Will_T,"-37.81295822, 144.95678789"
1431720251014,143,2025-10-14,17,211,281,492,Spencer_T,"-37.821728, 144.95557015"
132820240417,132,2024-04-17,8,201,127,328,King335_T,"-37.81267639, 144.95386444"
135820240412,135,2024-04-12,8,290,350,640,Spen161_T,"-37.8172861, 144.95319102"
107120240912,107,2024-09-12,1,11,3,14,280Will_T,"-37.81246271, 144.95690188"
1181520240212,118,2024-02-12,15,15,17,32,Fli114C_T,"-37.81632783, 144.97090512"
871920240606,87,2024-06-06,19,94,62,156,Errol23_T,"-37.80454949, 144.94921863"
1651420250511,165,2025-05-11,14,36,33,69,Spen475_T,"-37.80953359, 144.94939004"
1231820241001,123,2024-10-01,18,10,6,16,BirBridge_T,"-37.81753741, 144.97329734"
1642120250804,164,2025-08-04,21,25,45,70,Lat526_T,"-37.813005, 144.95160411"
1611720250315,161,2025-03-15,17,525,198,723,BirArt1109_T,"-37.81851276, 144.97131336"
67220240221,67,2024-02-21,2,5,3,8,FLDegS_T,"-37.81688755, 144.96562569"
681120240803,68,2024-08-03,11,243,188,431,FLDegN_T,"-37.8168479, 144.96559789"
181220240125,18,2024-01-25,12,260,243,503,Col12_T,"-37.81344862, 144.97305353"
18920240906,18,2024-09-06,9,97,434,531,Col12_T,"-37.81344862, 144.97305353"
631220240320,63,2024-03-20,12,541,591,1132,Bou231_T,"-37.81333081, 144.96675571"
241620240429,24,2024-04-29,16,554,1649,2203,Col620_T,"-37.81887963, 144.95449198"
72520231219,72,2023-12-19,5,8,12,20,ACMI_T,"-37.81726338, 144.96872809"
761020250216,76,2025-02-16,10,56,47,103,KenMac_T,"-37.79453803, 144.93036194"
21420250317,2,2025-03-17,14,702,649,1351,Bou283_T,"-37.81380668, 144.96516718"
27820240130,27,2024-01-30,8,60,77,137,Vic_T,"-37.80606888, 144.95644692"
531620250129,53,2025-01-29,16,598,468,1066,Col254_T,"-37.81564191, 144.965499"
531520240526,53,2024-05-26,15,499,476,975,Col254_T,"-37.81564191, 144.965499"
271220250330,27,2025-03-30,12,360,243,603,Vic_T,"-37.80606888, 144.95644692"
251620231223,25,2023-12-23,16,991,867,1858,MCEC_T,"-37.82401776, 144.95604426"
251420250202,25,2025-02-02,14,383,340,723,MCEC_T,"-37.82401776, 144.95604426"
52520250324,52,2025-03-24,5,10,4,14,Eli263_T,"-37.81252157, 144.9619401"
201020231022,20,2023-10-22,10,145,101,246,LtB170_T,"-37.81172914, 144.9682466"
511620251012,51,2025-10-12,16,114,98,212,Fra118_T,"-37.80841815, 144.95906316"
51620250811,51,2025-08-11,6,62,11,73,Fra118_T,"-37.80841815, 144.95906316"
49320250611,49,2025-06-11,3,20,21,41,Eli501_T,"-37.80730068, 144.95956055"
49720250104,49,2025-01-04,7,59,67,126,Eli501_T,"-37.80730068, 144.95956055"
491620250124,49,2025-01-24,16,172,231,403,Eli501_T,"-37.80730068, 144.95956055"
49020250216,49,2025-02-16,0,44,51,95,Eli501_T,"-37.80730068, 144.95956055"
25220250723,25,2025-07-23,2,0,4,4,MCEC_T,"-37.82401776, 144.95604426"
81620240104,8,2024-01-04,16,175,226,401,WebBN_T,"-37.82293543, 144.9471751"
81020240430,8,2024-04-30,10,122,125,247,WebBN_T,"-37.82293543, 144.9471751"
752020250106,75,2025-01-06,20,19,10,29,SprFli_T,"-37.81515276, 144.97467661"
782320231213,78,2023-12-13,23,5,7,12,HarEsB_T,"-37.81471642, 144.9446508"
78120241125,78,2024-11-25,1,2,1,3,HarEsB_T,"-37.81471642, 144.9446508"
782020250307,78,2025-03-07,20,14,5,19,HarEsB_T,"-37.81471642, 144.9446508"
141720241206,14,2024-12-06,17,592,188,780,SanBri_T,"-37.82011242, 144.96291897"
591620241212,59,2024-12-12,16,232,276,508,RMIT_T,"-37.80825648, 144.96304859"
71220231202,71,2023-12-02,2,4,0,4,WestWP_T,"-37.81235775, 144.97136962"
591520241019,59,2024-10-19,15,252,223,475,RMIT_T,"-37.80825648, 144.96304859"
281320240317,28,2024-03-17,13,830,1084,1914,VAC_T,"-37.82129925, 144.96879309"
471420240613,47,2024-06-13,14,604,609,1213,Eli250_T,"-37.81258467, 144.9625775"
432220240914,43,2024-09-14,22,16,14,30,UM2_T,"-37.79844526, 144.96411782"
52320250914,5,2025-09-14,23,84,82,166,PriNW_T,"-37.81874249, 144.96787656"
1071620240118,107,2024-01-18,16,151,128,279,280Will_T,"-37.81246271, 144.95690188"
1331320240729,133,2024-07-29,13,495,455,950,Spen229_T,"-37.81531435, 144.95227769"
118620231028,118,2023-10-28,6,1,1,2,Fli114C_T,"-37.81632783, 144.97090512"
118620240717,118,2024-07-17,6,1,3,4,Fli114C_T,"-37.81632783, 144.97090512"
118220240316,118,2024-03-16,2,2,0,2,Fli114C_T,"-37.81632783, 144.97090512"
872320250425,87,2025-04-25,23,13,13,26,Errol23_T,"-37.80454949, 144.94921863"
87320250718,87,2025-07-18,3,1,0,1,Errol23_T,"-37.80454949, 144.94921863"
44820241011,44,2024-10-11,8,51,56,107,UM3_T,"-37.79698741, 144.96441306"
166920250205,166,2025-02-05,9,19,41,60,Spen484_T,"-37.80896733, 144.94931703"
132620231220,132,2023-12-20,6,26,25,51,King335_T,"-37.81267639, 144.95386444"
671920240723,67,2024-07-23,19,200,315,515,FLDegS_T,"-37.81688755, 144.96562569"
681520240728,68,2024-07-28,15,231,147,378,FLDegN_T,"-37.8168479, 144.96559789"
11220250116,1,2025-01-16,12,1521,1375,2896,Bou292_T,"-37.81349441, 144.96515323"
11420250222,1,2025-02-22,14,1410,1441,2851,Bou292_T,"-37.81349441, 144.96515323"
68220250227,68,2025-02-27,2,1,0,1,FLDegN_T,"-37.8168479, 144.96559789"
181220241222,18,2024-12-22,12,98,108,206,Col12_T,"-37.81344862, 144.97305353"
621620231124,62,2023-11-24,16,250,130,380,Lat224_T,"-37.80996494, 144.96216521"
62420240505,62,2024-05-05,4,30,27,57,Lat224_T,"-37.80996494, 144.96216521"
861520250917,86,2025-09-17,15,44,54,98,574Qub_T,"-37.80309992, 144.94908064"
242320240929,24,2024-09-29,23,131,235,366,Col620_T,"-37.81887963, 144.95449198"
241820231203,24,2023-12-03,18,268,536,804,Col620_T,"-37.81887963, 144.95449198"
24120240208,24,2024-02-08,1,19,29,48,Col620_T,"-37.81887963, 144.95449198"
35820250102,35,2025-01-02,8,381,445,826,SouthB_T,"-37.82018685, 144.96508508"
531220250304,53,2025-03-04,12,1023,918,1941,Col254_T,"-37.81564191, 144.965499"
531120241129,53,2024-11-29,11,730,741,1471,Col254_T,"-37.81564191, 144.965499"
23520240613,23,2024-06-13,5,24,19,43,Col623_T,"-37.81909256, 144.95452748"
79120240720,79,2024-07-20,1,129,99,228,FliSS_T,"-37.81794046, 144.96616678"
791820250119,79,2025-01-19,18,584,580,1164,FliSS_T,"-37.81794046, 144.96616678"
46620250921,46,2025-09-21,6,3,7,10,Pel147_T,"-37.80240719, 144.9615673"
522320250212,52,2025-02-12,23,82,83,165,Eli263_T,"-37.81252157, 144.9619401"
461720250617,46,2025-06-17,17,70,74,144,Pel147_T,"-37.80240719, 144.9615673"
512220231215,51,2023-12-15,22,60,54,114,Fra118_T,"-37.80841815, 144.95906316"
1642320240816,164,2024-08-16,23,14,8,22,Lat526_T,"-37.813005, 144.95160411"
78720240211,78,2024-02-11,7,17,42,59,HarEsB_T,"-37.81471642, 144.9446508"
651720240922,65,2024-09-22,17,831,775,1606,SwaCs_T,"-37.81569416, 144.9668064"
54220241110,54,2024-11-10,2,14,22,36,Swa607_T,"-37.804024, 144.96308399"
31920240517,31,2024-05-17,9,74,86,160,Lyg161_T,"-37.80169681, 144.96658911"
472120240310,47,2024-03-10,21,709,422,1131,Eli250_T,"-37.81258467, 144.9625775"
51620231118,5,2023-11-18,16,2185,1729,3914,PriNW_T,"-37.81874249, 144.96787656"
362220250207,36,2025-02-07,22,119,120,239,Que85_T,"-37.81652527, 144.96121062"
61020250611,61,2025-06-11,0,13,13,26,RMIT14_T,"-37.80767455, 144.96309114"
502020250906,50,2025-09-06,20,267,258,525,Lyg309_T,"-37.79808192, 144.96721013"
502320240114,50,2024-01-14,23,12,6,18,Lyg309_T,"-37.79808192, 144.96721013"
441220250203,44,2025-02-03,12,65,54,119,UM3_T,"-37.79698741, 144.96441306"
45720241009,45,2024-10-09,7,154,143,297,Swa148_T,"-37.81414075, 144.96609379"
165520250919,165,2025-09-19,5,2,1,3,Spen475_T,"-37.80953359, 144.94939004"
1661920250104,166,2025-01-04,19,36,55,91,Spen484_T,"-37.80896733, 144.94931703"
1662120250607,166,2025-06-07,21,3,3,6,Spen484_T,"-37.80896733, 144.94931703"
1431620250627,143,2025-06-27,16,157,217,374,Spencer_T,"-37.821728, 144.95557015"
1321720240730,132,2024-07-30,17,172,199,371,King335_T,"-37.81267639, 144.95386444"
1342120250104,134,2025-01-04,21,287,196,483,Spen201_T,"-37.81694221, 144.95303935"
1341820231028,134,2023-10-28,18,410,345,755,Spen201_T,"-37.81694221, 144.95303935"
1351420241119,135,2024-11-19,14,455,425,880,Spen161_T,"-37.8172861, 144.95319102"
135320240129,135,2024-01-29,3,20,14,34,Spen161_T,"-37.8172861, 144.95319102"
107920250904,107,2025-09-04,9,115,192,307,280Will_T,"-37.81246271, 144.95690188"
1331420250802,133,2025-08-02,14,446,519,965,Spen229_T,"-37.81531435, 144.95227769"
1331720240324,133,2024-03-24,17,857,502,1359,Spen229_T,"-37.81531435, 144.95227769"
1181420250126,118,2025-01-26,14,30,32,62,Fli114C_T,"-37.81632783, 144.97090512"
851920240208,85,2024-02-08,19,59,76,135,488Mac_T,"-37.79432415, 144.92973378"
85120250404,85,2025-04-04,1,1,1,2,488Mac_T,"-37.79432415, 144.92973378"
851720250704,85,2025-07-04,17,96,106,202,488Mac_T,"-37.79432415, 144.92973378"
11920240119,1,2024-01-19,19,988,768,1756,Bou292_T,"-37.81349441, 144.96515323"
181420240201,18,2024-02-01,14,307,161,468,Col12_T,"-37.81344862, 144.97305353"
63820241105,63,2024-11-05,8,61,58,119,Bou231_T,"-37.81333081, 144.96675571"
1920250911,1,2025-09-11,9,252,434,686,Bou292_T,"-37.81349441, 144.96515323"
12020250525,12,2025-05-25,0,47,31,78,NewQ_T,"-37.81457988, 144.94292398"
72120250417,72,2025-04-17,1,2,8,10,ACMI_T,"-37.81726338, 144.96872809"
722020240830,72,2024-08-30,20,232,179,411,ACMI_T,"-37.81726338, 144.96872809"
531520250311,53,2025-03-11,15,562,451,1013,Col254_T,"-37.81564191, 144.965499"
531620240827,53,2024-08-27,16,525,445,970,Col254_T,"-37.81564191, 144.965499"
53520241021,53,2024-10-21,5,5,5,10,Col254_T,"-37.81564191, 144.965499"
30720240404,30,2024-04-04,7,22,68,90,Lon189_T,"-37.8112185, 144.96656806"
462320250204,46,2025-02-04,23,1,0,1,Pel147_T,"-37.80240719, 144.9615673"
462120250825,46,2025-08-25,21,3,0,3,Pel147_T,"-37.80240719, 144.9615673"
511120241109,51,2024-11-09,11,97,99,196,Fra118_T,"-37.80841815, 144.95906316"
161920250220,161,2025-02-20,9,106,135,241,BirArt1109_T,"-37.81851276, 144.97131336"
164020241019,164,2024-10-19,0,7,16,23,Lat526_T,"-37.813005, 144.95160411"
1411520250830,141,2025-08-30,15,111,114,225,474Fl_T,"-37.81997273, 144.95834911"
49720231018,49,2023-10-18,7,33,46,79,Eli501_T,"-37.80730068, 144.95956055"
1091720240301,109,2024-03-01,17,382,158,540,LatWill_T,"-37.81193681, 144.95621105"
191020241203,19,2024-12-03,10,133,118,251,LtB210_T,"-37.81237202, 144.96550671"
180820250629,180,2025-06-29,8,19,12,31,Mac330_T,"-37.79497059, 144.93530329"
141420240319,141,2024-03-19,4,5,7,12,474Fl_T,"-37.81997273, 144.95834911"
661020250911,66,2025-09-11,10,559,533,1092,QVN_T,"-37.81057846, 144.96444294"
69520240414,69,2024-04-14,5,3,0,3,FLDegC_T,"-37.81687226, 144.96559144"
841520250211,84,2025-02-11,15,813,1225,2038,ElFi_T,"-37.81798049, 144.96503383"
41620240728,4,2024-07-28,16,1708,1139,2847,Swa123_T,"-37.81487988, 144.9660878"
70820241210,70,2024-12-10,8,83,89,172,Errol20_T,"-37.80456984, 144.94946228"
411120250608,41,2025-06-08,11,1637,769,2406,Swa31,"-37.81668634, 144.96689733"
711120250401,71,2025-04-01,11,12,17,29,WestWP_T,"-37.81235775, 144.97136962"
47320240607,47,2024-06-07,3,36,12,48,Eli250_T,"-37.81258467, 144.9625775"
361420240716,36,2024-07-16,14,142,247,389,Que85_T,"-37.81652527, 144.96121062"
36120250513,36,2025-05-13,1,4,3,7,Que85_T,"-37.81652527, 144.96121062"
36920231120,36,2023-11-20,9,187,179,366,Que85_T,"-37.81652527, 144.96121062"
361520240212,36,2024-02-12,15,185,184,369,Que85_T,"-37.81652527, 144.96121062"
361120240323,36,2024-03-23,11,147,115,262,Que85_T,"-37.81652527, 144.96121062"
61020240324,61,2024-03-24,0,80,63,143,RMIT14_T,"-37.80767455, 144.96309114"
432220240802,43,2024-08-02,22,35,18,53,UM2_T,"-37.79844526, 144.96411782"
431220240809,43,2024-08-09,12,263,295,558,UM2_T,"-37.79844526, 144.96411782"
1312020250922,131,2025-09-22,20,71,51,122,King2_T,"-37.82009057, 144.95758725"
1311520240712,131,2024-07-12,15,234,117,351,King2_T,"-37.82009057, 144.95758725"
132320250203,132,2025-02-03,3,7,1,8,King335_T,"-37.81267639, 144.95386444"
1322320250511,132,2025-05-11,23,36,55,91,King335_T,"-37.81267639, 144.95386444"
135220241122,135,2024-11-22,2,11,19,30,Spen161_T,"-37.8172861, 144.95319102"
133020240111,133,2024-01-11,0,41,23,64,Spen229_T,"-37.81531435, 144.95227769"
1081820240704,108,2024-07-04,18,96,106,202,261Will_T,"-37.81295822, 144.95678789"
1661220241210,166,2024-12-10,12,50,58,108,Spen484_T,"-37.80896733, 144.94931703"
165720241012,165,2024-10-12,7,7,10,17,Spen475_T,"-37.80953359, 144.94939004"
671720240929,67,2024-09-29,17,274,456,730,FLDegS_T,"-37.81688755, 144.96562569"
852320231023,85,2023-10-23,23,2,2,4,488Mac_T,"-37.79432415, 144.92973378"
172020250720,17,2025-07-20,20,65,39,104,Col15_T,"-37.81362543, 144.97323591"
172220251003,17,2025-10-03,22,82,90,172,Col15_T,"-37.81362543, 144.97323591"
1820231105,1,2023-11-05,8,64,69,133,Bou292_T,"-37.81349441, 144.96515323"
1020240409,1,2024-04-09,0,5,13,18,Bou292_T,"-37.81349441, 144.96515323"
181820250824,18,2025-08-24,18,25,37,62,Col12_T,"-37.81344862, 144.97305353"
861520240531,86,2024-05-31,15,42,63,105,574Qub_T,"-37.80309992, 144.94908064"
112320240916,11,2024-09-16,23,5,10,15,WatCit_T,"-37.81564989, 144.93970694"
112020250322,11,2025-03-22,20,213,205,418,WatCit_T,"-37.81564989, 144.93970694"
242220240504,24,2024-05-04,22,284,627,911,Col620_T,"-37.81887963, 144.95449198"
102320250122,10,2025-01-22,23,7,7,14,BouHbr_T,"-37.81876474, 144.94710545"
10420250428,10,2025-04-28,4,2,4,6,BouHbr_T,"-37.81876474, 144.94710545"
352120240610,35,2024-06-10,21,247,398,645,SouthB_T,"-37.82018685, 144.96508508"
2320240430,2,2024-04-30,3,1,0,1,Bou283_T,"-37.81380668, 144.96516718"
582020241219,58,2024-12-19,20,305,274,579,Bou688_T,"-37.81686075, 144.95358075"
21920250820,2,2025-08-20,19,279,258,537,Bou283_T,"-37.81380668, 144.96516718"
27920241018,27,2024-10-18,9,68,131,199,Vic_T,"-37.80606888, 144.95644692"
27120250323,27,2025-03-23,1,23,7,30,Vic_T,"-37.80606888, 144.95644692"
271720250622,27,2025-06-22,17,131,101,232,Vic_T,"-37.80606888, 144.95644692"
27820250825,27,2025-08-25,8,60,88,148,Vic_T,"-37.80606888, 144.95644692"
79320240219,79,2024-02-19,3,24,13,37,FliSS_T,"-37.81794046, 144.96616678"
482120250707,48,2025-07-07,21,38,62,100,QVMQ_T,"-37.80631581, 144.95866697"
49820231125,49,2023-11-25,8,140,100,240,Eli501_T,"-37.80730068, 144.95956055"
492020240609,49,2024-06-09,20,167,172,339,Eli501_T,"-37.80730068, 144.95956055"
1091820251014,109,2025-10-14,18,262,106,368,LatWill_T,"-37.81193681, 144.95621105"
191820240616,19,2024-06-16,18,580,401,981,LtB210_T,"-37.81237202, 144.96550671"
1422120250610,142,2025-06-10,21,7,7,14,Hammer1584_T,"-37.81970749, 144.96795734"
691320250520,69,2025-05-20,13,229,285,514,FLDegC_T,"-37.81687226, 144.96559144"
691520250609,69,2025-06-09,15,187,239,426,FLDegC_T,"-37.81687226, 144.96559144"
6220231124,6,2023-11-24,2,17,18,35,FliS_T,"-37.81911705, 144.96558255"
391120250904,39,2025-09-04,11,93,77,170,AlfPl_T,"-37.81379749, 144.96995745"
412120240302,41,2024-03-02,21,1120,1141,2261,Swa31,"-37.81668634, 144.96689733"
75120250211,75,2025-02-11,1,3,1,4,SprFli_T,"-37.81515276, 144.97467661"
41120250402,41,2025-04-02,1,40,79,119,Swa31,"-37.81668634, 144.96689733"
771120250426,77,2025-04-26,11,214,168,382,HarEsP_T,"-37.81441438, 144.94433026"
592020250810,59,2025-08-10,20,516,280,796,RMIT_T,"-37.80825648, 144.96304859"
291920241201,29,2024-12-01,19,226,168,394,AG_T,"-37.8199817, 144.96872865"
401520231028,40,2023-10-28,15,133,102,235,Spr201_T,"-37.80999341, 144.97227587"
45320250723,45,2025-07-23,3,6,25,31,Swa148_T,"-37.81414075, 144.96609379"
211920240614,21,2024-06-14,19,502,546,1048,Bourke155_T,"-37.81267313, 144.96788288"
51620250527,5,2025-05-27,16,56,90,146,PriNW_T,"-37.81874249, 144.96787656"
211920241212,21,2024-12-12,19,351,408,759,Bourke155_T,"-37.81267313, 144.96788288"
132920250812,132,2025-08-12,9,144,74,218,King335_T,"-37.81267639, 144.95386444"
1791720250914,179,2025-09-14,17,81,65,146,Pow61_T,"-37.82392385, 144.96299677"
1671220250909,167,2025-09-09,12,60,77,137,Lat526_T,"-37.81304149, 144.95155955"
165920241201,165,2024-12-01,9,14,29,43,Spen475_T,"-37.80953359, 144.94939004"
1662020241011,166,2024-10-11,20,14,20,34,Spen484_T,"-37.80896733, 144.94931703"
166720241121,166,2024-11-21,7,12,32,44,Spen484_T,"-37.80896733, 144.94931703"
1671620240822,167,2024-08-22,16,28,104,132,Lat526_T,"-37.81304149, 144.95155955"
851820240301,85,2024-03-01,18,89,83,172,488Mac_T,"-37.79432415, 144.92973378"
681520240116,68,2024-01-16,15,204,185,389,FLDegN_T,"-37.8168479, 144.96559789"
63820231222,63,2023-12-22,8,88,119,207,Bou231_T,"-37.81333081, 144.96675571"
862120240413,86,2024-04-13,21,23,54,77,574Qub_T,"-37.80309992, 144.94908064"
671420250115,67,2025-01-15,14,489,694,1183,FLDegS_T,"-37.81688755, 144.96562569"
112320240609,11,2024-06-09,23,10,14,24,WatCit_T,"-37.81564989, 144.93970694"
721520240521,72,2024-05-21,15,133,270,403,ACMI_T,"-37.81726338, 144.96872809"
35520240716,35,2024-07-16,5,51,47,98,SouthB_T,"-37.82018685, 144.96508508"
351320250722,35,2025-07-22,13,256,329,585,SouthB_T,"-37.82018685, 144.96508508"
271420250324,27,2025-03-24,14,85,93,178,Vic_T,"-37.80606888, 144.95644692"
9020240107,9,2024-01-07,0,18,31,49,Col700_T,"-37.81982992, 144.95102555"
53020240625,53,2024-06-25,0,8,13,21,Col254_T,"-37.81564191, 144.965499"
301720240603,30,2024-06-03,17,234,352,586,Lon189_T,"-37.8112185, 144.96656806"
791020240602,79,2024-06-02,10,296,161,457,FliSS_T,"-37.81794046, 144.96616678"
301020250915,30,2025-09-15,10,103,152,255,Lon189_T,"-37.8112185, 144.96656806"
252020240208,25,2024-02-08,20,394,307,701,MCEC_T,"-37.82401776, 144.95604426"
201120250628,20,2025-06-28,11,199,183,382,LtB170_T,"-37.81172914, 144.9682466"
202220240914,20,2024-09-14,22,229,574,803,LtB170_T,"-37.81172914, 144.9682466"
109520241026,109,2024-10-26,5,7,7,14,LatWill_T,"-37.81193681, 144.95621105"
491920240803,49,2024-08-03,19,262,215,477,Eli501_T,"-37.80730068, 144.95956055"
25920250701,25,2025-07-01,9,97,196,293,MCEC_T,"-37.82401776, 144.95604426"
48520240521,48,2024-05-21,5,8,9,17,QVMQ_T,"-37.80631581, 144.95866697"
1801120250606,180,2025-06-06,11,33,16,49,Mac330_T,"-37.79497059, 144.93530329"
1391620250514,139,2025-05-14,16,142,39,181,Signal1647_T,"-37.81959923, 144.9632832"
1231120240703,123,2024-07-03,11,3,1,4,BirBridge_T,"-37.81753741, 144.97329734"
1611520241219,161,2024-12-19,15,37,55,92,BirArt1109_T,"-37.81851276, 144.97131336"
662220240216,66,2024-02-16,22,862,467,1329,QVN_T,"-37.81057846, 144.96444294"
691320240201,69,2024-02-01,13,217,258,475,FLDegC_T,"-37.81687226, 144.96559144"
841320250126,84,2025-01-26,13,1613,1468,3081,ElFi_T,"-37.81798049, 144.96503383"
751420240321,75,2024-03-21,14,45,100,145,SprFli_T,"-37.81515276, 144.97467661"
412320250206,41,2025-02-06,23,71,58,129,Swa31,"-37.81668634, 144.96689733"
8020240401,8,2024-04-01,0,5,4,9,WebBN_T,"-37.82293543, 144.9471751"
781620250424,78,2025-04-24,16,18,128,146,HarEsB_T,"-37.81471642, 144.9446508"
29320250507,29,2025-05-07,3,2,3,5,AG_T,"-37.8199817, 144.96872865"
402020250202,40,2025-02-02,20,67,32,99,Spr201_T,"-37.80999341, 144.97227587"
36020250509,36,2025-05-09,0,23,33,56,Que85_T,"-37.81652527, 144.96121062"
61320231101,61,2023-11-01,3,15,4,19,RMIT14_T,"-37.80767455, 144.96309114"
501320250525,50,2025-05-25,13,306,301,607,Lyg309_T,"-37.79808192, 144.96721013"
431220250628,43,2025-06-28,12,118,88,206,UM2_T,"-37.79844526, 144.96411782"
431620240402,43,2024-04-02,16,92,68,160,UM2_T,"-37.79844526, 144.96411782"
43120240815,43,2024-08-15,1,34,1,35,UM2_T,"-37.79844526, 144.96411782"
45720250824,45,2025-08-24,7,33,52,85,Swa148_T,"-37.81414075, 144.96609379"
1432320241022,143,2024-10-22,23,124,637,761,Spencer_T,"-37.821728, 144.95557015"
1401520240420,140,2024-04-20,15,118,82,200,Boyd2837_T,"-37.82590962, 144.96185972"
1351920240705,135,2024-07-05,19,171,223,394,Spen161_T,"-37.8172861, 144.95319102"
1331620241106,133,2024-11-06,16,602,723,1325,Spen229_T,"-37.81531435, 144.95227769"
133820241224,133,2024-12-24,8,310,298,608,Spen229_T,"-37.81531435, 144.95227769"
107520240421,107,2024-04-21,5,9,5,14,280Will_T,"-37.81246271, 144.95690188"
1182220240602,118,2024-06-02,22,1,3,4,Fli114C_T,"-37.81632783, 144.97090512"
108420250316,108,2025-03-16,4,11,4,15,261Will_T,"-37.81295822, 144.95678789"
871620250131,87,2025-01-31,16,100,97,197,Errol23_T,"-37.80454949, 144.94921863"
1652320250115,165,2025-01-15,23,5,1,6,Spen475_T,"-37.80953359, 144.94939004"
302320250311,30,2025-03-11,23,111,173,284,Lon189_T,"-37.8112185, 144.96656806"
791020250318,79,2025-03-18,10,479,229,708,FliSS_T,"-37.81794046, 144.96616678"
301420240305,30,2024-03-05,14,202,332,534,Lon189_T,"-37.8112185, 144.96656806"
46520231102,46,2023-11-02,5,1,6,7,Pel147_T,"-37.80240719, 144.9615673"
20920241121,20,2024-11-21,9,74,77,151,LtB170_T,"-37.81172914, 144.9682466"
20820240112,20,2024-01-12,8,47,53,100,LtB170_T,"-37.81172914, 144.9682466"
20120240416,20,2024-04-16,1,5,13,18,LtB170_T,"-37.81172914, 144.9682466"
522220250508,52,2025-05-08,22,96,121,217,Eli263_T,"-37.81252157, 144.9619401"
521020240419,52,2024-04-19,10,212,177,389,Eli263_T,"-37.81252157, 144.9619401"
51720250724,51,2025-07-24,7,36,41,77,Fra118_T,"-37.80841815, 144.95906316"
1232320231129,123,2023-11-29,23,5,0,5,BirBridge_T,"-37.81753741, 144.97329734"
1091720240426,109,2024-04-26,17,266,144,410,LatWill_T,"-37.81193681, 144.95621105"
109920240707,109,2024-07-07,9,24,49,73,LatWill_T,"-37.81193681, 144.95621105"
192220250219,19,2025-02-19,22,168,283,451,LtB210_T,"-37.81237202, 144.96550671"
1371020250206,137,2025-02-06,10,12,50,62,BouHbr2353_T,"-37.81894815, 144.94612292"
1371120250727,137,2025-07-27,11,12,21,33,BouHbr2353_T,"-37.81894815, 144.94612292"
139620250828,139,2025-08-28,6,12,31,43,Signal1647_T,"-37.81959923, 144.9632832"
142720240405,142,2024-04-05,7,142,59,201,Hammer1584_T,"-37.81970749, 144.96795734"
841520250716,84,2025-07-16,15,873,1456,2329,ElFi_T,"-37.81798049, 144.96503383"
4420241212,4,2024-12-12,4,12,18,30,Swa123_T,"-37.81487988, 144.9660878"
391620250325,39,2025-03-25,16,103,83,186,AlfPl_T,"-37.81379749, 144.96995745"
391720250625,39,2025-06-25,17,61,19,80,AlfPl_T,"-37.81379749, 144.96995745"
781320231223,78,2023-12-23,13,46,65,111,HarEsB_T,"-37.81471642, 144.9446508"
422320250911,42,2025-09-11,23,14,23,37,UM1_T,"-37.80008566, 144.96386412"
771620240712,77,2024-07-12,16,224,211,435,HarEsP_T,"-37.81441438, 144.94433026"
77820250904,77,2025-09-04,8,122,178,300,HarEsP_T,"-37.81441438, 144.94433026"
421920240716,42,2024-07-16,19,44,91,135,UM1_T,"-37.80008566, 144.96386412"
14520250304,14,2025-03-04,5,39,39,78,SanBri_T,"-37.82011242, 144.96291897"
291220250822,29,2025-08-22,12,449,239,688,AG_T,"-37.8199817, 144.96872865"
591420251003,59,2025-10-03,14,1027,1135,2162,RMIT_T,"-37.80825648, 144.96304859"
711420250508,71,2025-05-08,14,7,10,17,WestWP_T,"-37.81235775, 144.97136962"
59820240715,59,2024-07-15,8,667,186,853,RMIT_T,"-37.80825648, 144.96304859"
541820240827,54,2024-08-27,18,394,646,1040,Swa607_T,"-37.804024, 144.96308399"
311220241209,31,2024-12-09,12,143,107,250,Lyg161_T,"-37.80169681, 144.96658911"
11620240112,1,2024-01-12,16,1118,944,2062,Bou292_T,"-37.81349441, 144.96515323"
18420250108,18,2025-01-08,4,0,3,3,Col12_T,"-37.81344862, 144.97305353"
62920250124,62,2025-01-24,9,83,138,221,Lat224_T,"-37.80996494, 144.96216521"
24320240819,24,2024-08-19,3,23,15,38,Col620_T,"-37.81887963, 144.95449198"
112320250827,11,2025-08-27,23,13,7,20,WatCit_T,"-37.81564989, 144.93970694"
122020241210,12,2024-12-10,20,271,246,517,NewQ_T,"-37.81457988, 144.94292398"
791620231030,79,2023-10-30,16,403,430,833,FliSS_T,"-37.81794046, 144.96616678"
532320240409,53,2024-04-09,23,18,25,43,Col254_T,"-37.81564191, 144.965499"
481220240212,48,2024-02-12,12,189,143,332,QVMQ_T,"-37.80631581, 144.95866697"
1801020250923,180,2025-09-23,10,44,16,60,Mac330_T,"-37.79497059, 144.93530329"
1421820240415,142,2024-04-15,18,260,147,407,Hammer1584_T,"-37.81970749, 144.96795734"
69520231115,69,2023-11-15,5,5,7,12,FLDegC_T,"-37.81687226, 144.96559144"
841320250208,84,2025-02-08,13,1088,1418,2506,ElFi_T,"-37.81798049, 144.96503383"
41120240627,4,2024-06-27,11,1116,816,1932,Swa123_T,"-37.81487988, 144.9660878"
81020250302,8,2025-03-02,10,106,194,300,WebBN_T,"-37.82293543, 144.9471751"
75320250115,75,2025-01-15,3,0,1,1,SprFli_T,"-37.81515276, 144.97467661"
78320251009,78,2025-10-09,3,1,0,1,HarEsB_T,"-37.81471642, 144.9446508"
591020240424,59,2024-04-24,10,1314,768,2082,RMIT_T,"-37.80825648, 144.96304859"
29120250508,29,2025-05-08,1,2,12,14,AG_T,"-37.8199817, 144.96872865"
401520240426,40,2024-04-26,15,178,168,346,Spr201_T,"-37.80999341, 144.97227587"
441820250313,44,2025-03-13,18,154,173,327,UM3_T,"-37.79698741, 144.96441306"
45220250814,45,2025-08-14,2,7,9,16,Swa148_T,"-37.81414075, 144.96609379"
1311220250715,131,2025-07-15,12,216,194,410,King2_T,"-37.82009057, 144.95758725"
162020240925,162,2024-09-25,0,36,33,69,Eli489_T,"-37.80740397, 144.95987909"
1341820240301,134,2024-03-01,18,485,406,891,Spen201_T,"-37.81694221, 144.95303935"
1351920250801,135,2025-08-01,19,238,355,593,Spen161_T,"-37.8172861, 144.95319102"
108320251001,108,2025-10-01,3,7,7,14,261Will_T,"-37.81295822, 144.95678789"
1851020251004,185,2025-10-04,10,499,473,972,Eli197_T,"-37.81374643, 144.96276183"
672020240525,67,2024-05-25,20,244,244,488,FLDegS_T,"-37.81688755, 144.96562569"
851520250323,85,2025-03-23,15,48,66,114,488Mac_T,"-37.79432415, 144.92973378"
17320250112,17,2025-01-12,3,8,5,13,Col15_T,"-37.81362543, 144.97323591"
1520231103,1,2023-11-03,5,10,9,19,Bou292_T,"-37.81349441, 144.96515323"
12120240924,1,2024-09-24,21,26,22,48,Bou292_T,"-37.81349441, 144.96515323"
18920231201,18,2023-12-01,9,130,457,587,Col12_T,"-37.81344862, 144.97305353"
631320240627,63,2024-06-27,13,508,619,1127,Bou231_T,"-37.81333081, 144.96675571"
621520240317,62,2024-03-17,15,283,168,451,Lat224_T,"-37.80996494, 144.96216521"
12920240314,12,2024-03-14,9,178,92,270,NewQ_T,"-37.81457988, 144.94292398"
111220240103,11,2024-01-03,12,107,95,202,WatCit_T,"-37.81564989, 144.93970694"
35220250930,35,2025-09-30,2,7,6,13,SouthB_T,"-37.82018685, 144.96508508"
582320250112,58,2025-01-12,23,385,143,528,Bou688_T,"-37.81686075, 144.95358075"
301320240701,30,2024-07-01,13,362,430,792,Lon189_T,"-37.8112185, 144.96656806"
461120250227,46,2025-02-27,11,59,50,109,Pel147_T,"-37.80240719, 144.9615673"
25220250110,25,2025-01-10,2,5,11,16,MCEC_T,"-37.82401776, 144.95604426"
521520231130,52,2023-11-30,15,514,281,795,Eli263_T,"-37.81252157, 144.9619401"
1381120240519,138,2024-05-19,11,3,5,8,EntPark1671_T,"-37.81996544, 144.95981454"
1382220240412,138,2024-04-12,22,1,0,1,EntPark1671_T,"-37.81996544, 144.95981454"
123820240405,123,2024-04-05,8,22,8,30,BirBridge_T,"-37.81753741, 144.97329734"
1231720250325,123,2025-03-25,17,44,42,86,BirBridge_T,"-37.81753741, 144.97329734"
482220250115,48,2025-01-15,22,106,60,166,QVMQ_T,"-37.80631581, 144.95866697"
482020250414,48,2025-04-14,20,61,101,162,QVMQ_T,"-37.80631581, 144.95866697"
492120240403,49,2024-04-03,21,152,148,300,Eli501_T,"-37.80730068, 144.95956055"
191120250718,19,2025-07-18,11,361,207,568,LtB210_T,"-37.81237202, 144.96550671"
192020250822,19,2025-08-22,20,658,785,1443,LtB210_T,"-37.81237202, 144.96550671"
109320241113,109,2024-11-13,3,5,3,8,LatWill_T,"-37.81193681, 144.95621105"
109020241119,109,2024-11-19,0,28,32,60,LatWill_T,"-37.81193681, 144.95621105"
19320240501,19,2024-05-01,3,13,13,26,LtB210_T,"-37.81237202, 144.96550671"
1372120240103,137,2024-01-03,21,1,8,9,BouHbr2353_T,"-37.81894815, 144.94612292"
1371720250517,137,2025-05-17,17,6,17,23,BouHbr2353_T,"-37.81894815, 144.94612292"
139520240922,139,2024-09-22,5,2,1,3,Signal1647_T,"-37.81959923, 144.9632832"
1361520240727,136,2024-07-27,15,99,20,119,BirFed1120_T,"-37.8184141, 144.97357915"
691020241213,69,2024-12-13,10,245,165,410,FLDegC_T,"-37.81687226, 144.96559144"
42120250105,4,2025-01-05,21,582,548,1130,Swa123_T,"-37.81487988, 144.9660878"
70720231228,70,2023-12-28,7,14,16,30,Errol20_T,"-37.80456984, 144.94946228"
391320231024,39,2023-10-24,13,234,248,482,AlfPl_T,"-37.81379749, 144.96995745"
751820241011,75,2024-10-11,18,71,34,105,SprFli_T,"-37.81515276, 144.97467661"
39120250824,39,2025-08-24,1,12,6,18,AlfPl_T,"-37.81379749, 144.96995745"
8220231231,8,2023-12-31,2,2,1,3,WebBN_T,"-37.82293543, 144.9471751"
77420240207,77,2024-02-07,4,4,5,9,HarEsP_T,"-37.81441438, 144.94433026"
71020250927,71,2025-09-27,0,7,13,20,WestWP_T,"-37.81235775, 144.97136962"
711020250316,71,2025-03-16,10,0,2,2,WestWP_T,"-37.81235775, 144.97136962"
28220231223,28,2023-12-23,2,10,20,30,VAC_T,"-37.82129925, 144.96879309"
471420240114,47,2024-01-14,14,917,1065,1982,Eli250_T,"-37.81258467, 144.9625775"
47220250505,47,2025-05-05,2,21,36,57,Eli250_T,"-37.81258467, 144.9625775"
40220231230,40,2023-12-30,2,5,5,10,Spr201_T,"-37.80999341, 144.97227587"
212020241209,21,2024-12-09,20,259,302,561,Bourke155_T,"-37.81267313, 144.96788288"
361320241111,36,2024-11-11,13,256,233,489,Que85_T,"-37.81652527, 144.96121062"
36420250205,36,2025-02-05,4,8,2,10,Que85_T,"-37.81652527, 144.96121062"
362320231105,36,2023-11-05,23,22,33,55,Que85_T,"-37.81652527, 144.96121062"
372120231123,37,2023-11-23,21,41,53,94,Lyg260_T,"-37.80107122, 144.96704554"
37220240412,37,2024-04-12,2,12,6,18,Lyg260_T,"-37.80107122, 144.96704554"
371320241121,37,2024-11-21,13,113,148,261,Lyg260_T,"-37.80107122, 144.96704554"
871220240229,87,2024-02-29,12,169,157,326,Errol23_T,"-37.80454949, 144.94921863"
162820250809,162,2025-08-09,8,209,159,368,Eli489_T,"-37.80740397, 144.95987909"
132020241020,132,2024-10-20,0,70,50,120,King335_T,"-37.81267639, 144.95386444"
108020250327,108,2025-03-27,0,43,36,79,261Will_T,"-37.81295822, 144.95678789"
134320240605,134,2024-06-05,3,22,8,30,Spen201_T,"-37.81694221, 144.95303935"
135220240304,135,2024-03-04,2,8,4,12,Spen161_T,"-37.8172861, 144.95319102"
107020250802,107,2025-08-02,0,30,24,54,280Will_T,"-37.81246271, 144.95690188"
1181220251005,118,2025-10-05,12,25,34,59,Fli114C_T,"-37.81632783, 144.97090512"
1181420240421,118,2024-04-21,14,23,30,53,Fli114C_T,"-37.81632783, 144.97090512"
1182120240425,118,2024-04-25,21,5,4,9,Fli114C_T,"-37.81632783, 144.97090512"
108320250806,108,2025-08-06,3,2,6,8,261Will_T,"-37.81295822, 144.95678789"
251920250807,25,2025-08-07,19,214,189,403,MCEC_T,"-37.82401776, 144.95604426"
52120240511,52,2024-05-11,1,93,77,170,Eli263_T,"-37.81252157, 144.9619401"
52420240522,52,2024-05-22,4,1,1,2,Eli263_T,"-37.81252157, 144.9619401"
511820250803,51,2025-08-03,18,105,77,182,Fra118_T,"-37.80841815, 144.95906316"
232020241008,23,2024-10-08,20,86,192,278,Col623_T,"-37.81909256, 144.95452748"
161820250604,161,2025-06-04,8,119,248,367,BirArt1109_T,"-37.81851276, 144.97131336"
1171320241210,117,2024-12-10,13,222,187,409,Fli114F_T,"-37.81629332, 144.97090877"
1091720250114,109,2025-01-14,17,415,119,534,LatWill_T,"-37.81193681, 144.95621105"
1392320250516,139,2025-05-16,23,9,9,18,Signal1647_T,"-37.81959923, 144.9632832"
137020240420,137,2024-04-20,0,0,1,1,BouHbr2353_T,"-37.81894815, 144.94612292"
1371920241101,137,2024-11-01,19,22,28,50,BouHbr2353_T,"-37.81894815, 144.94612292"
67920241227,67,2024-12-27,9,286,327,613,FLDegS_T,"-37.81688755, 144.96562569"
851720240529,85,2024-05-29,17,83,131,214,488Mac_T,"-37.79432415, 144.92973378"
85720240707,85,2024-07-07,7,7,4,11,488Mac_T,"-37.79432415, 144.92973378"
681920231126,68,2023-11-26,19,162,75,237,FLDegN_T,"-37.8168479, 144.96559789"
861620250721,86,2025-07-21,16,41,57,98,574Qub_T,"-37.80309992, 144.94908064"
121020240626,12,2024-06-26,10,135,156,291,NewQ_T,"-37.81457988, 144.94292398"
111020241101,11,2024-11-01,10,41,42,83,WatCit_T,"-37.81564989, 144.93970694"
241320240524,24,2024-05-24,13,731,665,1396,Col620_T,"-37.81887963, 144.95449198"
24720240812,24,2024-08-12,7,882,248,1130,Col620_T,"-37.81887963, 144.95449198"
102320250302,10,2025-03-02,23,5,5,10,BouHbr_T,"-37.81876474, 144.94710545"
10120240724,10,2024-07-24,1,1,1,2,BouHbr_T,"-37.81876474, 144.94710545"
101220241120,10,2024-11-20,12,216,162,378,BouHbr_T,"-37.81876474, 144.94710545"
72920240307,72,2024-03-07,9,477,162,639,ACMI_T,"-37.81726338, 144.96872809"
21720241203,2,2024-12-03,17,703,573,1276,Bou283_T,"-37.81380668, 144.96516718"
9920240626,9,2024-06-26,9,176,1813,1989,Col700_T,"-37.81982992, 144.95102555"
91020250715,9,2025-07-15,10,170,562,732,Col700_T,"-37.81982992, 144.95102555"
231620240210,23,2024-02-10,16,131,208,339,Col623_T,"-37.81909256, 144.95452748"
662020240320,66,2024-03-20,20,1017,784,1801,QVN_T,"-37.81057846, 144.96444294"
4820250113,4,2025-01-13,8,460,321,781,Swa123_T,"-37.81487988, 144.9660878"
42320250627,4,2025-06-27,23,456,751,1207,Swa123_T,"-37.81487988, 144.9660878"
70620231107,70,2023-11-07,6,3,8,11,Errol20_T,"-37.80456984, 144.94946228"
701920251001,70,2025-10-01,19,151,236,387,Errol20_T,"-37.80456984, 144.94946228"
751820240122,75,2024-01-22,18,81,103,184,SprFli_T,"-37.81515276, 144.97467661"
39720250829,39,2025-08-29,7,22,41,63,AlfPl_T,"-37.81379749, 144.96995745"
77820241102,77,2024-11-02,8,79,86,165,HarEsP_T,"-37.81441438, 144.94433026"
77920241210,77,2024-12-10,9,94,122,216,HarEsP_T,"-37.81441438, 144.94433026"
421120240803,42,2024-08-03,11,73,51,124,UM1_T,"-37.80008566, 144.96386412"
291720240424,29,2024-04-24,17,315,268,583,AG_T,"-37.8199817, 144.96872865"
291020241116,29,2024-11-16,10,279,405,684,AG_T,"-37.8199817, 144.96872865"
541720241012,54,2024-10-12,17,106,192,298,Swa607_T,"-37.804024, 144.96308399"
472120240812,47,2024-08-12,21,284,313,597,Eli250_T,"-37.81258467, 144.9625775"
211320250612,21,2025-06-12,13,429,385,814,Bourke155_T,"-37.81267313, 144.96788288"
611520241208,61,2024-12-08,15,517,599,1116,RMIT14_T,"-37.80767455, 144.96309114"
501320240219,50,2024-02-19,13,214,198,412,Lyg309_T,"-37.79808192, 144.96721013"
43820231117,43,2023-11-17,8,88,51,139,UM2_T,"-37.79844526, 144.96411782"
451620250904,45,2025-09-04,16,450,626,1076,Swa148_T,"-37.81414075, 144.96609379"
442120231102,44,2023-11-02,21,14,10,24,UM3_T,"-37.79698741, 144.96441306"
441020250118,44,2025-01-18,10,32,50,82,UM3_T,"-37.79698741, 144.96441306"
45220240929,45,2024-09-29,2,41,166,207,Swa148_T,"-37.81414075, 144.96609379"
451320250510,45,2025-05-10,13,893,1416,2309,Swa148_T,"-37.81414075, 144.96609379"
452320250513,45,2025-05-13,23,68,92,160,Swa148_T,"-37.81414075, 144.96609379"
451320240404,45,2024-04-04,13,762,1031,1793,Swa148_T,"-37.81414075, 144.96609379"
1672220241226,167,2024-12-26,22,11,23,34,Lat526_T,"-37.81304149, 144.95155955"
792120250109,79,2025-01-09,21,254,426,680,FliSS_T,"-37.81794046, 144.96616678"
46520241111,46,2024-11-11,5,2,1,3,Pel147_T,"-37.80240719, 144.9615673"
511220241231,51,2024-12-31,12,155,168,323,Fra118_T,"-37.80841815, 144.95906316"
51920250423,51,2025-04-23,9,75,71,146,Fra118_T,"-37.80841815, 144.95906316"
123520250104,123,2025-01-04,5,1,1,2,BirBridge_T,"-37.81753741, 144.97329734"
161720240721,161,2024-07-21,7,367,193,560,BirArt1109_T,"-37.81851276, 144.97131336"
1611320241017,161,2024-10-17,13,159,219,378,BirArt1109_T,"-37.81851276, 144.97131336"
49620250510,49,2025-05-10,6,39,45,84,Eli501_T,"-37.80730068, 144.95956055"
49220240904,49,2024-09-04,2,27,65,92,Eli501_T,"-37.80730068, 144.95956055"
49020240304,49,2024-03-04,0,51,39,90,Eli501_T,"-37.80730068, 144.95956055"
1361420231107,136,2023-11-07,14,42,56,98,BirFed1120_T,"-37.8184141, 144.97357915"
1421220240728,142,2024-07-28,12,591,282,873,Hammer1584_T,"-37.81970749, 144.96795734"
37920240429,37,2024-04-29,9,45,37,82,Lyg260_T,"-37.80107122, 144.96704554"
37620240731,37,2024-07-31,6,4,6,10,Lyg260_T,"-37.80107122, 144.96704554"
431620240831,43,2024-08-31,16,38,45,83,UM2_T,"-37.79844526, 144.96411782"
431620250313,43,2025-03-13,16,324,529,853,UM2_T,"-37.79844526, 144.96411782"
45220250201,45,2025-02-01,2,32,85,117,Swa148_T,"-37.81414075, 144.96609379"
451620231219,45,2023-12-19,16,698,836,1534,Swa148_T,"-37.81414075, 144.96609379"
5320250527,5,2025-05-27,3,4,1,5,PriNW_T,"-37.81874249, 144.96787656"
1181920250727,118,2025-07-27,19,7,2,9,Fli114C_T,"-37.81632783, 144.97090512"
1182120231027,118,2023-10-27,21,9,7,16,Fli114C_T,"-37.81632783, 144.97090512"
1181420240408,118,2024-04-08,14,26,29,55,Fli114C_T,"-37.81632783, 144.97090512"
44020240514,44,2024-05-14,0,3,5,8,UM3_T,"-37.79698741, 144.96441306"
44520250725,44,2025-07-25,5,0,1,1,UM3_T,"-37.79698741, 144.96441306"
50320240905,50,2024-09-05,3,2,0,2,Lyg309_T,"-37.79808192, 144.96721013"
1311320251009,131,2025-10-09,13,193,211,404,King2_T,"-37.82009057, 144.95758725"
1311020240814,131,2024-08-14,10,65,80,145,King2_T,"-37.82009057, 144.95758725"
162120250723,162,2025-07-23,1,8,8,16,Eli489_T,"-37.80740397, 144.95987909"
1401220250410,140,2025-04-10,12,5,5,10,Boyd2837_T,"-37.82590962, 144.96185972"
143420250626,143,2025-06-26,4,13,5,18,Spencer_T,"-37.821728, 144.95557015"
131620250226,131,2025-02-26,6,29,33,62,King2_T,"-37.82009057, 144.95758725"
1341820241219,134,2024-12-19,18,518,418,936,Spen201_T,"-37.81694221, 144.95303935"
67220241223,67,2024-12-23,2,2,2,4,FLDegS_T,"-37.81688755, 144.96562569"
681920250617,68,2025-06-17,19,145,67,212,FLDegN_T,"-37.8168479, 144.96559789"
181520240214,18,2024-02-14,15,374,144,518,Col12_T,"-37.81344862, 144.97305353"
181520241229,18,2024-12-29,15,69,73,142,Col12_T,"-37.81344862, 144.97305353"
63920250721,63,2025-07-21,9,156,273,429,Bou231_T,"-37.81333081, 144.96675571"
681720250508,68,2025-05-08,17,255,166,421,FLDegN_T,"-37.8168479, 144.96559789"
861120240805,86,2024-08-05,11,48,49,97,574Qub_T,"-37.80309992, 144.94908064"
86820250208,86,2025-02-08,8,37,20,57,574Qub_T,"-37.80309992, 144.94908064"
861420250614,86,2025-06-14,14,57,76,133,574Qub_T,"-37.80309992, 144.94908064"
11920240330,11,2024-03-30,9,69,72,141,WatCit_T,"-37.81564989, 144.93970694"
112220240708,11,2024-07-08,22,6,8,14,WatCit_T,"-37.81564989, 144.93970694"
24620240201,24,2024-02-01,6,296,133,429,Col620_T,"-37.81887963, 144.95449198"
12920241007,12,2024-10-07,9,67,56,123,NewQ_T,"-37.81457988, 144.94292398"
122120250219,12,2025-02-19,21,109,131,240,NewQ_T,"-37.81457988, 144.94292398"
121220250514,12,2025-05-14,12,204,236,440,NewQ_T,"-37.81457988, 144.94292398"
76520240519,76,2024-05-19,5,1,1,2,KenMac_T,"-37.79453803, 144.93036194"
2120250411,2,2025-04-11,1,6,10,16,Bou283_T,"-37.81380668, 144.96516718"
35020251010,35,2025-10-10,0,34,66,100,SouthB_T,"-37.82018685, 144.96508508"
22120240102,2,2024-01-02,21,24,105,129,Bou283_T,"-37.81380668, 144.96516718"
271920240527,27,2024-05-27,19,70,28,98,Vic_T,"-37.80606888, 144.95644692"
91720240402,9,2024-04-02,17,1757,128,1885,Col700_T,"-37.81982992, 144.95102555"
531920250428,53,2025-04-28,19,146,142,288,Col254_T,"-37.81564191, 144.965499"
851920251008,85,2025-10-08,19,61,73,134,488Mac_T,"-37.79432415, 144.92973378"
172320250710,17,2025-07-10,23,24,32,56,Col15_T,"-37.81362543, 144.97323591"
11420240310,1,2024-03-10,14,1102,1119,2221,Bou292_T,"-37.81349441, 144.96515323"
672220231028,67,2023-10-28,22,194,220,414,FLDegS_T,"-37.81688755, 144.96562569"
67020250115,67,2025-01-15,0,11,21,32,FLDegS_T,"-37.81688755, 144.96562569"
62520240226,62,2024-02-26,5,12,6,18,Lat224_T,"-37.80996494, 144.96216521"
56820231022,56,2023-10-22,8,64,27,91,Lon364_T,"-37.81234775, 144.96153311"
56420250128,56,2025-01-28,4,3,4,7,Lon364_T,"-37.81234775, 144.96153311"
111220251015,11,2025-10-15,12,197,181,378,WatCit_T,"-37.81564989, 144.93970694"
10520240123,10,2024-01-23,5,5,4,9,BouHbr_T,"-37.81876474, 144.94710545"
122120240320,12,2024-03-20,21,149,138,287,NewQ_T,"-37.81457988, 144.94292398"
121720241030,12,2024-10-30,17,407,518,925,NewQ_T,"-37.81457988, 144.94292398"
122020231227,12,2023-12-27,20,359,373,732,NewQ_T,"-37.81457988, 144.94292398"
101920241206,10,2024-12-06,19,77,41,118,BouHbr_T,"-37.81876474, 144.94710545"
241820250124,24,2025-01-24,18,483,834,1317,Col620_T,"-37.81887963, 144.95449198"
762120231201,76,2023-12-01,21,14,27,41,KenMac_T,"-37.79453803, 144.93036194"
721520250903,72,2025-09-03,15,92,300,392,ACMI_T,"-37.81726338, 144.96872809"
722320250204,72,2025-02-04,23,31,23,54,ACMI_T,"-37.81726338, 144.96872809"
58820241021,58,2024-10-21,8,1450,200,1650,Bou688_T,"-37.81686075, 144.95358075"
521320240911,52,2024-09-11,13,382,260,642,Eli263_T,"-37.81252157, 144.9619401"
52120240124,52,2024-01-24,1,10,20,30,Eli263_T,"-37.81252157, 144.9619401"
512220241003,51,2024-10-03,22,52,35,87,Fra118_T,"-37.80841815, 144.95906316"
231720250301,23,2025-03-01,17,217,357,574,Col623_T,"-37.81909256, 144.95452748"
232320250705,23,2025-07-05,23,77,150,227,Col623_T,"-37.81909256, 144.95452748"
491220240110,49,2024-01-10,12,208,246,454,Eli501_T,"-37.80730068, 144.95956055"
1091320250815,109,2025-08-15,13,186,129,315,LatWill_T,"-37.81193681, 144.95621105"
1372120240823,137,2024-08-23,21,1,2,3,BouHbr2353_T,"-37.81894815, 144.94612292"
1422320241008,142,2024-10-08,23,1,3,4,Hammer1584_T,"-37.81970749, 144.96795734"
4020240820,4,2024-08-20,0,24,22,46,Swa123_T,"-37.81487988, 144.9660878"
70620231216,70,2023-12-16,6,4,2,6,Errol20_T,"-37.80456984, 144.94946228"
70920241205,70,2024-12-05,9,86,78,164,Errol20_T,"-37.80456984, 144.94946228"
8820250925,8,2025-09-25,8,271,143,414,WebBN_T,"-37.82293543, 144.9471751"
8420241104,8,2024-11-04,4,8,6,14,WebBN_T,"-37.82293543, 144.9471751"
77420250513,77,2025-05-13,4,1,4,5,HarEsP_T,"-37.81441438, 144.94433026"
771520240410,77,2024-04-10,15,150,93,243,HarEsP_T,"-37.81441438, 144.94433026"
292320240416,29,2024-04-16,23,11,29,40,AG_T,"-37.8199817, 144.96872865"
141520240726,14,2024-07-26,15,484,148,632,SanBri_T,"-37.82011242, 144.96291897"
54420250625,54,2025-06-25,4,8,7,15,Swa607_T,"-37.804024, 144.96308399"
281820251002,28,2025-10-02,18,497,533,1030,VAC_T,"-37.82129925, 144.96879309"
29720250928,29,2025-09-28,7,77,113,190,AG_T,"-37.8199817, 144.96872865"
471720250114,47,2025-01-14,17,1305,743,2048,Eli250_T,"-37.81258467, 144.9625775"
311920250304,31,2025-03-04,19,166,132,298,Lyg161_T,"-37.80169681, 144.96658911"
61520241118,61,2024-11-18,5,5,22,27,RMIT14_T,"-37.80767455, 144.96309114"
162720250810,162,2025-08-10,7,94,43,137,Eli489_T,"-37.80740397, 144.95987909"
1431720241125,143,2024-11-25,17,186,251,437,Spencer_T,"-37.821728, 144.95557015"
1071720250927,107,2025-09-27,17,86,117,203,280Will_T,"-37.81246271, 144.95690188"
871020250515,87,2025-05-15,10,47,71,118,Errol23_T,"-37.80454949, 144.94921863"
70120240109,70,2024-01-09,1,0,1,1,Errol20_T,"-37.80456984, 144.94946228"
691620250317,69,2025-03-17,16,97,122,219,FLDegC_T,"-37.81687226, 144.96559144"
61720240606,6,2024-06-06,17,2399,1046,3445,FliS_T,"-37.81911705, 144.96558255"
681420250112,68,2025-01-12,14,250,255,505,FLDegN_T,"-37.8168479, 144.96559789"
681520240129,68,2024-01-29,15,217,169,386,FLDegN_T,"-37.8168479, 144.96559789"
681620240405,68,2024-04-05,16,241,198,439,FLDegN_T,"-37.8168479, 144.96559789"
68720240926,68,2024-09-26,7,58,42,100,FLDegN_T,"-37.8168479, 144.96559789"
682120240814,68,2024-08-14,21,64,18,82,FLDegN_T,"-37.8168479, 144.96559789"
621920231105,62,2023-11-05,19,217,100,317,Lat224_T,"-37.80996494, 144.96216521"
561120240510,56,2024-05-10,11,249,199,448,Lon364_T,"-37.81234775, 144.96153311"
861820250124,86,2025-01-24,18,64,72,136,574Qub_T,"-37.80309992, 144.94908064"
121420240723,12,2024-07-23,14,141,146,287,NewQ_T,"-37.81457988, 144.94292398"
12420240828,12,2024-08-28,4,1,3,4,NewQ_T,"-37.81457988, 144.94292398"
111320241009,11,2024-10-09,13,129,117,246,WatCit_T,"-37.81564989, 144.93970694"
351720240601,35,2024-06-01,17,1314,1952,3266,SouthB_T,"-37.82018685, 144.96508508"
27520240822,27,2024-08-22,5,6,3,9,Vic_T,"-37.80606888, 144.95644692"
92020240217,9,2024-02-17,20,34,47,81,Col700_T,"-37.81982992, 144.95102555"
9420250916,9,2025-09-16,4,6,1,7,Col700_T,"-37.81982992, 144.95102555"
532120241028,53,2024-10-28,21,99,171,270,Col254_T,"-37.81564191, 144.965499"
301420250705,30,2025-07-05,14,247,589,836,Lon189_T,"-37.8112185, 144.96656806"
1641620250521,164,2025-05-21,16,153,122,275,Lat526_T,"-37.813005, 144.95160411"
1231620231101,123,2023-11-01,16,29,20,49,BirBridge_T,"-37.81753741, 144.97329734"
49920240809,49,2024-08-09,9,197,249,446,Eli501_T,"-37.80730068, 144.95956055"
1092220240712,109,2024-07-12,22,75,116,191,LatWill_T,"-37.81193681, 144.95621105"
191720241204,19,2024-12-04,17,637,458,1095,LtB210_T,"-37.81237202, 144.96550671"
1371020241225,137,2024-12-25,10,5,17,22,BouHbr2353_T,"-37.81894815, 144.94612292"
1421520240110,142,2024-01-10,15,472,456,928,Hammer1584_T,"-37.81970749, 144.96795734"
69720241006,69,2024-10-06,7,9,5,14,FLDegC_T,"-37.81687226, 144.96559144"
662320231028,66,2023-10-28,23,392,376,768,QVN_T,"-37.81057846, 144.96444294"
701420240501,70,2024-05-01,14,126,134,260,Errol20_T,"-37.80456984, 144.94946228"
3520250908,3,2025-09-08,5,27,33,60,Swa295_T,"-37.81101524, 144.96429485"
82220240204,8,2024-02-04,22,27,18,45,WebBN_T,"-37.82293543, 144.9471751"
591520240504,59,2024-05-04,15,635,633,1268,RMIT_T,"-37.80825648, 144.96304859"
77120250320,77,2025-03-20,1,11,11,22,HarEsP_T,"-37.81441438, 144.94433026"
77020250325,77,2025-03-25,0,16,20,36,HarEsP_T,"-37.81441438, 144.94433026"
29520240217,29,2024-02-17,5,26,16,42,AG_T,"-37.8199817, 144.96872865"
292120240312,29,2024-03-12,21,49,60,109,AG_T,"-37.8199817, 144.96872865"
291620240319,29,2024-03-19,16,217,297,514,AG_T,"-37.8199817, 144.96872865"
291120240717,29,2024-07-17,11,171,304,475,AG_T,"-37.8199817, 144.96872865"
14020250727,14,2025-07-27,0,1,0,1,SanBri_T,"-37.82011242, 144.96291897"
59320241030,59,2024-10-30,3,18,7,25,RMIT_T,"-37.80825648, 144.96304859"
591220250214,59,2025-02-14,12,356,441,797,RMIT_T,"-37.80825648, 144.96304859"
541920240818,54,2024-08-18,19,135,154,289,Swa607_T,"-37.804024, 144.96308399"
312320240506,31,2024-05-06,23,17,22,39,Lyg161_T,"-37.80169681, 144.96658911"
471220250906,47,2025-09-06,12,898,1005,1903,Eli250_T,"-37.81258467, 144.9625775"
402120240625,40,2024-06-25,21,59,27,86,Spr201_T,"-37.80999341, 144.97227587"
211120240507,21,2024-05-07,11,280,216,496,Bourke155_T,"-37.81267313, 144.96788288"
21220250722,21,2025-07-22,2,6,5,11,Bourke155_T,"-37.81267313, 144.96788288"
36020250422,36,2025-04-22,0,5,6,11,Que85_T,"-37.81652527, 144.96121062"
37920250314,37,2025-03-14,9,57,37,94,Lyg260_T,"-37.80107122, 144.96704554"
43020240906,43,2024-09-06,0,3,4,7,UM2_T,"-37.79844526, 144.96411782"
165620250429,165,2025-04-29,6,6,10,16,Spen475_T,"-37.80953359, 144.94939004"
143020240515,143,2024-05-15,0,29,15,44,Spencer_T,"-37.821728, 144.95557015"
135320250915,135,2025-09-15,3,20,10,30,Spen161_T,"-37.8172861, 144.95319102"
118620241202,118,2024-12-02,6,4,7,11,Fli114C_T,"-37.81632783, 144.97090512"
681420240411,68,2024-04-11,14,282,174,456,FLDegN_T,"-37.8168479, 144.96559789"
63620250715,63,2025-07-15,6,1,13,14,Bou231_T,"-37.81333081, 144.96675571"
561720241214,56,2024-12-14,17,368,449,817,Lon364_T,"-37.81234775, 144.96153311"
86220240901,86,2024-09-01,2,1,1,2,574Qub_T,"-37.80309992, 144.94908064"
241920231207,24,2023-12-07,19,454,763,1217,Col620_T,"-37.81887963, 144.95449198"
561820250831,56,2025-08-31,18,262,317,579,Lon364_T,"-37.81234775, 144.96153311"
76020231127,76,2023-11-27,0,0,1,1,KenMac_T,"-37.79453803, 144.93036194"
2720250403,2,2025-04-03,7,42,83,125,Bou283_T,"-37.81380668, 144.96516718"
351520250313,35,2025-03-13,15,1075,1204,2279,SouthB_T,"-37.82018685, 144.96508508"
92120240706,9,2024-07-06,21,49,103,152,Col700_T,"-37.81982992, 144.95102555"
9420241210,9,2024-12-10,4,7,0,7,Col700_T,"-37.81982992, 144.95102555"
791120240201,79,2024-02-01,11,431,268,699,FliSS_T,"-37.81794046, 144.96616678"
251120240313,25,2024-03-13,11,0,0,0,MCEC_T,"-37.82401776, 144.95604426"
1612320241202,161,2024-12-02,23,0,1,1,BirArt1109_T,"-37.81851276, 144.97131336"
138820241027,138,2024-10-27,8,1,3,4,EntPark1671_T,"-37.81996544, 144.95981454"
48020240307,48,2024-03-07,0,19,37,56,QVMQ_T,"-37.80631581, 144.95866697"
481720240921,48,2024-09-21,17,178,170,348,QVMQ_T,"-37.80631581, 144.95866697"
1391420250424,139,2025-04-24,14,177,89,266,Signal1647_T,"-37.81959923, 144.9632832"
1392020250604,139,2025-06-04,20,19,13,32,Signal1647_T,"-37.81959923, 144.9632832"
1391820240202,139,2024-02-02,18,118,59,177,Signal1647_T,"-37.81959923, 144.9632832"
66820231018,66,2023-10-18,8,177,513,690,QVN_T,"-37.81057846, 144.96444294"
66620240626,66,2024-06-26,6,22,68,90,QVN_T,"-37.81057846, 144.96444294"
6020250712,6,2025-07-12,0,268,133,401,FliS_T,"-37.81911705, 144.96558255"
441520241203,44,2024-12-03,15,35,55,90,UM3_T,"-37.79698741, 144.96441306"
451720250927,45,2025-09-27,17,770,742,1512,Swa148_T,"-37.81414075, 144.96609379"
1311820240604,131,2024-06-04,18,51,73,124,King2_T,"-37.82009057, 144.95758725"
1431420250603,143,2025-06-03,14,99,135,234,Spencer_T,"-37.821728, 144.95557015"
143120250711,143,2025-07-11,1,28,17,45,Spencer_T,"-37.821728, 144.95557015"
1401720231212,140,2023-12-12,17,84,133,217,Boyd2837_T,"-37.82590962, 144.96185972"
132420240610,132,2024-06-10,4,10,5,15,King335_T,"-37.81267639, 144.95386444"
1321820240128,132,2024-01-28,18,151,115,266,King335_T,"-37.81267639, 144.95386444"
133220250419,133,2025-04-19,2,34,16,50,Spen229_T,"-37.81531435, 144.95227769"
1071620250419,107,2025-04-19,16,110,127,237,280Will_T,"-37.81246271, 144.95690188"
167320251014,167,2025-10-14,3,1,0,1,Lat526_T,"-37.81304149, 144.95155955"
67520241226,67,2024-12-26,5,6,7,13,FLDegS_T,"-37.81688755, 144.96562569"
851120240626,85,2024-06-26,11,74,63,137,488Mac_T,"-37.79432415, 144.92973378"
67620250103,67,2025-01-03,6,30,30,60,FLDegS_T,"-37.81688755, 144.96562569"
681520231026,68,2023-10-26,15,202,128,330,FLDegN_T,"-37.8168479, 144.96559789"
67820240803,67,2024-08-03,8,161,89,250,FLDegS_T,"-37.81688755, 144.96562569"
68920250818,68,2025-08-18,9,230,162,392,FLDegN_T,"-37.8168479, 144.96559789"
121420240904,12,2024-09-04,14,100,108,208,NewQ_T,"-37.81457988, 144.94292398"
12020250624,12,2025-06-24,0,1,0,1,NewQ_T,"-37.81457988, 144.94292398"
22320250202,2,2025-02-02,23,16,26,42,Bou283_T,"-37.81380668, 144.96516718"
35420240117,35,2024-01-17,4,18,11,29,SouthB_T,"-37.82018685, 144.96508508"
582320250517,58,2025-05-17,23,332,343,675,Bou688_T,"-37.81686075, 144.95358075"
352320250211,35,2025-02-11,23,163,326,489,SouthB_T,"-37.82018685, 144.96508508"
35520250501,35,2025-05-01,5,74,37,111,SouthB_T,"-37.82018685, 144.96508508"
271420240608,27,2024-06-08,14,294,183,477,Vic_T,"-37.80606888, 144.95644692"
91020240609,9,2024-06-09,10,36,70,106,Col700_T,"-37.81982992, 144.95102555"
251820240516,25,2024-05-16,18,714,320,1034,MCEC_T,"-37.82401776, 144.95604426"
202020240614,20,2024-06-14,20,362,598,960,LtB170_T,"-37.81172914, 144.9682466"
461320240319,46,2024-03-19,13,217,192,409,Pel147_T,"-37.80240719, 144.9615673"
511120250717,51,2025-07-17,11,94,105,199,Fra118_T,"-37.80841815, 144.95906316"
1091620240806,109,2024-08-06,16,450,153,603,LatWill_T,"-37.81193681, 144.95621105"
1801420251016,180,2025-10-16,14,19,26,45,Mac330_T,"-37.79497059, 144.93530329"
1361620250105,136,2025-01-05,16,100,52,152,BirFed1120_T,"-37.8184141, 144.97357915"
142920250613,142,2025-06-13,9,145,154,299,Hammer1584_T,"-37.81970749, 144.96795734"
142320240707,142,2024-07-07,3,7,2,9,Hammer1584_T,"-37.81970749, 144.96795734"
161920250305,161,2025-03-05,9,63,153,216,BirArt1109_T,"-37.81851276, 144.97131336"
69620240825,69,2024-08-25,6,6,4,10,FLDegC_T,"-37.81687226, 144.96559144"
84320241024,84,2024-10-24,3,8,19,27,ElFi_T,"-37.81798049, 144.96503383"
42220240130,4,2024-01-30,22,440,220,660,Swa123_T,"-37.81487988, 144.9660878"
42320250123,4,2025-01-23,23,363,215,578,Swa123_T,"-37.81487988, 144.9660878"
751120240924,75,2024-09-24,11,40,33,73,SprFli_T,"-37.81515276, 144.97467661"
75720250318,75,2025-03-18,7,47,43,90,SprFli_T,"-37.81515276, 144.97467661"
411920240801,41,2024-08-01,19,244,146,390,Swa31,"-37.81668634, 144.96689733"
782320250803,78,2025-08-03,23,1,8,9,HarEsB_T,"-37.81471642, 144.9446508"
771120240112,77,2024-01-12,11,106,48,154,HarEsP_T,"-37.81441438, 144.94433026"
591520241118,59,2024-11-18,15,271,381,652,RMIT_T,"-37.80825648, 144.96304859"
9320250930,9,2025-09-30,3,1,2,3,Col700_T,"-37.81982992, 144.95102555"
9220240110,9,2024-01-10,2,2,1,3,Col700_T,"-37.81982992, 144.95102555"
231820240812,23,2024-08-12,18,207,349,556,Col623_T,"-37.81909256, 144.95452748"
30120240802,30,2024-08-02,1,59,72,131,Lon189_T,"-37.8112185, 144.96656806"
301220241129,30,2024-11-29,12,266,382,648,Lon189_T,"-37.8112185, 144.96656806"
301320240115,30,2024-01-15,13,287,353,640,Lon189_T,"-37.8112185, 144.96656806"
521820250925,52,2025-09-25,18,386,437,823,Eli263_T,"-37.81252157, 144.9619401"
201520240417,20,2024-04-17,15,189,420,609,LtB170_T,"-37.81172914, 144.9682466"
202020250611,20,2025-06-11,20,142,311,453,LtB170_T,"-37.81172914, 144.9682466"
1301020250424,130,2025-04-24,10,71,49,120,Bou892T,"-37.8204637, 144.94126826"
1641220240826,164,2024-08-26,12,89,83,172,Lat526_T,"-37.813005, 144.95160411"
1411020251002,141,2025-10-02,10,91,133,224,474Fl_T,"-37.81997273, 144.95834911"
251620250826,25,2025-08-26,16,431,365,796,MCEC_T,"-37.82401776, 144.95604426"
482120231021,48,2023-10-21,21,125,120,245,QVMQ_T,"-37.80631581, 144.95866697"
1391320240918,139,2024-09-18,13,72,98,170,Signal1647_T,"-37.81959923, 144.9632832"
1421720250917,142,2025-09-17,17,545,363,908,Hammer1584_T,"-37.81970749, 144.96795734"
68220240401,68,2024-04-01,2,3,2,5,FLDegN_T,"-37.8168479, 144.96559789"
851020250313,85,2025-03-13,10,72,61,133,488Mac_T,"-37.79432415, 144.92973378"
851520250920,85,2025-09-20,15,102,66,168,488Mac_T,"-37.79432415, 144.92973378"
66920240702,66,2024-07-02,9,230,389,619,QVN_T,"-37.81057846, 144.96444294"
75520231028,75,2023-10-28,5,3,3,6,SprFli_T,"-37.81515276, 144.97467661"
391720240823,39,2024-08-23,17,161,71,232,AlfPl_T,"-37.81379749, 144.96995745"
421120240816,42,2024-08-16,11,297,341,638,UM1_T,"-37.80008566, 144.96386412"
78520241110,78,2024-11-10,5,2,2,4,HarEsB_T,"-37.81471642, 144.9446508"
782020250110,78,2025-01-10,20,16,26,42,HarEsB_T,"-37.81471642, 144.9446508"
291420240711,29,2024-07-11,14,181,252,433,AG_T,"-37.8199817, 144.96872865"
141420231123,14,2023-11-23,14,402,158,560,SanBri_T,"-37.82011242, 144.96291897"
59320241017,59,2024-10-17,3,2,2,4,RMIT_T,"-37.80825648, 144.96304859"
59320240210,59,2024-02-10,3,53,12,65,RMIT_T,"-37.80825648, 144.96304859"
54920240126,54,2024-01-26,9,36,34,70,Swa607_T,"-37.804024, 144.96308399"
40020241123,40,2024-11-23,0,50,39,89,Spr201_T,"-37.80999341, 144.97227587"
401720240417,40,2024-04-17,17,208,411,619,Spr201_T,"-37.80999341, 144.97227587"
401820240718,40,2024-07-18,18,139,213,352,Spr201_T,"-37.80999341, 144.97227587"
362220250125,36,2025-01-25,22,133,108,241,Que85_T,"-37.81652527, 144.96121062"
43320240316,43,2024-03-16,3,3,2,5,UM2_T,"-37.79844526, 144.96411782"
21320250225,21,2025-02-25,3,7,1,8,Bourke155_T,"-37.81267313, 144.96788288"
1661520250906,166,2025-09-06,15,75,52,127,Spen484_T,"-37.80896733, 144.94931703"
132320231213,132,2023-12-13,3,8,5,13,King335_T,"-37.81267639, 144.95386444"
1351020240607,135,2024-06-07,10,302,347,649,Spen161_T,"-37.8172861, 144.95319102"
85320241116,85,2024-11-16,3,2,1,3,488Mac_T,"-37.79432415, 144.92973378"
172320240604,17,2024-06-04,23,23,28,51,Col15_T,"-37.81362543, 144.97323591"
171720241002,17,2024-10-02,17,267,650,917,Col15_T,"-37.81362543, 144.97323591"
171220241030,17,2024-10-30,12,737,723,1460,Col15_T,"-37.81362543, 144.97323591"
41520250311,4,2025-03-11,15,1390,1283,2673,Swa123_T,"-37.81487988, 144.9660878"
4620251009,4,2025-10-09,6,94,53,147,Swa123_T,"-37.81487988, 144.9660878"
31820240708,3,2024-07-08,18,993,1191,2184,Swa295_T,"-37.81101524, 144.96429485"
39620231231,39,2023-12-31,6,1,5,6,AlfPl_T,"-37.81379749, 144.96995745"
82120241111,8,2024-11-11,21,54,33,87,WebBN_T,"-37.82293543, 144.9471751"
81220250803,8,2025-08-03,12,242,258,500,WebBN_T,"-37.82293543, 144.9471751"
781720250616,78,2025-06-16,17,3,30,33,HarEsB_T,"-37.81471642, 144.9446508"
772320240223,77,2024-02-23,23,570,54,624,HarEsP_T,"-37.81441438, 144.94433026"
14220231113,14,2023-11-13,2,10,4,14,SanBri_T,"-37.82011242, 144.96291897"
711520250326,71,2025-03-26,15,20,15,35,WestWP_T,"-37.81235775, 144.97136962"
71320250419,71,2025-04-19,3,4,5,9,WestWP_T,"-37.81235775, 144.97136962"
212320231111,21,2023-11-11,23,374,426,800,Bourke155_T,"-37.81267313, 144.96788288"
501920250702,50,2025-07-02,19,100,110,210,Lyg309_T,"-37.79808192, 144.96721013"
501220240206,50,2024-02-06,12,193,218,411,Lyg309_T,"-37.79808192, 144.96721013"
432120240309,43,2024-03-09,21,39,33,72,UM2_T,"-37.79844526, 144.96411782"
5220250523,5,2025-05-23,2,12,18,30,PriNW_T,"-37.81874249, 144.96787656"
1651020250912,165,2025-09-12,10,32,48,80,Spen475_T,"-37.80953359, 144.94939004"
1791720250901,179,2025-09-01,17,82,91,173,Pow61_T,"-37.82392385, 144.96299677"
143420250821,143,2025-08-21,4,15,7,22,Spencer_T,"-37.821728, 144.95557015"
132920250314,132,2025-03-14,9,145,98,243,King335_T,"-37.81267639, 144.95386444"
108620250226,108,2025-02-26,6,42,278,320,261Will_T,"-37.81295822, 144.95678789"
1081820250502,108,2025-05-02,18,478,203,681,261Will_T,"-37.81295822, 144.95678789"
108820250504,108,2025-05-04,8,40,82,122,261Will_T,"-37.81295822, 144.95678789"
132220250726,132,2025-07-26,2,16,12,28,King335_T,"-37.81267639, 144.95386444"
132620250823,132,2025-08-23,6,22,13,35,King335_T,"-37.81267639, 144.95386444"
135820250613,135,2025-06-13,8,233,294,527,Spen161_T,"-37.8172861, 144.95319102"
133020250914,133,2025-09-14,0,107,59,166,Spen229_T,"-37.81531435, 144.95227769"
172220231027,17,2023-10-27,22,95,231,326,Col15_T,"-37.81362543, 144.97323591"
12320250415,1,2025-04-15,23,45,46,91,Bou292_T,"-37.81349441, 144.96515323"
621720231230,62,2023-12-30,17,153,71,224,Lat224_T,"-37.80996494, 144.96216521"
56720240725,56,2024-07-25,7,65,60,125,Lon364_T,"-37.81234775, 144.96153311"
86920250121,86,2025-01-21,9,38,41,79,574Qub_T,"-37.80309992, 144.94908064"
12620241226,12,2024-12-26,6,29,19,48,NewQ_T,"-37.81457988, 144.94292398"
241520251013,24,2025-10-13,15,462,1158,1620,Col620_T,"-37.81887963, 144.95449198"
761720231019,76,2023-10-19,17,69,78,147,KenMac_T,"-37.79453803, 144.93036194"
351620241215,35,2024-12-15,16,995,1401,2396,SouthB_T,"-37.82018685, 144.96508508"
21520240930,2,2024-09-30,15,608,697,1305,Bou283_T,"-37.81380668, 144.96516718"
271520240924,27,2024-09-24,15,133,96,229,Vic_T,"-37.80606888, 144.95644692"
27320241018,27,2024-10-18,3,5,4,9,Vic_T,"-37.80606888, 144.95644692"
792220251007,79,2025-10-07,22,126,149,275,FliSS_T,"-37.81794046, 144.96616678"
46820240211,46,2024-02-11,8,6,10,16,Pel147_T,"-37.80240719, 144.9615673"
52920250325,52,2025-03-25,9,183,261,444,Eli263_T,"-37.81252157, 144.9619401"
54420240806,54,2024-08-06,4,2,1,3,Swa607_T,"-37.804024, 144.96308399"
471520250201,47,2025-02-01,15,706,836,1542,Eli250_T,"-37.81258467, 144.9625775"
471620251007,47,2025-10-07,16,1335,967,2302,Eli250_T,"-37.81258467, 144.9625775"
43920240909,43,2024-09-09,9,128,90,218,UM2_T,"-37.79844526, 144.96411782"
51120240308,5,2024-03-08,11,721,1064,1785,PriNW_T,"-37.81874249, 144.96787656"
212020231018,21,2023-10-18,20,299,416,715,Bourke155_T,"-37.81267313, 144.96788288"
140920241207,140,2024-12-07,9,114,61,175,Boyd2837_T,"-37.82590962, 144.96185972"
1311220240705,131,2024-07-05,12,163,179,342,King2_T,"-37.82009057, 144.95758725"
132320241001,132,2024-10-01,3,10,1,11,King335_T,"-37.81267639, 144.95386444"
1322120241119,132,2024-11-19,21,130,87,217,King335_T,"-37.81267639, 144.95386444"
1341620231025,134,2023-10-25,16,480,525,1005,Spen201_T,"-37.81694221, 144.95303935"
135920240823,135,2024-08-23,9,250,325,575,Spen161_T,"-37.8172861, 144.95319102"
118920250716,118,2025-07-16,9,30,10,40,Fli114C_T,"-37.81632783, 144.97090512"
1081520240421,108,2024-04-21,15,55,105,160,261Will_T,"-37.81295822, 144.95678789"
108620250718,108,2025-07-18,6,26,157,183,261Will_T,"-37.81295822, 144.95678789"
1081520231222,108,2023-12-22,15,377,196,573,261Will_T,"-37.81295822, 144.95678789"
87820231024,87,2023-10-24,8,121,66,187,Errol23_T,"-37.80454949, 144.94921863"
85820240706,85,2024-07-06,8,37,33,70,488Mac_T,"-37.79432415, 144.92973378"
681220240217,68,2024-02-17,12,311,195,506,FLDegN_T,"-37.8168479, 144.96559789"
11520251006,11,2025-10-06,5,1,3,4,WatCit_T,"-37.81564989, 144.93970694"
121420240415,12,2024-04-15,14,128,130,258,NewQ_T,"-37.81457988, 144.94292398"
242020250902,24,2025-09-02,20,295,396,691,Col620_T,"-37.81887963, 144.95449198"
721920231019,72,2023-10-19,19,196,359,555,ACMI_T,"-37.81726338, 144.96872809"
762220250422,76,2025-04-22,22,1,6,7,KenMac_T,"-37.79453803, 144.93036194"
27420240515,27,2024-05-15,4,4,2,6,Vic_T,"-37.80606888, 144.95644692"
53020250328,53,2025-03-28,0,33,38,71,Col254_T,"-37.81564191, 144.965499"
91920250413,9,2025-04-13,19,30,55,85,Col700_T,"-37.81982992, 144.95102555"
9520240530,9,2024-05-30,5,12,50,62,Col700_T,"-37.81982992, 144.95102555"
79420240302,79,2024-03-02,4,38,41,79,FliSS_T,"-37.81794046, 144.96616678"
301720240530,30,2024-05-30,17,235,382,617,Lon189_T,"-37.8112185, 144.96656806"
30120240229,30,2024-02-29,1,89,69,158,Lon189_T,"-37.8112185, 144.96656806"
25020240311,25,2024-03-11,0,53,90,143,MCEC_T,"-37.82401776, 144.95604426"
521320250601,52,2025-06-01,13,420,348,768,Eli263_T,"-37.81252157, 144.9619401"
56120240819,56,2024-08-19,1,22,28,50,Lon364_T,"-37.81234775, 144.96153311"
241820241017,24,2024-10-17,18,553,1342,1895,Col620_T,"-37.81887963, 144.95449198"
11720250528,11,2025-05-28,7,40,30,70,WatCit_T,"-37.81564989, 144.93970694"
561920250904,56,2025-09-04,19,392,368,760,Lon364_T,"-37.81234775, 144.96153311"
242320250801,24,2025-08-01,23,203,338,541,Col620_T,"-37.81887963, 144.95449198"
352220240315,35,2024-03-15,22,846,2812,3658,SouthB_T,"-37.82018685, 144.96508508"
22020241227,2,2024-12-27,20,492,419,911,Bou283_T,"-37.81380668, 144.96516718"
351420240219,35,2024-02-19,14,1034,1295,2329,SouthB_T,"-37.82018685, 144.96508508"
58520250221,58,2025-02-21,5,64,16,80,Bou688_T,"-37.81686075, 144.95358075"
53320240702,53,2024-07-02,3,5,4,9,Col254_T,"-37.81564191, 144.965499"
791220240519,79,2024-05-19,12,353,327,680,FliSS_T,"-37.81794046, 144.96616678"
792320250311,79,2025-03-11,23,103,112,215,FliSS_T,"-37.81794046, 144.96616678"
301720231231,30,2023-12-31,17,299,359,658,Lon189_T,"-37.8112185, 144.96656806"
46120240503,46,2024-05-03,1,2,1,3,Pel147_T,"-37.80240719, 144.9615673"
52320241107,52,2024-11-07,3,1,1,2,Eli263_T,"-37.81252157, 144.9619401"
522120240211,52,2024-02-11,21,165,139,304,Eli263_T,"-37.81252157, 144.9619401"
1301520250504,130,2025-05-04,15,64,90,154,Bou892T,"-37.8204637, 144.94126826"
164820251011,164,2025-10-11,8,37,18,55,Lat526_T,"-37.813005, 144.95160411"
1381820241207,138,2024-12-07,18,1,11,12,EntPark1671_T,"-37.81996544, 144.95981454"
117020251006,117,2025-10-06,0,21,11,32,Fli114F_T,"-37.81629332, 144.97090877"
49720231031,49,2023-10-31,7,51,89,140,Eli501_T,"-37.80730068, 144.95956055"
109720240604,109,2024-06-04,7,42,323,365,LatWill_T,"-37.81193681, 144.95621105"
1801920250813,180,2025-08-13,19,5,4,9,Mac330_T,"-37.79497059, 144.93530329"
136520241222,136,2024-12-22,5,1,4,5,BirFed1120_T,"-37.8184141, 144.97357915"
1361220250422,136,2025-04-22,12,114,64,178,BirFed1120_T,"-37.8184141, 144.97357915"
1421620240927,142,2024-09-27,16,785,793,1578,Hammer1584_T,"-37.81970749, 144.96795734"
661020241126,66,2024-11-26,10,355,443,798,QVN_T,"-37.81057846, 144.96444294"
691720241105,69,2024-11-05,17,90,76,166,FLDegC_T,"-37.81687226, 144.96559144"
62220231103,6,2023-11-03,22,665,590,1255,FliS_T,"-37.81911705, 144.96558255"
84820240804,84,2024-08-04,8,261,161,422,ElFi_T,"-37.81798049, 144.96503383"
66820240707,66,2024-07-07,8,38,71,109,QVN_T,"-37.81057846, 144.96444294"
702020240711,70,2024-07-11,20,92,90,182,Errol20_T,"-37.80456984, 144.94946228"
751220251013,75,2025-10-13,12,64,81,145,SprFli_T,"-37.81515276, 144.97467661"
71520250208,71,2025-02-08,5,1,2,3,WestWP_T,"-37.81235775, 144.97136962"
541420250602,54,2025-06-02,14,106,91,197,Swa607_T,"-37.804024, 144.96308399"
28620240202,28,2024-02-02,6,112,60,172,VAC_T,"-37.82129925, 144.96879309"
291520251011,29,2025-10-11,15,393,479,872,AG_T,"-37.8199817, 144.96872865"
47120231227,47,2023-12-27,1,53,45,98,Eli250_T,"-37.81258467, 144.9625775"
372220250722,37,2025-07-22,22,16,16,32,Lyg260_T,"-37.80107122, 144.96704554"
45120240908,45,2024-09-08,1,89,250,339,Swa148_T,"-37.81414075, 144.96609379"
441020231019,44,2023-10-19,10,64,90,154,UM3_T,"-37.79698741, 144.96441306"
43120250522,43,2025-05-22,1,15,1,16,UM2_T,"-37.79844526, 144.96411782"
133620250220,133,2025-02-20,6,367,223,590,Spen229_T,"-37.81531435, 144.95227769"
1332320250616,133,2025-06-16,23,65,34,99,Spen229_T,"-37.81531435, 144.95227769"
135320240211,135,2024-02-11,3,26,22,48,Spen161_T,"-37.8172861, 144.95319102"
1181020250919,118,2025-09-19,10,18,18,36,Fli114C_T,"-37.81632783, 144.97090512"
23620240721,23,2024-07-21,6,38,32,70,Col623_T,"-37.81909256, 144.95452748"
492220240312,49,2024-03-12,22,116,79,195,Eli501_T,"-37.80730068, 144.95956055"
137720250803,137,2025-08-03,7,1,2,3,BouHbr2353_T,"-37.81894815, 144.94612292"
117620231018,117,2023-10-18,6,34,20,54,Fli114F_T,"-37.81629332, 144.97090877"
61620231115,6,2023-11-15,16,1639,978,2617,FliS_T,"-37.81911705, 144.96558255"
84120240605,84,2024-06-05,1,9,14,23,ElFi_T,"-37.81798049, 144.96503383"
42320231106,4,2023-11-06,23,892,402,1294,Swa123_T,"-37.81487988, 144.9660878"
31920240616,3,2024-06-16,19,889,955,1844,Swa295_T,"-37.81101524, 144.96429485"
31620240817,3,2024-08-17,16,1354,1582,2936,Swa295_T,"-37.81101524, 144.96429485"
751520241222,75,2024-12-22,15,59,47,106,SprFli_T,"-37.81515276, 144.97467661"
782320240914,78,2024-09-14,23,0,10,10,HarEsB_T,"-37.81471642, 144.9446508"
771020250213,77,2025-02-13,10,56,47,103,HarEsP_T,"-37.81441438, 144.94433026"
292320240815,29,2024-08-15,23,7,47,54,AG_T,"-37.8199817, 144.96872865"
29720240116,29,2024-01-16,7,102,118,220,AG_T,"-37.8199817, 144.96872865"
711220231218,71,2023-12-18,12,26,38,64,WestWP_T,"-37.81235775, 144.97136962"
471620250621,47,2025-06-21,16,1292,1128,2420,Eli250_T,"-37.81258467, 144.9625775"
36120231022,36,2023-10-22,1,94,79,173,Que85_T,"-37.81652527, 144.96121062"
36220231103,36,2023-11-03,2,14,5,19,Que85_T,"-37.81652527, 144.96121062"
61620240715,61,2024-07-15,6,27,46,73,RMIT14_T,"-37.80767455, 144.96309114"
43720231023,43,2023-10-23,7,63,32,95,UM2_T,"-37.79844526, 144.96411782"
211920250512,21,2025-05-12,19,187,286,473,Bourke155_T,"-37.81267313, 144.96788288"
1071620231206,107,2023-12-06,16,214,110,324,280Will_T,"-37.81246271, 144.95690188"
1071420240930,107,2024-09-30,14,127,134,261,280Will_T,"-37.81246271, 144.95690188"
133220231206,133,2023-12-06,2,15,5,20,Spen229_T,"-37.81531435, 144.95227769"
108620240829,108,2024-08-29,6,9,194,203,261Will_T,"-37.81295822, 144.95678789"
872320250313,87,2025-03-13,23,8,14,22,Errol23_T,"-37.80454949, 144.94921863"
681520250430,68,2025-04-30,15,255,208,463,FLDegN_T,"-37.8168479, 144.96559789"
182220250528,18,2025-05-28,22,8,4,12,Col12_T,"-37.81344862, 144.97305353"
632320241224,63,2024-12-24,23,12,47,59,Bou231_T,"-37.81333081, 144.96675571"
621820240513,62,2024-05-13,18,236,191,427,Lat224_T,"-37.80996494, 144.96216521"
56720240408,56,2024-04-08,7,71,61,132,Lon364_T,"-37.81234775, 144.96153311"
24120240305,24,2024-03-05,1,11,11,22,Col620_T,"-37.81887963, 144.95449198"
721620250516,72,2025-05-16,16,155,466,621,ACMI_T,"-37.81726338, 144.96872809"
352120241208,35,2024-12-08,21,1221,2549,3770,SouthB_T,"-37.82018685, 144.96508508"
35120240227,35,2024-02-27,1,30,72,102,SouthB_T,"-37.82018685, 144.96508508"
21920241022,2,2024-10-22,19,173,196,369,Bou283_T,"-37.81380668, 144.96516718"
30720250609,30,2025-06-09,7,23,59,82,Lon189_T,"-37.8112185, 144.96656806"
30320240702,30,2024-07-02,3,9,18,27,Lon189_T,"-37.8112185, 144.96656806"
301520240217,30,2024-02-17,15,392,523,915,Lon189_T,"-37.8112185, 144.96656806"
252220240427,25,2024-04-27,22,1131,237,1368,MCEC_T,"-37.82401776, 144.95604426"
201720250501,20,2025-05-01,17,378,273,651,LtB170_T,"-37.81172914, 144.9682466"
461420240508,46,2024-05-08,14,139,147,286,Pel147_T,"-37.80240719, 144.9615673"
46120240615,46,2024-06-15,1,4,4,8,Pel147_T,"-37.80240719, 144.9615673"
511020240314,51,2024-03-14,10,107,125,232,Fra118_T,"-37.80841815, 144.95906316"
25420250617,25,2025-06-17,4,6,4,10,MCEC_T,"-37.82401776, 144.95604426"
25820250831,25,2025-08-31,8,173,234,407,MCEC_T,"-37.82401776, 144.95604426"
482220241203,48,2024-12-03,22,34,43,77,QVMQ_T,"-37.80631581, 144.95866697"
1361620240906,136,2024-09-06,16,583,111,694,BirFed1120_T,"-37.8184141, 144.97357915"
1422220240902,142,2024-09-02,22,29,40,69,Hammer1584_T,"-37.81970749, 144.96795734"
123920240217,123,2024-02-17,9,15,9,24,BirBridge_T,"-37.81753741, 144.97329734"
661420241210,66,2024-12-10,14,1001,1147,2148,QVN_T,"-37.81057846, 144.96444294"
41720231019,4,2023-10-19,17,1836,1315,3151,Swa123_T,"-37.81487988, 144.9660878"
32320250531,3,2025-05-31,23,519,555,1074,Swa295_T,"-37.81101524, 144.96429485"
32220240206,3,2024-02-06,22,441,368,809,Swa295_T,"-37.81101524, 144.96429485"
75720231018,75,2023-10-18,7,38,27,65,SprFli_T,"-37.81515276, 144.97467661"
77820251004,77,2025-10-04,8,108,94,202,HarEsP_T,"-37.81441438, 144.94433026"
42920240718,42,2024-07-18,9,139,124,263,UM1_T,"-37.80008566, 144.96386412"
14020240122,14,2024-01-22,0,54,47,101,SanBri_T,"-37.82011242, 144.96291897"
652020240405,65,2024-04-05,20,454,548,1002,SwaCs_T,"-37.81569416, 144.9668064"
541520240119,54,2024-01-19,15,61,106,167,Swa607_T,"-37.804024, 144.96308399"
471120250116,47,2025-01-16,11,610,761,1371,Eli250_T,"-37.81258467, 144.9625775"
401820240214,40,2024-02-14,18,133,264,397,Spr201_T,"-37.80999341, 144.97227587"
37220250104,37,2025-01-04,2,2,3,5,Lyg260_T,"-37.80107122, 144.96704554"
37120250109,37,2025-01-09,1,1,1,2,Lyg260_T,"-37.80107122, 144.96704554"
47720240626,47,2024-06-26,7,117,265,382,Eli250_T,"-37.81258467, 144.9625775"
441820250425,44,2025-04-25,18,12,8,20,UM3_T,"-37.79698741, 144.96441306"
44720250715,44,2025-07-15,7,15,18,33,UM3_T,"-37.79698741, 144.96441306"
43320250616,43,2025-06-16,3,0,1,1,UM2_T,"-37.79844526, 144.96411782"
11320250202,1,2025-02-02,13,1106,1184,2290,Bou292_T,"-37.81349441, 144.96515323"
671420240315,67,2024-03-15,14,322,489,811,FLDegS_T,"-37.81688755, 144.96562569"
111920240324,11,2024-03-24,19,164,164,328,WatCit_T,"-37.81564989, 144.93970694"
761420240513,76,2024-05-13,14,45,36,81,KenMac_T,"-37.79453803, 144.93036194"
721920250423,72,2025-04-23,19,149,201,350,ACMI_T,"-37.81726338, 144.96872809"
352320240325,35,2024-03-25,23,176,242,418,SouthB_T,"-37.82018685, 144.96508508"
22020231122,2,2023-11-22,20,132,276,408,Bou283_T,"-37.81380668, 144.96516718"
351820250717,35,2025-07-17,18,871,593,1464,SouthB_T,"-37.82018685, 144.96508508"
91520231208,9,2023-12-08,15,659,184,843,Col700_T,"-37.81982992, 144.95102555"
27420251014,27,2025-10-14,4,7,10,17,Vic_T,"-37.80606888, 144.95644692"
30120231031,30,2023-10-31,1,25,36,61,Lon189_T,"-37.8112185, 144.96656806"
302320231123,30,2023-11-23,23,209,265,474,Lon189_T,"-37.8112185, 144.96656806"
201520250118,20,2025-01-18,15,175,242,417,LtB170_T,"-37.81172914, 144.9682466"
20420250823,20,2025-08-23,4,9,22,31,LtB170_T,"-37.81172914, 144.9682466"
521320240825,52,2024-08-25,13,433,358,791,Eli263_T,"-37.81252157, 144.9619401"
46720241101,46,2024-11-01,7,45,45,90,Pel147_T,"-37.80240719, 144.9615673"
461520250208,46,2025-02-08,15,21,30,51,Pel147_T,"-37.80240719, 144.9615673"
461720240703,46,2024-07-03,17,133,58,191,Pel147_T,"-37.80240719, 144.9615673"
51820250723,51,2025-07-23,8,58,47,105,Fra118_T,"-37.80841815, 144.95906316"
511720240830,51,2024-08-30,17,114,112,226,Fra118_T,"-37.80841815, 144.95906316"
52220240701,52,2024-07-01,2,3,13,16,Eli263_T,"-37.81252157, 144.9619401"
1611220241225,161,2024-12-25,12,36,67,103,BirArt1109_T,"-37.81851276, 144.97131336"
492020241207,49,2024-12-07,20,188,148,336,Eli501_T,"-37.80730068, 144.95956055"
1371720241104,137,2024-11-04,17,21,63,84,BouHbr2353_T,"-37.81894815, 144.94612292"
137720250625,137,2025-06-25,7,11,3,14,BouHbr2353_T,"-37.81894815, 144.94612292"
139420250318,139,2025-03-18,4,1,0,1,Signal1647_T,"-37.81959923, 144.9632832"
1361020251004,136,2025-10-04,10,174,73,247,BirFed1120_T,"-37.8184141, 144.97357915"
661720250122,66,2025-01-22,17,1376,1444,2820,QVN_T,"-37.81057846, 144.96444294"
661220250806,66,2025-08-06,12,1113,1301,2414,QVN_T,"-37.81057846, 144.96444294"
6720240312,6,2024-03-12,7,506,780,1286,FliS_T,"-37.81911705, 144.96558255"
6020240325,6,2024-03-25,0,161,75,236,FliS_T,"-37.81911705, 144.96558255"
841520231212,84,2023-12-12,15,795,1273,2068,ElFi_T,"-37.81798049, 144.96503383"
84520250505,84,2025-05-05,5,43,28,71,ElFi_T,"-37.81798049, 144.96503383"
41520240426,4,2024-04-26,15,1801,1588,3389,Swa123_T,"-37.81487988, 144.9660878"
42220250630,4,2025-06-30,22,216,263,479,Swa123_T,"-37.81487988, 144.9660878"
392120241031,39,2024-10-31,21,4,3,7,AlfPl_T,"-37.81379749, 144.96995745"
39020250318,39,2025-03-18,0,1,1,2,AlfPl_T,"-37.81379749, 144.96995745"
751920250804,75,2025-08-04,19,7,3,10,SprFli_T,"-37.81515276, 144.97467661"
782020240907,78,2024-09-07,20,10,17,27,HarEsB_T,"-37.81471642, 144.9446508"
65720231217,65,2023-12-17,7,55,29,84,SwaCs_T,"-37.81569416, 144.9668064"
421420251015,42,2025-10-15,14,275,312,587,UM1_T,"-37.80008566, 144.96386412"
652020231106,65,2023-11-06,20,170,424,594,SwaCs_T,"-37.81569416, 144.9668064"
291520240112,29,2024-01-12,15,190,290,480,AG_T,"-37.8199817, 144.96872865"
14920250426,14,2025-04-26,9,225,64,289,SanBri_T,"-37.82011242, 144.96291897"
142220240629,14,2024-06-29,22,262,340,602,SanBri_T,"-37.82011242, 144.96291897"
591820241215,59,2024-12-15,18,168,221,389,RMIT_T,"-37.80825648, 144.96304859"
281420250905,28,2025-09-05,14,519,678,1197,VAC_T,"-37.82129925, 144.96879309"
21320240607,21,2024-06-07,3,18,29,47,Bourke155_T,"-37.81267313, 144.96788288"
36320240714,36,2024-07-14,3,61,57,118,Que85_T,"-37.81652527, 144.96121062"
871020250110,87,2025-01-10,10,84,112,196,Errol23_T,"-37.80454949, 144.94921863"
61720250512,61,2025-05-12,7,143,153,296,RMIT14_T,"-37.80767455, 144.96309114"
61020240627,61,2024-06-27,0,51,33,84,RMIT14_T,"-37.80767455, 144.96309114"
502220240504,50,2024-05-04,22,230,114,344,Lyg309_T,"-37.79808192, 144.96721013"
431520231019,43,2023-10-19,15,235,359,594,UM2_T,"-37.79844526, 144.96411782"
5820250209,5,2025-02-09,8,100,218,318,PriNW_T,"-37.81874249, 144.96787656"
1791120250527,179,2025-05-27,11,33,37,70,Pow61_T,"-37.82392385, 144.96299677"
131720250126,131,2025-01-26,7,19,42,61,King2_T,"-37.82009057, 144.95758725"
1621520250516,162,2025-05-16,15,796,835,1631,Eli489_T,"-37.80740397, 144.95987909"
140720240606,140,2024-06-06,7,85,11,96,Boyd2837_T,"-37.82590962, 144.96185972"
1071520231030,107,2023-10-30,15,122,121,243,280Will_T,"-37.81246271, 144.95690188"
132320250829,132,2025-08-29,3,3,5,8,King335_T,"-37.81267639, 144.95386444"
132420240511,132,2024-05-11,4,4,9,13,King335_T,"-37.81267639, 144.95386444"
1342120240207,134,2024-02-07,21,271,296,567,Spen201_T,"-37.81694221, 144.95303935"
133820250411,133,2025-04-11,8,382,420,802,Spen229_T,"-37.81531435, 144.95227769"
133420250505,133,2025-05-05,4,11,22,33,Spen229_T,"-37.81531435, 144.95227769"
107420250306,107,2025-03-06,4,2,1,3,280Will_T,"-37.81246271, 144.95690188"
118820250820,118,2025-08-20,8,36,16,52,Fli114C_T,"-37.81632783, 144.97090512"
108120250902,108,2025-09-02,1,7,14,21,261Will_T,"-37.81295822, 144.95678789"
108720240620,108,2024-06-20,7,24,519,543,261Will_T,"-37.81295822, 144.95678789"
281220240927,28,2024-09-27,12,842,913,1755,VAC_T,"-37.82129925, 144.96879309"
471020250821,47,2025-08-21,10,401,459,860,Eli250_T,"-37.81258467, 144.9625775"
51020240621,5,2024-06-21,10,324,724,1048,PriNW_T,"-37.81874249, 144.96787656"
70120250410,70,2025-04-10,1,1,0,1,Errol20_T,"-37.80456984, 144.94946228"
1181020250112,118,2025-01-12,10,7,99,106,Fli114C_T,"-37.81632783, 144.97090512"
871120250617,87,2025-06-17,11,90,89,179,Errol23_T,"-37.80454949, 144.94921863"
50820250821,50,2025-08-21,8,34,84,118,Lyg309_T,"-37.79808192, 144.96721013"
442120240903,44,2024-09-03,21,12,19,31,UM3_T,"-37.79698741, 144.96441306"
44620240904,44,2024-09-04,6,5,3,8,UM3_T,"-37.79698741, 144.96441306"
50420231103,50,2023-11-03,4,10,0,10,Lyg309_T,"-37.79808192, 144.96721013"
167720250518,167,2025-05-18,7,3,25,28,Lat526_T,"-37.81304149, 144.95155955"
1401620250610,140,2025-06-10,16,87,91,178,Boyd2837_T,"-37.82590962, 144.96185972"
1431420250716,143,2025-07-16,14,195,215,410,Spencer_T,"-37.821728, 144.95557015"
1321420241115,132,2024-11-15,14,202,198,400,King335_T,"-37.81267639, 144.95386444"
1431620240522,143,2024-05-22,16,263,302,565,Spencer_T,"-37.821728, 144.95557015"
67920250527,67,2025-05-27,9,499,310,809,FLDegS_T,"-37.81688755, 144.96562569"
851520231222,85,2023-12-22,15,105,111,216,488Mac_T,"-37.79432415, 144.92973378"
861720250213,86,2025-02-13,17,69,77,146,574Qub_T,"-37.80309992, 144.94908064"
621420250104,62,2025-01-04,14,161,104,265,Lat224_T,"-37.80996494, 144.96216521"
242020240922,24,2024-09-22,20,254,462,716,Col620_T,"-37.81887963, 144.95449198"
121620250701,12,2025-07-01,16,163,205,368,NewQ_T,"-37.81457988, 144.94292398"
72720250825,72,2025-08-25,7,152,49,201,ACMI_T,"-37.81726338, 144.96872809"
72020240802,72,2024-08-02,0,4,14,18,ACMI_T,"-37.81726338, 144.96872809"
721020240120,72,2024-01-20,10,183,216,399,ACMI_T,"-37.81726338, 144.96872809"
351320250916,35,2025-09-16,13,864,1069,1933,SouthB_T,"-37.82018685, 144.96508508"
35520240117,35,2024-01-17,5,96,64,160,SouthB_T,"-37.82018685, 144.96508508"
2020240519,2,2024-05-19,0,35,76,111,Bou283_T,"-37.81380668, 144.96516718"
21120250907,2,2025-09-07,11,464,561,1025,Bou283_T,"-37.81380668, 144.96516718"
792120231023,79,2023-10-23,21,203,240,443,FliSS_T,"-37.81794046, 144.96616678"
91520231026,9,2023-10-26,15,755,184,939,Col700_T,"-37.81982992, 144.95102555"
30620251013,30,2025-10-13,6,12,22,34,Lon189_T,"-37.8112185, 144.96656806"
252220241012,25,2024-10-12,22,852,267,1119,MCEC_T,"-37.82401776, 144.95604426"
512220250913,51,2025-09-13,22,41,33,74,Fra118_T,"-37.80841815, 144.95906316"
511420250403,51,2025-04-03,14,138,138,276,Fra118_T,"-37.80841815, 144.95906316"
511120250409,51,2025-04-09,11,48,50,98,Fra118_T,"-37.80841815, 144.95906316"
1301120240309,130,2024-03-09,11,28,30,58,Bou892T,"-37.8204637, 144.94126826"
1411920240730,141,2024-07-30,19,90,72,162,474Fl_T,"-37.81997273, 144.95834911"
1171720240415,117,2024-04-15,17,171,352,523,Fli114F_T,"-37.81629332, 144.97090877"
481220250319,48,2025-03-19,12,233,232,465,QVMQ_T,"-37.80631581, 144.95866697"
109420241221,109,2024-12-21,4,8,5,13,LatWill_T,"-37.81193681, 144.95621105"
191220250506,19,2025-05-06,12,459,409,868,LtB210_T,"-37.81237202, 144.96550671"
139720231211,139,2023-12-11,7,12,88,100,Signal1647_T,"-37.81959923, 144.9632832"
1362320250330,136,2025-03-30,23,2,1,3,BirFed1120_T,"-37.8184141, 144.97357915"
1421420240903,142,2024-09-03,14,371,204,575,Hammer1584_T,"-37.81970749, 144.96795734"
1421220240116,142,2024-01-16,12,606,481,1087,Hammer1584_T,"-37.81970749, 144.96795734"
32320250225,3,2025-02-25,23,270,168,438,Swa295_T,"-37.81101524, 144.96429485"
391020231103,39,2023-11-03,10,120,93,213,AlfPl_T,"-37.81379749, 144.96995745"
1092220241223,109,2024-12-23,22,53,58,111,LatWill_T,"-37.81193681, 144.95621105"
491320250316,49,2025-03-16,13,310,452,762,Eli501_T,"-37.80730068, 144.95956055"
19920231211,19,2023-12-11,9,89,78,167,LtB210_T,"-37.81237202, 144.96550671"
48320240604,48,2024-06-04,3,4,5,9,QVMQ_T,"-37.80631581, 144.95866697"
1412020241004,141,2024-10-04,20,156,160,316,474Fl_T,"-37.81997273, 144.95834911"
1421020240208,142,2024-02-08,10,247,189,436,Hammer1584_T,"-37.81970749, 144.96795734"
1301020250524,130,2025-05-24,10,90,63,153,Bou892T,"-37.8204637, 144.94126826"
1381720241227,138,2024-12-27,17,13,5,18,EntPark1671_T,"-37.81996544, 144.95981454"
1171520240602,117,2024-06-02,15,171,157,328,Fli114F_T,"-37.81629332, 144.97090877"
5220240902,5,2024-09-02,2,9,8,17,PriNW_T,"-37.81874249, 144.96787656"
131320240519,131,2024-05-19,3,68,99,167,King2_T,"-37.82009057, 144.95758725"
1321520240310,132,2024-03-10,15,122,106,228,King335_T,"-37.81267639, 144.95386444"
134720240611,134,2024-06-11,7,149,149,298,Spen201_T,"-37.81694221, 144.95303935"
134220240727,134,2024-07-27,2,46,37,83,Spen201_T,"-37.81694221, 144.95303935"
124920250312,124,2025-03-12,9,2,3,5,BirBridge_T,"-37.81757416, 144.97329934"
184520250918,184,2025-09-18,5,18,23,41,Eli124_T,"-37.81512416, 144.96371988"
184720250921,184,2025-09-21,7,77,85,162,Eli124_T,"-37.81512416, 144.96371988"
165920250920,165,2025-09-20,9,18,36,54,Spen475_T,"-37.80953359, 144.94939004"
1661420250103,166,2025-01-03,14,38,44,82,Spen484_T,"-37.80896733, 144.94931703"
167520250205,167,2025-02-05,5,0,4,4,Lat526_T,"-37.81304149, 144.95155955"
167320250611,167,2025-06-11,3,1,2,3,Lat526_T,"-37.81304149, 144.95155955"
1651520250411,165,2025-04-11,15,51,36,87,Spen475_T,"-37.80953359, 144.94939004"
11920240205,1,2024-02-05,19,531,342,873,Bou292_T,"-37.81349441, 144.96515323"
67020250106,67,2025-01-06,0,11,17,28,FLDegS_T,"-37.81688755, 144.96562569"
67120250515,67,2025-05-15,1,6,10,16,FLDegS_T,"-37.81688755, 144.96562569"
112120250528,11,2025-05-28,21,15,6,21,WatCit_T,"-37.81564989, 144.93970694"
122120250120,12,2025-01-20,21,366,299,665,NewQ_T,"-37.81457988, 144.94292398"
24220250126,24,2025-01-26,2,39,57,96,Col620_T,"-37.81887963, 144.95449198"
24620240701,24,2024-07-01,6,416,174,590,Col620_T,"-37.81887963, 144.95449198"
761720241127,76,2024-11-27,17,35,58,93,KenMac_T,"-37.79453803, 144.93036194"
761820250823,76,2025-08-23,18,68,43,111,KenMac_T,"-37.79453803, 144.93036194"
721820250714,72,2025-07-14,18,58,270,328,ACMI_T,"-37.81726338, 144.96872809"
35720241026,35,2024-10-26,7,235,241,476,SouthB_T,"-37.82018685, 144.96508508"
2520240416,2,2024-04-16,5,3,10,13,Bou283_T,"-37.81380668, 144.96516718"
27220240125,27,2024-01-25,2,8,2,10,Vic_T,"-37.80606888, 144.95644692"
532120250523,53,2025-05-23,21,118,207,325,Col254_T,"-37.81564191, 144.965499"
531020231031,53,2023-10-31,10,436,420,856,Col254_T,"-37.81564191, 144.965499"
791720231109,79,2023-11-09,17,709,583,1292,FliSS_T,"-37.81794046, 144.96616678"
79720240309,79,2024-03-09,7,94,67,161,FliSS_T,"-37.81794046, 144.96616678"
302220240216,30,2024-02-16,22,322,543,865,Lon189_T,"-37.8112185, 144.96656806"
25620240711,25,2024-07-11,6,57,82,139,MCEC_T,"-37.82401776, 144.95604426"
1092120250419,109,2025-04-19,21,88,95,183,LatWill_T,"-37.81193681, 144.95621105"
492020250329,49,2025-03-29,20,209,218,427,Eli501_T,"-37.80730068, 144.95956055"
252220250719,25,2025-07-19,22,228,322,550,MCEC_T,"-37.82401776, 144.95604426"
1372120231221,137,2023-12-21,21,5,11,16,BouHbr2353_T,"-37.81894815, 144.94612292"
141520240222,141,2024-02-22,5,13,11,24,474Fl_T,"-37.81997273, 144.95834911"
1411720240326,141,2024-03-26,17,168,169,337,474Fl_T,"-37.81997273, 144.95834911"
141020240703,141,2024-07-03,0,18,23,41,474Fl_T,"-37.81997273, 144.95834911"
1301420241217,130,2024-12-17,14,60,35,95,Bou892T,"-37.8204637, 144.94126826"
180220250716,180,2025-07-16,2,1,0,1,Mac330_T,"-37.79497059, 144.93530329"
161620240808,161,2024-08-08,6,7,2,9,BirArt1109_T,"-37.81851276, 144.97131336"
85420240808,85,2024-08-08,4,3,0,3,488Mac_T,"-37.79432415, 144.92973378"
842320240316,84,2024-03-16,23,643,662,1305,ElFi_T,"-37.81798049, 144.96503383"
66120240317,66,2024-03-17,1,228,200,428,QVN_T,"-37.81057846, 144.96444294"
32120240125,3,2024-01-25,21,971,833,1804,Swa295_T,"-37.81101524, 144.96429485"
32320240313,3,2024-03-13,23,328,254,582,Swa295_T,"-37.81101524, 144.96429485"
421520250816,42,2025-08-16,15,84,65,149,UM1_T,"-37.80008566, 144.96386412"
14920250928,14,2025-09-28,9,194,55,249,SanBri_T,"-37.82011242, 144.96291897"
142120240509,14,2024-05-09,21,173,75,248,SanBri_T,"-37.82011242, 144.96291897"
142220241201,14,2024-12-01,22,373,124,497,SanBri_T,"-37.82011242, 144.96291897"
711820240707,71,2024-07-07,18,5,3,8,WestWP_T,"-37.81235775, 144.97136962"
28620241121,28,2024-11-21,6,144,92,236,VAC_T,"-37.82129925, 144.96879309"
21120250410,21,2025-04-10,1,28,25,53,Bourke155_T,"-37.81267313, 144.96788288"
212020240207,21,2024-02-07,20,359,379,738,Bourke155_T,"-37.81267313, 144.96788288"
472220251012,47,2025-10-12,22,261,182,443,Eli250_T,"-37.81258467, 144.9625775"
431920240409,43,2024-04-09,19,66,198,264,UM2_T,"-37.79844526, 144.96411782"
43920240511,43,2024-05-11,9,42,48,90,UM2_T,"-37.79844526, 144.96411782"
1311320240709,131,2024-07-09,13,153,76,229,King2_T,"-37.82009057, 144.95758725"
143920250205,143,2025-02-05,9,79,166,245,Spencer_T,"-37.821728, 144.95557015"
133420240203,133,2024-02-03,4,16,32,48,Spen229_T,"-37.81531435, 144.95227769"
118620250627,118,2025-06-27,6,1,0,1,Fli114C_T,"-37.81632783, 144.97090512"
1792020250427,179,2025-04-27,20,44,57,101,Pow61_T,"-37.82392385, 144.96299677"
1791420250603,179,2025-06-03,14,42,40,82,Pow61_T,"-37.82392385, 144.96299677"
167020251003,167,2025-10-03,0,1,2,3,Lat526_T,"-37.81304149, 144.95155955"
182120240916,18,2024-09-16,21,3,3,6,Col12_T,"-37.81344862, 144.97305353"
18520241113,18,2024-11-13,5,0,9,9,Col12_T,"-37.81344862, 144.97305353"
561320241229,56,2024-12-29,13,390,336,726,Lon364_T,"-37.81234775, 144.96153311"
862320250320,86,2025-03-20,23,2,13,15,574Qub_T,"-37.80309992, 144.94908064"
63520250124,63,2025-01-24,5,0,1,1,Bou231_T,"-37.81333081, 144.96675571"
102320231231,10,2023-12-31,23,339,923,1262,BouHbr_T,"-37.81876474, 144.94710545"
761220231216,76,2023-12-16,12,90,70,160,KenMac_T,"-37.79453803, 144.93036194"
21920240602,2,2024-06-02,19,106,139,245,Bou283_T,"-37.81380668, 144.96516718"
21720240701,2,2024-07-01,17,465,410,875,Bou283_T,"-37.81380668, 144.96516718"
351020250424,35,2025-04-24,10,799,715,1514,SouthB_T,"-37.82018685, 144.96508508"
9220231215,9,2023-12-15,2,4,3,7,Col700_T,"-37.81982992, 144.95102555"
531120231216,53,2023-12-16,11,845,704,1549,Col254_T,"-37.81564191, 144.965499"
271420250209,27,2025-02-09,14,348,200,548,Vic_T,"-37.80606888, 144.95644692"
301520240621,30,2024-06-21,15,242,333,575,Lon189_T,"-37.8112185, 144.96656806"
79320240606,79,2024-06-06,3,8,10,18,FliSS_T,"-37.81794046, 144.96616678"
79020240612,79,2024-06-12,0,23,40,63,FliSS_T,"-37.81794046, 144.96616678"
20720250817,20,2025-08-17,7,21,12,33,LtB170_T,"-37.81172914, 144.9682466"
201720240828,20,2024-08-28,17,253,206,459,LtB170_T,"-37.81172914, 144.9682466"
41220251008,41,2025-10-08,2,45,39,84,Swa31,"-37.81668634, 144.96689733"
42120241125,42,2024-11-25,1,1,6,7,UM1_T,"-37.80008566, 144.96386412"
65520240608,65,2024-06-08,5,5,7,12,SwaCs_T,"-37.81569416, 144.9668064"
65420240217,65,2024-02-17,4,8,30,38,SwaCs_T,"-37.81569416, 144.9668064"
40820250505,40,2025-05-05,8,176,310,486,Spr201_T,"-37.80999341, 144.97227587"
311420250102,31,2025-01-02,14,205,231,436,Lyg161_T,"-37.80169681, 144.96658911"
311120250721,31,2025-07-21,11,96,95,191,Lyg161_T,"-37.80169681, 144.96658911"
47420250603,47,2025-06-03,4,8,20,28,Eli250_T,"-37.81258467, 144.9625775"
471220250725,47,2025-07-25,12,954,1077,2031,Eli250_T,"-37.81258467, 144.9625775"
43820240416,43,2024-04-16,8,234,100,334,UM2_T,"-37.79844526, 144.96411782"
107420250903,107,2025-09-03,4,3,11,14,280Will_T,"-37.81246271, 144.95690188"
107620250203,107,2025-02-03,6,16,23,39,280Will_T,"-37.81246271, 144.95690188"
1341320231119,134,2023-11-19,13,279,311,590,Spen201_T,"-37.81694221, 144.95303935"
1351220231212,135,2023-12-12,12,540,559,1099,Spen161_T,"-37.8172861, 144.95319102"
108920231229,108,2023-12-29,9,99,175,274,261Will_T,"-37.81295822, 144.95678789"
108520250818,108,2025-08-18,5,16,76,92,261Will_T,"-37.81295822, 144.95678789"
1081020231112,108,2023-11-12,10,111,86,197,261Will_T,"-37.81295822, 144.95678789"
871720241008,87,2024-10-08,17,118,111,229,Errol23_T,"-37.80454949, 144.94921863"
87720250529,87,2025-05-29,7,28,23,51,Errol23_T,"-37.80454949, 144.94921863"
611120240716,61,2024-07-16,11,358,571,929,RMIT14_T,"-37.80767455, 144.96309114"
441620240910,44,2024-09-10,16,110,70,180,UM3_T,"-37.79698741, 144.96441306"
1811620250816,181,2025-08-16,16,896,1084,1980,Eli368_T,"-37.81009465, 144.96143149"
1821220250613,182,2025-06-13,12,311,257,568,King163_T,"-37.81627451, 144.95550503"
1662320250820,166,2025-08-20,23,3,1,4,Spen484_T,"-37.80896733, 144.94931703"
165720241111,165,2024-11-11,7,10,42,52,Spen475_T,"-37.80953359, 144.94939004"
1312120240607,131,2024-06-07,21,92,89,181,King2_T,"-37.82009057, 144.95758725"
140520240530,140,2024-05-30,5,3,2,5,Boyd2837_T,"-37.82590962, 144.96185972"
134720250911,134,2025-09-11,7,163,174,337,Spen201_T,"-37.81694221, 144.95303935"
135720250506,135,2025-05-06,7,220,267,487,Spen161_T,"-37.8172861, 144.95319102"
1351620250625,135,2025-06-25,16,323,319,642,Spen161_T,"-37.8172861, 144.95319102"
681920240317,68,2024-03-17,19,114,59,173,FLDegN_T,"-37.8168479, 144.96559789"
85620240708,85,2024-07-08,6,17,10,27,488Mac_T,"-37.79432415, 144.92973378"
63520241004,63,2024-10-04,5,0,22,22,Bou231_T,"-37.81333081, 144.96675571"
18920231118,18,2023-11-18,9,36,44,80,Col12_T,"-37.81344862, 144.97305353"
182020250409,18,2025-04-09,20,36,35,71,Col12_T,"-37.81344862, 144.97305353"
631020250617,63,2025-06-17,10,152,218,370,Bou231_T,"-37.81333081, 144.96675571"
86820240729,86,2024-07-29,8,31,18,49,574Qub_T,"-37.80309992, 144.94908064"
101520240421,10,2024-04-21,15,94,27,121,BouHbr_T,"-37.81876474, 144.94710545"
35120240731,35,2024-07-31,1,11,22,33,SouthB_T,"-37.82018685, 144.96508508"
351320231231,35,2023-12-31,13,1589,1920,3509,SouthB_T,"-37.82018685, 144.96508508"
58820250407,58,2025-04-07,8,1516,180,1696,Bou688_T,"-37.81686075, 144.95358075"
27820241105,27,2024-11-05,8,41,48,89,Vic_T,"-37.80606888, 144.95644692"
58320250904,58,2025-09-04,3,11,10,21,Bou688_T,"-37.81686075, 144.95358075"
53220240711,53,2024-07-11,2,4,2,6,Col254_T,"-37.81564191, 144.965499"
23820240312,23,2024-03-12,8,466,465,931,Col623_T,"-37.81909256, 144.95452748"
79720241127,79,2024-11-27,7,243,146,389,FliSS_T,"-37.81794046, 144.96616678"
202320240721,20,2024-07-21,23,70,55,125,LtB170_T,"-37.81172914, 144.9682466"
252320250326,25,2025-03-26,23,64,54,118,MCEC_T,"-37.82401776, 144.95604426"
51920241011,51,2024-10-11,9,49,63,112,Fra118_T,"-37.80841815, 144.95906316"
51320240928,51,2024-09-28,3,12,6,18,Fra118_T,"-37.80841815, 144.95906316"
51420231213,51,2023-12-13,4,5,2,7,Fra118_T,"-37.80841815, 144.95906316"
232220250513,23,2025-05-13,22,39,118,157,Col623_T,"-37.81909256, 144.95452748"
232320241101,23,2024-11-01,23,36,70,106,Col623_T,"-37.81909256, 144.95452748"
231220241111,23,2024-11-11,12,412,523,935,Col623_T,"-37.81909256, 144.95452748"
491620231120,49,2023-11-20,16,156,149,305,Eli501_T,"-37.80730068, 144.95956055"
1371720250417,137,2025-04-17,17,11,82,93,BouHbr2353_T,"-37.81894815, 144.94612292"
141620231219,141,2023-12-19,6,19,12,31,474Fl_T,"-37.81997273, 144.95834911"
1411020240615,141,2024-06-15,10,111,90,201,474Fl_T,"-37.81997273, 144.95834911"
142520240619,142,2024-06-19,5,5,1,6,Hammer1584_T,"-37.81970749, 144.96795734"
1611820240609,161,2024-06-09,18,330,1,331,BirArt1109_T,"-37.81851276, 144.97131336"
117320240127,117,2024-01-27,3,2,9,11,Fli114F_T,"-37.81629332, 144.97090877"
117920250119,117,2025-01-19,9,129,149,278,Fli114F_T,"-37.81629332, 144.97090877"
691520240221,69,2024-02-21,15,199,152,351,FLDegC_T,"-37.81687226, 144.96559144"
691420250821,69,2025-08-21,14,273,239,512,FLDegC_T,"-37.81687226, 144.96559144"
6320240804,6,2024-08-04,3,51,48,99,FliS_T,"-37.81911705, 144.96558255"
6320240821,6,2024-08-21,3,17,7,24,FliS_T,"-37.81911705, 144.96558255"
701020240906,70,2024-09-06,10,94,109,203,Errol20_T,"-37.80456984, 144.94946228"
31720240224,3,2024-02-24,17,1565,1959,3524,Swa295_T,"-37.81101524, 144.96429485"
391420250327,39,2025-03-27,14,90,117,207,AlfPl_T,"-37.81379749, 144.96995745"
411720240315,41,2024-03-15,17,2074,2157,4231,Swa31,"-37.81668634, 144.96689733"
8220240421,8,2024-04-21,2,1,1,2,WebBN_T,"-37.82293543, 144.9471751"
291720250125,29,2025-01-25,17,639,636,1275,AG_T,"-37.8199817, 144.96872865"
71920250419,71,2025-04-19,9,4,4,8,WestWP_T,"-37.81235775, 144.97136962"
541120240207,54,2024-02-07,11,161,145,306,Swa607_T,"-37.804024, 144.96308399"
471220240202,47,2024-02-02,12,744,816,1560,Eli250_T,"-37.81258467, 144.9625775"
311220240624,31,2024-06-24,12,130,113,243,Lyg161_T,"-37.80169681, 144.96658911"
47920250920,47,2025-09-20,9,264,332,596,Eli250_T,"-37.81258467, 144.9625775"
451420240909,45,2024-09-09,14,574,674,1248,Swa148_T,"-37.81414075, 144.96609379"
451020241012,45,2024-10-12,10,467,322,789,Swa148_T,"-37.81414075, 144.96609379"
5220231019,5,2023-10-19,2,16,7,23,PriNW_T,"-37.81874249, 144.96787656"
212320250715,21,2025-07-15,23,53,95,148,Bourke155_T,"-37.81267313, 144.96788288"
131620240314,131,2024-03-14,6,15,20,35,King2_T,"-37.82009057, 144.95758725"
1321920250325,132,2025-03-25,19,166,181,347,King335_T,"-37.81267639, 144.95386444"
1351420241219,135,2024-12-19,14,502,469,971,Spen161_T,"-37.8172861, 144.95319102"
1352120250523,135,2025-05-23,21,165,200,365,Spen161_T,"-37.8172861, 144.95319102"
1352320250710,135,2025-07-10,23,40,106,146,Spen161_T,"-37.8172861, 144.95319102"
1351920240306,135,2024-03-06,19,314,268,582,Spen161_T,"-37.8172861, 144.95319102"
1181620241017,118,2024-10-17,16,22,30,52,Fli114C_T,"-37.81632783, 144.97090512"
1181320251005,118,2025-10-05,13,20,64,84,Fli114C_T,"-37.81632783, 144.97090512"
1182220240403,118,2024-04-03,22,5,5,10,Fli114C_T,"-37.81632783, 144.97090512"
1081820240301,108,2024-03-01,18,466,224,690,261Will_T,"-37.81295822, 144.95678789"
108120240507,108,2024-05-07,1,3,6,9,261Will_T,"-37.81295822, 144.95678789"
871220250212,87,2025-02-12,12,136,124,260,Errol23_T,"-37.80454949, 144.94921863"
1671020251002,167,2025-10-02,10,40,82,122,Lat526_T,"-37.81304149, 144.95155955"
671520250922,67,2025-09-22,15,328,518,846,FLDegS_T,"-37.81688755, 144.96562569"
171820240319,17,2024-03-19,18,199,341,540,Col15_T,"-37.81362543, 144.97323591"
171820240401,17,2024-04-01,18,61,82,143,Col15_T,"-37.81362543, 144.97323591"
17420240813,17,2024-08-13,4,5,3,8,Col15_T,"-37.81362543, 144.97323591"
172320250307,17,2025-03-07,23,66,63,129,Col15_T,"-37.81362543, 144.97323591"
67820240327,67,2024-03-27,8,325,276,601,FLDegS_T,"-37.81688755, 144.96562569"
181820231125,18,2023-11-25,18,71,54,125,Col12_T,"-37.81344862, 144.97305353"
1231220250505,123,2025-05-05,12,53,55,108,BirBridge_T,"-37.81753741, 144.97329734"
130920250123,130,2025-01-23,9,49,35,84,Bou892T,"-37.8204637, 144.94126826"
1612120240902,161,2024-09-02,21,1,61,62,BirArt1109_T,"-37.81851276, 144.97131336"
138820250314,138,2025-03-14,8,4,0,4,EntPark1671_T,"-37.81996544, 144.95981454"
117420251012,117,2025-10-12,4,34,15,49,Fli114F_T,"-37.81629332, 144.97090877"
117920240821,117,2024-08-21,9,210,131,341,Fli114F_T,"-37.81629332, 144.97090877"
48920240131,48,2024-01-31,9,103,72,175,QVMQ_T,"-37.80631581, 144.95866697"
1801620250403,180,2025-04-03,16,58,51,109,Mac330_T,"-37.79497059, 144.93530329"
1362120240731,136,2024-07-31,21,1,0,1,BirFed1120_T,"-37.8184141, 144.97357915"
142820250718,142,2025-07-18,8,182,255,437,Hammer1584_T,"-37.81970749, 144.96795734"
61720240619,6,2024-06-19,17,2308,995,3303,FliS_T,"-37.81911705, 144.96558255"
32020231020,3,2023-10-20,20,1507,1368,2875,Swa295_T,"-37.81101524, 144.96429485"
70220240408,70,2024-04-08,2,2,1,3,Errol20_T,"-37.80456984, 144.94946228"
3220240601,3,2024-06-01,2,167,154,321,Swa295_T,"-37.81101524, 144.96429485"
81120250417,8,2025-04-17,11,122,196,318,WebBN_T,"-37.82293543, 144.9471751"
41520240711,41,2024-07-11,5,45,40,85,Swa31,"-37.81668634, 144.96689733"
421020240701,42,2024-07-01,10,91,83,174,UM1_T,"-37.80008566, 144.96386412"
78220241203,78,2024-12-03,2,0,5,5,HarEsB_T,"-37.81471642, 144.9446508"
142120250226,14,2025-02-26,21,248,111,359,SanBri_T,"-37.82011242, 144.96291897"
71420250418,71,2025-04-18,4,1,1,2,WestWP_T,"-37.81235775, 144.97136962"
472020231217,47,2023-12-17,20,553,544,1097,Eli250_T,"-37.81258467, 144.9625775"
31120241007,31,2024-10-07,1,13,13,26,Lyg161_T,"-37.80169681, 144.96658911"
311920250330,31,2025-03-30,19,315,248,563,Lyg161_T,"-37.80169681, 144.96658911"
441520240302,44,2024-03-02,15,12,23,35,UM3_T,"-37.79698741, 144.96441306"
432020250512,43,2025-05-12,20,38,121,159,UM2_T,"-37.79844526, 144.96411782"
45320250320,45,2025-03-20,3,3,17,20,Swa148_T,"-37.81414075, 144.96609379"
451020240427,45,2024-04-27,10,308,345,653,Swa148_T,"-37.81414075, 144.96609379"
51020250101,5,2025-01-01,10,414,657,1071,PriNW_T,"-37.81874249, 144.96787656"
1071520231112,107,2023-11-12,15,106,122,228,280Will_T,"-37.81246271, 144.95690188"
1071820240121,107,2024-01-21,18,62,101,163,280Will_T,"-37.81246271, 144.95690188"
124820250215,124,2025-02-15,8,1,2,3,BirBridge_T,"-37.81757416, 144.97329934"
1181720240620,118,2024-06-20,17,15,36,51,Fli114C_T,"-37.81632783, 144.97090512"
108120241005,108,2024-10-05,1,29,16,45,261Will_T,"-37.81295822, 144.95678789"
611420250927,61,2025-09-27,14,288,464,752,RMIT14_T,"-37.80767455, 144.96309114"
612120240809,61,2024-08-09,21,257,139,396,RMIT14_T,"-37.80767455, 144.96309114"
442020250104,44,2025-01-04,20,8,7,15,UM3_T,"-37.79698741, 144.96441306"
166420250122,166,2025-01-22,4,1,1,2,Spen484_T,"-37.80896733, 144.94931703"
1791420250508,179,2025-05-08,14,47,51,98,Pow61_T,"-37.82392385, 144.96299677"
1791720250720,179,2025-07-20,17,42,49,91,Pow61_T,"-37.82392385, 144.96299677"
167320250512,167,2025-05-12,3,2,5,7,Lat526_T,"-37.81304149, 144.95155955"
1311820231219,131,2023-12-19,18,78,80,158,King2_T,"-37.82009057, 144.95758725"
131020240828,131,2024-08-28,0,8,6,14,King2_T,"-37.82009057, 144.95758725"
143820240427,143,2024-04-27,8,112,155,267,Spencer_T,"-37.821728, 144.95557015"
1342220240801,134,2024-08-01,22,149,148,297,Spen201_T,"-37.81694221, 144.95303935"
181720240123,18,2024-01-23,17,991,76,1067,Col12_T,"-37.81344862, 144.97305353"
62820240913,62,2024-09-13,8,71,113,184,Lat224_T,"-37.80996494, 144.96216521"
102020231207,10,2023-12-07,20,55,34,89,BouHbr_T,"-37.81876474, 144.94710545"
10920240206,10,2024-02-06,9,65,145,210,BouHbr_T,"-37.81876474, 144.94710545"
242320240527,24,2024-05-27,23,92,117,209,Col620_T,"-37.81887963, 144.95449198"
72620241123,72,2024-11-23,6,18,28,46,ACMI_T,"-37.81726338, 144.96872809"
72220240528,72,2024-05-28,2,2,3,5,ACMI_T,"-37.81726338, 144.96872809"
21720250503,2,2025-05-03,17,538,483,1021,Bou283_T,"-37.81380668, 144.96516718"
532320250209,53,2025-02-09,23,7,58,65,Col254_T,"-37.81564191, 144.965499"
562120240521,56,2024-05-21,21,163,180,343,Lon364_T,"-37.81234775, 144.96153311"
862120240911,86,2024-09-11,21,1,17,18,574Qub_T,"-37.80309992, 144.94908064"
861220250603,86,2025-06-03,12,47,58,105,574Qub_T,"-37.80309992, 144.94908064"
10220250824,10,2025-08-24,2,3,3,6,BouHbr_T,"-37.81876474, 144.94710545"
721420250604,72,2025-06-04,14,238,313,551,ACMI_T,"-37.81726338, 144.96872809"
35820240315,35,2024-03-15,8,644,1422,2066,SouthB_T,"-37.82018685, 144.96508508"
531320250107,53,2025-01-07,13,977,710,1687,Col254_T,"-37.81564191, 144.965499"
531020250327,53,2025-03-27,10,488,358,846,Col254_T,"-37.81564191, 144.965499"
531820240315,53,2024-03-15,18,717,411,1128,Col254_T,"-37.81564191, 144.965499"
30220240711,30,2024-07-11,2,40,29,69,Lon189_T,"-37.8112185, 144.96656806"
791620240415,79,2024-04-15,16,513,450,963,FliSS_T,"-37.81794046, 144.96616678"
30620240222,30,2024-02-22,6,10,24,34,Lon189_T,"-37.8112185, 144.96656806"
461820250502,46,2025-05-02,18,27,30,57,Pel147_T,"-37.80240719, 144.9615673"
231920240829,23,2024-08-29,19,131,249,380,Col623_T,"-37.81909256, 144.95452748"
1091420240118,109,2024-01-18,14,147,128,275,LatWill_T,"-37.81193681, 144.95621105"
109020241106,109,2024-11-06,0,15,18,33,LatWill_T,"-37.81193681, 144.95621105"
491820240413,49,2024-04-13,18,209,220,429,Eli501_T,"-37.80730068, 144.95956055"
482320240507,48,2024-05-07,23,20,57,77,QVMQ_T,"-37.80631581, 144.95866697"
1362320240415,136,2024-04-15,23,2,1,3,BirFed1120_T,"-37.8184141, 144.97357915"
1361220250604,136,2025-06-04,12,152,91,243,BirFed1120_T,"-37.8184141, 144.97357915"
1301220240322,130,2024-03-22,12,33,39,72,Bou892T,"-37.8204637, 144.94126826"
1612020250927,161,2025-09-27,20,6,129,135,BirArt1109_T,"-37.81851276, 144.97131336"
1382020240206,138,2024-02-06,20,3,3,6,EntPark1671_T,"-37.81996544, 144.95981454"
1171520240129,117,2024-01-29,15,115,140,255,Fli114F_T,"-37.81629332, 144.97090877"
1171820240408,117,2024-04-08,18,107,132,239,Fli114F_T,"-37.81629332, 144.97090877"
1171620250627,117,2025-06-27,16,143,269,412,Fli114F_T,"-37.81629332, 144.97090877"
69120240901,69,2024-09-01,1,5,5,10,FLDegC_T,"-37.81687226, 144.96559144"
61520250413,6,2025-04-13,15,1069,921,1990,FliS_T,"-37.81911705, 144.96558255"
662220240707,66,2024-07-07,22,385,224,609,QVN_T,"-37.81057846, 144.96444294"
4720240221,4,2024-02-21,7,293,199,492,Swa123_T,"-37.81487988, 144.9660878"
701120231108,70,2023-11-08,11,143,142,285,Errol20_T,"-37.80456984, 144.94946228"
702220250912,70,2025-09-12,22,143,74,217,Errol20_T,"-37.80456984, 144.94946228"
31920250414,3,2025-04-14,19,796,798,1594,Swa295_T,"-37.81101524, 144.96429485"
82020251011,8,2025-10-11,20,24,35,59,WebBN_T,"-37.82293543, 144.9471751"
421720250326,42,2025-03-26,17,274,642,916,UM1_T,"-37.80008566, 144.96386412"
14020240924,14,2024-09-24,0,52,20,72,SanBri_T,"-37.82011242, 144.96291897"
711320250204,71,2025-02-04,13,8,5,13,WestWP_T,"-37.81235775, 144.97136962"
282220241029,28,2024-10-29,22,96,1234,1330,VAC_T,"-37.82129925, 144.96879309"
29720251015,29,2025-10-15,7,200,117,317,AG_T,"-37.8199817, 144.96872865"
471820241225,47,2024-12-25,18,474,487,961,Eli250_T,"-37.81258467, 144.9625775"
311020250510,31,2025-05-10,10,132,93,225,Lyg161_T,"-37.80169681, 144.96658911"
31120250723,31,2025-07-23,1,9,1,10,Lyg161_T,"-37.80169681, 144.96658911"
441420250119,44,2025-01-19,14,18,26,44,UM3_T,"-37.79698741, 144.96441306"
5320250427,5,2025-04-27,3,37,66,103,PriNW_T,"-37.81874249, 144.96787656"
1622020250522,162,2025-05-22,20,239,262,501,Eli489_T,"-37.80740397, 144.95987909"
132220250825,132,2025-08-25,2,7,2,9,King335_T,"-37.81267639, 144.95386444"
134020240512,134,2024-05-12,0,73,63,136,Spen201_T,"-37.81694221, 144.95303935"
53520240423,53,2024-04-23,5,10,8,18,Col254_T,"-37.81564191, 144.965499"
52520240829,52,2024-08-29,5,5,6,11,Eli263_T,"-37.81252157, 144.9619401"
1301520250906,130,2025-09-06,15,38,69,107,Bou892T,"-37.8204637, 144.94126826"
1611620250309,161,2025-03-09,16,1358,953,2311,BirArt1109_T,"-37.81851276, 144.97131336"
1381020241001,138,2024-10-01,10,4,3,7,EntPark1671_T,"-37.81996544, 144.95981454"
1381320250124,138,2025-01-24,13,19,19,38,EntPark1671_T,"-37.81996544, 144.95981454"
1391020240526,139,2024-05-26,10,30,18,48,Signal1647_T,"-37.81959923, 144.9632832"
1422020240503,142,2024-05-03,20,256,153,409,Hammer1584_T,"-37.81970749, 144.96795734"
31820240721,3,2024-07-21,18,872,1263,2135,Swa295_T,"-37.81101524, 144.96429485"
391020240502,39,2024-05-02,10,108,117,225,AlfPl_T,"-37.81379749, 144.96995745"
391920240504,39,2024-05-04,19,84,46,130,AlfPl_T,"-37.81379749, 144.96995745"
752320250920,75,2025-09-20,23,9,10,19,SprFli_T,"-37.81515276, 144.97467661"
771420240618,77,2024-06-18,14,87,74,161,HarEsP_T,"-37.81441438, 144.94433026"
781220241119,78,2024-11-19,12,53,61,114,HarEsB_T,"-37.81471642, 144.9446508"
78120250330,78,2025-03-30,1,5,8,13,HarEsB_T,"-37.81471642, 144.9446508"
781720250629,78,2025-06-29,17,11,11,22,HarEsB_T,"-37.81471642, 144.9446508"
781620250926,78,2025-09-26,16,60,64,124,HarEsB_T,"-37.81471642, 144.9446508"
591920250618,59,2025-06-18,19,477,450,927,RMIT_T,"-37.80825648, 144.96304859"
71920240101,71,2024-01-01,9,18,6,24,WestWP_T,"-37.81235775, 144.97136962"
651520240529,65,2024-05-29,15,383,635,1018,SwaCs_T,"-37.81569416, 144.9668064"
542320240406,54,2024-04-06,23,90,80,170,Swa607_T,"-37.804024, 144.96308399"
471020231218,47,2023-12-18,10,527,644,1171,Eli250_T,"-37.81258467, 144.9625775"
5020240718,5,2024-07-18,0,12,12,24,PriNW_T,"-37.81874249, 144.96787656"
1331620250908,133,2025-09-08,16,489,567,1056,Spen229_T,"-37.81531435, 144.95227769"
1321120250408,132,2025-04-08,11,170,120,290,King335_T,"-37.81267639, 144.95386444"
132520250828,132,2025-08-28,5,5,3,8,King335_T,"-37.81267639, 144.95386444"
1181920231028,118,2023-10-28,19,26,30,56,Fli114C_T,"-37.81632783, 144.97090512"
1181920240911,118,2024-09-11,19,6,7,13,Fli114C_T,"-37.81632783, 144.97090512"
118020250113,118,2025-01-13,0,12,9,21,Fli114C_T,"-37.81632783, 144.97090512"
872220240903,87,2024-09-03,22,17,14,31,Errol23_T,"-37.80454949, 144.94921863"
871020240630,87,2024-06-30,10,71,75,146,Errol23_T,"-37.80454949, 144.94921863"
1792220250615,179,2025-06-15,22,29,42,71,Pow61_T,"-37.82392385, 144.96299677"
1651120251002,165,2025-10-02,11,32,38,70,Spen475_T,"-37.80953359, 144.94939004"
1401020250210,140,2025-02-10,10,92,35,127,Boyd2837_T,"-37.82590962, 144.96185972"
162820241007,162,2024-10-07,8,221,152,373,Eli489_T,"-37.80740397, 144.95987909"
135520240809,135,2024-08-09,5,15,11,26,Spen161_T,"-37.8172861, 144.95319102"
135620241025,135,2024-10-25,6,46,78,124,Spen161_T,"-37.8172861, 144.95319102"
691120250715,69,2025-07-15,11,255,155,410,FLDegC_T,"-37.81687226, 144.96559144"
61820240906,6,2024-09-06,18,1109,1044,2153,FliS_T,"-37.81911705, 144.96558255"
681720240706,68,2024-07-06,17,104,31,135,FLDegN_T,"-37.8168479, 144.96559789"
682020241106,68,2024-11-06,20,76,31,107,FLDegN_T,"-37.8168479, 144.96559789"
851320231215,85,2023-12-15,13,129,138,267,488Mac_T,"-37.79432415, 144.92973378"
171520250826,17,2025-08-26,15,272,323,595,Col15_T,"-37.81362543, 144.97323591"
1520240917,1,2024-09-17,5,10,15,25,Bou292_T,"-37.81349441, 144.96515323"
63720231223,63,2023-12-23,7,37,57,94,Bou231_T,"-37.81333081, 144.96675571"
631620240129,63,2024-01-29,16,290,351,641,Bou231_T,"-37.81333081, 144.96675571"
12020231021,12,2023-10-21,0,69,54,123,NewQ_T,"-37.81457988, 144.94292398"
56020240824,56,2024-08-24,0,129,172,301,Lon364_T,"-37.81234775, 144.96153311"
1351620250112,135,2025-01-12,16,361,362,723,Spen161_T,"-37.8172861, 144.95319102"
1331820250327,133,2025-03-27,18,712,581,1293,Spen229_T,"-37.81531435, 144.95227769"
107220240518,107,2024-05-18,2,16,2,18,280Will_T,"-37.81246271, 144.95690188"
1071820241023,107,2024-10-23,18,214,184,398,280Will_T,"-37.81246271, 144.95690188"
1182020250321,118,2025-03-21,20,13,16,29,Fli114C_T,"-37.81632783, 144.97090512"
108020240108,108,2024-01-08,0,33,24,57,261Will_T,"-37.81295822, 144.95678789"
872020250319,87,2025-03-19,20,109,131,240,Errol23_T,"-37.80454949, 144.94921863"
85020241205,85,2024-12-05,0,2,5,7,488Mac_T,"-37.79432415, 144.92973378"
171120250624,17,2025-06-24,11,329,238,567,Col15_T,"-37.81362543, 144.97323591"
11220240818,1,2024-08-18,12,1249,1051,2300,Bou292_T,"-37.81349441, 144.96515323"
68120250124,68,2025-01-24,1,2,0,2,FLDegN_T,"-37.8168479, 144.96559789"
181420250210,18,2025-02-10,14,204,151,355,Col12_T,"-37.81344862, 144.97305353"
1920250803,1,2025-08-03,9,217,355,572,Bou292_T,"-37.81349441, 144.96515323"
86420250107,86,2025-01-07,4,0,2,2,574Qub_T,"-37.80309992, 144.94908064"
12920250110,12,2025-01-10,9,149,115,264,NewQ_T,"-37.81457988, 144.94292398"
10220241204,10,2024-12-04,2,1,1,2,BouHbr_T,"-37.81876474, 144.94710545"
76620250706,76,2025-07-06,6,3,1,4,KenMac_T,"-37.79453803, 144.93036194"
22120250420,2,2025-04-20,21,108,191,299,Bou283_T,"-37.81380668, 144.96516718"
35720231225,35,2023-12-25,7,100,80,180,SouthB_T,"-37.82018685, 144.96508508"
58320231123,58,2023-11-23,3,5,3,8,Bou688_T,"-37.81686075, 144.95358075"
582120231225,58,2023-12-25,21,242,128,370,Bou688_T,"-37.81686075, 144.95358075"
91420250521,9,2025-05-21,14,496,252,748,Col700_T,"-37.81982992, 144.95102555"
271320250219,27,2025-02-19,13,134,73,207,Vic_T,"-37.80606888, 144.95644692"
30420250124,30,2025-01-24,4,18,28,46,Lon189_T,"-37.8112185, 144.96656806"
30420240908,30,2024-09-08,4,52,124,176,Lon189_T,"-37.8112185, 144.96656806"
251420241017,25,2024-10-17,14,554,450,1004,MCEC_T,"-37.82401776, 144.95604426"
201420250306,20,2025-03-06,14,169,189,358,LtB170_T,"-37.81172914, 144.9682466"
20620250723,20,2025-07-23,6,11,17,28,LtB170_T,"-37.81172914, 144.9682466"
461120250507,46,2025-05-07,11,89,71,160,Pel147_T,"-37.80240719, 144.9615673"
109020231219,109,2023-12-19,0,11,26,37,LatWill_T,"-37.81193681, 144.95621105"
109320231230,109,2023-12-30,3,4,7,11,LatWill_T,"-37.81193681, 144.95621105"
252320250824,25,2025-08-24,23,42,53,95,MCEC_T,"-37.82401776, 144.95604426"
19720231208,19,2023-12-08,7,26,12,38,LtB210_T,"-37.81237202, 144.96550671"
48720240219,48,2024-02-19,7,67,30,97,QVMQ_T,"-37.80631581, 144.95866697"
180620250701,180,2025-07-01,6,4,16,20,Mac330_T,"-37.79497059, 144.93530329"
180620250718,180,2025-07-18,6,0,5,5,Mac330_T,"-37.79497059, 144.93530329"
137820231129,137,2023-11-29,8,71,13,84,BouHbr2353_T,"-37.81894815, 144.94612292"
1372020240630,137,2024-06-30,20,16,38,54,BouHbr2353_T,"-37.81894815, 144.94612292"
1391720240821,139,2024-08-21,17,237,57,294,Signal1647_T,"-37.81959923, 144.9632832"
1421220250112,142,2025-01-12,12,140,130,270,Hammer1584_T,"-37.81970749, 144.96795734"
1231720240423,123,2024-04-23,17,35,22,57,BirBridge_T,"-37.81753741, 144.97329734"
161720250705,161,2025-07-05,7,54,42,96,BirArt1109_T,"-37.81851276, 144.97131336"
164120250409,164,2025-04-09,1,1,4,5,Lat526_T,"-37.813005, 144.95160411"
138720250804,138,2025-08-04,7,3,3,6,EntPark1671_T,"-37.81996544, 144.95981454"
1172020241206,117,2024-12-06,20,180,130,310,Fli114F_T,"-37.81629332, 144.97090877"
84420250903,84,2025-09-03,4,4,14,18,ElFi_T,"-37.81798049, 144.96503383"
4920240715,4,2024-07-15,9,449,312,761,Swa123_T,"-37.81487988, 144.9660878"
701920241030,70,2024-10-30,19,162,287,449,Errol20_T,"-37.80456984, 144.94946228"
702220250826,70,2025-08-26,22,27,37,64,Errol20_T,"-37.80456984, 144.94946228"
75020250301,75,2025-03-01,0,0,9,9,SprFli_T,"-37.81515276, 144.97467661"
391020250219,39,2025-02-19,10,97,87,184,AlfPl_T,"-37.81379749, 144.96995745"
392320251016,39,2025-10-16,23,6,3,9,AlfPl_T,"-37.81379749, 144.96995745"
75420231024,75,2023-10-24,4,1,3,4,SprFli_T,"-37.81515276, 144.97467661"
75920231107,75,2023-11-07,9,24,15,39,SprFli_T,"-37.81515276, 144.97467661"
412120240804,41,2024-08-04,21,62,52,114,Swa31,"-37.81668634, 144.96689733"
711920240624,71,2024-06-24,19,2,6,8,WestWP_T,"-37.81235775, 144.97136962"
71720250330,71,2025-03-30,7,0,1,1,WestWP_T,"-37.81235775, 144.97136962"
711620250519,71,2025-05-19,16,19,14,33,WestWP_T,"-37.81235775, 144.97136962"
59520250913,59,2025-09-13,5,18,13,31,RMIT_T,"-37.80825648, 144.96304859"
28420250522,28,2025-05-22,4,3,29,32,VAC_T,"-37.82129925, 144.96879309"
61120240722,61,2024-07-22,1,45,14,59,RMIT14_T,"-37.80767455, 144.96309114"
5720240302,5,2024-03-02,7,88,110,198,PriNW_T,"-37.81874249, 144.96787656"
1431420250215,143,2025-02-15,14,194,203,397,Spencer_T,"-37.821728, 144.95557015"
1322320241220,132,2024-12-20,23,87,89,176,King335_T,"-37.81267639, 144.95386444"
132820250830,132,2025-08-30,8,35,40,75,King335_T,"-37.81267639, 144.95386444"
1331820241126,133,2024-11-26,18,743,589,1332,Spen229_T,"-37.81531435, 144.95227769"
133020251014,133,2025-10-14,0,33,18,51,Spen229_T,"-37.81531435, 144.95227769"
87420240416,87,2024-04-16,4,5,2,7,Errol23_T,"-37.80454949, 144.94921863"
872220240929,87,2024-09-29,22,11,14,25,Errol23_T,"-37.80454949, 144.94921863"
166420250414,166,2025-04-14,4,0,1,1,Spen484_T,"-37.80896733, 144.94931703"
852120251007,85,2025-10-07,21,12,18,30,488Mac_T,"-37.79432415, 144.92973378"
171020240724,17,2024-07-24,10,312,210,522,Col15_T,"-37.81362543, 144.97323591"
181220250924,18,2025-09-24,12,272,266,538,Col12_T,"-37.81344862, 144.97305353"
68120240307,68,2024-03-07,1,6,1,7,FLDegN_T,"-37.8168479, 144.96559789"
67120250114,67,2025-01-14,1,5,13,18,FLDegS_T,"-37.81688755, 144.96562569"
68320250123,68,2025-01-23,3,1,0,1,FLDegN_T,"-37.8168479, 144.96559789"
622120241031,62,2024-10-31,21,186,163,349,Lat224_T,"-37.80996494, 144.96216521"
112120240730,11,2024-07-30,21,28,20,48,WatCit_T,"-37.81564989, 144.93970694"
122120240324,12,2024-03-24,21,181,157,338,NewQ_T,"-37.81457988, 144.94292398"
121620231110,12,2023-11-10,16,139,126,265,NewQ_T,"-37.81457988, 144.94292398"
241620250318,24,2025-03-18,16,516,2301,2817,Col620_T,"-37.81887963, 144.95449198"
53220240615,53,2024-06-15,2,9,21,30,Col254_T,"-37.81564191, 144.965499"
791020240112,79,2024-01-12,10,401,220,621,FliSS_T,"-37.81794046, 144.96616678"
79720250109,79,2025-01-09,7,226,110,336,FliSS_T,"-37.81794046, 144.96616678"
251020240222,25,2024-02-22,10,160,381,541,MCEC_T,"-37.82401776, 144.95604426"
20220240520,20,2024-05-20,2,2,2,4,LtB170_T,"-37.81172914, 144.9682466"
52820241026,52,2024-10-26,8,50,43,93,Eli263_T,"-37.81252157, 144.9619401"
461720231031,46,2023-10-31,17,106,129,235,Pel147_T,"-37.80240719, 144.9615673"
51820240613,51,2024-06-13,8,54,63,117,Fra118_T,"-37.80841815, 144.95906316"
252020250916,25,2025-09-16,20,323,260,583,MCEC_T,"-37.82401776, 144.95604426"
462220241213,46,2024-12-13,22,2,0,2,Pel147_T,"-37.80240719, 144.9615673"
141820251011,141,2025-10-11,8,72,67,139,474Fl_T,"-37.81997273, 144.95834911"
1411220240506,141,2024-05-06,12,146,161,307,474Fl_T,"-37.81997273, 144.95834911"
1391720241207,139,2024-12-07,17,67,52,119,Signal1647_T,"-37.81959923, 144.9632832"
1362120240912,136,2024-09-12,21,3,1,4,BirFed1120_T,"-37.8184141, 144.97357915"
1231320240525,123,2024-05-25,13,39,6,45,BirBridge_T,"-37.81753741, 144.97329734"
441520250602,44,2025-06-02,15,65,62,127,UM3_T,"-37.79698741, 144.96441306"
43920231026,43,2023-10-26,9,124,62,186,UM2_T,"-37.79844526, 144.96411782"
1651420250524,165,2025-05-24,14,54,40,94,Spen475_T,"-37.80953359, 144.94939004"
1661520250322,166,2025-03-22,15,58,64,122,Spen484_T,"-37.80896733, 144.94931703"
143620240416,143,2024-04-16,6,43,61,104,Spencer_T,"-37.821728, 144.95557015"
1321120231225,132,2023-12-25,11,41,32,73,King335_T,"-37.81267639, 144.95386444"
1341520250812,134,2025-08-12,15,506,456,962,Spen201_T,"-37.81694221, 144.95303935"
1071020240916,107,2024-09-16,10,96,91,187,280Will_T,"-37.81246271, 144.95690188"
1331920240615,133,2024-06-15,19,318,350,668,Spen229_T,"-37.81531435, 144.95227769"
1241320250502,124,2025-05-02,13,3,7,10,BirBridge_T,"-37.81757416, 144.97329934"
1821320250613,182,2025-06-13,13,283,316,599,King163_T,"-37.81627451, 144.95550503"
681220240204,68,2024-02-04,12,239,169,408,FLDegN_T,"-37.8168479, 144.96559789"
1920231130,1,2023-11-30,9,388,524,912,Bou292_T,"-37.81349441, 144.96515323"
63220250704,63,2025-07-04,2,3,11,14,Bou231_T,"-37.81333081, 144.96675571"
561220250210,56,2025-02-10,12,412,273,685,Lon364_T,"-37.81234775, 144.96153311"
12820231115,12,2023-11-15,8,118,136,254,NewQ_T,"-37.81457988, 144.94292398"
241420250528,24,2025-05-28,14,533,908,1441,Col620_T,"-37.81887963, 144.95449198"
241820250819,24,2025-08-19,18,464,1266,1730,Col620_T,"-37.81887963, 144.95449198"
101020250309,10,2025-03-09,10,37,34,71,BouHbr_T,"-37.81876474, 144.94710545"
761720250925,76,2025-09-25,17,52,73,125,KenMac_T,"-37.79453803, 144.93036194"
721820240730,72,2024-07-30,18,115,326,441,ACMI_T,"-37.81726338, 144.96872809"
35620250816,35,2025-08-16,6,41,41,82,SouthB_T,"-37.82018685, 144.96508508"
27420241017,27,2024-10-17,4,5,2,7,Vic_T,"-37.80606888, 144.95644692"
9620250911,9,2025-09-11,6,27,223,250,Col700_T,"-37.81982992, 144.95102555"
231320240110,23,2024-01-10,13,416,405,821,Col623_T,"-37.81909256, 144.95452748"
79720250929,79,2025-09-29,7,164,97,261,FliSS_T,"-37.81794046, 144.96616678"
461020231026,46,2023-10-26,10,51,95,146,Pel147_T,"-37.80240719, 144.9615673"
20020250221,20,2025-02-21,0,43,63,106,LtB170_T,"-37.81172914, 144.9682466"
251420250120,25,2025-01-20,14,494,476,970,MCEC_T,"-37.82401776, 144.95604426"
52020240516,52,2024-05-16,0,12,24,36,Eli263_T,"-37.81252157, 144.9619401"
1412220250121,141,2025-01-21,22,35,69,104,474Fl_T,"-37.81997273, 144.95834911"
1381120240921,138,2024-09-21,11,8,9,17,EntPark1671_T,"-37.81996544, 144.95981454"
1381320241212,138,2024-12-12,13,11,7,18,EntPark1671_T,"-37.81996544, 144.95981454"
117220240709,117,2024-07-09,2,3,1,4,Fli114F_T,"-37.81629332, 144.97090877"
481820240901,48,2024-09-01,18,118,126,244,QVMQ_T,"-37.80631581, 144.95866697"
1392120240514,139,2024-05-14,21,15,12,27,Signal1647_T,"-37.81959923, 144.9632832"
139120250307,139,2025-03-07,1,0,3,3,Signal1647_T,"-37.81959923, 144.9632832"
1421320240215,142,2024-02-15,13,629,677,1306,Hammer1584_T,"-37.81970749, 144.96795734"
1301820240910,130,2024-09-10,18,35,36,71,Bou892T,"-37.8204637, 144.94126826"
841320250821,84,2025-08-21,13,1108,1258,2366,ElFi_T,"-37.81798049, 144.96503383"
391220250610,39,2025-06-10,12,241,120,361,AlfPl_T,"-37.81379749, 144.96995745"
241220240619,24,2024-06-19,12,955,630,1585,Col620_T,"-37.81887963, 144.95449198"
10320241112,10,2024-11-12,3,3,0,3,BouHbr_T,"-37.81876474, 144.94710545"
351720250707,35,2025-07-07,17,1728,1244,2972,SouthB_T,"-37.82018685, 144.96508508"
92120240623,9,2024-06-23,21,31,31,62,Col700_T,"-37.81982992, 144.95102555"
79720251012,79,2025-10-12,7,198,81,279,FliSS_T,"-37.81794046, 144.96616678"
301620250811,30,2025-08-11,16,177,366,543,Lon189_T,"-37.8112185, 144.96656806"
521720250612,52,2025-06-12,17,386,345,731,Eli263_T,"-37.81252157, 144.9619401"
521020240822,52,2024-08-22,10,203,162,365,Eli263_T,"-37.81252157, 144.9619401"
164820241209,164,2024-12-09,8,84,82,166,Lat526_T,"-37.813005, 144.95160411"
1381020231130,138,2023-11-30,10,3,11,14,EntPark1671_T,"-37.81996544, 144.95981454"
109420240610,109,2024-06-10,4,3,2,5,LatWill_T,"-37.81193681, 144.95621105"
482220240218,48,2024-02-18,22,47,76,123,QVMQ_T,"-37.80631581, 144.95866697"
1371220241215,137,2024-12-15,12,9,18,27,BouHbr2353_T,"-37.81894815, 144.94612292"
1391620240603,139,2024-06-03,16,94,14,108,Signal1647_T,"-37.81959923, 144.9632832"
139020250411,139,2025-04-11,0,2,7,9,Signal1647_T,"-37.81959923, 144.9632832"
137120240818,137,2024-08-18,1,0,1,1,BouHbr2353_T,"-37.81894815, 144.94612292"
1362320250802,136,2025-08-02,23,0,65,65,BirFed1120_T,"-37.8184141, 144.97357915"
661620250616,66,2025-06-16,16,1049,1190,2239,QVN_T,"-37.81057846, 144.96444294"
841220250306,84,2025-03-06,12,1041,1091,2132,ElFi_T,"-37.81798049, 144.96503383"
701720231024,70,2023-10-24,17,198,168,366,Errol20_T,"-37.80456984, 144.94946228"
701220250207,70,2025-02-07,12,162,166,328,Errol20_T,"-37.80456984, 144.94946228"
3120240524,3,2024-05-24,1,126,76,202,Swa295_T,"-37.81101524, 144.96429485"
391220250723,39,2025-07-23,12,301,180,481,AlfPl_T,"-37.81379749, 144.96995745"
751120240409,75,2024-04-09,11,47,38,85,SprFli_T,"-37.81515276, 144.97467661"
751520251007,75,2025-10-07,15,47,60,107,SprFli_T,"-37.81515276, 144.97467661"
14820241201,14,2024-12-01,8,120,50,170,SanBri_T,"-37.82011242, 144.96291897"
29720240211,29,2024-02-11,7,51,71,122,AG_T,"-37.8199817, 144.96872865"
591620240210,59,2024-02-10,16,704,615,1319,RMIT_T,"-37.80825648, 144.96304859"
54220250510,54,2025-05-10,2,26,17,43,Swa607_T,"-37.804024, 144.96308399"
28320240530,28,2024-05-30,3,4,20,24,VAC_T,"-37.82129925, 144.96879309"
40320241130,40,2024-11-30,3,6,3,9,Spr201_T,"-37.80999341, 144.97227587"
401120240210,40,2024-02-10,11,103,140,243,Spr201_T,"-37.80999341, 144.97227587"
361220240722,36,2024-07-22,12,321,289,610,Que85_T,"-37.81652527, 144.96121062"
432020240614,43,2024-06-14,20,47,56,103,UM2_T,"-37.79844526, 144.96411782"
51820240909,5,2024-09-09,18,801,1201,2002,PriNW_T,"-37.81874249, 144.96787656"
1331920240602,133,2024-06-02,19,252,224,476,Spen229_T,"-37.81531435, 144.95227769"
1321520250706,132,2025-07-06,15,162,181,343,King335_T,"-37.81267639, 144.95386444"
132120250912,132,2025-09-12,1,8,6,14,King335_T,"-37.81267639, 144.95386444"
87820250818,87,2025-08-18,8,93,67,160,Errol23_T,"-37.80454949, 144.94921863"
108620240526,108,2024-05-26,6,2,14,16,261Will_T,"-37.81295822, 144.95678789"
87920240331,87,2024-03-31,9,41,46,87,Errol23_T,"-37.80454949, 144.94921863"
611720231107,61,2023-11-07,17,261,313,574,RMIT14_T,"-37.80767455, 144.96309114"
771020240924,77,2024-09-24,10,137,72,209,HarEsP_T,"-37.81441438, 144.94433026"
29820240406,29,2024-04-06,8,75,135,210,AG_T,"-37.8199817, 144.96872865"
542320250321,54,2025-03-21,23,81,67,148,Swa607_T,"-37.804024, 144.96308399"
282020240828,28,2024-08-28,20,183,217,400,VAC_T,"-37.82129925, 144.96879309"
40520240406,40,2024-04-06,5,8,5,13,Spr201_T,"-37.80999341, 144.97227587"
40220231213,40,2023-12-13,2,5,2,7,Spr201_T,"-37.80999341, 144.97227587"
311120240325,31,2024-03-25,11,142,130,272,Lyg161_T,"-37.80169681, 144.96658911"
36220240623,36,2024-06-23,2,116,85,201,Que85_T,"-37.81652527, 144.96121062"
472220240807,47,2024-08-07,22,229,263,492,Eli250_T,"-37.81258467, 144.9625775"
45020250224,45,2025-02-24,0,10,60,70,Swa148_T,"-37.81414075, 144.96609379"
451720250103,45,2025-01-03,17,617,672,1289,Swa148_T,"-37.81414075, 144.96609379"
451020250128,45,2025-01-28,10,296,303,599,Swa148_T,"-37.81414075, 144.96609379"
131920250828,131,2025-08-28,9,123,94,217,King2_T,"-37.82009057, 144.95758725"
132320250117,132,2025-01-17,3,6,7,13,King335_T,"-37.81267639, 144.95386444"
134020250924,134,2025-09-24,0,29,59,88,Spen201_T,"-37.81694221, 144.95303935"
1322020250513,132,2025-05-13,20,107,118,225,King335_T,"-37.81267639, 144.95386444"
1322120250921,132,2025-09-21,21,59,64,123,King335_T,"-37.81267639, 144.95386444"
134920240809,134,2024-08-09,9,173,258,431,Spen201_T,"-37.81694221, 144.95303935"
1331120250418,133,2025-04-18,11,549,711,1260,Spen229_T,"-37.81531435, 144.95227769"
1072220250507,107,2025-05-07,22,50,45,95,280Will_T,"-37.81246271, 144.95690188"
1331620240704,133,2024-07-04,16,556,697,1253,Spen229_T,"-37.81531435, 144.95227769"
1081020250616,108,2025-06-16,10,206,316,522,261Will_T,"-37.81295822, 144.95678789"
108020250314,108,2025-03-14,0,35,31,66,261Will_T,"-37.81295822, 144.95678789"
1661720250228,166,2025-02-28,17,64,59,123,Spen484_T,"-37.80896733, 144.94931703"
1661020250922,166,2025-09-22,10,29,33,62,Spen484_T,"-37.80896733, 144.94931703"
32020250205,3,2025-02-05,20,638,570,1208,Swa295_T,"-37.81101524, 144.96429485"
852220250616,85,2025-06-16,22,2,5,7,488Mac_T,"-37.79432415, 144.92973378"
63820250825,63,2025-08-25,8,177,146,323,Bou231_T,"-37.81333081, 144.96675571"
681520240211,68,2024-02-11,15,183,151,334,FLDegN_T,"-37.8168479, 144.96559789"
56720240811,56,2024-08-11,7,37,26,63,Lon364_T,"-37.81234775, 144.96153311"
86720240413,86,2024-04-13,7,11,10,21,574Qub_T,"-37.80309992, 144.94908064"
861020241205,86,2024-12-05,10,35,35,70,574Qub_T,"-37.80309992, 144.94908064"
861720250925,86,2025-09-25,17,65,71,136,574Qub_T,"-37.80309992, 144.94908064"
101120250926,10,2025-09-26,11,36,21,57,BouHbr_T,"-37.81876474, 144.94710545"
241620240516,24,2024-05-16,16,567,1970,2537,Col620_T,"-37.81887963, 144.95449198"
721820231028,72,2023-10-28,18,447,499,946,ACMI_T,"-37.81726338, 144.96872809"
531120240614,53,2024-06-14,11,618,511,1129,Col254_T,"-37.81564191, 144.965499"
53820240220,53,2024-02-20,8,428,326,754,Col254_T,"-37.81564191, 144.965499"
20920231225,20,2023-12-25,9,17,20,37,LtB170_T,"-37.81172914, 144.9682466"
521420241014,52,2024-10-14,14,396,263,659,Eli263_T,"-37.81252157, 144.9619401"
521120240105,52,2024-01-05,11,237,190,427,Eli263_T,"-37.81252157, 144.9619401"
51720250819,51,2025-08-19,7,48,35,83,Fra118_T,"-37.80841815, 144.95906316"
411820240728,41,2024-07-28,18,102,63,165,Swa31,"-37.81668634, 144.96689733"
291820240417,29,2024-04-17,18,187,256,443,AG_T,"-37.8199817, 144.96872865"
291220240522,29,2024-05-22,12,250,309,559,AG_T,"-37.8199817, 144.96872865"
141820241021,14,2024-10-21,18,435,175,610,SanBri_T,"-37.82011242, 144.96291897"
712020240417,71,2024-04-17,20,6,9,15,WestWP_T,"-37.81235775, 144.97136962"
711620240704,71,2024-07-04,16,14,8,22,WestWP_T,"-37.81235775, 144.97136962"
31120250601,31,2025-06-01,1,34,97,131,Lyg161_T,"-37.80169681, 144.96658911"
62320241209,6,2024-12-09,23,415,192,607,FliS_T,"-37.81911705, 144.96558255"
62020241215,6,2024-12-15,20,812,1021,1833,FliS_T,"-37.81911705, 144.96558255"
661920231106,66,2023-11-06,19,1080,1004,2084,QVN_T,"-37.81057846, 144.96444294"
4020250912,4,2025-09-12,0,75,98,173,Swa123_T,"-37.81487988, 144.9660878"
31520250314,3,2025-03-14,15,1030,1054,2084,Swa295_T,"-37.81101524, 144.96429485"
75820231129,75,2023-11-29,8,54,49,103,SprFli_T,"-37.81515276, 144.97467661"
8520241022,8,2024-10-22,5,15,17,32,WebBN_T,"-37.82293543, 144.9471751"
59120241018,59,2024-10-18,1,39,11,50,RMIT_T,"-37.80825648, 144.96304859"
77620250716,77,2025-07-16,6,15,48,63,HarEsP_T,"-37.81441438, 144.94433026"
42820240809,42,2024-08-09,8,337,95,432,UM1_T,"-37.80008566, 144.96386412"
591720250117,59,2025-01-17,17,238,484,722,RMIT_T,"-37.80825648, 144.96304859"
47220240729,47,2024-07-29,2,13,23,36,Eli250_T,"-37.81258467, 144.9625775"
311820250729,31,2025-07-29,18,181,127,308,Lyg161_T,"-37.80169681, 144.96658911"
51920231112,5,2023-11-12,19,812,781,1593,PriNW_T,"-37.81874249, 144.96787656"
211520240830,21,2024-08-30,15,266,280,546,Bourke155_T,"-37.81267313, 144.96788288"
211720250205,21,2025-02-05,17,383,320,703,Bourke155_T,"-37.81267313, 144.96788288"
36520241211,36,2024-12-11,5,14,6,20,Que85_T,"-37.81652527, 144.96121062"
372320240110,37,2024-01-10,23,52,38,90,Lyg260_T,"-37.80107122, 144.96704554"
871820240918,87,2024-09-18,18,120,84,204,Errol23_T,"-37.80454949, 144.94921863"
441320240129,44,2024-01-29,13,32,60,92,UM3_T,"-37.79698741, 144.96441306"
44720240401,44,2024-04-01,7,3,1,4,UM3_T,"-37.79698741, 144.96441306"
441020240417,44,2024-04-17,10,68,51,119,UM3_T,"-37.79698741, 144.96441306"
442220250727,44,2025-07-27,22,5,1,6,UM3_T,"-37.79698741, 144.96441306"
44420241018,44,2024-10-18,4,1,0,1,UM3_T,"-37.79698741, 144.96441306"
1651120251015,165,2025-10-15,11,25,39,64,Spen475_T,"-37.80953359, 144.94939004"
1401620240323,140,2024-03-23,16,87,73,160,Boyd2837_T,"-37.82590962, 144.96185972"
1431020241207,143,2024-12-07,10,127,329,456,Spencer_T,"-37.821728, 144.95557015"
143420250109,143,2025-01-09,4,17,3,20,Spencer_T,"-37.821728, 144.95557015"
1321420250723,132,2025-07-23,14,120,121,241,King335_T,"-37.81267639, 144.95386444"
1342220241230,134,2024-12-30,22,198,185,383,Spen201_T,"-37.81694221, 144.95303935"
134920250529,134,2025-05-29,9,246,316,562,Spen201_T,"-37.81694221, 144.95303935"
1071620240105,107,2024-01-05,16,89,75,164,280Will_T,"-37.81246271, 144.95690188"
1071320240824,107,2024-08-24,13,93,170,263,280Will_T,"-37.81246271, 144.95690188"
133120241207,133,2024-12-07,1,75,48,123,Spen229_T,"-37.81531435, 144.95227769"
1241020250525,124,2025-05-25,10,1,3,4,BirBridge_T,"-37.81757416, 144.97329934"
108220250828,108,2025-08-28,2,5,1,6,261Will_T,"-37.81295822, 144.95678789"
46320240627,46,2024-06-27,3,0,3,3,Pel147_T,"-37.80240719, 144.9615673"
231820240226,23,2024-02-26,18,175,341,516,Col623_T,"-37.81909256, 144.95452748"
1641220250321,164,2025-03-21,12,125,71,196,Lat526_T,"-37.813005, 144.95160411"
1411520250427,141,2025-04-27,15,115,132,247,474Fl_T,"-37.81997273, 144.95834911"
117020240801,117,2024-08-01,0,18,8,26,Fli114F_T,"-37.81629332, 144.97090877"
1231020250930,123,2025-09-30,10,18,15,33,BirBridge_T,"-37.81753741, 144.97329734"
117220240306,117,2024-03-06,2,11,6,17,Fli114F_T,"-37.81629332, 144.97090877"
117620240317,117,2024-03-17,6,14,6,20,Fli114F_T,"-37.81629332, 144.97090877"
19820231025,19,2023-10-25,8,93,55,148,LtB210_T,"-37.81237202, 144.96550671"
481420240805,48,2024-08-05,14,154,122,276,QVMQ_T,"-37.80631581, 144.95866697"
1301320250401,130,2025-04-01,13,72,100,172,Bou892T,"-37.8204637, 144.94126826"
85020241222,85,2024-12-22,0,0,15,15,488Mac_T,"-37.79432415, 144.92973378"
18520240308,18,2024-03-08,5,0,6,6,Col12_T,"-37.81344862, 144.97305353"
1391020250315,139,2025-03-15,10,43,34,77,Signal1647_T,"-37.81959923, 144.9632832"
1361320240624,136,2024-06-24,13,77,70,147,BirFed1120_T,"-37.8184141, 144.97357915"
1421220241226,142,2024-12-26,12,221,311,532,Hammer1584_T,"-37.81970749, 144.96795734"
1421220250915,142,2025-09-15,12,655,439,1094,Hammer1584_T,"-37.81970749, 144.96795734"
1301920250331,130,2025-03-31,19,31,28,59,Bou892T,"-37.8204637, 144.94126826"
1642220241122,164,2024-11-22,22,48,79,127,Lat526_T,"-37.813005, 144.95160411"
84720241225,84,2024-12-25,7,68,80,148,ElFi_T,"-37.81798049, 144.96503383"
31720250807,3,2025-08-07,17,1214,1479,2693,Swa295_T,"-37.81101524, 144.96429485"
772020250212,77,2025-02-12,20,225,171,396,HarEsP_T,"-37.81441438, 144.94433026"
77320250217,77,2025-02-17,3,1,1,2,HarEsP_T,"-37.81441438, 144.94433026"
712320250612,71,2025-06-12,23,2,1,3,WestWP_T,"-37.81235775, 144.97136962"
47120241011,47,2024-10-11,1,80,53,133,Eli250_T,"-37.81258467, 144.9625775"
31420250207,31,2025-02-07,4,6,0,6,Lyg161_T,"-37.80169681, 144.96658911"
312320250420,31,2025-04-20,23,49,120,169,Lyg161_T,"-37.80169681, 144.96658911"
31520250517,31,2025-05-17,5,6,1,7,Lyg161_T,"-37.80169681, 144.96658911"
541020250311,54,2025-03-11,10,219,102,321,Swa607_T,"-37.804024, 144.96308399"
36020240815,36,2024-08-15,0,8,8,16,Que85_T,"-37.81652527, 144.96121062"
362120241222,36,2024-12-22,21,42,44,86,Que85_T,"-37.81652527, 144.96121062"
45320241020,45,2024-10-20,3,32,108,140,Swa148_T,"-37.81414075, 144.96609379"
1321820240601,132,2024-06-01,18,126,129,255,King335_T,"-37.81267639, 144.95386444"
1341420241218,134,2024-12-18,14,361,354,715,Spen201_T,"-37.81694221, 144.95303935"
135620250524,135,2025-05-24,6,42,62,104,Spen161_T,"-37.8172861, 144.95319102"
1352220240716,135,2024-07-16,22,45,169,214,Spen161_T,"-37.8172861, 144.95319102"
1071520240827,107,2024-08-27,15,156,107,263,280Will_T,"-37.81246271, 144.95690188"
1332020240820,133,2024-08-20,20,342,240,582,Spen229_T,"-37.81531435, 144.95227769"
1241920250208,124,2025-02-08,19,4,6,10,BirBridge_T,"-37.81757416, 144.97329934"
1821120250726,182,2025-07-26,11,242,265,507,King163_T,"-37.81627451, 144.95550503"
167120250608,167,2025-06-08,1,3,3,6,Lat526_T,"-37.81304149, 144.95155955"
1671220251005,167,2025-10-05,12,42,66,108,Lat526_T,"-37.81304149, 144.95155955"
17520240519,17,2024-05-19,5,11,5,16,Col15_T,"-37.81362543, 144.97323591"
17520241203,17,2024-12-03,5,56,21,77,Col15_T,"-37.81362543, 144.97323591"
671020250510,67,2025-05-10,10,456,452,908,FLDegS_T,"-37.81688755, 144.96562569"
631820240106,63,2024-01-06,18,288,243,531,Bou231_T,"-37.81333081, 144.96675571"
861120250720,86,2025-07-20,11,78,46,124,574Qub_T,"-37.80309992, 144.94908064"
12620251015,12,2025-10-15,6,41,27,68,NewQ_T,"-37.81457988, 144.94292398"
561320250503,56,2025-05-03,13,280,289,569,Lon364_T,"-37.81234775, 144.96153311"
761820250507,76,2025-05-07,18,37,50,87,KenMac_T,"-37.79453803, 144.93036194"
351220250830,35,2025-08-30,12,726,749,1475,SouthB_T,"-37.82018685, 144.96508508"
531220240515,53,2024-05-15,12,994,789,1783,Col254_T,"-37.81564191, 144.965499"
27220250331,27,2025-03-31,2,7,2,9,Vic_T,"-37.80606888, 144.95644692"
301120241216,30,2024-12-16,11,129,175,304,Lon189_T,"-37.8112185, 144.96656806"
46920231225,46,2023-12-25,9,8,6,14,Pel147_T,"-37.80240719, 144.9615673"
23920250624,23,2025-06-24,9,573,329,902,Col623_T,"-37.81909256, 144.95452748"
231320250913,23,2025-09-13,13,151,254,405,Col623_T,"-37.81909256, 144.95452748"
49820240511,49,2024-05-11,8,138,136,274,Eli501_T,"-37.80730068, 144.95956055"
49420240821,49,2024-08-21,4,14,15,29,Eli501_T,"-37.80730068, 144.95956055"
67220240820,67,2024-08-20,2,1,5,6,FLDegS_T,"-37.81688755, 144.96562569"
561720240603,56,2024-06-03,17,380,341,721,Lon364_T,"-37.81234775, 144.96153311"
111320250906,11,2025-09-06,13,116,145,261,WatCit_T,"-37.81564989, 144.93970694"
721820231110,72,2023-11-10,18,385,486,871,ACMI_T,"-37.81726338, 144.96872809"
10420241207,10,2024-12-07,4,1,2,3,BouHbr_T,"-37.81876474, 144.94710545"
352020231114,35,2023-11-14,20,606,973,1579,SouthB_T,"-37.82018685, 144.96508508"
76020240915,76,2024-09-15,0,2,2,4,KenMac_T,"-37.79453803, 144.93036194"
22020240712,2,2024-07-12,20,329,290,619,Bou283_T,"-37.81380668, 144.96516718"
35220240209,35,2024-02-09,2,12,29,41,SouthB_T,"-37.82018685, 144.96508508"
351120250514,35,2025-05-14,11,770,618,1388,SouthB_T,"-37.82018685, 144.96508508"
581520250211,58,2025-02-11,15,553,669,1222,Bou688_T,"-37.81686075, 144.95358075"
272320240127,27,2024-01-27,23,59,57,116,Vic_T,"-37.80606888, 144.95644692"
92020240426,9,2024-04-26,20,49,62,111,Col700_T,"-37.81982992, 144.95102555"
9320241020,9,2024-10-20,3,11,33,44,Col700_T,"-37.81982992, 144.95102555"
53120250323,53,2025-03-23,1,26,42,68,Col254_T,"-37.81564191, 144.965499"
271320250720,27,2025-07-20,13,337,219,556,Vic_T,"-37.80606888, 144.95644692"
231120240222,23,2024-02-22,11,183,233,416,Col623_T,"-37.81909256, 144.95452748"
461920241119,46,2024-11-19,19,43,77,120,Pel147_T,"-37.80240719, 144.9615673"
461420250418,46,2025-04-18,14,54,52,106,Pel147_T,"-37.80240719, 144.9615673"
522320241205,52,2024-12-05,23,91,109,200,Eli263_T,"-37.81252157, 144.9619401"
661020240516,66,2024-05-16,10,458,481,939,QVN_T,"-37.81057846, 144.96444294"
70920250726,70,2025-07-26,9,85,86,171,Errol20_T,"-37.80456984, 144.94946228"
781720250129,78,2025-01-29,17,31,270,301,HarEsB_T,"-37.81471642, 144.9446508"
59820240602,59,2024-06-02,8,62,82,144,RMIT_T,"-37.80825648, 144.96304859"
651220240409,65,2024-04-09,12,398,432,830,SwaCs_T,"-37.81569416, 144.9668064"
29020240628,29,2024-06-28,0,4,19,23,AG_T,"-37.8199817, 144.96872865"
711020231128,71,2023-11-28,10,15,36,51,WestWP_T,"-37.81235775, 144.97136962"
311220240806,31,2024-08-06,12,203,165,368,Lyg161_T,"-37.80169681, 144.96658911"
442320250918,44,2025-09-18,23,12,2,14,UM3_T,"-37.79698741, 144.96441306"
51820250807,5,2025-08-07,18,1166,1491,2657,PriNW_T,"-37.81874249, 144.96787656"
51120250203,5,2025-02-03,11,375,803,1178,PriNW_T,"-37.81874249, 144.96787656"
165420241130,165,2024-11-30,4,7,1,8,Spen475_T,"-37.80953359, 144.94939004"
1651420250329,165,2025-03-29,14,69,60,129,Spen475_T,"-37.80953359, 144.94939004"
1791220251012,179,2025-10-12,12,83,40,123,Pow61_T,"-37.82392385, 144.96299677"
1312020250905,131,2025-09-05,20,103,96,199,King2_T,"-37.82009057, 144.95758725"
140620231209,140,2023-12-09,6,31,3,34,Boyd2837_T,"-37.82590962, 144.96185972"
1341320240518,134,2024-05-18,13,207,231,438,Spen201_T,"-37.81694221, 144.95303935"
1351720250315,135,2025-03-15,17,1093,565,1658,Spen161_T,"-37.8172861, 144.95319102"
1181720240607,118,2024-06-07,17,16,18,34,Fli114C_T,"-37.81632783, 144.97090512"
1082120250812,108,2025-08-12,21,82,51,133,261Will_T,"-37.81295822, 144.95678789"
1081620240102,108,2024-01-02,16,177,55,232,261Will_T,"-37.81295822, 144.95678789"
1821620251008,182,2025-10-08,16,230,200,430,King163_T,"-37.81627451, 144.95550503"
1841320250707,184,2025-07-07,13,1372,1435,2807,Eli124_T,"-37.81512416, 144.96371988"
672320250206,67,2025-02-06,23,47,108,155,FLDegS_T,"-37.81688755, 144.96562569"
681320251008,68,2025-10-08,13,452,563,1015,FLDegN_T,"-37.8168479, 144.96559789"
171820250115,17,2025-01-15,18,122,273,395,Col15_T,"-37.81362543, 144.97323591"
11720240704,1,2024-07-04,17,1403,1085,2488,Bou292_T,"-37.81349441, 144.96515323"
1220250225,1,2025-02-25,2,10,11,21,Bou292_T,"-37.81349441, 144.96515323"
44720240929,44,2024-09-29,7,6,7,13,UM3_T,"-37.79698741, 144.96441306"
1811020250531,181,2025-05-31,10,477,835,1312,Eli368_T,"-37.81009465, 144.96143149"
131320250707,131,2025-07-07,3,14,10,24,King2_T,"-37.82009057, 144.95758725"
1342320250808,134,2025-08-08,23,100,112,212,Spen201_T,"-37.81694221, 144.95303935"
682320250928,68,2025-09-28,23,18,5,23,FLDegN_T,"-37.8168479, 144.96559789"
852120240819,85,2024-08-19,21,7,15,22,488Mac_T,"-37.79432415, 144.92973378"
851720250621,85,2025-06-21,17,66,80,146,488Mac_T,"-37.79432415, 144.92973378"
852320250626,85,2025-06-26,23,1,6,7,488Mac_T,"-37.79432415, 144.92973378"
172320241007,17,2024-10-07,23,15,12,27,Col15_T,"-37.81362543, 144.97323591"
17220250108,17,2025-01-08,2,7,5,12,Col15_T,"-37.81362543, 144.97323591"
1220250825,1,2025-08-25,2,3,13,16,Bou292_T,"-37.81349441, 144.96515323"
101220250312,10,2025-03-12,12,211,169,380,BouHbr_T,"-37.81876474, 144.94710545"
10020250323,10,2025-03-23,0,7,12,19,BouHbr_T,"-37.81876474, 144.94710545"
72220250412,72,2025-04-12,2,2,13,15,ACMI_T,"-37.81726338, 144.96872809"
582120241013,58,2024-10-13,21,207,171,378,Bou688_T,"-37.81686075, 144.95358075"
791620250521,79,2025-05-21,16,475,684,1159,FliSS_T,"-37.81794046, 144.96616678"
30320241204,30,2024-12-04,3,17,15,32,Lon189_T,"-37.8112185, 144.96656806"
252120231203,25,2023-12-03,21,0,0,0,MCEC_T,"-37.82401776, 144.95604426"
25620240810,25,2024-08-10,6,29,43,72,MCEC_T,"-37.82401776, 144.95604426"
521220250307,52,2025-03-07,12,335,233,568,Eli263_T,"-37.81252157, 144.9619401"
461620250512,46,2025-05-12,16,114,236,350,Pel147_T,"-37.80240719, 144.9615673"
23220250103,23,2025-01-03,2,7,9,16,Col623_T,"-37.81909256, 144.95452748"
492020250827,49,2025-08-27,20,396,561,957,Eli501_T,"-37.80730068, 144.95956055"
1411420240712,141,2024-07-12,14,237,205,442,474Fl_T,"-37.81997273, 144.95834911"
1412120250613,141,2025-06-13,21,74,94,168,474Fl_T,"-37.81997273, 144.95834911"
491720240125,49,2024-01-25,17,180,151,331,Eli501_T,"-37.80730068, 144.95956055"
491320240613,49,2024-06-13,13,301,439,740,Eli501_T,"-37.80730068, 144.95956055"
1091020240923,109,2024-09-23,10,94,148,242,LatWill_T,"-37.81193681, 144.95621105"
1091920250602,109,2025-06-02,19,72,96,168,LatWill_T,"-37.81193681, 144.95621105"
1371320240314,137,2024-03-14,13,51,89,140,BouHbr2353_T,"-37.81894815, 144.94612292"
137020240407,137,2024-04-07,0,1,0,1,BouHbr2353_T,"-37.81894815, 144.94612292"
1371520240806,137,2024-08-06,15,13,103,116,BouHbr2353_T,"-37.81894815, 144.94612292"
1371620241012,137,2024-10-12,16,14,10,24,BouHbr2353_T,"-37.81894815, 144.94612292"
1362020240521,136,2024-05-21,20,5,3,8,BirFed1120_T,"-37.8184141, 144.97357915"
136920250118,136,2025-01-18,9,271,135,406,BirFed1120_T,"-37.8184141, 144.97357915"
1422220250213,142,2025-02-13,22,38,30,68,Hammer1584_T,"-37.81970749, 144.96795734"
661520240928,66,2024-09-28,15,1357,1273,2630,QVN_T,"-37.81057846, 144.96444294"
6920250702,6,2025-07-02,9,505,938,1443,FliS_T,"-37.81911705, 144.96558255"
3320240523,3,2024-05-23,3,25,19,44,Swa295_T,"-37.81101524, 144.96429485"
391520250730,39,2025-07-30,15,56,63,119,AlfPl_T,"-37.81379749, 144.96995745"
77920240612,77,2024-06-12,9,54,80,134,HarEsP_T,"-37.81441438, 144.94433026"
77720241008,77,2024-10-08,7,70,118,188,HarEsP_T,"-37.81441438, 144.94433026"
78120240723,78,2024-07-23,1,1,2,3,HarEsB_T,"-37.81471642, 144.9446508"
59520250818,59,2025-08-18,5,10,19,29,RMIT_T,"-37.80825648, 144.96304859"
291620250606,29,2025-06-06,16,160,162,322,AG_T,"-37.8199817, 144.96872865"
471120240120,47,2024-01-20,11,754,1011,1765,Eli250_T,"-37.81258467, 144.9625775"
312320250516,31,2025-05-16,23,113,207,320,Lyg161_T,"-37.80169681, 144.96658911"
311020251008,31,2025-10-08,10,101,94,195,Lyg161_T,"-37.80169681, 144.96658911"
361420240815,36,2024-08-15,14,195,269,464,Que85_T,"-37.81652527, 144.96121062"
631820231207,63,2023-12-07,18,475,468,943,Bou231_T,"-37.81333081, 144.96675571"
241020241227,24,2024-12-27,10,623,345,968,Col620_T,"-37.81887963, 144.95449198"
121820250704,12,2025-07-04,18,379,241,620,NewQ_T,"-37.81457988, 144.94292398"
122320250811,12,2025-08-11,23,9,9,18,NewQ_T,"-37.81457988, 144.94292398"
761720251012,76,2025-10-12,17,35,44,79,KenMac_T,"-37.79453803, 144.93036194"
2920250921,2,2025-09-21,9,133,178,311,Bou283_T,"-37.81380668, 144.96516718"
2820250926,2,2025-09-26,8,77,95,172,Bou283_T,"-37.81380668, 144.96516718"
2720240419,2,2024-04-19,7,27,61,88,Bou283_T,"-37.81380668, 144.96516718"
53420250905,53,2025-09-05,4,7,4,11,Col254_T,"-37.81564191, 144.965499"
27820250907,27,2025-09-07,8,38,111,149,Vic_T,"-37.80606888, 144.95644692"
791920240726,79,2024-07-26,19,375,350,725,FliSS_T,"-37.81794046, 144.96616678"
791820250719,79,2025-07-19,18,516,330,846,FliSS_T,"-37.81794046, 144.96616678"
30620250428,30,2025-04-28,6,14,32,46,Lon189_T,"-37.8112185, 144.96656806"
512220241016,51,2024-10-16,22,40,48,88,Fra118_T,"-37.80841815, 144.95906316"
1172020250311,117,2025-03-11,20,124,139,263,Fli114F_T,"-37.81629332, 144.97090877"
1231820240823,123,2024-08-23,18,2,0,2,BirBridge_T,"-37.81753741, 144.97329734"
1231220250907,123,2025-09-07,12,5,2,7,BirBridge_T,"-37.81753741, 144.97329734"
492320241201,49,2024-12-01,23,86,66,152,Eli501_T,"-37.80730068, 144.95956055"
49520250627,49,2025-06-27,5,22,18,40,Eli501_T,"-37.80730068, 144.95956055"
109320250526,109,2025-05-26,3,5,7,12,LatWill_T,"-37.81193681, 144.95621105"
48920240327,48,2024-03-27,9,144,81,225,QVMQ_T,"-37.80631581, 144.95866697"
137620231122,137,2023-11-22,6,25,10,35,BouHbr2353_T,"-37.81894815, 144.94612292"
1392320240908,139,2024-09-08,23,7,4,11,Signal1647_T,"-37.81959923, 144.9632832"
136620250504,136,2025-05-04,6,3,2,5,BirFed1120_T,"-37.8184141, 144.97357915"
61920240828,6,2024-08-28,19,579,571,1150,FliS_T,"-37.81911705, 144.96558255"
61420241226,6,2024-12-26,14,816,778,1594,FliS_T,"-37.81911705, 144.96558255"
32220240107,3,2024-01-07,22,367,346,713,Swa295_T,"-37.81101524, 144.96429485"
3820240219,3,2024-02-19,8,226,376,602,Swa295_T,"-37.81101524, 144.96429485"
81820250910,8,2025-09-10,18,97,143,240,WebBN_T,"-37.82293543, 144.9471751"
77420250301,77,2025-03-01,4,3,0,3,HarEsP_T,"-37.81441438, 144.94433026"
42820250707,42,2025-07-07,8,100,130,230,UM1_T,"-37.80008566, 144.96386412"
311420240401,31,2024-04-01,14,119,128,247,Lyg161_T,"-37.80169681, 144.96658911"
542220240409,54,2024-04-09,22,44,62,106,Swa607_T,"-37.804024, 144.96308399"
28520250331,28,2025-03-31,5,35,35,70,VAC_T,"-37.82129925, 144.96879309"
40020241011,40,2024-10-11,0,11,5,16,Spr201_T,"-37.80999341, 144.97227587"
312020231226,31,2023-12-26,20,209,191,400,Lyg161_T,"-37.80169681, 144.96658911"
5520241126,5,2024-11-26,5,28,43,71,PriNW_T,"-37.81874249, 144.96787656"
371620240403,37,2024-04-03,16,100,114,214,Lyg260_T,"-37.80107122, 144.96704554"
611320250310,61,2025-03-10,13,461,596,1057,RMIT14_T,"-37.80767455, 144.96309114"
871620240417,87,2024-04-17,16,111,106,217,Errol23_T,"-37.80454949, 144.94921863"
50820240408,50,2024-04-08,8,42,78,120,Lyg309_T,"-37.79808192, 144.96721013"
45820250711,45,2025-07-11,8,181,195,376,Swa148_T,"-37.81414075, 144.96609379"
45520250804,45,2025-08-04,5,16,14,30,Swa148_T,"-37.81414075, 144.96609379"
1671820241020,167,2024-10-20,18,46,45,91,Lat526_T,"-37.81304149, 144.95155955"
1811120250828,181,2025-08-28,11,426,739,1165,Eli368_T,"-37.81009465, 144.96143149"
25920250614,25,2025-06-14,9,204,557,761,MCEC_T,"-37.82401776, 144.95604426"
1801620250707,180,2025-07-07,16,45,35,80,Mac330_T,"-37.79497059, 144.93530329"
1372320231209,137,2023-12-09,23,5,2,7,BouHbr2353_T,"-37.81894815, 144.94612292"
1302020250523,130,2025-05-23,20,3,4,7,Bou892T,"-37.8204637, 144.94126826"
1302320250517,130,2025-05-17,23,1,0,1,Bou892T,"-37.8204637, 144.94126826"
117920250610,117,2025-06-10,9,190,107,297,Fli114F_T,"-37.81629332, 144.97090877"
66620250511,66,2025-05-11,6,10,50,60,QVN_T,"-37.81057846, 144.96444294"
69620240509,69,2024-05-09,6,21,7,28,FLDegC_T,"-37.81687226, 144.96559144"
751120250123,75,2025-01-23,11,59,52,111,SprFli_T,"-37.81515276, 144.97467661"
391020240930,39,2024-09-30,10,72,86,158,AlfPl_T,"-37.81379749, 144.96995745"
392220240606,39,2024-06-06,22,17,17,34,AlfPl_T,"-37.81379749, 144.96995745"
412020250130,41,2025-01-30,20,675,847,1522,Swa31,"-37.81668634, 144.96689733"
82120241211,8,2024-12-11,21,65,55,120,WebBN_T,"-37.82293543, 144.9471751"
291420250417,29,2025-04-17,14,306,292,598,AG_T,"-37.8199817, 144.96872865"
711120251016,71,2025-10-16,11,17,11,28,WestWP_T,"-37.81235775, 144.97136962"
59320250802,59,2025-08-02,3,60,16,76,RMIT_T,"-37.80825648, 144.96304859"
281120250829,28,2025-08-29,11,589,395,984,VAC_T,"-37.82129925, 144.96879309"
401220231129,40,2023-11-29,12,367,736,1103,Spr201_T,"-37.80999341, 144.97227587"
31020240830,31,2024-08-30,0,8,18,26,Lyg161_T,"-37.80169681, 144.96658911"
211320240420,21,2024-04-20,13,477,536,1013,Bourke155_T,"-37.81267313, 144.96788288"
362020240925,36,2024-09-25,20,93,113,206,Que85_T,"-37.81652527, 144.96121062"
50720240409,50,2024-04-09,7,18,49,67,Lyg309_T,"-37.79808192, 144.96721013"
501420240825,50,2024-08-25,14,305,279,584,Lyg309_T,"-37.79808192, 144.96721013"
502120250127,50,2025-01-27,21,141,85,226,Lyg309_T,"-37.79808192, 144.96721013"
45820251005,45,2025-10-05,8,63,93,156,Swa148_T,"-37.81414075, 144.96609379"
51820241022,5,2024-10-22,18,799,687,1486,PriNW_T,"-37.81874249, 144.96787656"
181120250718,181,2025-07-18,1,73,62,135,Eli368_T,"-37.81009465, 144.96143149"
135320231230,135,2023-12-30,3,15,25,40,Spen161_T,"-37.8172861, 144.95319102"
107820251009,107,2025-10-09,8,85,256,341,280Will_T,"-37.81246271, 144.95690188"
1071120241006,107,2024-10-06,11,55,78,133,280Will_T,"-37.81246271, 144.95690188"
107020241026,107,2024-10-26,0,31,26,57,280Will_T,"-37.81246271, 144.95690188"
1241420250721,124,2025-07-21,14,1,1,2,BirBridge_T,"-37.81757416, 144.97329934"
1081520240824,108,2024-08-24,15,68,147,215,261Will_T,"-37.81295822, 144.95678789"
171520251008,17,2025-10-08,15,318,316,634,Col15_T,"-37.81362543, 144.97323591"
11820240102,1,2024-01-02,18,531,302,833,Bou292_T,"-37.81349441, 144.96515323"
11620240628,1,2024-06-28,16,1395,1196,2591,Bou292_T,"-37.81349441, 144.96515323"
181620250122,18,2025-01-22,16,528,128,656,Col12_T,"-37.81344862, 144.97305353"
181220250522,18,2025-05-22,12,283,274,557,Col12_T,"-37.81344862, 144.97305353"
631520240630,63,2024-06-30,15,299,387,686,Bou231_T,"-37.81333081, 144.96675571"
56520240315,56,2024-03-15,5,8,8,16,Lon364_T,"-37.81234775, 144.96153311"
562120240923,56,2024-09-23,21,184,200,384,Lon364_T,"-37.81234775, 144.96153311"
11020250610,11,2025-06-10,0,13,8,21,WatCit_T,"-37.81564989, 144.93970694"
24620240227,24,2024-02-27,6,365,198,563,Col620_T,"-37.81887963, 144.95449198"
122220231128,12,2023-11-28,22,99,120,219,NewQ_T,"-37.81457988, 144.94292398"
121220250609,12,2025-06-09,12,104,107,211,NewQ_T,"-37.81457988, 144.94292398"
562020250516,56,2025-05-16,20,439,532,971,Lon364_T,"-37.81234775, 144.96153311"
76820240104,76,2024-01-04,8,28,29,57,KenMac_T,"-37.79453803, 144.93036194"
76220240901,76,2024-09-01,2,1,1,2,KenMac_T,"-37.79453803, 144.93036194"
722120250426,72,2025-04-26,21,123,280,403,ACMI_T,"-37.81726338, 144.96872809"
2620231208,2,2023-12-08,6,12,26,38,Bou283_T,"-37.81380668, 144.96516718"
51020250921,5,2025-09-21,10,449,736,1185,PriNW_T,"-37.81874249, 144.96787656"
5520250108,5,2025-01-08,5,25,36,61,PriNW_T,"-37.81874249, 144.96787656"
212020231117,21,2023-11-17,20,524,640,1164,Bourke155_T,"-37.81267313, 144.96788288"
21820250328,21,2025-03-28,8,68,93,161,Bourke155_T,"-37.81267313, 144.96788288"
107920250917,107,2025-09-17,9,63,188,251,280Will_T,"-37.81246271, 144.95690188"
1331320250808,133,2025-08-08,13,559,504,1063,Spen229_T,"-37.81531435, 144.95227769"
1241220250515,124,2025-05-15,12,4,10,14,BirBridge_T,"-37.81757416, 144.97329934"
166120241229,166,2024-12-29,1,1,0,1,Spen484_T,"-37.80896733, 144.94931703"
1662220250628,166,2025-06-28,22,51,6,57,Spen484_T,"-37.80896733, 144.94931703"
179320251017,179,2025-10-17,3,0,1,1,Pow61_T,"-37.82392385, 144.96299677"
1671520250501,167,2025-05-01,15,46,96,142,Lat526_T,"-37.81304149, 144.95155955"
135920250526,135,2025-05-26,9,277,328,605,Spen161_T,"-37.8172861, 144.95319102"
1351720240513,135,2024-05-13,17,348,340,688,Spen161_T,"-37.8172861, 144.95319102"
135820240716,135,2024-07-16,8,278,338,616,Spen161_T,"-37.8172861, 144.95319102"
67020250201,67,2025-02-01,0,34,70,104,FLDegS_T,"-37.81688755, 144.96562569"
851520240703,85,2024-07-03,15,51,52,103,488Mac_T,"-37.79432415, 144.92973378"
17920240325,17,2024-03-25,9,870,388,1258,Col15_T,"-37.81362543, 144.97323591"
17020240625,17,2024-06-25,0,4,7,11,Col15_T,"-37.81362543, 144.97323591"
172220240815,17,2024-08-15,22,87,199,286,Col15_T,"-37.81362543, 144.97323591"
182220240409,18,2024-04-09,22,1,3,4,Col12_T,"-37.81344862, 144.97305353"
681320240109,68,2024-01-09,13,339,197,536,FLDegN_T,"-37.8168479, 144.96559789"
561820231215,56,2023-12-15,18,333,359,692,Lon364_T,"-37.81234775, 144.96153311"
111220240702,11,2024-07-02,12,166,147,313,WatCit_T,"-37.81564989, 144.93970694"
561520250510,56,2025-05-10,15,503,430,933,Lon364_T,"-37.81234775, 144.96153311"
10120250513,10,2025-05-13,1,4,0,4,BouHbr_T,"-37.81876474, 144.94710545"
56420250715,56,2025-07-15,4,1,0,1,Lon364_T,"-37.81234775, 144.96153311"
761320240904,76,2024-09-04,13,52,60,112,KenMac_T,"-37.79453803, 144.93036194"
35420241214,35,2024-12-14,4,14,35,49,SouthB_T,"-37.82018685, 144.96508508"
352320250309,35,2025-03-09,23,557,1134,1691,SouthB_T,"-37.82018685, 144.96508508"
21320240412,2,2024-04-12,13,975,1090,2065,Bou283_T,"-37.81380668, 144.96516718"
22120240506,2,2024-05-06,21,43,89,132,Bou283_T,"-37.81380668, 144.96516718"
2520240512,2,2024-05-12,5,2,6,8,Bou283_T,"-37.81380668, 144.96516718"
581920240207,58,2024-02-07,19,307,325,632,Bou688_T,"-37.81686075, 144.95358075"
27020250423,27,2025-04-23,0,10,1,11,Vic_T,"-37.80606888, 144.95644692"
531020240416,53,2024-04-16,10,473,411,884,Col254_T,"-37.81564191, 144.965499"
79920241230,79,2024-12-30,9,393,179,572,FliSS_T,"-37.81794046, 144.96616678"
20420240427,20,2024-04-27,4,14,19,33,LtB170_T,"-37.81172914, 144.9682466"
251320241118,25,2024-11-18,13,695,839,1534,MCEC_T,"-37.82401776, 144.95604426"
52820250815,52,2025-08-15,8,121,273,394,Eli263_T,"-37.81252157, 144.9619401"
51120240501,51,2024-05-01,1,13,7,20,Fra118_T,"-37.80841815, 144.95906316"
1411620240805,141,2024-08-05,16,140,100,240,474Fl_T,"-37.81997273, 144.95834911"
141920250116,141,2025-01-16,9,160,106,266,474Fl_T,"-37.81997273, 144.95834911"
49120250112,49,2025-01-12,1,55,31,86,Eli501_T,"-37.80730068, 144.95956055"
109520240930,109,2024-09-30,5,12,27,39,LatWill_T,"-37.81193681, 144.95621105"
19120250720,19,2025-07-20,1,129,161,290,LtB210_T,"-37.81237202, 144.96550671"
192120240411,19,2024-04-11,21,360,710,1070,LtB210_T,"-37.81237202, 144.96550671"
48320240105,48,2024-01-05,3,6,11,17,QVMQ_T,"-37.80631581, 144.95866697"
1371820250217,137,2025-02-17,18,13,39,52,BouHbr2353_T,"-37.81894815, 144.94612292"
1391520250810,139,2025-08-10,15,54,42,96,Signal1647_T,"-37.81959923, 144.9632832"
142620250611,142,2025-06-11,6,4,2,6,Hammer1584_T,"-37.81970749, 144.96795734"
1421720250723,142,2025-07-23,17,219,164,383,Hammer1584_T,"-37.81970749, 144.96795734"
66620250415,66,2025-04-15,6,27,91,118,QVN_T,"-37.81057846, 144.96444294"
351520250824,35,2025-08-24,15,1617,1714,3331,SouthB_T,"-37.82018685, 144.96508508"
271620240702,27,2024-07-02,16,130,98,228,Vic_T,"-37.80606888, 144.95644692"
272220240104,27,2024-01-04,22,53,32,85,Vic_T,"-37.80606888, 144.95644692"
53320250824,53,2025-08-24,3,13,24,37,Col254_T,"-37.81564191, 144.965499"
532120250925,53,2025-09-25,21,182,280,462,Col254_T,"-37.81564191, 144.965499"
531720240906,53,2024-09-06,17,709,452,1161,Col254_T,"-37.81564191, 144.965499"
53620241128,53,2024-11-28,6,56,59,115,Col254_T,"-37.81564191, 144.965499"
30020250527,30,2025-05-27,0,38,45,83,Lon189_T,"-37.8112185, 144.96656806"
25620231022,25,2023-10-22,6,34,39,73,MCEC_T,"-37.82401776, 144.95604426"
46620241007,46,2024-10-07,6,1,6,7,Pel147_T,"-37.80240719, 144.9615673"
461420250518,46,2025-05-18,14,62,49,111,Pel147_T,"-37.80240719, 144.9615673"
512120240519,51,2024-05-19,21,45,39,84,Fra118_T,"-37.80841815, 144.95906316"
51920231227,51,2023-12-27,9,59,41,100,Fra118_T,"-37.80841815, 144.95906316"
19020250811,19,2025-08-11,0,48,65,113,LtB210_T,"-37.81237202, 144.96550671"
491920250622,49,2025-06-22,19,193,176,369,Eli501_T,"-37.80730068, 144.95956055"
492120250130,49,2025-01-30,21,152,96,248,Eli501_T,"-37.80730068, 144.95956055"
49220250219,49,2025-02-19,2,25,27,52,Eli501_T,"-37.80730068, 144.95956055"
48920250114,48,2025-01-14,9,193,152,345,QVMQ_T,"-37.80631581, 144.95866697"
136720240328,136,2024-03-28,7,42,50,92,BirFed1120_T,"-37.8184141, 144.97357915"
1641020240918,164,2024-09-18,10,102,50,152,Lat526_T,"-37.813005, 144.95160411"
138120240927,138,2024-09-27,1,2,0,2,EntPark1671_T,"-37.81996544, 144.95981454"
117520250501,117,2025-05-01,5,14,7,21,Fli114F_T,"-37.81629332, 144.97090877"
69020240504,69,2024-05-04,0,8,1,9,FLDegC_T,"-37.81687226, 144.96559144"
691820241029,69,2024-10-29,18,116,118,234,FLDegC_T,"-37.81687226, 144.96559144"
691520250514,69,2025-05-14,15,136,213,349,FLDegC_T,"-37.81687226, 144.96559144"
41120231215,41,2023-12-15,1,84,121,205,Swa31,"-37.81668634, 144.96689733"
41720241107,41,2024-11-07,7,778,248,1026,Swa31,"-37.81668634, 144.96689733"
141520240323,14,2024-03-23,15,647,185,832,SanBri_T,"-37.82011242, 144.96291897"
54720240817,54,2024-08-17,7,28,17,45,Swa607_T,"-37.804024, 144.96308399"
211720240422,21,2024-04-22,17,457,398,855,Bourke155_T,"-37.81267313, 144.96788288"
361420240720,36,2024-07-20,14,131,116,247,Que85_T,"-37.81652527, 144.96121062"
61520241231,61,2024-12-31,5,14,5,19,RMIT14_T,"-37.80767455, 144.96309114"
501420231223,50,2023-12-23,14,412,467,879,Lyg309_T,"-37.79808192, 144.96721013"
431520241223,43,2024-12-23,15,45,40,85,UM2_T,"-37.79844526, 144.96411782"
45120240618,45,2024-06-18,1,15,23,38,Swa148_T,"-37.81414075, 144.96609379"
45820250918,45,2025-09-18,8,302,343,645,Swa148_T,"-37.81414075, 144.96609379"
52120241203,5,2024-12-03,21,533,669,1202,PriNW_T,"-37.81874249, 144.96787656"
5020240830,5,2024-08-30,0,21,49,70,PriNW_T,"-37.81874249, 144.96787656"
5420231022,5,2023-10-22,4,18,26,44,PriNW_T,"-37.81874249, 144.96787656"
1071420231129,107,2023-11-29,14,31,49,80,280Will_T,"-37.81246271, 144.95690188"
1181920241007,118,2024-10-07,19,8,9,17,Fli114C_T,"-37.81632783, 144.97090512"
124820231021,124,2023-10-21,8,1,1,2,BirBridge_T,"-37.81757416, 144.97329934"
1241720231217,124,2023-12-17,17,0,1,1,BirBridge_T,"-37.81757416, 144.97329934"
84820240205,84,2024-02-05,8,1358,422,1780,ElFi_T,"-37.81798049, 144.96503383"
61920250726,6,2025-07-26,19,539,676,1215,FliS_T,"-37.81911705, 144.96558255"
391820250328,39,2025-03-28,18,123,56,179,AlfPl_T,"-37.81379749, 144.96995745"
39320250407,39,2025-04-07,3,4,5,9,AlfPl_T,"-37.81379749, 144.96995745"
751020241125,75,2024-11-25,10,10,8,18,SprFli_T,"-37.81515276, 144.97467661"
41720250407,41,2025-04-07,7,784,364,1148,Swa31,"-37.81668634, 144.96689733"
71320240924,71,2024-09-24,3,11,4,15,WestWP_T,"-37.81235775, 144.97136962"
712020250118,71,2025-01-18,20,3,5,8,WestWP_T,"-37.81235775, 144.97136962"
28120240613,28,2024-06-13,1,4,9,13,VAC_T,"-37.82129925, 144.96879309"
471620231018,47,2023-10-18,16,1152,832,1984,Eli250_T,"-37.81258467, 144.9625775"
31820240426,31,2024-04-26,8,67,44,111,Lyg161_T,"-37.80169681, 144.96658911"
361320241029,36,2024-10-29,13,297,325,622,Que85_T,"-37.81652527, 144.96121062"
362120240317,36,2024-03-17,21,77,76,153,Que85_T,"-37.81652527, 144.96121062"
452020240829,45,2024-08-29,20,366,707,1073,Swa148_T,"-37.81414075, 144.96609379"
45020250729,45,2025-07-29,0,4,43,47,Swa148_T,"-37.81414075, 144.96609379"
1181920231223,118,2023-12-23,19,24,78,102,Fli114C_T,"-37.81632783, 144.97090512"
1081120250303,108,2025-03-03,11,337,340,677,261Will_T,"-37.81295822, 144.95678789"
1661320250414,166,2025-04-14,13,73,64,137,Spen484_T,"-37.80896733, 144.94931703"
132920240512,132,2024-05-12,9,167,65,232,King335_T,"-37.81267639, 144.95386444"
1342120250413,134,2025-04-13,21,291,178,469,Spen201_T,"-37.81694221, 144.95303935"
441920250720,44,2025-07-20,19,13,7,20,UM3_T,"-37.79698741, 144.96441306"
166620250104,166,2025-01-04,6,5,3,8,Spen484_T,"-37.80896733, 144.94931703"
1621020250506,162,2025-05-06,10,383,407,790,Eli489_T,"-37.80740397, 144.95987909"
85620231227,85,2023-12-27,6,9,4,13,488Mac_T,"-37.79432415, 144.92973378"
851420241205,85,2024-12-05,14,46,62,108,488Mac_T,"-37.79432415, 144.92973378"
85020250924,85,2025-09-24,0,2,0,2,488Mac_T,"-37.79432415, 144.92973378"
171420240318,17,2024-03-18,14,404,357,761,Col15_T,"-37.81362543, 144.97323591"
171220240627,17,2024-06-27,12,773,686,1459,Col15_T,"-37.81362543, 144.97323591"
181120240321,18,2024-03-21,11,223,293,516,Col12_T,"-37.81344862, 144.97305353"
632120250813,63,2025-08-13,21,38,121,159,Bou231_T,"-37.81333081, 144.96675571"
241620240819,24,2024-08-19,16,499,1632,2131,Col620_T,"-37.81887963, 144.95449198"
10720240104,10,2024-01-04,7,9,42,51,BouHbr_T,"-37.81876474, 144.94710545"
10720241201,10,2024-12-01,7,23,13,36,BouHbr_T,"-37.81876474, 144.94710545"
24620241216,24,2024-12-16,6,251,119,370,Col620_T,"-37.81887963, 144.95449198"
561820250706,56,2025-07-06,18,414,459,873,Lon364_T,"-37.81234775, 144.96153311"
351020240514,35,2024-05-14,10,528,478,1006,SouthB_T,"-37.82018685, 144.96508508"
21920240715,2,2024-07-15,19,115,100,215,Bou283_T,"-37.81380668, 144.96516718"
22020240824,2,2024-08-24,20,235,276,511,Bou283_T,"-37.81380668, 144.96516718"
581420250326,58,2025-03-26,14,597,499,1096,Bou688_T,"-37.81686075, 144.95358075"
58520231205,58,2023-12-05,5,100,23,123,Bou688_T,"-37.81686075, 144.95358075"
76520250724,76,2025-07-24,5,0,1,1,KenMac_T,"-37.79453803, 144.93036194"
272220241006,27,2024-10-06,22,40,28,68,Vic_T,"-37.80606888, 144.95644692"
1852320250802,185,2025-08-02,23,389,297,686,Eli197_T,"-37.81374643, 144.96276183"
108220240111,108,2024-01-11,2,18,15,33,261Will_T,"-37.81295822, 144.95678789"
872020241118,87,2024-11-18,20,51,45,96,Errol23_T,"-37.80454949, 144.94921863"
1821720251001,182,2025-10-01,17,379,234,613,King163_T,"-37.81627451, 144.95550503"
167320250206,167,2025-02-06,3,0,2,2,Lat526_T,"-37.81304149, 144.95155955"
1651020240915,165,2024-09-15,10,16,43,59,Spen475_T,"-37.80953359, 144.94939004"
681020250905,68,2025-09-05,10,215,206,421,FLDegN_T,"-37.8168479, 144.96559789"
182220231106,18,2023-11-06,22,14,15,29,Col12_T,"-37.81344862, 144.97305353"
562020240227,56,2024-02-27,20,244,286,530,Lon364_T,"-37.81234775, 144.96153311"
101120250520,10,2025-05-20,11,107,73,180,BouHbr_T,"-37.81876474, 144.94710545"
72420240310,72,2024-03-10,4,5,0,5,ACMI_T,"-37.81726338, 144.96872809"
761520240812,76,2024-08-12,15,55,105,160,KenMac_T,"-37.79453803, 144.93036194"
271620240628,27,2024-06-28,16,165,89,254,Vic_T,"-37.80606888, 144.95644692"
252220231228,25,2023-12-28,22,202,251,453,MCEC_T,"-37.82401776, 144.95604426"
51320250618,51,2025-06-18,3,1,5,6,Fra118_T,"-37.80841815, 144.95906316"
23320241129,23,2024-11-29,3,5,20,25,Col623_T,"-37.81909256, 144.95452748"
231220231224,23,2023-12-24,12,107,138,245,Col623_T,"-37.81909256, 144.95452748"
141720241201,141,2024-12-01,7,34,23,57,474Fl_T,"-37.81997273, 144.95834911"
1391620250113,139,2025-01-13,16,182,45,227,Signal1647_T,"-37.81959923, 144.9632832"
136920231127,136,2023-11-27,9,56,35,91,BirFed1120_T,"-37.8184141, 144.97357915"
1422320241012,142,2024-10-12,23,12,8,20,Hammer1584_T,"-37.81970749, 144.96795734"
117520240612,117,2024-06-12,5,11,7,18,Fli114F_T,"-37.81629332, 144.97090877"
6120240822,6,2024-08-22,1,7,21,28,FliS_T,"-37.81911705, 144.96558255"
6820250107,6,2025-01-07,8,758,1804,2562,FliS_T,"-37.81911705, 144.96558255"
66020231227,66,2023-12-27,0,79,52,131,QVN_T,"-37.81057846, 144.96444294"
70320240512,70,2024-05-12,3,1,5,6,Errol20_T,"-37.80456984, 144.94946228"
751120240522,75,2024-05-22,11,56,44,100,SprFli_T,"-37.81515276, 144.97467661"
392120250902,39,2025-09-02,21,14,18,32,AlfPl_T,"-37.81379749, 144.96995745"
39520250209,39,2025-02-09,5,0,1,1,AlfPl_T,"-37.81379749, 144.96995745"
81620241205,8,2024-12-05,16,119,355,474,WebBN_T,"-37.82293543, 144.9471751"
41120250831,41,2025-08-31,1,218,568,786,Swa31,"-37.81668634, 144.96689733"
421120250114,42,2025-01-14,11,84,93,177,UM1_T,"-37.80008566, 144.96386412"
771020240608,77,2024-06-08,10,100,122,222,HarEsP_T,"-37.81441438, 144.94433026"
292120240211,29,2024-02-11,21,78,186,264,AG_T,"-37.8199817, 144.96872865"
29620240229,29,2024-02-29,6,11,8,19,AG_T,"-37.8199817, 144.96872865"
71720241125,71,2024-11-25,7,23,18,41,WestWP_T,"-37.81235775, 144.97136962"
592120240707,59,2024-07-07,21,290,131,421,RMIT_T,"-37.80825648, 144.96304859"
65020240503,65,2024-05-03,0,101,42,143,SwaCs_T,"-37.81569416, 144.9668064"
652320240412,65,2024-04-12,23,101,333,434,SwaCs_T,"-37.81569416, 144.9668064"
541820250530,54,2025-05-30,18,167,305,472,Swa607_T,"-37.804024, 144.96308399"
54220250622,54,2025-06-22,2,26,10,36,Swa607_T,"-37.804024, 144.96308399"
541720250706,54,2025-07-06,17,79,86,165,Swa607_T,"-37.804024, 144.96308399"
471420241224,47,2024-12-24,14,990,1090,2080,Eli250_T,"-37.81258467, 144.9625775"
131520240405,131,2024-04-05,5,12,16,28,King2_T,"-37.82009057, 144.95758725"
162920240820,162,2024-08-20,9,262,255,517,Eli489_T,"-37.80740397, 144.95987909"
1351520241102,135,2024-11-02,15,586,451,1037,Spen161_T,"-37.8172861, 144.95319102"
1071220250622,107,2025-06-22,12,71,180,251,280Will_T,"-37.81246271, 144.95690188"
1331820241209,133,2024-12-09,18,779,593,1372,Spen229_T,"-37.81531435, 144.95227769"
118920240831,118,2024-08-31,9,12,35,47,Fli114C_T,"-37.81632783, 144.97090512"
1241520241222,124,2024-12-22,15,3,5,8,BirBridge_T,"-37.81757416, 144.97329934"
852320240326,85,2024-03-26,23,0,5,5,488Mac_T,"-37.79432415, 144.92973378"
67920240824,67,2024-08-24,9,328,308,636,FLDegS_T,"-37.81688755, 144.96562569"
181720250411,18,2025-04-11,17,459,180,639,Col12_T,"-37.81344862, 144.97305353"
18920250722,18,2025-07-22,9,126,681,807,Col12_T,"-37.81344862, 144.97305353"
622120240321,62,2024-03-21,21,236,116,352,Lat224_T,"-37.80996494, 144.96216521"
56720231105,56,2023-11-05,7,44,15,59,Lon364_T,"-37.81234775, 144.96153311"
861920250102,86,2025-01-02,19,36,48,84,574Qub_T,"-37.80309992, 144.94908064"
111120231112,11,2023-11-12,11,129,149,278,WatCit_T,"-37.81564989, 144.93970694"
24120231101,24,2023-11-01,1,35,30,65,Col620_T,"-37.81887963, 144.95449198"
101220240510,10,2024-05-10,12,139,99,238,BouHbr_T,"-37.81876474, 144.94710545"
721120231228,72,2023-12-28,11,230,221,451,ACMI_T,"-37.81726338, 144.96872809"
721620250529,72,2025-05-29,16,140,579,719,ACMI_T,"-37.81726338, 144.96872809"
22220240514,2,2024-05-14,22,26,77,103,Bou283_T,"-37.81380668, 144.96516718"
351820250117,35,2025-01-17,18,1846,2129,3975,SouthB_T,"-37.82018685, 144.96508508"
27720241011,27,2024-10-11,7,39,42,81,Vic_T,"-37.80606888, 144.95644692"
271320231116,27,2023-11-16,13,153,145,298,Vic_T,"-37.80606888, 144.95644692"
92220240618,9,2024-06-18,22,54,19,73,Col700_T,"-37.81982992, 144.95102555"
532020240818,53,2024-08-18,20,125,148,273,Col254_T,"-37.81564191, 144.965499"
79020250609,79,2025-06-09,0,73,95,168,FliSS_T,"-37.81794046, 144.96616678"
79620250110,79,2025-01-10,6,68,59,127,FliSS_T,"-37.81794046, 144.96616678"
521520250314,52,2025-03-14,15,478,273,751,Eli263_T,"-37.81252157, 144.9619401"
23120240308,23,2024-03-08,1,7,19,26,Col623_T,"-37.81909256, 144.95452748"
1611920241016,161,2024-10-16,19,98,84,182,BirArt1109_T,"-37.81851276, 144.97131336"
1611120241225,161,2024-12-25,11,40,91,131,BirArt1109_T,"-37.81851276, 144.97131336"
1411920240717,141,2024-07-17,19,57,54,111,474Fl_T,"-37.81997273, 144.95834911"
1411720250126,141,2025-01-26,17,162,119,281,474Fl_T,"-37.81997273, 144.95834911"
138720250217,138,2025-02-17,7,2,1,3,EntPark1671_T,"-37.81996544, 144.95981454"
137720241018,137,2024-10-18,7,13,5,18,BouHbr2353_T,"-37.81894815, 144.94612292"
1362120240510,136,2024-05-10,21,2,1,3,BirFed1120_T,"-37.8184141, 144.97357915"
66120231222,66,2023-12-22,1,88,54,142,QVN_T,"-37.81057846, 144.96444294"
701020240404,70,2024-04-04,10,86,113,199,Errol20_T,"-37.80456984, 144.94946228"
701320250125,70,2025-01-25,13,130,144,274,Errol20_T,"-37.80456984, 144.94946228"
702020250513,70,2025-05-13,20,133,98,231,Errol20_T,"-37.80456984, 144.94946228"
701620250522,70,2025-05-22,16,171,145,316,Errol20_T,"-37.80456984, 144.94946228"
39220240102,39,2024-01-02,2,0,5,5,AlfPl_T,"-37.81379749, 144.96995745"
14520250317,14,2025-03-17,5,45,40,85,SanBri_T,"-37.82011242, 144.96291897"
711920241113,71,2024-11-13,19,5,9,14,WestWP_T,"-37.81235775, 144.97136962"
711020250719,71,2025-07-19,10,3,14,17,WestWP_T,"-37.81235775, 144.97136962"
401120250416,40,2025-04-16,11,283,306,589,Spr201_T,"-37.80999341, 144.97227587"
27620231128,27,2023-11-28,6,17,19,36,Vic_T,"-37.80606888, 144.95644692"
91220241110,9,2024-11-10,12,53,71,124,Col700_T,"-37.81982992, 144.95102555"
201220231207,20,2023-12-07,12,386,251,637,LtB170_T,"-37.81172914, 144.9682466"
25820231102,25,2023-11-02,8,284,536,820,MCEC_T,"-37.82401776, 144.95604426"
1611320250819,161,2025-08-19,13,264,177,441,BirArt1109_T,"-37.81851276, 144.97131336"
1171120250217,117,2025-02-17,11,140,135,275,Fli114F_T,"-37.81629332, 144.97090877"
491920231019,49,2023-10-19,19,157,142,299,Eli501_T,"-37.80730068, 144.95956055"
136020250628,136,2025-06-28,0,2,0,2,BirFed1120_T,"-37.8184141, 144.97357915"
61620231228,6,2023-12-28,16,1122,989,2111,FliS_T,"-37.81911705, 144.96558255"
84320250921,84,2025-09-21,3,59,94,153,ElFi_T,"-37.81798049, 144.96503383"
771920251006,77,2025-10-06,19,174,121,295,HarEsP_T,"-37.81441438, 144.94433026"
782320240416,78,2024-04-16,23,1,5,6,HarEsB_T,"-37.81471642, 144.9446508"
14420240917,14,2024-09-17,4,22,4,26,SanBri_T,"-37.82011242, 144.96291897"
712320240312,71,2024-03-12,23,1,3,4,WestWP_T,"-37.81235775, 144.97136962"
71920250515,71,2025-05-15,9,26,12,38,WestWP_T,"-37.81235775, 144.97136962"
54320240616,54,2024-06-16,3,30,6,36,Swa607_T,"-37.804024, 144.96308399"
311320231230,31,2023-12-30,13,211,124,335,Lyg161_T,"-37.80169681, 144.96658911"
362120251007,36,2025-10-07,21,58,90,148,Que85_T,"-37.81652527, 144.96121062"
431920231024,43,2023-10-24,19,122,162,284,UM2_T,"-37.79844526, 144.96411782"
43520240302,43,2024-03-02,5,6,1,7,UM2_T,"-37.79844526, 144.96411782"
211720250123,21,2025-01-23,17,465,399,864,Bourke155_T,"-37.81267313, 144.96788288"
1322220250830,132,2025-08-30,22,84,82,166,King335_T,"-37.81267639, 144.95386444"
61020240227,6,2024-02-27,10,491,418,909,FliS_T,"-37.81911705, 144.96558255"
841820250924,84,2025-09-24,18,568,914,1482,ElFi_T,"-37.81798049, 144.96503383"
77120250402,77,2025-04-02,1,6,1,7,HarEsP_T,"-37.81441438, 144.94433026"
782120240715,78,2024-07-15,21,0,4,4,HarEsB_T,"-37.81471642, 144.9446508"
141320240805,14,2024-08-05,13,292,157,449,SanBri_T,"-37.82011242, 144.96291897"
71920241102,71,2024-11-02,9,7,6,13,WestWP_T,"-37.81235775, 144.97136962"
652120240728,65,2024-07-28,21,162,345,507,SwaCs_T,"-37.81569416, 144.9668064"
31620250202,31,2025-02-02,6,12,3,15,Lyg161_T,"-37.80169681, 144.96658911"
212120241029,21,2024-10-29,21,163,188,351,Bourke155_T,"-37.81267313, 144.96788288"
361720241014,36,2024-10-14,17,263,257,520,Que85_T,"-37.81652527, 144.96121062"
36520240127,36,2024-01-27,5,10,9,19,Que85_T,"-37.81652527, 144.96121062"
61820231115,61,2023-11-15,8,182,326,508,RMIT14_T,"-37.80767455, 144.96309114"
501520240409,50,2024-04-09,15,197,162,359,Lyg309_T,"-37.79808192, 144.96721013"
431820231115,43,2023-11-15,18,401,281,682,UM2_T,"-37.79844526, 144.96411782"
441920240515,44,2024-05-15,19,56,89,145,UM3_T,"-37.79698741, 144.96441306"
452220241116,45,2024-11-16,22,358,837,1195,Swa148_T,"-37.81414075, 144.96609379"
1651920250107,165,2025-01-07,19,42,29,71,Spen475_T,"-37.80953359, 144.94939004"
1661920250717,166,2025-07-17,19,22,43,65,Spen484_T,"-37.80896733, 144.94931703"
1791920250216,179,2025-02-16,19,76,63,139,Pow61_T,"-37.82392385, 144.96299677"
1671320250424,167,2025-04-24,13,8,22,30,Lat526_T,"-37.81304149, 144.95155955"
131520240808,131,2024-08-08,5,1,5,6,King2_T,"-37.82009057, 144.95758725"
1321120241108,132,2024-11-08,11,118,75,193,King335_T,"-37.81267639, 144.95386444"
132820231231,132,2023-12-31,8,62,24,86,King335_T,"-37.81267639, 144.95386444"
1322120240422,132,2024-04-22,21,78,76,154,King335_T,"-37.81267639, 144.95386444"
1331320250613,133,2025-06-13,13,568,458,1026,Spen229_T,"-37.81531435, 144.95227769"
1331420231229,133,2023-12-29,14,501,596,1097,Spen229_T,"-37.81531435, 144.95227769"
1182320240126,118,2024-01-26,23,6,8,14,Fli114C_T,"-37.81632783, 144.97090512"
118620240730,118,2024-07-30,6,1,1,2,Fli114C_T,"-37.81632783, 144.97090512"
671020250423,67,2025-04-23,10,323,356,679,FLDegS_T,"-37.81688755, 144.96562569"
172220250212,17,2025-02-12,22,48,61,109,Col15_T,"-37.81362543, 144.97323591"
62820240329,62,2024-03-29,8,25,26,51,Lat224_T,"-37.80996494, 144.96216521"
561720240130,56,2024-01-30,17,330,350,680,Lon364_T,"-37.81234775, 144.96153311"
561120240912,56,2024-09-12,11,254,192,446,Lon364_T,"-37.81234775, 144.96153311"
56720250221,56,2025-02-21,7,68,58,126,Lon364_T,"-37.81234775, 144.96153311"
86120250204,86,2025-02-04,1,0,1,1,574Qub_T,"-37.80309992, 144.94908064"
122120240307,12,2024-03-07,21,170,178,348,NewQ_T,"-37.81457988, 144.94292398"
11320250104,11,2025-01-04,3,3,8,11,WatCit_T,"-37.81564989, 144.93970694"
11720250415,11,2025-04-15,7,91,68,159,WatCit_T,"-37.81564989, 144.93970694"
762120241123,76,2024-11-23,21,22,21,43,KenMac_T,"-37.79453803, 144.93036194"
35220250528,35,2025-05-28,2,8,8,16,SouthB_T,"-37.82018685, 144.96508508"
58820241203,58,2024-12-03,8,1856,157,2013,Bou688_T,"-37.81686075, 144.95358075"
79220240325,79,2024-03-25,2,19,20,39,FliSS_T,"-37.81794046, 144.96616678"
791020240711,79,2024-07-11,10,444,276,720,FliSS_T,"-37.81794046, 144.96616678"
792120231105,79,2023-11-05,21,216,364,580,FliSS_T,"-37.81794046, 144.96616678"
791520250510,79,2025-05-10,15,657,598,1255,FliSS_T,"-37.81794046, 144.96616678"
461020250322,46,2025-03-22,10,45,46,91,Pel147_T,"-37.80240719, 144.9615673"
20820250816,20,2025-08-16,8,27,44,71,LtB170_T,"-37.81172914, 144.9682466"
25220231024,25,2023-10-24,2,9,10,19,MCEC_T,"-37.82401776, 144.95604426"
251220240313,25,2024-03-13,12,0,0,0,MCEC_T,"-37.82401776, 144.95604426"
141320241125,141,2024-11-25,3,13,16,29,474Fl_T,"-37.81997273, 144.95834911"
123820250218,123,2025-02-18,8,85,8,93,BirBridge_T,"-37.81753741, 144.97329734"
491220240821,49,2024-08-21,12,294,325,619,Eli501_T,"-37.80730068, 144.95956055"
49720240901,49,2024-09-01,7,60,56,116,Eli501_T,"-37.80730068, 144.95956055"
471320250629,47,2025-06-29,13,940,1245,2185,Eli250_T,"-37.81258467, 144.9625775"
1331920250902,133,2025-09-02,19,410,331,741,Spen229_T,"-37.81531435, 144.95227769"
133120231224,133,2023-12-24,1,48,35,83,Spen229_T,"-37.81531435, 144.95227769"
108420241016,108,2024-10-16,4,1,3,4,261Will_T,"-37.81295822, 144.95678789"
612020241002,61,2024-10-02,20,471,275,746,RMIT14_T,"-37.80767455, 144.96309114"
44320250531,44,2025-05-31,3,10,0,10,UM3_T,"-37.79698741, 144.96441306"
1671620250624,167,2025-06-24,16,51,70,121,Lat526_T,"-37.81304149, 144.95155955"
1652120250428,165,2025-04-28,21,21,4,25,Spen475_T,"-37.80953359, 144.94939004"
131420231020,131,2023-10-20,4,7,8,15,King2_T,"-37.82009057, 144.95758725"
1311320240804,131,2024-08-04,13,110,131,241,King2_T,"-37.82009057, 144.95758725"
1621520240701,162,2024-07-01,15,262,308,570,Eli489_T,"-37.80740397, 144.95987909"
1321920241008,132,2024-10-08,19,163,164,327,King335_T,"-37.81267639, 144.95386444"
1351220250828,135,2025-08-28,12,383,422,805,Spen161_T,"-37.8172861, 144.95319102"
851820240911,85,2024-09-11,18,56,77,133,488Mac_T,"-37.79432415, 144.92973378"
18220250105,18,2025-01-05,2,6,2,8,Col12_T,"-37.81344862, 144.97305353"
18520250430,18,2025-04-30,5,1,14,15,Col12_T,"-37.81344862, 144.97305353"
11420250116,11,2025-01-16,4,0,1,1,WatCit_T,"-37.81564989, 144.93970694"
11320240707,11,2024-07-07,3,0,3,3,WatCit_T,"-37.81564989, 144.93970694"
2120240929,2,2024-09-29,1,50,74,124,Bou283_T,"-37.81380668, 144.96516718"
35220240127,35,2024-01-27,2,64,106,170,SouthB_T,"-37.82018685, 144.96508508"
79620241115,79,2024-11-15,6,122,55,177,FliSS_T,"-37.81794046, 144.96616678"
30820240901,30,2024-09-01,8,41,97,138,Lon189_T,"-37.8112185, 144.96656806"
30520240119,30,2024-01-19,5,15,44,59,Lon189_T,"-37.8112185, 144.96656806"
25420231209,25,2023-12-09,4,5,16,21,MCEC_T,"-37.82401776, 144.95604426"
522120241018,52,2024-10-18,21,307,195,502,Eli263_T,"-37.81252157, 144.9619401"
231720250314,23,2025-03-14,17,332,567,899,Col623_T,"-37.81909256, 144.95452748"
1231820231104,123,2023-11-04,18,49,27,76,BirBridge_T,"-37.81753741, 144.97329734"
1611820240830,161,2024-08-30,18,23,17,40,BirArt1109_T,"-37.81851276, 144.97131336"
1171720250425,117,2025-04-25,17,128,101,229,Fli114F_T,"-37.81629332, 144.97090877"
1172020231210,117,2023-12-10,20,121,218,339,Fli114F_T,"-37.81629332, 144.97090877"
1171520241117,117,2024-11-17,15,150,230,380,Fli114F_T,"-37.81629332, 144.97090877"
1171620250123,117,2025-01-23,16,232,381,613,Fli114F_T,"-37.81629332, 144.97090877"
481920250513,48,2025-05-13,19,76,91,167,QVMQ_T,"-37.80631581, 144.95866697"
141620240604,141,2024-06-04,6,27,17,44,474Fl_T,"-37.81997273, 144.95834911"
49320231025,49,2023-10-25,3,22,31,53,Eli501_T,"-37.80730068, 144.95956055"
136820250528,136,2025-05-28,8,106,198,304,BirFed1120_T,"-37.8184141, 144.97357915"
11720250423,1,2025-04-23,17,1385,986,2371,Bou292_T,"-37.81349441, 144.96515323"
671120250513,67,2025-05-13,11,421,567,988,FLDegS_T,"-37.81688755, 144.96562569"
68020240329,68,2024-03-29,0,5,3,8,FLDegN_T,"-37.8168479, 144.96559789"
67620240805,67,2024-08-05,6,36,28,64,FLDegS_T,"-37.81688755, 144.96562569"
562020250403,56,2025-04-03,20,208,295,503,Lon364_T,"-37.81234775, 144.96153311"
11320241109,11,2024-11-09,3,1,6,7,WatCit_T,"-37.81564989, 144.93970694"
24920240317,24,2024-03-17,9,532,513,1045,Col620_T,"-37.81887963, 144.95449198"
56520250702,56,2025-07-02,5,2,5,7,Lon364_T,"-37.81234775, 144.96153311"
49520240713,49,2024-07-13,5,27,29,56,Eli501_T,"-37.80730068, 144.95956055"
192120250712,19,2025-07-12,21,557,644,1201,LtB210_T,"-37.81237202, 144.96550671"
109420241026,109,2024-10-26,4,14,6,20,LatWill_T,"-37.81193681, 144.95621105"
139920251012,139,2025-10-12,9,46,50,96,Signal1647_T,"-37.81959923, 144.9632832"
1371320240118,137,2024-01-18,13,50,65,115,BouHbr2353_T,"-37.81894815, 144.94612292"
1361520241129,136,2024-11-29,15,112,46,158,BirFed1120_T,"-37.8184141, 144.97357915"
142920240815,142,2024-08-15,9,211,152,363,Hammer1584_T,"-37.81970749, 144.96795734"
1301220250105,130,2025-01-05,12,33,10,43,Bou892T,"-37.8204637, 144.94126826"
1301420250116,130,2025-01-16,14,71,37,108,Bou892T,"-37.8204637, 144.94126826"
691520240820,69,2024-08-20,15,125,138,263,FLDegC_T,"-37.81687226, 144.96559144"
691720250505,69,2025-05-05,17,87,174,261,FLDegC_T,"-37.81687226, 144.96559144"
842020231201,84,2023-12-01,20,778,1154,1932,ElFi_T,"-37.81798049, 144.96503383"
842120250927,84,2025-09-27,21,676,811,1487,ElFi_T,"-37.81798049, 144.96503383"
70920250323,70,2025-03-23,9,73,73,146,Errol20_T,"-37.80456984, 144.94946228"
39520250714,39,2025-07-14,5,3,3,6,AlfPl_T,"-37.81379749, 144.96995745"
39920240423,39,2024-04-23,9,143,172,315,AlfPl_T,"-37.81379749, 144.96995745"
82020240624,8,2024-06-24,20,26,25,51,WebBN_T,"-37.82293543, 144.9471751"
141220231030,14,2023-10-30,12,316,121,437,SanBri_T,"-37.82011242, 144.96291897"
71820240510,71,2024-05-10,8,11,11,22,WestWP_T,"-37.81235775, 144.97136962"
311420250227,31,2025-02-27,14,139,185,324,Lyg161_T,"-37.80169681, 144.96658911"
51020240118,5,2024-01-18,10,675,1047,1722,PriNW_T,"-37.81874249, 144.96787656"
21420240520,21,2024-05-20,4,7,8,15,Bourke155_T,"-37.81267313, 144.96788288"
21720250329,21,2025-03-29,7,19,24,43,Bourke155_T,"-37.81267313, 144.96788288"
361620240908,36,2024-09-08,16,75,70,145,Que85_T,"-37.81652527, 144.96121062"
611520250412,61,2025-04-12,15,477,506,983,RMIT14_T,"-37.80767455, 144.96309114"
611920250807,61,2025-08-07,19,334,424,758,RMIT14_T,"-37.80767455, 144.96309114"
50420250815,50,2025-08-15,4,10,2,12,Lyg309_T,"-37.79808192, 144.96721013"
452120241121,45,2024-11-21,21,471,750,1221,Swa148_T,"-37.81414075, 144.96609379"
1812020250517,181,2025-05-17,20,559,771,1330,Eli368_T,"-37.81009465, 144.96143149"
1811420250723,181,2025-07-23,14,607,925,1532,Eli368_T,"-37.81009465, 144.96143149"
131220240831,131,2024-08-31,2,21,51,72,King2_T,"-37.82009057, 144.95758725"
1622320250416,162,2025-04-16,23,102,59,161,Eli489_T,"-37.80740397, 144.95987909"
1401020231207,140,2023-12-07,10,102,34,136,Boyd2837_T,"-37.82590962, 144.96185972"
132920231126,132,2023-11-26,9,52,24,76,King335_T,"-37.81267639, 144.95386444"
132220240425,132,2024-04-25,2,35,16,51,King335_T,"-37.81267639, 144.95386444"
134820241204,134,2024-12-04,8,426,446,872,Spen201_T,"-37.81694221, 144.95303935"
135320240810,135,2024-08-10,3,20,13,33,Spen161_T,"-37.8172861, 144.95319102"
1331120231222,133,2023-12-22,11,422,520,942,Spen229_T,"-37.81531435, 144.95227769"
171520240204,17,2024-02-04,15,123,127,250,Col15_T,"-37.81362543, 144.97323591"
681720250425,68,2025-04-25,17,120,78,198,FLDegN_T,"-37.8168479, 144.96559789"
63820250310,63,2025-03-10,8,45,81,126,Bou231_T,"-37.81333081, 144.96675571"
11020250613,1,2025-06-13,10,397,492,889,Bou292_T,"-37.81349441, 144.96515323"
12220250817,1,2025-08-17,22,72,86,158,Bou292_T,"-37.81349441, 144.96515323"
621520241205,62,2024-12-05,15,172,160,332,Lat224_T,"-37.80996494, 144.96216521"
56220240909,56,2024-09-09,2,10,16,26,Lon364_T,"-37.81234775, 144.96153311"
862120250114,86,2025-01-14,21,19,45,64,574Qub_T,"-37.80309992, 144.94908064"
241120250129,24,2025-01-29,11,595,415,1010,Col620_T,"-37.81887963, 144.95449198"
40020231210,40,2023-12-10,0,52,29,81,Spr201_T,"-37.80999341, 144.97227587"
611520241108,61,2024-11-08,15,539,535,1074,RMIT14_T,"-37.80767455, 144.96309114"
44020250214,44,2025-02-14,0,1,1,2,UM3_T,"-37.79698741, 144.96441306"
452220231120,45,2023-11-20,22,84,217,301,Swa148_T,"-37.81414075, 144.96609379"
5220241219,5,2024-12-19,2,8,19,27,PriNW_T,"-37.81874249, 144.96787656"
52020240525,5,2024-05-25,20,527,745,1272,PriNW_T,"-37.81874249, 144.96787656"
162420250708,162,2025-07-08,4,4,8,12,Eli489_T,"-37.80740397, 144.95987909"
1621920250828,162,2025-08-28,19,249,224,473,Eli489_T,"-37.80740397, 144.95987909"
143320250727,143,2025-07-27,3,79,19,98,Spencer_T,"-37.821728, 144.95557015"
132320231113,132,2023-11-13,3,3,1,4,King335_T,"-37.81267639, 144.95386444"
134520240118,134,2024-01-18,5,35,54,89,Spen201_T,"-37.81694221, 144.95303935"
1351220251010,135,2025-10-10,12,438,540,978,Spen161_T,"-37.8172861, 144.95319102"
133920241215,133,2024-12-15,9,302,385,687,Spen229_T,"-37.81531435, 144.95227769"
1332020250109,133,2025-01-09,20,422,326,748,Spen229_T,"-37.81531435, 144.95227769"
1331020240903,133,2024-09-03,10,378,414,792,Spen229_T,"-37.81531435, 144.95227769"
118920240511,118,2024-05-11,9,2,14,16,Fli114C_T,"-37.81632783, 144.97090512"
691320250702,69,2025-07-02,13,95,121,216,FLDegC_T,"-37.81687226, 144.96559144"
6820231107,6,2023-11-07,8,400,260,660,FliS_T,"-37.81911705, 144.96558255"
6720250309,6,2025-03-09,7,124,117,241,FliS_T,"-37.81911705, 144.96558255"
841920240112,84,2024-01-12,19,840,970,1810,ElFi_T,"-37.81798049, 144.96503383"
84420250920,84,2025-09-20,4,12,31,43,ElFi_T,"-37.81798049, 144.96503383"
4120250501,4,2025-05-01,1,33,25,58,Swa123_T,"-37.81487988, 144.9660878"
70520231225,70,2023-12-25,5,1,1,2,Errol20_T,"-37.80456984, 144.94946228"
391720240711,39,2024-07-11,17,129,80,209,AlfPl_T,"-37.81379749, 144.96995745"
39820240913,39,2024-09-13,8,26,41,67,AlfPl_T,"-37.81379749, 144.96995745"
411620241214,41,2024-12-14,16,1734,1742,3476,Swa31,"-37.81668634, 144.96689733"
8720250719,8,2025-07-19,7,33,52,85,WebBN_T,"-37.82293543, 144.9471751"
77420250911,77,2025-09-11,4,2,4,6,HarEsP_T,"-37.81441438, 144.94433026"
29620241101,29,2024-11-01,6,37,83,120,AG_T,"-37.8199817, 144.96872865"
291220250307,29,2025-03-07,12,312,414,726,AG_T,"-37.8199817, 144.96872865"
29720240112,29,2024-01-12,7,96,98,194,AG_T,"-37.8199817, 144.96872865"
71020231229,71,2023-12-29,0,2,3,5,WestWP_T,"-37.81235775, 144.97136962"
711820240216,71,2024-02-16,18,12,17,29,WestWP_T,"-37.81235775, 144.97136962"
712220250102,71,2025-01-02,22,5,3,8,WestWP_T,"-37.81235775, 144.97136962"
591120250831,59,2025-08-31,11,370,221,591,RMIT_T,"-37.80825648, 144.96304859"
591820251004,59,2025-10-04,18,575,487,1062,RMIT_T,"-37.80825648, 144.96304859"
59320241112,59,2024-11-12,3,6,6,12,RMIT_T,"-37.80825648, 144.96304859"
422020240522,42,2024-05-22,20,97,148,245,UM1_T,"-37.80008566, 144.96386412"
47420250508,47,2025-05-08,4,19,20,39,Eli250_T,"-37.81258467, 144.9625775"
311220231018,31,2023-10-18,12,194,166,360,Lyg161_T,"-37.80169681, 144.96658911"
361720250730,36,2025-07-30,17,246,245,491,Que85_T,"-37.81652527, 144.96121062"
61520240703,61,2024-07-03,5,14,26,40,RMIT14_T,"-37.80767455, 144.96309114"
502320240713,50,2024-07-13,23,89,41,130,Lyg309_T,"-37.79808192, 144.96721013"
182320250714,182,2025-07-14,3,12,14,26,King163_T,"-37.81627451, 144.95550503"
162520250612,162,2025-06-12,5,17,15,32,Eli489_T,"-37.80740397, 144.95987909"
1431220240820,143,2024-08-20,12,148,223,371,Spencer_T,"-37.821728, 144.95557015"
132320240914,132,2024-09-14,3,11,0,11,King335_T,"-37.81267639, 144.95386444"
134620250929,134,2025-09-29,6,155,152,307,Spen201_T,"-37.81694221, 144.95303935"
1071720241212,107,2024-12-12,17,247,176,423,280Will_T,"-37.81246271, 144.95690188"
1331320250626,133,2025-06-26,13,495,479,974,Spen229_T,"-37.81531435, 144.95227769"
762220240703,76,2024-07-03,22,6,7,13,KenMac_T,"-37.79453803, 144.93036194"
35520250418,35,2025-04-18,5,25,21,46,SouthB_T,"-37.82018685, 144.96508508"
35020250828,35,2025-08-28,0,13,31,44,SouthB_T,"-37.82018685, 144.96508508"
58320231206,58,2023-12-06,3,2,10,12,Bou688_T,"-37.81686075, 144.95358075"
53320250906,53,2025-09-06,3,19,13,32,Col254_T,"-37.81564191, 144.965499"
53920240211,53,2024-02-11,9,205,126,331,Col254_T,"-37.81564191, 144.965499"
27720250908,27,2025-09-08,7,33,47,80,Vic_T,"-37.80606888, 144.95644692"
791620240719,79,2024-07-19,16,408,388,796,FliSS_T,"-37.81794046, 144.96616678"
301620250211,30,2025-02-11,16,180,299,479,Lon189_T,"-37.8112185, 144.96656806"
462320231019,46,2023-10-19,23,31,39,70,Pel147_T,"-37.80240719, 144.9615673"
201120240912,20,2024-09-12,11,121,105,226,LtB170_T,"-37.81172914, 144.9682466"
231720240525,23,2024-05-25,17,211,277,488,Col623_T,"-37.81909256, 144.95452748"
1411020250820,141,2025-08-20,10,103,95,198,474Fl_T,"-37.81997273, 144.95834911"
1231520240710,123,2024-07-10,15,15,0,15,BirBridge_T,"-37.81753741, 144.97329734"
481920250220,48,2025-02-20,19,110,121,231,QVMQ_T,"-37.80631581, 144.95866697"
1091220250923,109,2025-09-23,12,172,141,313,LatWill_T,"-37.81193681, 144.95621105"
49120240228,49,2024-02-28,1,36,41,77,Eli501_T,"-37.80730068, 144.95956055"
301220250901,30,2025-09-01,12,226,404,630,Lon189_T,"-37.8112185, 144.96656806"
1391420250407,139,2025-04-07,14,61,70,131,Signal1647_T,"-37.81959923, 144.9632832"
1372320240203,137,2024-02-03,23,5,3,8,BouHbr2353_T,"-37.81894815, 144.94612292"
1301020240123,130,2024-01-23,10,23,26,49,Bou892T,"-37.8204637, 144.94126826"
130920250723,130,2025-07-23,9,42,24,66,Bou892T,"-37.8204637, 144.94126826"
1801920250731,180,2025-07-31,19,1,5,6,Mac330_T,"-37.79497059, 144.93530329"
6020231121,6,2023-11-21,0,105,49,154,FliS_T,"-37.81911705, 144.96558255"
662220240720,66,2024-07-20,22,607,477,1084,QVN_T,"-37.81057846, 144.96444294"
6720250612,6,2025-06-12,7,435,728,1163,FliS_T,"-37.81911705, 144.96558255"
391520231018,39,2023-10-18,15,103,90,193,AlfPl_T,"-37.81379749, 144.96995745"
81920240210,8,2024-02-10,19,82,135,217,WebBN_T,"-37.82293543, 144.9471751"
591720231018,59,2023-10-18,17,823,1023,1846,RMIT_T,"-37.80825648, 144.96304859"
59020231209,59,2023-12-09,0,164,74,238,RMIT_T,"-37.80825648, 144.96304859"
771120241014,77,2024-10-14,11,97,54,151,HarEsP_T,"-37.81441438, 144.94433026"
77820250502,77,2025-05-02,8,153,158,311,HarEsP_T,"-37.81441438, 144.94433026"
591820250917,59,2025-09-17,18,901,1230,2131,RMIT_T,"-37.80825648, 144.96304859"
59020241105,59,2024-11-05,0,50,58,108,RMIT_T,"-37.80825648, 144.96304859"
591620241129,59,2024-11-29,16,277,345,622,RMIT_T,"-37.80825648, 144.96304859"
312020241122,31,2024-11-22,20,434,360,794,Lyg161_T,"-37.80169681, 144.96658911"
541020240608,54,2024-06-08,10,68,54,122,Swa607_T,"-37.804024, 144.96308399"
541120231022,54,2023-10-22,11,71,82,153,Swa607_T,"-37.804024, 144.96308399"
471020241114,47,2024-11-14,10,365,516,881,Eli250_T,"-37.81258467, 144.9625775"
31120250710,31,2025-07-10,1,8,6,14,Lyg161_T,"-37.80169681, 144.96658911"
52020231126,5,2023-11-26,20,746,1147,1893,PriNW_T,"-37.81874249, 144.96787656"
5320240322,5,2024-03-22,3,22,20,42,PriNW_T,"-37.81874249, 144.96787656"
5520240724,5,2024-07-24,5,13,45,58,PriNW_T,"-37.81874249, 144.96787656"
212220240526,21,2024-05-26,22,130,190,320,Bourke155_T,"-37.81267313, 144.96788288"
37620240912,37,2024-09-12,6,7,6,13,Lyg260_T,"-37.80107122, 144.96704554"
44120240327,44,2024-03-27,1,2,0,2,UM3_T,"-37.79698741, 144.96441306"
451020250728,45,2025-07-28,10,302,339,641,Swa148_T,"-37.81414075, 144.96609379"
51220251007,5,2025-10-07,12,744,765,1509,PriNW_T,"-37.81874249, 144.96787656"
166920250123,166,2025-01-23,9,22,50,72,Spen484_T,"-37.80896733, 144.94931703"
167020250713,167,2025-07-13,0,4,10,14,Lat526_T,"-37.81304149, 144.95155955"
1082120231226,108,2023-12-26,21,83,70,153,261Will_T,"-37.81295822, 144.95678789"
1361320240607,136,2024-06-07,13,89,58,147,BirFed1120_T,"-37.8184141, 144.97357915"
1362320231212,136,2023-12-12,23,1,0,1,BirFed1120_T,"-37.8184141, 144.97357915"
142120240915,142,2024-09-15,1,13,8,21,Hammer1584_T,"-37.81970749, 144.96795734"
1171920250704,117,2025-07-04,19,238,160,398,Fli114F_T,"-37.81629332, 144.97090877"
672120241224,67,2024-12-24,21,344,332,676,FLDegS_T,"-37.81688755, 144.96562569"
67620250508,67,2025-05-08,6,114,60,174,FLDegS_T,"-37.81688755, 144.96562569"
852020250329,85,2025-03-29,20,31,33,64,488Mac_T,"-37.79432415, 144.92973378"
852120250604,85,2025-06-04,21,17,11,28,488Mac_T,"-37.79432415, 144.92973378"
181920240515,18,2024-05-15,19,1,7,8,Col12_T,"-37.81344862, 144.97305353"
18920250622,18,2025-06-22,9,30,48,78,Col12_T,"-37.81344862, 144.97305353"
111420240907,11,2024-09-07,14,164,149,313,WatCit_T,"-37.81564989, 144.93970694"
11920241231,11,2024-12-31,9,77,66,143,WatCit_T,"-37.81564989, 144.93970694"
102220240810,10,2024-08-10,22,98,94,192,BouHbr_T,"-37.81876474, 144.94710545"
24720251013,24,2025-10-13,7,873,293,1166,Col620_T,"-37.81887963, 144.95449198"
721320240613,72,2024-06-13,13,170,181,351,ACMI_T,"-37.81726338, 144.96872809"
721020240623,72,2024-06-23,10,119,303,422,ACMI_T,"-37.81726338, 144.96872809"
581020250329,58,2025-03-29,10,792,256,1048,Bou688_T,"-37.81686075, 144.95358075"
35320250101,35,2025-01-01,3,486,420,906,SouthB_T,"-37.82018685, 144.96508508"
21920250824,2,2025-08-24,19,335,254,589,Bou283_T,"-37.81380668, 144.96516718"
27820241006,27,2024-10-06,8,46,44,90,Vic_T,"-37.80606888, 144.95644692"
9720240219,9,2024-02-19,7,55,1071,1126,Col700_T,"-37.81982992, 144.95102555"
53320240116,53,2024-01-16,3,12,8,20,Col254_T,"-37.81564191, 144.965499"
27620250715,27,2025-07-15,6,18,24,42,Vic_T,"-37.80606888, 144.95644692"
30320241230,30,2024-12-30,3,40,58,98,Lon189_T,"-37.8112185, 144.96656806"
792020250330,79,2025-03-30,20,190,274,464,FliSS_T,"-37.81794046, 144.96616678"
30720251012,30,2025-10-12,7,29,66,95,Lon189_T,"-37.8112185, 144.96656806"
52720250413,52,2025-04-13,7,23,20,43,Eli263_T,"-37.81252157, 144.9619401"
461920241202,46,2024-12-02,19,35,93,128,Pel147_T,"-37.80240719, 144.9615673"
25820250619,25,2025-06-19,8,256,549,805,MCEC_T,"-37.82401776, 144.95604426"
139820240608,139,2024-06-08,8,17,15,32,Signal1647_T,"-37.81959923, 144.9632832"
66520250503,66,2025-05-03,5,6,15,21,QVN_T,"-37.81057846, 144.96444294"
66320251006,66,2025-10-06,3,20,1,21,QVN_T,"-37.81057846, 144.96444294"
6220231211,6,2023-12-11,2,11,23,34,FliS_T,"-37.81911705, 144.96558255"
6520240803,6,2024-08-03,5,28,49,77,FliS_T,"-37.81911705, 144.96558255"
4920240308,4,2024-03-08,9,736,487,1223,Swa123_T,"-37.81487988, 144.9660878"
4320241213,4,2024-12-13,3,31,41,72,Swa123_T,"-37.81487988, 144.9660878"
3920240714,3,2024-07-14,9,188,240,428,Swa295_T,"-37.81101524, 144.96429485"
75420231028,75,2023-10-28,4,2,3,5,SprFli_T,"-37.81515276, 144.97467661"
411820250712,41,2025-07-12,18,1655,1763,3418,Swa31,"-37.81668634, 144.96689733"
77220250510,77,2025-05-10,2,5,0,5,HarEsP_T,"-37.81441438, 144.94433026"
141520231123,14,2023-11-23,15,473,135,608,SanBri_T,"-37.82011242, 144.96291897"
59020241205,59,2024-12-05,0,29,30,59,RMIT_T,"-37.80825648, 144.96304859"
28420251011,28,2025-10-11,4,8,10,18,VAC_T,"-37.82129925, 144.96879309"
28820240127,28,2024-01-27,8,93,88,181,VAC_T,"-37.82129925, 144.96879309"
471720240422,47,2024-04-22,17,1232,824,2056,Eli250_T,"-37.81258467, 144.9625775"
311420240718,31,2024-07-18,14,131,136,267,Lyg161_T,"-37.80169681, 144.96658911"
1671620240904,167,2024-09-04,16,75,78,153,Lat526_T,"-37.81304149, 144.95155955"
107120231124,107,2023-11-24,1,21,9,30,280Will_T,"-37.81246271, 144.95690188"
1351720231114,135,2023-11-14,17,899,559,1458,Spen161_T,"-37.8172861, 144.95319102"
1351620240420,135,2024-04-20,16,940,484,1424,Spen161_T,"-37.8172861, 144.95319102"
1182020250918,118,2025-09-18,20,4,4,8,Fli114C_T,"-37.81632783, 144.97090512"
1082320240225,108,2024-02-25,23,43,47,90,261Will_T,"-37.81295822, 144.95678789"
1081920240305,108,2024-03-05,19,289,156,445,261Will_T,"-37.81295822, 144.95678789"
63020240426,63,2024-04-26,0,26,105,131,Bou231_T,"-37.81333081, 144.96675571"
63720250311,63,2025-03-11,7,72,74,146,Bou231_T,"-37.81333081, 144.96675571"
671420240817,67,2024-08-17,14,447,729,1176,FLDegS_T,"-37.81688755, 144.96562569"
68120240921,68,2024-09-21,1,2,0,2,FLDegN_T,"-37.8168479, 144.96559789"
11720250618,1,2025-06-18,17,1238,928,2166,Bou292_T,"-37.81349441, 144.96515323"
1320250816,1,2025-08-16,3,21,29,50,Bou292_T,"-37.81349441, 144.96515323"
62420240422,62,2024-04-22,4,7,10,17,Lat224_T,"-37.80996494, 144.96216521"
62120240827,62,2024-08-27,1,36,33,69,Lat224_T,"-37.80996494, 144.96216521"
621820240829,62,2024-08-29,18,350,729,1079,Lat224_T,"-37.80996494, 144.96216521"
56820231104,56,2023-11-04,8,61,43,104,Lon364_T,"-37.81234775, 144.96153311"
562120250109,56,2025-01-09,21,210,278,488,Lon364_T,"-37.81234775, 144.96153311"
861920231211,86,2023-12-11,19,25,38,63,574Qub_T,"-37.80309992, 144.94908064"
111520250831,11,2025-08-31,15,116,99,215,WatCit_T,"-37.81564989, 144.93970694"
21120240425,2,2024-04-25,11,483,564,1047,Bou283_T,"-37.81380668, 144.96516718"
58420231205,58,2023-12-05,4,18,14,32,Bou688_T,"-37.81686075, 144.95358075"
9720240524,9,2024-05-24,7,47,690,737,Col700_T,"-37.81982992, 144.95102555"
531520240413,53,2024-04-13,15,899,659,1558,Col254_T,"-37.81564191, 144.965499"
531120240227,53,2024-02-27,11,673,585,1258,Col254_T,"-37.81564191, 144.965499"
461820240630,46,2024-06-30,18,24,36,60,Pel147_T,"-37.80240719, 144.9615673"
201520240404,20,2024-04-04,15,225,265,490,LtB170_T,"-37.81172914, 144.9682466"
251320240117,25,2024-01-17,13,507,474,981,MCEC_T,"-37.82401776, 144.95604426"
46720241105,46,2024-11-05,7,6,4,10,Pel147_T,"-37.80240719, 144.9615673"
1381620250408,138,2025-04-08,16,21,9,30,EntPark1671_T,"-37.81996544, 144.95981454"
192220250819,19,2025-08-19,22,137,209,346,LtB210_T,"-37.81237202, 144.96550671"
109620250520,109,2025-05-20,6,34,93,127,LatWill_T,"-37.81193681, 144.95621105"
1091120240206,109,2024-02-06,11,118,130,248,LatWill_T,"-37.81193681, 144.95621105"
1091620240308,109,2024-03-08,16,305,156,461,LatWill_T,"-37.81193681, 144.95621105"
491220250926,49,2025-09-26,12,369,549,918,Eli501_T,"-37.80730068, 144.95956055"
251220251016,25,2025-10-16,12,735,893,1628,MCEC_T,"-37.82401776, 144.95604426"
1361520240223,136,2024-02-23,15,69,48,117,BirFed1120_T,"-37.8184141, 144.97357915"
1642020250707,164,2025-07-07,20,51,55,106,Lat526_T,"-37.813005, 144.95160411"
164120250812,164,2025-08-12,1,0,4,4,Lat526_T,"-37.813005, 144.95160411"
6020250207,6,2025-02-07,0,175,88,263,FliS_T,"-37.81911705, 144.96558255"
702120231202,70,2023-12-02,21,117,105,222,Errol20_T,"-37.80456984, 144.94946228"
70620250624,70,2025-06-24,6,5,7,12,Errol20_T,"-37.80456984, 144.94946228"
32220241204,3,2024-12-04,22,476,367,843,Swa295_T,"-37.81101524, 144.96429485"
391920240629,39,2024-06-29,19,59,44,103,AlfPl_T,"-37.81379749, 144.96995745"
82220241024,8,2024-10-24,22,32,43,75,WebBN_T,"-37.82293543, 144.9471751"
75620250722,75,2025-07-22,6,16,16,32,SprFli_T,"-37.81515276, 144.97467661"
81120240520,8,2024-05-20,11,90,153,243,WebBN_T,"-37.82293543, 144.9471751"
81320240224,8,2024-02-24,13,198,245,443,WebBN_T,"-37.82293543, 144.9471751"
41620240120,41,2024-01-20,6,171,142,313,Swa31,"-37.81668634, 144.96689733"
311720240110,31,2024-01-10,17,285,118,403,Lyg161_T,"-37.80169681, 144.96658911"
211120240215,21,2024-02-15,11,371,274,645,Bourke155_T,"-37.81267313, 144.96788288"
361220240218,36,2024-02-18,12,104,131,235,Que85_T,"-37.81652527, 144.96121062"
501920240527,50,2024-05-27,19,159,124,283,Lyg309_T,"-37.79808192, 144.96721013"
431820241029,43,2024-10-29,18,161,146,307,UM2_T,"-37.79844526, 144.96411782"
1311020250517,131,2025-05-17,10,54,123,177,King2_T,"-37.82009057, 144.95758725"
1311320240622,131,2024-06-22,13,93,151,244,King2_T,"-37.82009057, 144.95758725"
1311420240828,131,2024-08-28,14,95,112,207,King2_T,"-37.82009057, 144.95758725"
162320250613,162,2025-06-13,3,12,3,15,Eli489_T,"-37.80740397, 144.95987909"
143820250210,143,2025-02-10,8,98,221,319,Spencer_T,"-37.821728, 144.95557015"
1321020250109,132,2025-01-09,10,171,83,254,King335_T,"-37.81267639, 144.95386444"
1072020250618,107,2025-06-18,20,59,92,151,280Will_T,"-37.81246271, 144.95690188"
1920231117,1,2023-11-17,9,360,185,545,Bou292_T,"-37.81349441, 144.96515323"
1020240426,1,2024-04-26,0,20,38,58,Bou292_T,"-37.81349441, 144.96515323"
1220241109,1,2024-11-09,2,29,31,60,Bou292_T,"-37.81349441, 144.96515323"
621020250927,62,2025-09-27,10,139,151,290,Lat224_T,"-37.80996494, 144.96216521"
63620231102,63,2023-11-02,6,45,39,84,Bou231_T,"-37.81333081, 144.96675571"
111320241204,11,2024-12-04,13,148,115,263,WatCit_T,"-37.81564989, 144.93970694"
111020251016,11,2025-10-16,10,125,137,262,WatCit_T,"-37.81564989, 144.93970694"
122320240511,12,2024-05-11,23,103,117,220,NewQ_T,"-37.81457988, 144.94292398"
12420240815,12,2024-08-15,4,1,1,2,NewQ_T,"-37.81457988, 144.94292398"
761020250621,76,2025-06-21,10,93,68,161,KenMac_T,"-37.79453803, 144.93036194"
76220240429,76,2024-04-29,2,1,1,2,KenMac_T,"-37.79453803, 144.93036194"
76620240903,76,2024-09-03,6,16,15,31,KenMac_T,"-37.79453803, 144.93036194"
351520250910,35,2025-09-10,15,721,671,1392,SouthB_T,"-37.82018685, 144.96508508"
582320250430,58,2025-04-30,23,99,106,205,Bou688_T,"-37.81686075, 144.95358075"
581720250707,58,2025-07-07,17,705,1175,1880,Bou688_T,"-37.81686075, 144.95358075"
58920240613,58,2024-06-13,9,1064,203,1267,Bou688_T,"-37.81686075, 144.95358075"
27420241004,27,2024-10-04,4,2,2,4,Vic_T,"-37.80606888, 144.95644692"
91220231127,9,2023-11-27,12,654,567,1221,Col700_T,"-37.81982992, 144.95102555"
791820231020,79,2023-10-20,18,682,519,1201,FliSS_T,"-37.81794046, 144.96616678"
30820231130,30,2023-11-30,8,108,122,230,Lon189_T,"-37.8112185, 144.96656806"
251620241110,25,2024-11-10,16,887,694,1581,MCEC_T,"-37.82401776, 144.95604426"
251320241231,25,2024-12-31,13,695,769,1464,MCEC_T,"-37.82401776, 144.95604426"
52520250813,52,2025-08-13,5,6,2,8,Eli263_T,"-37.81252157, 144.9619401"
202220240516,20,2024-05-16,22,107,249,356,LtB170_T,"-37.81172914, 144.9682466"
20620241007,20,2024-10-07,6,5,7,12,LtB170_T,"-37.81172914, 144.9682466"
522120240116,52,2024-01-16,21,210,153,363,Eli263_T,"-37.81252157, 144.9619401"
511920240120,51,2024-01-20,19,119,59,178,Fra118_T,"-37.80841815, 144.95906316"
191820250418,19,2025-04-18,18,955,638,1593,LtB210_T,"-37.81237202, 144.96550671"
109620231207,109,2023-12-07,6,28,103,131,LatWill_T,"-37.81193681, 144.95621105"
192020241106,19,2024-11-06,20,347,507,854,LtB210_T,"-37.81237202, 144.96550671"
481020240127,48,2024-01-27,10,363,316,679,QVMQ_T,"-37.80631581, 144.95866697"
139720241207,139,2024-12-07,7,7,6,13,Signal1647_T,"-37.81959923, 144.9632832"
1421620231226,142,2023-12-26,16,228,404,632,Hammer1584_T,"-37.81970749, 144.96795734"
1231620250618,123,2025-06-18,16,26,29,55,BirBridge_T,"-37.81753741, 144.97329734"
1611720240625,161,2024-06-25,17,112,79,191,BirArt1109_T,"-37.81851276, 144.97131336"
1171320241123,117,2024-11-23,13,113,116,229,Fli114F_T,"-37.81629332, 144.97090877"
41320250725,4,2025-07-25,13,1875,1518,3393,Swa123_T,"-37.81487988, 144.9660878"
771220240525,77,2024-05-25,12,327,351,678,HarEsP_T,"-37.81441438, 144.94433026"
781420241213,78,2024-12-13,14,36,83,119,HarEsB_T,"-37.81471642, 144.9446508"
771420250420,77,2025-04-20,14,218,120,338,HarEsP_T,"-37.81441438, 144.94433026"
77220250826,77,2025-08-26,2,1,3,4,HarEsP_T,"-37.81441438, 144.94433026"
141620231230,14,2023-12-30,16,611,189,800,SanBri_T,"-37.82011242, 144.96291897"
71520240603,71,2024-06-03,5,15,3,18,WestWP_T,"-37.81235775, 144.97136962"
712320231108,71,2023-11-08,23,4,0,4,WestWP_T,"-37.81235775, 144.97136962"
59220241121,59,2024-11-21,2,30,12,42,RMIT_T,"-37.80825648, 144.96304859"
281620240725,28,2024-07-25,16,298,951,1249,VAC_T,"-37.82129925, 144.96879309"
52820240710,52,2024-07-10,8,133,256,389,Eli263_T,"-37.81252157, 144.9619401"
511220240412,51,2024-04-12,12,181,147,328,Fra118_T,"-37.80841815, 144.95906316"
164920241121,164,2024-11-21,9,116,60,176,Lat526_T,"-37.813005, 144.95160411"
1411320240427,141,2024-04-27,13,225,183,408,474Fl_T,"-37.81997273, 144.95834911"
1411420250501,141,2025-05-01,14,206,134,340,474Fl_T,"-37.81997273, 144.95834911"
1381720250527,138,2025-05-27,17,12,1,13,EntPark1671_T,"-37.81996544, 144.95981454"
1382220250327,138,2025-03-27,22,1,0,1,EntPark1671_T,"-37.81996544, 144.95981454"
1232320250815,123,2025-08-15,23,1,0,1,BirBridge_T,"-37.81753741, 144.97329734"
192320250413,19,2025-04-13,23,103,166,269,LtB210_T,"-37.81237202, 144.96550671"
139520250807,139,2025-08-07,5,0,6,6,Signal1647_T,"-37.81959923, 144.9632832"
1371620240427,137,2024-04-27,16,14,18,32,BouHbr2353_T,"-37.81894815, 144.94612292"
1372220250802,137,2025-08-02,22,1,0,1,BouHbr2353_T,"-37.81894815, 144.94612292"
1391220241001,139,2024-10-01,12,62,74,136,Signal1647_T,"-37.81959923, 144.9632832"
1392220241119,139,2024-11-19,22,11,11,22,Signal1647_T,"-37.81959923, 144.9632832"
1361520250611,136,2025-06-11,15,77,40,117,BirFed1120_T,"-37.8184141, 144.97357915"
142020240222,142,2024-02-22,0,14,20,34,Hammer1584_T,"-37.81970749, 144.96795734"
1642320250701,164,2025-07-01,23,10,28,38,Lat526_T,"-37.813005, 144.95160411"
851020250425,85,2025-04-25,10,89,75,164,488Mac_T,"-37.79432415, 144.92973378"
17620250524,17,2025-05-24,6,25,16,41,Col15_T,"-37.81362543, 144.97323591"
11320240219,1,2024-02-19,13,1465,1359,2824,Bou292_T,"-37.81349441, 144.96515323"
682220250624,68,2025-06-24,22,10,6,16,FLDegN_T,"-37.8168479, 144.96559789"
182120250227,18,2025-02-27,21,42,21,63,Col12_T,"-37.81344862, 144.97305353"
862320240127,86,2024-01-27,23,1,12,13,574Qub_T,"-37.80309992, 144.94908064"
86820250126,86,2025-01-26,8,31,23,54,574Qub_T,"-37.80309992, 144.94908064"
561720250518,56,2025-05-18,17,362,455,817,Lon364_T,"-37.81234775, 144.96153311"
241220241204,24,2024-12-04,12,879,814,1693,Col620_T,"-37.81887963, 144.95449198"
12720250107,12,2025-01-07,7,85,59,144,NewQ_T,"-37.81457988, 144.94292398"
10420250511,10,2025-05-11,4,2,1,3,BouHbr_T,"-37.81876474, 144.94710545"
10720240729,10,2024-07-29,7,18,66,84,BouHbr_T,"-37.81876474, 144.94710545"
72320250429,72,2025-04-29,3,0,2,2,ACMI_T,"-37.81726338, 144.96872809"
722020241025,72,2024-10-25,20,133,189,322,ACMI_T,"-37.81726338, 144.96872809"
352020240513,35,2024-05-13,20,417,626,1043,SouthB_T,"-37.82018685, 144.96508508"
27720231127,27,2023-11-27,7,36,43,79,Vic_T,"-37.80606888, 144.95644692"
79420240618,79,2024-06-18,4,13,11,24,FliSS_T,"-37.81794046, 144.96616678"
791820250106,79,2025-01-06,18,383,335,718,FliSS_T,"-37.81794046, 144.96616678"
301620231112,30,2023-11-12,16,303,475,778,Lon189_T,"-37.8112185, 144.96656806"
28420250314,28,2025-03-14,4,11,30,41,VAC_T,"-37.82129925, 144.96879309"
471220241022,47,2024-10-22,12,889,915,1804,Eli250_T,"-37.81258467, 144.9625775"
401620251002,40,2025-10-02,16,210,188,398,Spr201_T,"-37.80999341, 144.97227587"
211020231118,21,2023-11-18,10,218,169,387,Bourke155_T,"-37.81267313, 144.96788288"
211720241211,21,2024-12-11,17,419,390,809,Bourke155_T,"-37.81267313, 144.96788288"
372220250709,37,2025-07-09,22,28,29,57,Lyg260_T,"-37.80107122, 144.96704554"
431620231225,43,2023-12-25,16,12,22,34,UM2_T,"-37.79844526, 144.96411782"
432120250527,43,2025-05-27,21,18,26,44,UM2_T,"-37.79844526, 144.96411782"
44620240822,44,2024-08-22,6,5,5,10,UM3_T,"-37.79698741, 144.96441306"
52220250222,5,2025-02-22,22,1689,1184,2873,PriNW_T,"-37.81874249, 144.96787656"
1652120250106,165,2025-01-06,21,34,7,41,Spen475_T,"-37.80953359, 144.94939004"
701320250502,70,2025-05-02,13,187,176,363,Errol20_T,"-37.80456984, 144.94946228"
701120250608,70,2025-06-08,11,75,84,159,Errol20_T,"-37.80456984, 144.94946228"
421220241214,42,2024-12-14,12,86,84,170,UM1_T,"-37.80008566, 144.96386412"
711820240815,71,2024-08-15,18,28,24,52,WestWP_T,"-37.81235775, 144.97136962"
401520250821,40,2025-08-21,15,226,178,404,Spr201_T,"-37.80999341, 144.97227587"
31120240903,31,2024-09-03,1,5,3,8,Lyg161_T,"-37.80169681, 144.96658911"
451020241218,45,2024-12-18,10,383,358,741,Swa148_T,"-37.81414075, 144.96609379"
451120240817,45,2024-08-17,11,609,511,1120,Swa148_T,"-37.81414075, 144.96609379"
1671420250329,167,2025-03-29,14,83,106,189,Lat526_T,"-37.81304149, 144.95155955"
1181220250526,118,2025-05-26,12,10,24,34,Fli114C_T,"-37.81632783, 144.97090512"
681920250706,68,2025-07-06,19,107,61,168,FLDegN_T,"-37.8168479, 144.96559789"
632120241021,63,2024-10-21,21,27,103,130,Bou231_T,"-37.81333081, 144.96675571"
631920250821,63,2025-08-21,19,203,360,563,Bou231_T,"-37.81333081, 144.96675571"
121020240511,12,2024-05-11,10,139,122,261,NewQ_T,"-37.81457988, 144.94292398"
121320250408,12,2025-04-08,13,240,177,417,NewQ_T,"-37.81457988, 144.94292398"
721820240409,72,2024-04-09,18,158,469,627,ACMI_T,"-37.81726338, 144.96872809"
721120240615,72,2024-06-15,11,166,249,415,ACMI_T,"-37.81726338, 144.96872809"
72820240828,72,2024-08-28,8,665,134,799,ACMI_T,"-37.81726338, 144.96872809"
271020240628,27,2024-06-28,10,128,143,271,Vic_T,"-37.80606888, 144.95644692"
79120250530,79,2025-05-30,1,13,26,39,FliSS_T,"-37.81794046, 144.96616678"
251020241216,25,2024-12-16,10,155,434,589,MCEC_T,"-37.82401776, 144.95604426"
1372220250724,137,2025-07-24,22,0,2,2,BouHbr2353_T,"-37.81894815, 144.94612292"
139620231205,139,2023-12-05,6,10,25,35,Signal1647_T,"-37.81959923, 144.9632832"
1381420240420,138,2024-04-20,14,6,6,12,EntPark1671_T,"-37.81996544, 144.95981454"
1381320240527,138,2024-05-27,13,17,6,23,EntPark1671_T,"-37.81996544, 144.95981454"
61520240217,6,2024-02-17,15,1267,1424,2691,FliS_T,"-37.81911705, 144.96558255"
841920231212,84,2023-12-12,19,758,1182,1940,ElFi_T,"-37.81798049, 144.96503383"
842320240405,84,2024-04-05,23,382,549,931,ElFi_T,"-37.81798049, 144.96503383"
291020240126,29,2024-01-26,10,356,665,1021,AG_T,"-37.8199817, 144.96872865"
471520240816,47,2024-08-16,15,952,784,1736,Eli250_T,"-37.81258467, 144.9625775"
45520240723,45,2024-07-23,5,11,25,36,Swa148_T,"-37.81414075, 144.96609379"
5420240401,5,2024-04-01,4,19,30,49,PriNW_T,"-37.81874249, 144.96787656"
87920250826,87,2025-08-26,9,67,54,121,Errol23_T,"-37.80454949, 144.94921863"
1671720240929,167,2024-09-29,17,33,43,76,Lat526_T,"-37.81304149, 144.95155955"
1432220241124,143,2024-11-24,22,87,97,184,Spencer_T,"-37.821728, 144.95557015"
851620240922,85,2024-09-22,16,66,87,153,488Mac_T,"-37.79432415, 144.92973378"
182020250401,18,2025-04-01,20,22,20,42,Col12_T,"-37.81344862, 144.97305353"
12520250420,12,2025-04-20,5,8,7,15,NewQ_T,"-37.81457988, 144.94292398"
1662320241018,166,2024-10-18,23,7,3,10,Spen484_T,"-37.80896733, 144.94931703"
1672020251005,167,2025-10-05,20,10,21,31,Lat526_T,"-37.81304149, 144.95155955"
162320250609,162,2025-06-09,3,15,16,31,Eli489_T,"-37.80740397, 144.95987909"
162620240913,162,2024-09-13,6,82,54,136,Eli489_T,"-37.80740397, 144.95987909"
134420240114,134,2024-01-14,4,51,58,109,Spen201_T,"-37.81694221, 144.95303935"
1351920250102,135,2025-01-02,19,301,304,605,Spen161_T,"-37.8172861, 144.95319102"
133920250519,133,2025-05-19,9,357,381,738,Spen229_T,"-37.81531435, 144.95227769"
1181520250527,118,2025-05-27,15,8,23,31,Fli114C_T,"-37.81632783, 144.97090512"
1081820240131,108,2024-01-31,18,631,163,794,261Will_T,"-37.81295822, 144.95678789"
63820231122,63,2023-11-22,8,197,195,392,Bou231_T,"-37.81333081, 144.96675571"
671620240408,67,2024-04-08,16,156,297,453,FLDegS_T,"-37.81688755, 144.96562569"
12020250421,1,2025-04-21,20,125,169,294,Bou292_T,"-37.81349441, 144.96515323"
11520250710,1,2025-07-10,15,1395,1194,2589,Bou292_T,"-37.81349441, 144.96515323"
621420231113,62,2023-11-13,14,206,164,370,Lat224_T,"-37.80996494, 144.96216521"
561520250105,56,2025-01-05,15,250,269,519,Lon364_T,"-37.81234775, 144.96153311"
241020240212,24,2024-02-12,10,661,385,1046,Col620_T,"-37.81887963, 144.95449198"
111620240914,11,2024-09-14,16,61,40,101,WatCit_T,"-37.81564989, 144.93970694"
24120250217,24,2025-02-17,1,19,16,35,Col620_T,"-37.81887963, 144.95449198"
111120250629,11,2025-06-29,11,92,133,225,WatCit_T,"-37.81564989, 144.93970694"
35420241201,35,2024-12-01,4,15,40,55,SouthB_T,"-37.82018685, 144.96508508"
2220250727,2,2025-07-27,2,15,70,85,Bou283_T,"-37.81380668, 144.96516718"
2120231228,2,2023-12-28,1,12,32,44,Bou283_T,"-37.81380668, 144.96516718"
352020250302,35,2025-03-02,20,605,1114,1719,SouthB_T,"-37.82018685, 144.96508508"
58720240610,58,2024-06-10,7,91,58,149,Bou688_T,"-37.81686075, 144.95358075"
58620241014,58,2024-10-14,6,188,71,259,Bou688_T,"-37.81686075, 144.95358075"
27620231115,27,2023-11-15,6,12,19,31,Vic_T,"-37.80606888, 144.95644692"
531220240502,53,2024-05-02,12,926,849,1775,Col254_T,"-37.81564191, 144.965499"
531720231105,53,2023-11-05,17,541,291,832,Col254_T,"-37.81564191, 144.965499"
301920231106,30,2023-11-06,19,332,421,753,Lon189_T,"-37.8112185, 144.96656806"
462120240104,46,2024-01-04,21,19,24,43,Pel147_T,"-37.80240719, 144.9615673"
20420250128,20,2025-01-28,4,1,4,5,LtB170_T,"-37.81172914, 144.9682466"
20220240411,20,2024-04-11,2,12,10,22,LtB170_T,"-37.81172914, 144.9682466"
511720240718,51,2024-07-18,17,99,94,193,Fra118_T,"-37.80841815, 144.95906316"
1611220250927,161,2025-09-27,12,8771,109,8880,BirArt1109_T,"-37.81851276, 144.97131336"
1301620240409,130,2024-04-09,16,15,28,43,Bou892T,"-37.8204637, 144.94126826"
1301920250216,130,2025-02-16,19,31,38,69,Bou892T,"-37.8204637, 144.94126826"
66620250402,66,2025-04-02,6,23,90,113,QVN_T,"-37.81057846, 144.96444294"
69320240320,69,2024-03-20,3,1,0,1,FLDegC_T,"-37.81687226, 144.96559144"
70220231218,70,2023-12-18,2,2,2,4,Errol20_T,"-37.80456984, 144.94946228"
751520231031,75,2023-10-31,15,61,43,104,SprFli_T,"-37.81515276, 144.97467661"
39520250311,39,2025-03-11,5,3,3,6,AlfPl_T,"-37.81379749, 144.96995745"
81620250323,8,2025-03-23,16,195,229,424,WebBN_T,"-37.82293543, 144.9471751"
411620240225,41,2024-02-25,16,1471,1429,2900,Swa31,"-37.81668634, 144.96689733"
412120251005,41,2025-10-05,21,407,653,1060,Swa31,"-37.81668634, 144.96689733"
77720240201,77,2024-02-01,7,91,141,232,HarEsP_T,"-37.81441438, 144.94433026"
59820240728,59,2024-07-28,8,45,79,124,RMIT_T,"-37.80825648, 144.96304859"
101020241115,10,2024-11-15,10,54,52,106,BouHbr_T,"-37.81876474, 144.94710545"
58220231221,58,2023-12-21,2,17,28,45,Bou688_T,"-37.81686075, 144.95358075"
35420241206,35,2024-12-06,4,26,20,46,SouthB_T,"-37.82018685, 144.96508508"
791520240429,79,2024-04-29,15,401,343,744,FliSS_T,"-37.81794046, 144.96616678"
532020250624,53,2025-06-24,20,99,147,246,Col254_T,"-37.81564191, 144.965499"
531720240414,53,2024-04-14,17,500,324,824,Col254_T,"-37.81564191, 144.965499"
461020250820,46,2025-08-20,10,134,69,203,Pel147_T,"-37.80240719, 144.9615673"
1371120250115,137,2025-01-15,11,8,53,61,BouHbr2353_T,"-37.81894815, 144.94612292"
1802020250621,180,2025-06-21,20,2,2,4,Mac330_T,"-37.79497059, 144.93530329"
1172220240212,117,2024-02-12,22,69,55,124,Fli114F_T,"-37.81629332, 144.97090877"
192220241030,19,2024-10-30,22,159,289,448,LtB210_T,"-37.81237202, 144.96550671"
391020250507,39,2025-05-07,10,83,72,155,AlfPl_T,"-37.81379749, 144.96995745"
751420250208,75,2025-02-08,14,39,41,80,SprFli_T,"-37.81515276, 144.97467661"
41620250710,41,2025-07-10,6,358,104,462,Swa31,"-37.81668634, 144.96689733"
77520231225,77,2023-12-25,5,1,4,5,HarEsP_T,"-37.81441438, 144.94433026"
771920241112,77,2024-11-12,19,164,120,284,HarEsP_T,"-37.81441438, 144.94433026"
421520240914,42,2024-09-14,15,83,85,168,UM1_T,"-37.80008566, 144.96386412"
31320250204,31,2025-02-04,3,1,2,3,Lyg161_T,"-37.80169681, 144.96658911"
36120240305,36,2024-03-05,1,11,8,19,Que85_T,"-37.81652527, 144.96121062"
212220231211,21,2023-12-11,22,201,180,381,Bourke155_T,"-37.81267313, 144.96788288"
45220240713,45,2024-07-13,2,43,102,145,Swa148_T,"-37.81414075, 144.96609379"
211920240311,21,2024-03-11,19,309,360,669,Bourke155_T,"-37.81267313, 144.96788288"
612120250704,61,2025-07-04,21,119,102,221,RMIT14_T,"-37.80767455, 144.96309114"
431320250807,43,2025-08-07,13,330,496,826,UM2_T,"-37.79844526, 144.96411782"
1842120250910,184,2025-09-10,21,158,274,432,Eli124_T,"-37.81512416, 144.96371988"
131220250810,131,2025-08-10,2,49,52,101,King2_T,"-37.82009057, 144.95758725"
132220250301,132,2025-03-01,2,41,28,69,King335_T,"-37.81267639, 144.95386444"
1351420250922,135,2025-09-22,14,345,332,677,Spen161_T,"-37.8172861, 144.95319102"
118720250116,118,2025-01-16,7,10,14,24,Fli114C_T,"-37.81632783, 144.97090512"
851120250726,85,2025-07-26,11,119,94,213,488Mac_T,"-37.79432415, 144.92973378"
172120241005,17,2024-10-05,21,53,68,121,Col15_T,"-37.81362543, 144.97323591"
11720240730,1,2024-07-30,17,1128,877,2005,Bou292_T,"-37.81349441, 144.96515323"
681820240516,68,2024-05-16,18,117,25,142,FLDegN_T,"-37.8168479, 144.96559789"
622220240713,62,2024-07-13,22,129,53,182,Lat224_T,"-37.80996494, 144.96216521"
72420231213,72,2023-12-13,4,8,8,16,ACMI_T,"-37.81726338, 144.96872809"
722320250905,72,2025-09-05,23,63,547,610,ACMI_T,"-37.81726338, 144.96872809"
271220241027,27,2024-10-27,12,319,257,576,Vic_T,"-37.80606888, 144.95644692"
201220250825,20,2025-08-25,12,280,272,552,LtB170_T,"-37.81172914, 144.9682466"
1371420240826,137,2024-08-26,14,14,36,50,BouHbr2353_T,"-37.81894815, 144.94612292"
1391420231214,139,2023-12-14,14,81,71,152,Signal1647_T,"-37.81959923, 144.9632832"
109720240505,109,2024-05-05,7,12,13,25,LatWill_T,"-37.81193681, 144.95621105"
192220240823,19,2024-08-23,22,344,451,795,LtB210_T,"-37.81237202, 144.96550671"
192220241116,19,2024-11-16,22,482,585,1067,LtB210_T,"-37.81237202, 144.96550671"
701820250316,70,2025-03-16,18,124,118,242,Errol20_T,"-37.80456984, 144.94946228"
701020240501,70,2024-05-01,10,94,116,210,Errol20_T,"-37.80456984, 144.94946228"
701920240816,70,2024-08-16,19,179,303,482,Errol20_T,"-37.80456984, 144.94946228"
291920240217,29,2024-02-17,19,383,678,1061,AG_T,"-37.8199817, 144.96872865"
591020231217,59,2023-12-17,10,174,264,438,RMIT_T,"-37.80825648, 144.96304859"
362220240302,36,2024-03-02,22,152,175,327,Que85_T,"-37.81652527, 144.96121062"
1071120240614,107,2024-06-14,11,86,137,223,280Will_T,"-37.81246271, 144.95690188"
281720231211,28,2023-12-11,17,436,872,1308,VAC_T,"-37.82129925, 144.96879309"
28020240214,28,2024-02-14,0,16,11,27,VAC_T,"-37.82129925, 144.96879309"
40920240628,40,2024-06-28,9,150,212,362,Spr201_T,"-37.80999341, 144.97227587"
21420240922,21,2024-09-22,4,59,45,104,Bourke155_T,"-37.81267313, 144.96788288"
211720250710,21,2025-07-10,17,473,351,824,Bourke155_T,"-37.81267313, 144.96788288"
361320250801,36,2025-08-01,13,312,349,661,Que85_T,"-37.81652527, 144.96121062"
361720250829,36,2025-08-29,17,234,261,495,Que85_T,"-37.81652527, 144.96121062"
108920250529,108,2025-05-29,9,276,1288,1564,261Will_T,"-37.81295822, 144.95678789"
871020231110,87,2023-11-10,10,97,80,177,Errol23_T,"-37.80454949, 144.94921863"
611520240219,61,2024-02-19,15,471,880,1351,RMIT14_T,"-37.80767455, 144.96309114"
611720240519,61,2024-05-19,17,290,314,604,RMIT14_T,"-37.80767455, 144.96309114"
44420250906,44,2025-09-06,4,3,0,3,UM3_T,"-37.79698741, 144.96441306"
132020240907,132,2024-09-07,0,52,62,114,King335_T,"-37.81267639, 144.95386444"
1322020250530,132,2025-05-30,20,115,134,249,King335_T,"-37.81267639, 144.95386444"
134220250429,134,2025-04-29,2,11,5,16,Spen201_T,"-37.81694221, 144.95303935"
134920250503,134,2025-05-03,9,251,336,587,Spen201_T,"-37.81694221, 144.95303935"
59620250209,59,2025-02-09,6,6,6,12,RMIT_T,"-37.80825648, 144.96304859"
42620250501,42,2025-05-01,6,17,35,52,UM1_T,"-37.80008566, 144.96386412"
651020231124,65,2023-11-24,10,373,325,698,SwaCs_T,"-37.81569416, 144.9668064"
29920250719,29,2025-07-19,9,159,262,421,AG_T,"-37.8199817, 144.96872865"
291320240708,29,2024-07-08,13,335,384,719,AG_T,"-37.8199817, 144.96872865"
29520250414,29,2025-04-14,5,9,23,32,AG_T,"-37.8199817, 144.96872865"
14220240910,14,2024-09-10,2,2,1,3,SanBri_T,"-37.82011242, 144.96291897"
14120231222,14,2023-12-22,1,56,16,72,SanBri_T,"-37.82011242, 144.96291897"
141720240322,14,2024-03-22,17,724,234,958,SanBri_T,"-37.82011242, 144.96291897"
47120250506,47,2025-05-06,1,32,25,57,Eli250_T,"-37.81258467, 144.9625775"
40920250404,40,2025-04-04,9,178,205,383,Spr201_T,"-37.80999341, 144.97227587"
21020240929,21,2024-09-29,0,204,186,390,Bourke155_T,"-37.81267313, 144.96788288"
361020240610,36,2024-06-10,10,91,72,163,Que85_T,"-37.81652527, 144.96121062"
371320250309,37,2025-03-09,13,44,48,92,Lyg260_T,"-37.80107122, 144.96704554"
371420240323,37,2024-03-23,14,166,102,268,Lyg260_T,"-37.80107122, 144.96704554"
611320240216,61,2024-02-16,13,637,778,1415,RMIT14_T,"-37.80767455, 144.96309114"
431720241105,43,2024-11-05,17,83,70,153,UM2_T,"-37.79844526, 144.96411782"
441520231115,44,2023-11-15,15,89,52,141,UM3_T,"-37.79698741, 144.96441306"
451920250816,45,2025-08-16,19,558,789,1347,Swa148_T,"-37.81414075, 144.96609379"
45220231224,45,2023-12-24,2,46,146,192,Swa148_T,"-37.81414075, 144.96609379"
1651020241114,165,2024-11-14,10,23,32,55,Spen475_T,"-37.80953359, 144.94939004"
1401820240113,140,2024-01-13,18,100,86,186,Boyd2837_T,"-37.82590962, 144.96185972"
131920250228,131,2025-02-28,9,102,123,225,King2_T,"-37.82009057, 144.95758725"
1321320240930,132,2024-09-30,13,180,167,347,King335_T,"-37.81267639, 144.95386444"
108320250215,108,2025-02-15,3,17,13,30,261Will_T,"-37.81295822, 144.95678789"
1352020250309,135,2025-03-09,20,184,242,426,Spen161_T,"-37.8172861, 144.95319102"
133820241120,133,2024-11-20,8,474,567,1041,Spen229_T,"-37.81531435, 144.95227769"
107820240626,107,2024-06-26,8,62,240,302,280Will_T,"-37.81246271, 144.95690188"
1071120250204,107,2025-02-04,11,78,87,165,280Will_T,"-37.81246271, 144.95690188"
107320250623,107,2025-06-23,3,0,3,3,280Will_T,"-37.81246271, 144.95690188"
871820250309,87,2025-03-09,18,111,82,193,Errol23_T,"-37.80454949, 144.94921863"
1851220250808,185,2025-08-08,12,749,754,1503,Eli197_T,"-37.81374643, 144.96276183"
17220250426,17,2025-04-26,2,2,1,3,Col15_T,"-37.81362543, 144.97323591"
63420250716,63,2025-07-16,4,0,2,2,Bou231_T,"-37.81333081, 144.96675571"
121420231120,12,2023-11-20,14,145,145,290,NewQ_T,"-37.81457988, 144.94292398"
86720240226,86,2024-02-26,7,29,25,54,574Qub_T,"-37.80309992, 144.94908064"
621720240103,62,2024-01-03,17,212,279,491,Lat224_T,"-37.80996494, 144.96216521"
561520240712,56,2024-07-12,15,450,394,844,Lon364_T,"-37.81234775, 144.96153311"
24020241211,24,2024-12-11,0,44,78,122,Col620_T,"-37.81887963, 144.95449198"
241020241231,24,2024-12-31,10,472,363,835,Col620_T,"-37.81887963, 144.95449198"
581520231030,58,2023-10-30,15,527,430,957,Bou688_T,"-37.81686075, 144.95358075"
2020240904,2,2024-09-04,0,13,33,46,Bou283_T,"-37.81380668, 144.96516718"
58120240622,58,2024-06-22,1,55,90,145,Bou688_T,"-37.81686075, 144.95358075"
272120250830,27,2025-08-30,21,77,37,114,Vic_T,"-37.80606888, 144.95644692"
272120241106,27,2024-11-06,21,92,42,134,Vic_T,"-37.80606888, 144.95644692"
22020250713,2,2025-07-13,20,106,160,266,Bou283_T,"-37.81380668, 144.96516718"
21120250903,2,2025-09-03,11,476,502,978,Bou283_T,"-37.81380668, 144.96516718"
531420240725,53,2024-07-25,14,707,587,1294,Col254_T,"-37.81564191, 144.965499"
79020240811,79,2024-08-11,0,135,227,362,FliSS_T,"-37.81794046, 144.96616678"
521020231116,52,2023-11-16,10,215,221,436,Eli263_T,"-37.81252157, 144.9619401"
51220241020,51,2024-10-20,2,15,4,19,Fra118_T,"-37.80841815, 144.95906316"
511320240304,51,2024-03-04,13,101,109,210,Fra118_T,"-37.80841815, 144.95906316"
521720240814,52,2024-08-14,17,419,372,791,Eli263_T,"-37.81252157, 144.9619401"
1411420241231,141,2024-12-31,14,117,113,230,474Fl_T,"-37.81997273, 144.95834911"
191020250611,19,2025-06-11,10,183,140,323,LtB210_T,"-37.81237202, 144.96550671"
1091520231228,109,2023-12-28,15,105,117,222,LatWill_T,"-37.81193681, 144.95621105"
19220240813,19,2024-08-13,2,10,22,32,LtB210_T,"-37.81237202, 144.96550671"
108220250211,108,2025-02-11,2,9,9,18,261Will_T,"-37.81295822, 144.95678789"
1241320250506,124,2025-05-06,13,10,7,17,BirBridge_T,"-37.81757416, 144.97329934"
172120240421,17,2024-04-21,21,71,84,155,Col15_T,"-37.81362543, 144.97323591"
171220240714,17,2024-07-14,12,181,107,288,Col15_T,"-37.81362543, 144.97323591"
11820240605,1,2024-06-05,18,892,538,1430,Bou292_T,"-37.81349441, 144.96515323"
1420250219,1,2025-02-19,4,2,2,4,Bou292_T,"-37.81349441, 144.96515323"
68920240920,68,2024-09-20,9,199,177,376,FLDegN_T,"-37.8168479, 144.96559789"
621620241025,62,2024-10-25,16,230,225,455,Lat224_T,"-37.80996494, 144.96216521"
762220241101,76,2024-11-01,22,14,19,33,KenMac_T,"-37.79453803, 144.93036194"
22020240208,2,2024-02-08,20,249,285,534,Bou283_T,"-37.81380668, 144.96516718"
27220240607,27,2024-06-07,2,6,7,13,Vic_T,"-37.80606888, 144.95644692"
91920250907,9,2025-09-07,19,29,30,59,Col700_T,"-37.81982992, 144.95102555"
79920250228,79,2025-02-28,9,473,230,703,FliSS_T,"-37.81794046, 144.96616678"
30620240409,30,2024-04-09,6,18,18,36,Lon189_T,"-37.8112185, 144.96656806"
79920240810,79,2024-08-10,9,286,181,467,FliSS_T,"-37.81794046, 144.96616678"
23720231031,23,2023-10-31,7,342,178,520,Col623_T,"-37.81909256, 144.95452748"
23020240220,23,2024-02-20,0,8,19,27,Col623_T,"-37.81909256, 144.95452748"
23620250510,23,2025-05-10,6,24,45,69,Col623_T,"-37.81909256, 144.95452748"
481220240612,48,2024-06-12,12,197,149,346,QVMQ_T,"-37.80631581, 144.95866697"
20220250923,20,2025-09-23,2,3,3,6,LtB170_T,"-37.81172914, 144.9682466"
251720240627,25,2024-06-27,17,986,434,1420,MCEC_T,"-37.82401776, 144.95604426"
52320241111,52,2024-11-11,3,3,5,8,Eli263_T,"-37.81252157, 144.9619401"
522120241230,52,2024-12-30,21,259,200,459,Eli263_T,"-37.81252157, 144.9619401"
52020241014,52,2024-10-14,0,12,48,60,Eli263_T,"-37.81252157, 144.9619401"
1411120250905,141,2025-09-05,11,120,74,194,474Fl_T,"-37.81997273, 144.95834911"
1371020240826,137,2024-08-26,10,17,31,48,BouHbr2353_T,"-37.81894815, 144.94612292"
1391020231214,139,2023-12-14,10,29,52,81,Signal1647_T,"-37.81959923, 144.9632832"
1391220240615,139,2024-06-15,12,66,52,118,Signal1647_T,"-37.81959923, 144.9632832"
1422120240709,142,2024-07-09,21,14,7,21,Hammer1584_T,"-37.81970749, 144.96795734"
1171620240522,117,2024-05-22,16,188,324,512,Fli114F_T,"-37.81629332, 144.97090877"
491520231218,49,2023-12-18,15,146,110,256,Eli501_T,"-37.80730068, 144.95956055"
49320250914,49,2025-09-14,3,48,37,85,Eli501_T,"-37.80730068, 144.95956055"
851420251003,85,2025-10-03,14,73,74,147,488Mac_T,"-37.79432415, 144.92973378"
17820240321,17,2024-03-21,8,1418,216,1634,Col15_T,"-37.81362543, 144.97323591"
662320240928,66,2024-09-28,23,299,303,602,QVN_T,"-37.81057846, 144.96444294"
691320240227,69,2024-02-27,13,175,246,421,FLDegC_T,"-37.81687226, 144.96559144"
691420240910,69,2024-09-10,14,204,201,405,FLDegC_T,"-37.81687226, 144.96559144"
69320250116,69,2025-01-16,3,1,0,1,FLDegC_T,"-37.81687226, 144.96559144"
701920241203,70,2024-12-03,19,141,216,357,Errol20_T,"-37.80456984, 144.94946228"
702320241229,70,2024-12-29,23,3,1,4,Errol20_T,"-37.80456984, 144.94946228"
3820250811,3,2025-08-11,8,240,247,487,Swa295_T,"-37.81101524, 144.96429485"
81120250203,8,2025-02-03,11,97,157,254,WebBN_T,"-37.82293543, 144.9471751"
8420240120,8,2024-01-20,4,2,0,2,WebBN_T,"-37.82293543, 144.9471751"
772220240626,77,2024-06-26,22,28,17,45,HarEsP_T,"-37.81441438, 144.94433026"
292120250211,29,2025-02-11,21,209,191,400,AG_T,"-37.8199817, 144.96872865"
29620240113,29,2024-01-13,6,43,36,79,AG_T,"-37.8199817, 144.96872865"
141520250727,14,2025-07-27,15,311,126,437,SanBri_T,"-37.82011242, 144.96291897"
71220240527,71,2024-05-27,2,1,2,3,WestWP_T,"-37.81235775, 144.97136962"
281020250123,28,2025-01-23,10,951,362,1313,VAC_T,"-37.82129925, 144.96879309"
311020240105,31,2024-01-05,10,75,72,147,Lyg161_T,"-37.80169681, 144.96658911"
361820250213,36,2025-02-13,18,170,187,357,Que85_T,"-37.81652527, 144.96121062"
371820241008,37,2024-10-08,18,112,161,273,Lyg260_T,"-37.80107122, 144.96704554"
37320250522,37,2025-05-22,3,5,0,5,Lyg260_T,"-37.80107122, 144.96704554"
130920250809,130,2025-08-09,9,46,38,84,Bou892T,"-37.8204637, 144.94126826"
691820240501,69,2024-05-01,18,48,60,108,FLDegC_T,"-37.81687226, 144.96559144"
84020241121,84,2024-11-21,0,75,57,132,ElFi_T,"-37.81798049, 144.96503383"
841620241215,84,2024-12-15,16,789,1177,1966,ElFi_T,"-37.81798049, 144.96503383"
701620250505,70,2025-05-05,16,160,156,316,Errol20_T,"-37.80456984, 144.94946228"
391620240306,39,2024-03-06,16,142,110,252,AlfPl_T,"-37.81379749, 144.96995745"
75620240824,75,2024-08-24,6,4,9,13,SprFli_T,"-37.81515276, 144.97467661"
411320240112,41,2024-01-12,13,1489,1318,2807,Swa31,"-37.81668634, 144.96689733"
411920240202,41,2024-02-02,19,1134,1002,2136,Swa31,"-37.81668634, 144.96689733"
421420241113,42,2024-11-13,14,128,135,263,UM1_T,"-37.80008566, 144.96386412"
29520240725,29,2024-07-25,5,12,18,30,AG_T,"-37.8199817, 144.96872865"
54820240226,54,2024-02-26,8,433,35,468,Swa607_T,"-37.804024, 144.96308399"
54720240701,54,2024-07-01,7,23,22,45,Swa607_T,"-37.804024, 144.96308399"
472220240217,47,2024-02-17,22,547,424,971,Eli250_T,"-37.81258467, 144.9625775"
431420240811,43,2024-08-11,14,111,84,195,UM2_T,"-37.79844526, 144.96411782"
451220250722,45,2025-07-22,12,415,547,962,Swa148_T,"-37.81414075, 144.96609379"
5020250524,5,2025-05-24,0,88,171,259,PriNW_T,"-37.81874249, 144.96787656"
167820251011,167,2025-10-11,8,4,53,57,Lat526_T,"-37.81304149, 144.95155955"
1652220250406,165,2025-04-06,22,8,2,10,Spen475_T,"-37.80953359, 144.94939004"
1322020241209,132,2024-12-09,20,111,124,235,King335_T,"-37.81267639, 144.95386444"
135620240523,135,2024-05-23,6,54,41,95,Spen161_T,"-37.8172861, 144.95319102"
133220240717,133,2024-07-17,2,11,12,23,Spen229_T,"-37.81531435, 144.95227769"
133920240721,133,2024-07-21,9,328,425,753,Spen229_T,"-37.81531435, 144.95227769"
1181720250418,118,2025-04-18,17,18,8,26,Fli114C_T,"-37.81632783, 144.97090512"
1241820231028,124,2023-10-28,18,1,4,5,BirBridge_T,"-37.81757416, 144.97329934"
1241220250714,124,2025-07-14,12,3,3,6,BirBridge_T,"-37.81757416, 144.97329934"
108820250820,108,2025-08-20,8,248,2461,2709,261Will_T,"-37.81295822, 144.95678789"
67720251005,67,2025-10-05,7,38,43,81,FLDegS_T,"-37.81688755, 144.96562569"
85820250112,85,2025-01-12,8,64,34,98,488Mac_T,"-37.79432415, 144.92973378"
1820241118,1,2024-11-18,8,277,273,550,Bou292_T,"-37.81349441, 144.96515323"
672320250120,67,2025-01-20,23,20,24,44,FLDegS_T,"-37.81688755, 144.96562569"
861820240223,86,2024-02-23,18,52,60,112,574Qub_T,"-37.80309992, 144.94908064"
56920250412,56,2025-04-12,9,162,112,274,Lon364_T,"-37.81234775, 144.96153311"
72220240202,72,2024-02-02,2,5,5,10,ACMI_T,"-37.81726338, 144.96872809"
27920231213,27,2023-12-13,9,41,60,101,Vic_T,"-37.80606888, 144.95644692"
2620250708,2,2025-07-08,6,18,41,59,Bou283_T,"-37.81380668, 144.96516718"
79720241206,79,2024-12-06,7,167,152,319,FliSS_T,"-37.81794046, 144.96616678"
512320241212,51,2024-12-12,23,51,23,74,Fra118_T,"-37.80841815, 144.95906316"
51420250726,51,2025-07-26,4,5,8,13,Fra118_T,"-37.80841815, 144.95906316"
51420250829,51,2025-08-29,4,3,3,6,Fra118_T,"-37.80841815, 144.95906316"
23820250211,23,2025-02-11,8,756,470,1226,Col623_T,"-37.81909256, 144.95452748"
231120250922,23,2025-09-22,11,180,228,408,Col623_T,"-37.81909256, 144.95452748"
87920231110,87,2023-11-10,9,49,47,96,Errol23_T,"-37.80454949, 144.94921863"
432020240124,43,2024-01-24,20,39,57,96,UM2_T,"-37.79844526, 144.96411782"
43120240806,43,2024-08-06,1,4,3,7,UM2_T,"-37.79844526, 144.96411782"
45820250206,45,2025-02-06,8,276,305,581,Swa148_T,"-37.81414075, 144.96609379"
70520231129,70,2023-11-29,5,0,1,1,Errol20_T,"-37.80456984, 144.94946228"
185220251004,185,2025-10-04,2,94,66,160,Eli197_T,"-37.81374643, 144.96276183"
165920241218,165,2024-12-18,9,19,29,48,Spen475_T,"-37.80953359, 144.94939004"
1651420250415,165,2025-04-15,14,55,37,92,Spen475_T,"-37.80953359, 144.94939004"
1311320241120,131,2024-11-20,13,244,212,456,King2_T,"-37.82009057, 144.95758725"
1622320251010,162,2025-10-10,23,190,113,303,Eli489_T,"-37.80740397, 144.95987909"
1842020250802,184,2025-08-02,20,429,605,1034,Eli124_T,"-37.81512416, 144.96371988"
1351420240318,135,2024-03-18,14,368,353,721,Spen161_T,"-37.8172861, 144.95319102"
1181420250225,118,2025-02-25,14,15,22,37,Fli114C_T,"-37.81632783, 144.97090512"
67120240127,67,2024-01-27,1,22,17,39,FLDegS_T,"-37.81688755, 144.96562569"
671520241220,67,2024-12-20,15,294,415,709,FLDegS_T,"-37.81688755, 144.96562569"
63220250915,63,2025-09-15,2,4,18,22,Bou231_T,"-37.81333081, 144.96675571"
682220240917,68,2024-09-17,22,25,8,33,FLDegN_T,"-37.8168479, 144.96559789"
86720250618,86,2025-06-18,7,19,11,30,574Qub_T,"-37.80309992, 144.94908064"
11920240716,11,2024-07-16,9,41,50,91,WatCit_T,"-37.81564989, 144.93970694"
722220241204,72,2024-12-04,22,291,282,573,ACMI_T,"-37.81726338, 144.96872809"
72320240201,72,2024-02-01,3,4,6,10,ACMI_T,"-37.81726338, 144.96872809"
76620250205,76,2025-02-05,6,10,12,22,KenMac_T,"-37.79453803, 144.93036194"
761120240701,76,2024-07-01,11,71,73,144,KenMac_T,"-37.79453803, 144.93036194"
2720250330,2,2025-03-30,7,18,28,46,Bou283_T,"-37.81380668, 144.96516718"
79920251015,79,2025-10-15,9,328,203,531,FliSS_T,"-37.81794046, 144.96616678"
791520250311,79,2025-03-11,15,415,455,870,FliSS_T,"-37.81794046, 144.96616678"
191920240624,19,2024-06-24,19,405,476,881,LtB210_T,"-37.81237202, 144.96550671"
481120240309,48,2024-03-09,11,381,282,663,QVMQ_T,"-37.80631581, 144.95866697"
481020240713,48,2024-07-13,10,364,350,714,QVMQ_T,"-37.80631581, 144.95866697"
46620231024,46,2023-10-24,6,6,35,41,Pel147_T,"-37.80240719, 144.9615673"
1411520250328,141,2025-03-28,15,133,152,285,474Fl_T,"-37.81997273, 144.95834911"
1371820250903,137,2025-09-03,18,3,22,25,BouHbr2353_T,"-37.81894815, 144.94612292"
1372120231117,137,2023-11-17,21,2,4,6,BouHbr2353_T,"-37.81894815, 144.94612292"
1371720240719,137,2024-07-19,17,10,63,73,BouHbr2353_T,"-37.81894815, 144.94612292"
1372120241022,137,2024-10-22,21,3,5,8,BouHbr2353_T,"-37.81894815, 144.94612292"
137220241225,137,2024-12-25,2,1,0,1,BouHbr2353_T,"-37.81894815, 144.94612292"
1391820241221,139,2024-12-21,18,134,62,196,Signal1647_T,"-37.81959923, 144.9632832"
139220240413,139,2024-04-13,2,3,1,4,Signal1647_T,"-37.81959923, 144.9632832"
1362120240324,136,2024-03-24,21,6,3,9,BirFed1120_T,"-37.8184141, 144.97357915"
136720240912,136,2024-09-12,7,93,106,199,BirFed1120_T,"-37.8184141, 144.97357915"
161720250519,161,2025-05-19,7,69,116,185,BirArt1109_T,"-37.81851276, 144.97131336"
1381120240419,138,2024-04-19,11,1,6,7,EntPark1671_T,"-37.81996544, 144.95981454"
123820250627,123,2025-06-27,8,27,18,45,BirBridge_T,"-37.81753741, 144.97329734"
4220241109,4,2024-11-09,2,42,60,102,Swa123_T,"-37.81487988, 144.9660878"
39220250802,39,2025-08-02,2,3,4,7,AlfPl_T,"-37.81379749, 144.96995745"
75320250516,75,2025-05-16,3,1,2,3,SprFli_T,"-37.81515276, 144.97467661"
412220250511,41,2025-05-11,22,601,478,1079,Swa31,"-37.81668634, 144.96689733"
411420240601,41,2024-06-01,14,1595,1497,3092,Swa31,"-37.81668634, 144.96689733"
52720250417,52,2025-04-17,7,60,50,110,Eli263_T,"-37.81252157, 144.9619401"
461020240823,46,2024-08-23,10,79,54,133,Pel147_T,"-37.80240719, 144.9615673"
1381720240208,138,2024-02-08,17,5,5,10,EntPark1671_T,"-37.81996544, 144.95981454"
1381020250717,138,2025-07-17,10,4,7,11,EntPark1671_T,"-37.81996544, 144.95981454"
1172220241212,117,2024-12-12,22,157,116,273,Fli114F_T,"-37.81629332, 144.97090877"
19220240903,19,2024-09-03,2,12,13,25,LtB210_T,"-37.81237202, 144.96550671"
251920231130,25,2023-11-30,19,301,194,495,MCEC_T,"-37.82401776, 144.95604426"
25320231201,25,2023-12-01,3,5,7,12,MCEC_T,"-37.82401776, 144.95604426"
25820240531,25,2024-05-31,8,165,421,586,MCEC_T,"-37.82401776, 144.95604426"
481020231211,48,2023-12-11,10,133,71,204,QVMQ_T,"-37.80631581, 144.95866697"
137520250817,137,2025-08-17,5,0,1,1,BouHbr2353_T,"-37.81894815, 144.94612292"
1391620250422,139,2025-04-22,16,147,14,161,Signal1647_T,"-37.81959923, 144.9632832"
136520250612,136,2025-06-12,5,1,0,1,BirFed1120_T,"-37.8184141, 144.97357915"
1642320250419,164,2025-04-19,23,26,48,74,Lat526_T,"-37.813005, 144.95160411"
1612220250613,161,2025-06-13,22,4,39,43,BirArt1109_T,"-37.81851276, 144.97131336"
66220241014,66,2024-10-14,2,36,21,57,QVN_T,"-37.81057846, 144.96444294"
691720250924,69,2025-09-24,17,166,279,445,FLDegC_T,"-37.81687226, 144.96559144"
3820241112,3,2024-11-12,8,159,331,490,Swa295_T,"-37.81101524, 144.96429485"
66020240130,66,2024-01-30,0,50,22,72,QVN_T,"-37.81057846, 144.96444294"
702320240102,70,2024-01-02,23,8,8,16,Errol20_T,"-37.80456984, 144.94946228"
39720240914,39,2024-09-14,7,17,10,27,AlfPl_T,"-37.81379749, 144.96995745"
82320241129,8,2024-11-29,23,44,40,84,WebBN_T,"-37.82293543, 144.9471751"
591920241210,59,2024-12-10,19,241,147,388,RMIT_T,"-37.80825648, 144.96304859"
281620240326,28,2024-03-26,16,414,1198,1612,VAC_T,"-37.82129925, 144.96879309"
141320250421,14,2025-04-21,13,566,148,714,SanBri_T,"-37.82011242, 144.96291897"
711620240630,71,2024-06-30,16,14,9,23,WestWP_T,"-37.81235775, 144.97136962"
312020241118,31,2024-11-18,20,151,170,321,Lyg161_T,"-37.80169681, 144.96658911"
541520250304,54,2025-03-04,15,205,286,491,Swa607_T,"-37.804024, 144.96308399"
401120241216,40,2024-12-16,11,128,210,338,Spr201_T,"-37.80999341, 144.97227587"
431020250911,43,2025-09-11,10,236,133,369,UM2_T,"-37.79844526, 144.96411782"
431120231128,43,2023-11-28,11,102,107,209,UM2_T,"-37.79844526, 144.96411782"
43620240110,43,2024-01-10,6,12,3,15,UM2_T,"-37.79844526, 144.96411782"
431120250124,43,2025-01-24,11,65,50,115,UM2_T,"-37.79844526, 144.96411782"
452020240305,45,2024-03-05,20,269,694,963,Swa148_T,"-37.81414075, 144.96609379"
167620250105,167,2025-01-05,6,6,16,22,Lat526_T,"-37.81304149, 144.95155955"
1651620240914,165,2024-09-14,16,39,19,58,Spen475_T,"-37.80953359, 144.94939004"
162120240903,162,2024-09-03,1,17,17,34,Eli489_T,"-37.80740397, 144.95987909"
1622120240916,162,2024-09-16,21,143,135,278,Eli489_T,"-37.80740397, 144.95987909"
1322220241101,132,2024-11-01,22,110,107,217,King335_T,"-37.81267639, 144.95386444"
134520240518,134,2024-05-18,5,18,20,38,Spen201_T,"-37.81694221, 144.95303935"
1341820240630,134,2024-06-30,18,272,273,545,Spen201_T,"-37.81694221, 144.95303935"
135120240221,135,2024-02-21,1,25,30,55,Spen161_T,"-37.8172861, 144.95319102"
1331420240102,133,2024-01-02,14,462,566,1028,Spen229_T,"-37.81531435, 144.95227769"
1241220250415,124,2025-04-15,12,5,12,17,BirBridge_T,"-37.81757416, 144.97329934"
1822120250823,182,2025-08-23,21,327,329,656,King163_T,"-37.81627451, 144.95550503"
1791920250617,179,2025-06-17,19,42,66,108,Pow61_T,"-37.82392385, 144.96299677"
1661020250524,166,2025-05-24,10,62,82,144,Spen484_T,"-37.80896733, 144.94931703"
632220241205,63,2024-12-05,22,18,110,128,Bou231_T,"-37.81333081, 144.96675571"
681420241213,68,2024-12-13,14,250,211,461,FLDegN_T,"-37.8168479, 144.96559789"
862320250214,86,2025-02-14,23,2,12,14,574Qub_T,"-37.80309992, 144.94908064"
861120250624,86,2025-06-24,11,55,55,110,574Qub_T,"-37.80309992, 144.94908064"
651820240212,65,2024-02-12,18,304,485,789,SwaCs_T,"-37.81569416, 144.9668064"
421520251015,42,2025-10-15,15,319,395,714,UM1_T,"-37.80008566, 144.96386412"
141120250429,14,2025-04-29,11,193,89,282,SanBri_T,"-37.82011242, 144.96291897"
541420251001,54,2025-10-01,14,118,154,272,Swa607_T,"-37.804024, 144.96308399"
31220231114,31,2023-11-14,2,4,0,4,Lyg161_T,"-37.80169681, 144.96658911"
361320240414,36,2024-04-14,13,83,100,183,Que85_T,"-37.81652527, 144.96121062"
612220250218,61,2025-02-18,22,187,108,295,RMIT14_T,"-37.80767455, 144.96309114"
611620240314,61,2024-03-14,16,685,938,1623,RMIT14_T,"-37.80767455, 144.96309114"
61520240117,61,2024-01-17,5,11,20,31,RMIT14_T,"-37.80767455, 144.96309114"
451820250604,45,2025-06-04,18,334,679,1013,Swa148_T,"-37.81414075, 144.96609379"
181620250827,181,2025-08-27,6,114,119,233,Eli368_T,"-37.81009465, 144.96143149"
1852320251001,185,2025-10-01,23,95,97,192,Eli197_T,"-37.81374643, 144.96276183"
143220240825,143,2024-08-25,2,101,50,151,Spencer_T,"-37.821728, 144.95557015"
1341220241012,134,2024-10-12,12,415,505,920,Spen201_T,"-37.81694221, 144.95303935"
131820240308,131,2024-03-08,8,128,53,181,King2_T,"-37.82009057, 144.95758725"
1352120250705,135,2025-07-05,21,139,493,632,Spen161_T,"-37.8172861, 144.95319102"
1181420241210,118,2024-12-10,14,14,14,28,Fli114C_T,"-37.81632783, 144.97090512"
1181420251012,118,2025-10-12,14,18,33,51,Fli114C_T,"-37.81632783, 144.97090512"
171720231101,17,2023-11-01,17,279,791,1070,Col15_T,"-37.81362543, 144.97323591"
12020250521,1,2025-05-21,20,301,231,532,Bou292_T,"-37.81349441, 144.96515323"
63920240429,63,2024-04-29,9,151,181,332,Bou231_T,"-37.81333081, 144.96675571"
671520250806,67,2025-08-06,15,380,489,869,FLDegS_T,"-37.81688755, 144.96562569"
181620240425,18,2024-04-25,16,59,33,92,Col12_T,"-37.81344862, 144.97305353"
181120240720,18,2024-07-20,11,75,74,149,Col12_T,"-37.81344862, 144.97305353"
181320250902,18,2025-09-02,13,196,170,366,Col12_T,"-37.81344862, 144.97305353"
631320240107,63,2024-01-07,13,189,186,375,Bou231_T,"-37.81333081, 144.96675571"
632320250127,63,2025-01-27,23,1,27,28,Bou231_T,"-37.81333081, 144.96675571"
562220240615,56,2024-06-15,22,229,275,504,Lon364_T,"-37.81234775, 144.96153311"
861920240410,86,2024-04-10,19,38,60,98,574Qub_T,"-37.80309992, 144.94908064"
86220250113,86,2025-01-13,2,3,0,3,574Qub_T,"-37.80309992, 144.94908064"
86320241222,86,2024-12-22,3,0,1,1,574Qub_T,"-37.80309992, 144.94908064"
12620250911,12,2025-09-11,6,8,5,13,NewQ_T,"-37.81457988, 144.94292398"
11520250927,11,2025-09-27,5,1,1,2,WatCit_T,"-37.81564989, 144.93970694"
722320241223,72,2024-12-23,23,208,103,311,ACMI_T,"-37.81726338, 144.96872809"
722120250920,72,2025-09-20,21,114,250,364,ACMI_T,"-37.81726338, 144.96872809"
761120250215,76,2025-02-15,11,112,146,258,KenMac_T,"-37.79453803, 144.93036194"
72420250502,72,2025-05-02,4,0,1,1,ACMI_T,"-37.81726338, 144.96872809"
9520241118,9,2024-11-18,5,13,24,37,Col700_T,"-37.81982992, 144.95102555"
30420241212,30,2024-12-12,4,11,24,35,Lon189_T,"-37.8112185, 144.96656806"
30920240316,30,2024-03-16,9,56,145,201,Lon189_T,"-37.8112185, 144.96656806"
79520241103,79,2024-11-03,5,29,36,65,FliSS_T,"-37.81794046, 144.96616678"
511820231213,51,2023-12-13,18,150,138,288,Fra118_T,"-37.80841815, 144.95906316"
51420240125,51,2024-01-25,4,8,5,13,Fra118_T,"-37.80841815, 144.95906316"
51520240905,51,2024-09-05,5,6,10,16,Fra118_T,"-37.80841815, 144.95906316"
133420250409,133,2025-04-09,4,14,22,36,Spen229_T,"-37.81531435, 144.95227769"
1182220231217,118,2023-12-17,22,19,11,30,Fli114C_T,"-37.81632783, 144.97090512"
1182320250731,118,2025-07-31,23,0,2,2,Fli114C_T,"-37.81632783, 144.97090512"
852020250411,85,2025-04-11,20,40,36,76,488Mac_T,"-37.79432415, 144.92973378"
851320250913,85,2025-09-13,13,92,75,167,488Mac_T,"-37.79432415, 144.92973378"
11820241004,1,2024-10-04,18,1742,887,2629,Bou292_T,"-37.81349441, 144.96515323"
18320250709,18,2025-07-09,3,0,2,2,Col12_T,"-37.81344862, 144.97305353"
631120250416,63,2025-04-16,11,318,387,705,Bou231_T,"-37.81333081, 144.96675571"
631420250727,63,2025-07-27,14,298,393,691,Bou231_T,"-37.81333081, 144.96675571"
631120250802,63,2025-08-02,11,266,353,619,Bou231_T,"-37.81333081, 144.96675571"
122120231116,12,2023-11-16,21,95,87,182,NewQ_T,"-37.81457988, 144.94292398"
621020250425,62,2025-04-25,10,99,93,192,Lat224_T,"-37.80996494, 144.96216521"
112020250203,11,2025-02-03,20,203,213,416,WatCit_T,"-37.81564989, 144.93970694"
72820250129,72,2025-01-29,8,647,99,746,ACMI_T,"-37.81726338, 144.96872809"
581520250309,58,2025-03-09,15,533,332,865,Bou688_T,"-37.81686075, 144.95358075"
761920250913,76,2025-09-13,19,25,27,52,KenMac_T,"-37.79453803, 144.93036194"
58020250828,58,2025-08-28,0,55,63,118,Bou688_T,"-37.81686075, 144.95358075"
531120240601,53,2024-06-01,11,564,473,1037,Col254_T,"-37.81564191, 144.965499"
79520240622,79,2024-06-22,5,24,29,53,FliSS_T,"-37.81794046, 144.96616678"
23320231025,23,2023-10-25,3,0,7,7,Col623_T,"-37.81909256, 144.95452748"
52320250312,52,2025-03-12,3,6,18,24,Eli263_T,"-37.81252157, 144.9619401"
20220250224,20,2025-02-24,2,5,8,13,LtB170_T,"-37.81172914, 144.9682466"
461020250729,46,2025-07-29,10,131,54,185,Pel147_T,"-37.80240719, 144.9615673"
492320240703,49,2024-07-03,23,74,87,161,Eli501_T,"-37.80730068, 144.95956055"
1091620250108,109,2025-01-08,16,219,88,307,LatWill_T,"-37.81193681, 144.95621105"
49120250207,49,2025-02-07,1,31,32,63,Eli501_T,"-37.80730068, 144.95956055"
25720240921,25,2024-09-21,7,91,126,217,MCEC_T,"-37.82401776, 144.95604426"
481320250401,48,2025-04-01,13,447,245,692,QVMQ_T,"-37.80631581, 144.95866697"
1391120251015,139,2025-10-15,11,31,53,84,Signal1647_T,"-37.81959923, 144.9632832"
142420231125,142,2023-11-25,4,4,3,7,Hammer1584_T,"-37.81970749, 144.96795734"
1421420250119,142,2025-01-19,14,701,496,1197,Hammer1584_T,"-37.81970749, 144.96795734"
1301320240113,130,2024-01-13,13,18,25,43,Bou892T,"-37.8204637, 144.94126826"
1381620250906,138,2025-09-06,16,6,9,15,EntPark1671_T,"-37.81996544, 144.95981454"
117720250919,117,2025-09-19,7,79,38,117,Fli114F_T,"-37.81629332, 144.97090877"
117720240814,117,2024-08-14,7,137,53,190,Fli114F_T,"-37.81629332, 144.97090877"
66620250428,66,2025-04-28,6,22,84,106,QVN_T,"-37.81057846, 144.96444294"
692220250803,69,2025-08-03,22,16,16,32,FLDegC_T,"-37.81687226, 144.96559144"
6220231111,6,2023-11-11,2,114,83,197,FliS_T,"-37.81911705, 144.96558255"
841820241218,84,2024-12-18,18,1107,1736,2843,ElFi_T,"-37.81798049, 144.96503383"
31220231020,3,2023-10-20,12,958,1139,2097,Swa295_T,"-37.81101524, 144.96429485"
3220241129,3,2024-11-29,2,57,37,94,Swa295_T,"-37.81101524, 144.96429485"
75320240908,75,2024-09-08,3,7,9,16,SprFli_T,"-37.81515276, 144.97467661"
81020250204,8,2025-02-04,10,124,126,250,WebBN_T,"-37.82293543, 144.9471751"
81820240623,8,2024-06-23,18,104,51,155,WebBN_T,"-37.82293543, 144.9471751"
411420250922,41,2025-09-22,14,1442,1701,3143,Swa31,"-37.81668634, 144.96689733"
772120250606,77,2025-06-06,21,41,22,63,HarEsP_T,"-37.81441438, 144.94433026"
77320231227,77,2023-12-27,3,2,0,2,HarEsP_T,"-37.81441438, 144.94433026"
141120240515,14,2024-05-15,11,250,98,348,SanBri_T,"-37.82011242, 144.96291897"
71520240504,71,2024-05-04,5,2,2,4,WestWP_T,"-37.81235775, 144.97136962"
281420240614,28,2024-06-14,14,568,585,1153,VAC_T,"-37.82129925, 144.96879309"
281320231226,28,2023-12-26,13,840,778,1618,VAC_T,"-37.82129925, 144.96879309"
54720241216,54,2024-12-16,7,28,21,49,Swa607_T,"-37.804024, 144.96308399"
36220250425,36,2025-04-25,2,18,11,29,Que85_T,"-37.81652527, 144.96121062"
361720241109,36,2024-11-09,17,115,100,215,Que85_T,"-37.81652527, 144.96121062"
371420240726,37,2024-07-26,14,69,101,170,Lyg260_T,"-37.80107122, 144.96704554"
5520251011,5,2025-10-11,5,34,47,81,PriNW_T,"-37.81874249, 144.96787656"
62420250511,62,2025-05-11,4,17,21,38,Lat224_T,"-37.80996494, 144.96216521"
24920240412,24,2024-04-12,9,941,314,1255,Col620_T,"-37.81887963, 144.95449198"
352320250716,35,2025-07-16,23,75,84,159,SouthB_T,"-37.82018685, 144.96508508"
27120240517,27,2024-05-17,1,10,5,15,Vic_T,"-37.80606888, 144.95644692"
53420250802,53,2025-08-02,4,7,5,12,Col254_T,"-37.81564191, 144.965499"
91620231028,9,2023-10-28,16,127,76,203,Col700_T,"-37.81982992, 144.95102555"
79820250108,79,2025-01-08,8,510,217,727,FliSS_T,"-37.81794046, 144.96616678"
231820231110,23,2023-11-10,18,175,256,431,Col623_T,"-37.81909256, 144.95452748"
301420240824,30,2024-08-24,14,336,515,851,Lon189_T,"-37.8112185, 144.96656806"
301220241208,30,2024-12-08,12,292,377,669,Lon189_T,"-37.8112185, 144.96656806"
51920250817,51,2025-08-17,9,65,89,154,Fra118_T,"-37.80841815, 144.95906316"
231120250205,23,2025-02-05,11,253,247,500,Col623_T,"-37.81909256, 144.95452748"
232320240928,23,2024-09-28,23,52,110,162,Col623_T,"-37.81909256, 144.95452748"
20720240902,20,2024-09-02,7,30,27,57,LtB170_T,"-37.81172914, 144.9682466"
52620250505,52,2025-05-05,6,24,23,47,Eli263_T,"-37.81252157, 144.9619401"
1411220240519,141,2024-05-19,12,105,201,306,474Fl_T,"-37.81997273, 144.95834911"
1411320250223,141,2025-02-23,13,128,151,279,474Fl_T,"-37.81997273, 144.95834911"
138920241009,138,2024-10-09,9,5,4,9,EntPark1671_T,"-37.81996544, 144.95981454"
1171920250721,117,2025-07-21,19,65,70,135,Fli114F_T,"-37.81629332, 144.97090877"
139020250223,139,2025-02-23,0,14,18,32,Signal1647_T,"-37.81959923, 144.9632832"
1421320241018,142,2024-10-18,13,224,221,445,Hammer1584_T,"-37.81970749, 144.96795734"
1231420240710,123,2024-07-10,14,6,5,11,BirBridge_T,"-37.81753741, 144.97329734"
661420250826,66,2025-08-26,14,1055,1099,2154,QVN_T,"-37.81057846, 144.96444294"
691620250910,69,2025-09-10,16,163,210,373,FLDegC_T,"-37.81687226, 144.96559144"
61120241215,6,2024-12-15,11,720,721,1441,FliS_T,"-37.81911705, 144.96558255"
70420231217,70,2023-12-17,4,3,4,7,Errol20_T,"-37.80456984, 144.94946228"
70620240119,70,2024-01-19,6,12,10,22,Errol20_T,"-37.80456984, 144.94946228"
701520240920,70,2024-09-20,15,132,138,270,Errol20_T,"-37.80456984, 144.94946228"
391320240816,39,2024-08-16,13,145,171,316,AlfPl_T,"-37.81379749, 144.96995745"
81520250516,8,2025-05-16,15,146,221,367,WebBN_T,"-37.82293543, 144.9471751"
591820240217,59,2024-02-17,18,791,665,1456,RMIT_T,"-37.80825648, 144.96304859"
591520250804,59,2025-08-04,15,1126,1551,2677,RMIT_T,"-37.80825648, 144.96304859"
772120241207,77,2024-12-07,21,132,132,264,HarEsP_T,"-37.81441438, 144.94433026"
77420251015,77,2025-10-15,4,2,1,3,HarEsP_T,"-37.81441438, 144.94433026"
422120240926,42,2024-09-26,21,50,54,104,UM1_T,"-37.80008566, 144.96386412"
421120250705,42,2025-07-05,11,57,97,154,UM1_T,"-37.80008566, 144.96386412"
421220250930,42,2025-09-30,12,158,233,391,UM1_T,"-37.80008566, 144.96386412"
28820240131,28,2024-01-31,8,540,288,828,VAC_T,"-37.82129925, 144.96879309"
141020250216,14,2025-02-16,10,241,53,294,SanBri_T,"-37.82011242, 144.96291897"
14420231112,14,2023-11-12,4,43,8,51,SanBri_T,"-37.82011242, 144.96291897"
71520250709,71,2025-07-09,5,4,3,7,WestWP_T,"-37.81235775, 144.97136962"
31620250611,31,2025-06-11,6,12,7,19,Lyg161_T,"-37.80169681, 144.96658911"
54420250327,54,2025-03-27,4,7,7,14,Swa607_T,"-37.804024, 144.96308399"
472020240416,47,2024-04-16,20,426,374,800,Eli250_T,"-37.81258467, 144.9625775"
361820250110,36,2025-01-10,18,190,185,375,Que85_T,"-37.81652527, 144.96121062"
612220250818,61,2025-08-18,22,134,93,227,RMIT14_T,"-37.80767455, 144.96309114"
872220231219,87,2023-12-19,22,21,32,53,Errol23_T,"-37.80454949, 144.94921863"
45820240622,45,2024-06-22,8,112,99,211,Swa148_T,"-37.81414075, 144.96609379"
52320250503,5,2025-05-03,23,231,704,935,PriNW_T,"-37.81874249, 144.96787656"
1671820241003,167,2024-10-03,18,35,67,102,Lat526_T,"-37.81304149, 144.95155955"
140920240127,140,2024-01-27,9,151,51,202,Boyd2837_T,"-37.82590962, 144.96185972"
162220250319,162,2025-03-19,2,24,20,44,Eli489_T,"-37.80740397, 144.95987909"
1081020240930,108,2024-09-30,10,199,384,583,261Will_T,"-37.81295822, 144.95678789"
108520241202,108,2024-12-02,5,5,51,56,261Will_T,"-37.81295822, 144.95678789"
1071220240915,107,2024-09-15,12,121,196,317,280Will_T,"-37.81246271, 144.95690188"
1081520240607,108,2024-06-07,15,165,158,323,261Will_T,"-37.81295822, 144.95678789"
872320241009,87,2024-10-09,23,7,8,15,Errol23_T,"-37.80454949, 144.94921863"
871120250113,87,2025-01-13,11,90,85,175,Errol23_T,"-37.80454949, 144.94921863"
1661320250813,166,2025-08-13,13,51,58,109,Spen484_T,"-37.80896733, 144.94931703"
671620240322,67,2024-03-22,16,306,489,795,FLDegS_T,"-37.81688755, 144.96562569"
671020240509,67,2024-05-09,10,349,360,709,FLDegS_T,"-37.81688755, 144.96562569"
681020240102,68,2024-01-02,10,84,47,131,FLDegN_T,"-37.8168479, 144.96559789"
171620231108,17,2023-11-08,16,175,443,618,Col15_T,"-37.81362543, 144.97323591"
17520241220,17,2024-12-20,5,28,17,45,Col15_T,"-37.81362543, 144.97323591"
17120250130,17,2025-01-30,1,7,8,15,Col15_T,"-37.81362543, 144.97323591"
11620250130,1,2025-01-30,16,1013,1116,2129,Bou292_T,"-37.81349441, 144.96515323"
681920241027,68,2024-10-27,19,157,117,274,FLDegN_T,"-37.8168479, 144.96559789"
181320231126,18,2023-11-26,13,94,61,155,Col12_T,"-37.81344862, 144.97305353"
18220240331,18,2024-03-31,2,0,1,1,Col12_T,"-37.81344862, 144.97305353"
68620241118,68,2024-11-18,6,23,10,33,FLDegN_T,"-37.8168479, 144.96559789"
11020250929,1,2025-09-29,10,510,591,1101,Bou292_T,"-37.81349441, 144.96515323"
121320240113,12,2024-01-13,13,137,235,372,NewQ_T,"-37.81457988, 144.94292398"
622020241107,62,2024-11-07,20,257,256,513,Lat224_T,"-37.80996494, 144.96216521"
101920241102,10,2024-11-02,19,208,118,326,BouHbr_T,"-37.81876474, 144.94710545"
721720250803,72,2025-08-03,17,112,284,396,ACMI_T,"-37.81726338, 144.96872809"
581720250508,58,2025-05-08,17,813,1425,2238,Bou688_T,"-37.81686075, 144.95358075"
58520240404,58,2024-04-04,5,84,24,108,Bou688_T,"-37.81686075, 144.95358075"
531820250706,53,2025-07-06,18,230,181,411,Col254_T,"-37.81564191, 144.965499"
9620250513,9,2025-05-13,6,29,318,347,Col700_T,"-37.81982992, 144.95102555"
531120240119,53,2024-01-19,11,802,547,1349,Col254_T,"-37.81564191, 144.965499"
531320240307,53,2024-03-07,13,1044,804,1848,Col254_T,"-37.81564191, 144.965499"
231220231207,23,2023-12-07,12,453,600,1053,Col623_T,"-37.81909256, 144.95452748"
30120250717,30,2025-07-17,1,37,44,81,Lon189_T,"-37.8112185, 144.96656806"
52620240117,52,2024-01-17,6,23,23,46,Eli263_T,"-37.81252157, 144.9619401"
232020241124,23,2024-11-24,20,84,133,217,Col623_T,"-37.81909256, 144.95452748"
202120250217,20,2025-02-17,21,83,189,272,LtB170_T,"-37.81172914, 144.9682466"
521520240918,52,2024-09-18,15,361,225,586,Eli263_T,"-37.81252157, 144.9619401"
138620240422,138,2024-04-22,6,2,0,2,EntPark1671_T,"-37.81996544, 144.95981454"
1411920231114,141,2023-11-14,19,88,95,183,474Fl_T,"-37.81997273, 144.95834911"
1371720240615,137,2024-06-15,17,2,9,11,BouHbr2353_T,"-37.81894815, 144.94612292"
1391120240914,139,2024-09-14,11,20,18,38,Signal1647_T,"-37.81959923, 144.9632832"
136520250526,136,2025-05-26,5,3,1,4,BirFed1120_T,"-37.8184141, 144.97357915"
1361120251003,136,2025-10-03,11,73,31,104,BirFed1120_T,"-37.8184141, 144.97357915"
136220240318,136,2024-03-18,2,3,0,3,BirFed1120_T,"-37.8184141, 144.97357915"
130620250708,130,2025-07-08,6,8,2,10,Bou892T,"-37.8204637, 144.94126826"
1611420250105,161,2025-01-05,14,50,35,85,BirArt1109_T,"-37.81851276, 144.97131336"
691420231222,69,2023-12-22,14,267,309,576,FLDegC_T,"-37.81687226, 144.96559144"
41620240112,4,2024-01-12,16,1404,1158,2562,Swa123_T,"-37.81487988, 144.9660878"
61220250618,6,2025-06-18,12,716,601,1317,FliS_T,"-37.81911705, 144.96558255"
842320250228,84,2025-02-28,23,448,512,960,ElFi_T,"-37.81798049, 144.96503383"
31920240513,3,2024-05-13,19,838,924,1762,Swa295_T,"-37.81101524, 144.96429485"
31620240519,3,2024-05-19,16,1085,1223,2308,Swa295_T,"-37.81101524, 144.96429485"
41420240708,4,2024-07-08,14,1579,1513,3092,Swa123_T,"-37.81487988, 144.9660878"
391820250324,39,2025-03-24,18,59,39,98,AlfPl_T,"-37.81379749, 144.96995745"
75920250107,75,2025-01-07,9,33,36,69,SprFli_T,"-37.81515276, 144.97467661"
59620250315,59,2025-03-15,6,13,21,34,RMIT_T,"-37.80825648, 144.96304859"
771220250216,77,2025-02-16,12,167,84,251,HarEsP_T,"-37.81441438, 144.94433026"
291620240808,29,2024-08-08,16,151,237,388,AG_T,"-37.8199817, 144.96872865"
14220241014,14,2024-10-14,2,15,2,17,SanBri_T,"-37.82011242, 144.96291897"
712120240311,71,2024-03-11,21,3,1,4,WestWP_T,"-37.81235775, 144.97136962"
541420240214,54,2024-02-14,14,217,267,484,Swa607_T,"-37.804024, 144.96308399"
282320250124,28,2025-01-24,23,155,1567,1722,VAC_T,"-37.82129925, 144.96879309"
472120250506,47,2025-05-06,21,324,271,595,Eli250_T,"-37.81258467, 144.9625775"
361820240526,36,2024-05-26,18,79,54,133,Que85_T,"-37.81652527, 144.96121062"
211020231205,21,2023-12-05,10,178,171,349,Bourke155_T,"-37.81267313, 144.96788288"
371420240509,37,2024-05-09,14,72,84,156,Lyg260_T,"-37.80107122, 144.96704554"
61220240413,61,2024-04-13,2,40,11,51,RMIT14_T,"-37.80767455, 144.96309114"
441720250419,44,2025-04-19,17,38,41,79,UM3_T,"-37.79698741, 144.96441306"
45620250803,45,2025-08-03,6,21,40,61,Swa148_T,"-37.81414075, 144.96609379"
45820250219,45,2025-02-19,8,162,395,557,Swa148_T,"-37.81414075, 144.96609379"
52220250311,5,2025-03-11,22,1029,399,1428,PriNW_T,"-37.81874249, 144.96787656"
51920250317,5,2025-03-17,19,509,712,1221,PriNW_T,"-37.81874249, 144.96787656"
21920240530,21,2024-05-30,9,91,103,194,Bourke155_T,"-37.81267313, 144.96788288"
1671620250905,167,2025-09-05,16,73,89,162,Lat526_T,"-37.81304149, 144.95155955"
1311220231102,131,2023-11-02,12,97,123,220,King2_T,"-37.82009057, 144.95758725"
1622120250801,162,2025-08-01,21,240,164,404,Eli489_T,"-37.80740397, 144.95987909"
1431320240716,143,2024-07-16,13,205,262,467,Spencer_T,"-37.821728, 144.95557015"
108320250317,108,2025-03-17,3,14,9,23,261Will_T,"-37.81295822, 144.95678789"
132920231122,132,2023-11-22,9,113,60,173,King335_T,"-37.81267639, 144.95386444"
118720240815,118,2024-08-15,7,9,6,15,Fli114C_T,"-37.81632783, 144.97090512"
118820240416,118,2024-04-16,8,40,22,62,Fli114C_T,"-37.81632783, 144.97090512"
1081720250920,108,2025-09-20,17,119,119,238,261Will_T,"-37.81295822, 144.95678789"
1662020250209,166,2025-02-09,20,33,15,48,Spen484_T,"-37.80896733, 144.94931703"
68720231030,68,2023-10-30,7,41,36,77,FLDegN_T,"-37.8168479, 144.96559789"
18920250705,18,2025-07-05,9,70,78,148,Col12_T,"-37.81344862, 144.97305353"
682320250919,68,2025-09-19,23,36,71,107,FLDegN_T,"-37.8168479, 144.96559789"
56320240822,56,2024-08-22,3,8,23,31,Lon364_T,"-37.81234775, 144.96153311"
56120250305,56,2025-03-05,1,20,29,49,Lon364_T,"-37.81234775, 144.96153311"
101020240407,10,2024-04-07,10,23,34,57,BouHbr_T,"-37.81876474, 144.94710545"
121220250713,12,2025-07-13,12,127,212,339,NewQ_T,"-37.81457988, 144.94292398"
722320240425,72,2024-04-25,23,78,50,128,ACMI_T,"-37.81726338, 144.96872809"
721320241003,72,2024-10-03,13,208,437,645,ACMI_T,"-37.81726338, 144.96872809"
10420240209,10,2024-02-09,4,1,0,1,BouHbr_T,"-37.81876474, 144.94710545"
58320241106,58,2024-11-06,3,8,12,20,Bou688_T,"-37.81686075, 144.95358075"
27320231221,27,2023-12-21,3,5,1,6,Vic_T,"-37.80606888, 144.95644692"
22320250707,2,2025-07-07,23,9,21,30,Bou283_T,"-37.81380668, 144.96516718"
531420250609,53,2025-06-09,14,538,346,884,Col254_T,"-37.81564191, 144.965499"
532320250205,53,2025-02-05,23,33,105,138,Col254_T,"-37.81564191, 144.965499"
301520241119,30,2024-11-19,15,192,341,533,Lon189_T,"-37.8112185, 144.96656806"
20920241022,20,2024-10-22,9,72,56,128,LtB170_T,"-37.81172914, 144.9682466"
48920250123,48,2025-01-23,9,140,157,297,QVMQ_T,"-37.80631581, 144.95866697"
46020240720,46,2024-07-20,0,6,8,14,Pel147_T,"-37.80240719, 144.9615673"
25320240131,25,2024-01-31,3,1,5,6,MCEC_T,"-37.82401776, 144.95604426"
521520250318,52,2025-03-18,15,567,255,822,Eli263_T,"-37.81252157, 144.9619401"
461920250307,46,2025-03-07,19,56,68,124,Pel147_T,"-37.80240719, 144.9615673"
1361320240104,136,2024-01-04,13,114,108,222,BirFed1120_T,"-37.8184141, 144.97357915"
1301320240130,130,2024-01-30,13,40,75,115,Bou892T,"-37.8204637, 144.94126826"
1231720250827,123,2025-08-27,17,46,44,90,BirBridge_T,"-37.81753741, 144.97329734"
109020240114,109,2024-01-14,0,41,55,96,LatWill_T,"-37.81193681, 144.95621105"
191920250208,19,2025-02-08,19,779,625,1404,LtB210_T,"-37.81237202, 144.96550671"
41620240711,4,2024-07-11,16,1301,1190,2491,Swa123_T,"-37.81487988, 144.9660878"
391720250413,39,2025-04-13,17,47,32,79,AlfPl_T,"-37.81379749, 144.96995745"
752120240901,75,2024-09-01,21,8,20,28,SprFli_T,"-37.81515276, 144.97467661"
75420240413,75,2024-04-13,4,1,0,1,SprFli_T,"-37.81515276, 144.97467661"
772120250926,77,2025-09-26,21,105,70,175,HarEsP_T,"-37.81441438, 144.94433026"
29120240606,29,2024-06-06,1,1,22,23,AG_T,"-37.8199817, 144.96872865"
142320240213,14,2024-02-13,23,100,43,143,SanBri_T,"-37.82011242, 144.96291897"
28920241127,28,2024-11-27,9,319,191,510,VAC_T,"-37.82129925, 144.96879309"
47320250907,47,2025-09-07,3,45,70,115,Eli250_T,"-37.81258467, 144.9625775"
361220240726,36,2024-07-26,12,396,262,658,Que85_T,"-37.81652527, 144.96121062"
372220240902,37,2024-09-02,22,31,51,82,Lyg260_T,"-37.80107122, 144.96704554"
61520240729,61,2024-07-29,5,11,19,30,RMIT14_T,"-37.80767455, 144.96309114"
50820241002,50,2024-10-02,8,31,77,108,Lyg309_T,"-37.79808192, 144.96721013"
166920251009,166,2025-10-09,9,28,50,78,Spen484_T,"-37.80896733, 144.94931703"
162420250207,162,2025-02-07,4,9,5,14,Eli489_T,"-37.80740397, 144.95987909"
1621320241122,162,2024-11-22,13,469,668,1137,Eli489_T,"-37.80740397, 144.95987909"
132120240504,132,2024-05-04,1,33,43,76,King335_T,"-37.81267639, 144.95386444"
132320250617,132,2025-06-17,3,7,6,13,King335_T,"-37.81267639, 144.95386444"
1311420231105,131,2023-11-05,14,102,88,190,King2_T,"-37.82009057, 144.95758725"
133620250309,133,2025-03-09,6,61,108,169,Spen229_T,"-37.81531435, 144.95227769"
1071120250217,107,2025-02-17,11,70,105,175,280Will_T,"-37.81246271, 144.95690188"
12120250710,1,2025-07-10,21,294,240,534,Bou292_T,"-37.81349441, 144.96515323"
631120240921,63,2024-09-21,11,326,296,622,Bou231_T,"-37.81333081, 144.96675571"
681820231209,68,2023-12-09,18,112,65,177,FLDegN_T,"-37.8168479, 144.96559789"
681420250313,68,2025-03-13,14,344,275,619,FLDegN_T,"-37.8168479, 144.96559789"
672220250123,67,2025-01-23,22,88,156,244,FLDegS_T,"-37.81688755, 144.96562569"
861920240514,86,2024-05-14,19,53,72,125,574Qub_T,"-37.80309992, 144.94908064"
12920240413,12,2024-04-13,9,133,140,273,NewQ_T,"-37.81457988, 144.94292398"
461020240926,46,2024-09-26,10,49,34,83,Pel147_T,"-37.80240719, 144.9615673"
117220240119,117,2024-01-19,2,12,17,29,Fli114F_T,"-37.81629332, 144.97090877"
109820240530,109,2024-05-30,8,90,640,730,LatWill_T,"-37.81193681, 144.95621105"
1091520241020,109,2024-10-20,15,81,113,194,LatWill_T,"-37.81193681, 144.95621105"
109220241118,109,2024-11-18,2,8,8,16,LatWill_T,"-37.81193681, 144.95621105"
191020250715,19,2025-07-15,10,191,132,323,LtB210_T,"-37.81237202, 144.96550671"
491720241213,49,2024-12-13,17,219,259,478,Eli501_T,"-37.80730068, 144.95956055"
191320240725,19,2024-07-25,13,408,435,843,LtB210_T,"-37.81237202, 144.96550671"
25920250528,25,2025-05-28,9,121,317,438,MCEC_T,"-37.82401776, 144.95604426"
139820240101,139,2024-01-01,8,15,2,17,Signal1647_T,"-37.81959923, 144.9632832"
136820231123,136,2023-11-23,8,115,155,270,BirFed1120_T,"-37.8184141, 144.97357915"
852320250622,85,2025-06-22,23,2,8,10,488Mac_T,"-37.79432415, 144.92973378"
1220240416,1,2024-04-16,2,12,7,19,Bou292_T,"-37.81349441, 144.96515323"
84420250804,84,2025-08-04,4,7,22,29,ElFi_T,"-37.81798049, 144.96503383"
70320240125,70,2024-01-25,3,1,0,1,Errol20_T,"-37.80456984, 144.94946228"
41720240123,41,2024-01-23,7,834,249,1083,Swa31,"-37.81668634, 144.96689733"
782320241231,78,2024-12-31,23,142,1978,2120,HarEsB_T,"-37.81471642, 144.9446508"
29920240102,29,2024-01-02,9,87,110,197,AG_T,"-37.8199817, 144.96872865"
311820240623,31,2024-06-23,18,286,228,514,Lyg161_T,"-37.80169681, 144.96658911"
541220250430,54,2025-04-30,12,201,206,407,Swa607_T,"-37.804024, 144.96308399"
401720240421,40,2024-04-21,17,126,141,267,Spr201_T,"-37.80999341, 144.97227587"
211020241101,21,2024-11-01,10,197,154,351,Bourke155_T,"-37.81267313, 144.96788288"
611020250316,61,2025-03-16,10,99,249,348,RMIT14_T,"-37.80767455, 144.96309114"
432020250905,43,2025-09-05,20,48,92,140,UM2_T,"-37.79844526, 144.96411782"
451520240224,45,2024-02-24,15,793,1284,2077,Swa148_T,"-37.81414075, 144.96609379"
5520250112,5,2025-01-12,5,19,31,50,PriNW_T,"-37.81874249, 144.96787656"
1652120250909,165,2025-09-09,21,14,2,16,Spen475_T,"-37.80953359, 144.94939004"
140620240220,140,2024-02-20,6,13,7,20,Boyd2837_T,"-37.82590962, 144.96185972"
1401220250822,140,2025-08-22,12,98,59,157,Boyd2837_T,"-37.82590962, 144.96185972"
1431720250313,143,2025-03-13,17,374,581,955,Spencer_T,"-37.821728, 144.95557015"
132320250915,132,2025-09-15,3,14,8,22,King335_T,"-37.81267639, 144.95386444"
135220251007,135,2025-10-07,2,14,12,26,Spen161_T,"-37.8172861, 144.95319102"
1181120240405,118,2024-04-05,11,16,13,29,Fli114C_T,"-37.81632783, 144.97090512"
851220240609,85,2024-06-09,12,95,80,175,488Mac_T,"-37.79432415, 144.92973378"
171620250228,17,2025-02-28,16,231,277,508,Col15_T,"-37.81362543, 144.97323591"
63120240910,63,2024-09-10,1,0,9,9,Bou231_T,"-37.81333081, 144.96675571"
18820250515,18,2025-05-15,8,108,1293,1401,Col12_T,"-37.81344862, 144.97305353"
86020250105,86,2025-01-05,0,2,6,8,574Qub_T,"-37.80309992, 144.94908064"
862120250502,86,2025-05-02,21,12,52,64,574Qub_T,"-37.80309992, 144.94908064"
24320240407,24,2024-04-07,3,35,45,80,Col620_T,"-37.81887963, 144.95449198"
451620250930,45,2025-09-30,16,527,789,1316,Swa148_T,"-37.81414075, 144.96609379"
52020231222,5,2023-12-22,20,1742,3977,5719,PriNW_T,"-37.81874249, 144.96787656"
1071820241105,107,2024-11-05,18,91,101,192,280Will_T,"-37.81246271, 144.95690188"
1071520250116,107,2025-01-16,15,110,102,212,280Will_T,"-37.81246271, 144.95690188"
108320240115,108,2024-01-15,3,2,3,5,261Will_T,"-37.81295822, 144.95678789"
61520240901,61,2024-09-01,5,15,18,33,RMIT14_T,"-37.80767455, 144.96309114"
611220241101,61,2024-11-01,12,571,720,1291,RMIT14_T,"-37.80767455, 144.96309114"
611520241112,61,2024-11-12,15,519,579,1098,RMIT14_T,"-37.80767455, 144.96309114"
611920250309,61,2025-03-09,19,617,715,1332,RMIT14_T,"-37.80767455, 144.96309114"
441720250515,44,2025-05-15,17,150,94,244,UM3_T,"-37.79698741, 144.96441306"
131520240505,131,2024-05-05,5,10,36,46,King2_T,"-37.82009057, 144.95758725"
1351120250107,135,2025-01-07,11,362,476,838,Spen161_T,"-37.8172861, 144.95319102"
133620240420,133,2024-04-20,6,96,141,237,Spen229_T,"-37.81531435, 144.95227769"
1182320241127,118,2024-11-27,23,0,4,4,Fli114C_T,"-37.81632783, 144.97090512"
124820250901,124,2025-09-01,8,4,2,6,BirBridge_T,"-37.81757416, 144.97329934"
171020241027,17,2024-10-27,10,150,115,265,Col15_T,"-37.81362543, 144.97323591"
172120250523,17,2025-05-23,21,104,108,212,Col15_T,"-37.81362543, 144.97323591"
63220250730,63,2025-07-30,2,0,3,3,Bou231_T,"-37.81333081, 144.96675571"
681020250918,68,2025-09-18,10,254,238,492,FLDegN_T,"-37.8168479, 144.96559789"
621220240626,62,2024-06-26,12,137,116,253,Lat224_T,"-37.80996494, 144.96216521"
86720250502,86,2025-05-02,7,27,29,56,574Qub_T,"-37.80309992, 144.94908064"
241720240422,24,2024-04-22,17,567,2391,2958,Col620_T,"-37.81887963, 144.95449198"
121020250623,12,2025-06-23,10,69,172,241,NewQ_T,"-37.81457988, 144.94292398"
721620240813,72,2024-08-13,16,138,552,690,ACMI_T,"-37.81726338, 144.96872809"
721420250821,72,2025-08-21,14,177,363,540,ACMI_T,"-37.81726338, 144.96872809"
2020240406,2,2024-04-06,0,30,76,106,Bou283_T,"-37.81380668, 144.96516718"
35220240709,35,2024-07-09,2,7,18,25,SouthB_T,"-37.82018685, 144.96508508"
72320250927,72,2025-09-27,3,0,9,9,ACMI_T,"-37.81726338, 144.96872809"
21420250416,2,2025-04-16,14,712,739,1451,Bou283_T,"-37.81380668, 144.96516718"
91820240216,9,2024-02-16,18,599,137,736,Col700_T,"-37.81982992, 144.95102555"
30320240801,30,2024-08-01,3,20,37,57,Lon189_T,"-37.8112185, 144.96656806"
23520250402,23,2025-04-02,5,35,22,57,Col623_T,"-37.81909256, 144.95452748"
521520250621,52,2025-06-21,15,529,367,896,Eli263_T,"-37.81252157, 144.9619401"
202120240117,20,2024-01-17,21,139,433,572,LtB170_T,"-37.81172914, 144.9682466"
20220240507,20,2024-05-07,2,8,7,15,LtB170_T,"-37.81172914, 144.9682466"
52020240628,52,2024-06-28,0,37,28,65,Eli263_T,"-37.81252157, 144.9619401"
461620250525,46,2025-05-25,16,55,85,140,Pel147_T,"-37.80240719, 144.9615673"
492320240130,49,2024-01-30,23,60,44,104,Eli501_T,"-37.80730068, 144.95956055"
1092120250502,109,2025-05-02,21,101,112,213,LatWill_T,"-37.81193681, 144.95621105"
109920250608,109,2025-06-08,9,25,35,60,LatWill_T,"-37.81193681, 144.95621105"
1091920250922,109,2025-09-22,19,97,101,198,LatWill_T,"-37.81193681, 144.95621105"
49220250206,49,2025-02-06,2,31,34,65,Eli501_T,"-37.80730068, 144.95956055"
25220250710,25,2025-07-10,2,6,8,14,MCEC_T,"-37.82401776, 144.95604426"
481620240911,48,2024-09-11,16,111,122,233,QVMQ_T,"-37.80631581, 144.95866697"
1412020241017,141,2024-10-17,20,137,105,242,474Fl_T,"-37.81997273, 144.95834911"
1361520250918,136,2025-09-18,15,64,40,104,BirFed1120_T,"-37.8184141, 144.97357915"
139520250309,139,2025-03-09,5,2,2,4,Signal1647_T,"-37.81959923, 144.9632832"
1391820250408,139,2025-04-08,18,99,30,129,Signal1647_T,"-37.81959923, 144.9632832"
139920250916,139,2025-09-16,9,54,166,220,Signal1647_T,"-37.81959923, 144.9632832"
142920240828,142,2024-08-28,9,128,129,257,Hammer1584_T,"-37.81970749, 144.96795734"
1641420250903,164,2025-09-03,14,97,70,167,Lat526_T,"-37.813005, 144.95160411"
1171020250411,117,2025-04-11,10,117,117,234,Fli114F_T,"-37.81629332, 144.97090877"
692120231023,69,2023-10-23,21,20,23,43,FLDegC_T,"-37.81687226, 144.96559144"
84720250910,84,2025-09-10,7,734,260,994,ElFi_T,"-37.81798049, 144.96503383"
111820250215,11,2025-02-15,18,170,319,489,WatCit_T,"-37.81564989, 144.93970694"
101620240311,10,2024-03-11,16,27,41,68,BouHbr_T,"-37.81876474, 144.94710545"
9620240529,9,2024-05-29,6,39,374,413,Col700_T,"-37.81982992, 144.95102555"
9020240606,9,2024-06-06,0,3,9,12,Col700_T,"-37.81982992, 144.95102555"
9320231102,9,2023-11-02,3,8,4,12,Col700_T,"-37.81982992, 144.95102555"
52320231220,52,2023-12-20,3,4,8,12,Eli263_T,"-37.81252157, 144.9619401"
521320240405,52,2024-04-05,13,486,397,883,Eli263_T,"-37.81252157, 144.9619401"
511320240130,51,2024-01-30,13,110,149,259,Fra118_T,"-37.80841815, 144.95906316"
23620240717,23,2024-07-17,6,132,68,200,Col623_T,"-37.81909256, 144.95452748"
23320240813,23,2024-08-13,3,2,3,5,Col623_T,"-37.81909256, 144.95452748"
117320240409,117,2024-04-09,3,1,2,3,Fli114F_T,"-37.81629332, 144.97090877"
492020241120,49,2024-11-20,20,261,341,602,Eli501_T,"-37.80730068, 144.95956055"
1091220240206,109,2024-02-06,12,270,200,470,LatWill_T,"-37.81193681, 144.95621105"
492120231113,49,2023-11-13,21,140,107,247,Eli501_T,"-37.80730068, 144.95956055"
191720240610,19,2024-06-10,17,687,441,1128,LtB210_T,"-37.81237202, 144.96550671"
25620240724,25,2024-07-24,6,62,107,169,MCEC_T,"-37.82401776, 144.95604426"
252220240903,25,2024-09-03,22,107,78,185,MCEC_T,"-37.82401776, 144.95604426"
481120241210,48,2024-12-10,11,275,212,487,QVMQ_T,"-37.80631581, 144.95866697"
136820240709,136,2024-07-09,8,46,54,100,BirFed1120_T,"-37.8184141, 144.97357915"
1421820250819,142,2025-08-19,18,79,61,140,Hammer1584_T,"-37.81970749, 144.96795734"
1301820250426,130,2025-04-26,18,5,5,10,Bou892T,"-37.8204637, 144.94126826"
441420250706,44,2025-07-06,14,47,52,99,UM3_T,"-37.79698741, 144.96441306"
431820231202,43,2023-12-02,18,29,25,54,UM2_T,"-37.79844526, 144.96411782"
431220241216,43,2024-12-16,12,75,101,176,UM2_T,"-37.79844526, 144.96411782"
45720250712,45,2025-07-12,7,21,49,70,Swa148_T,"-37.81414075, 144.96609379"
52020231213,5,2023-12-13,20,1076,1429,2505,PriNW_T,"-37.81874249, 144.96787656"
1651520240826,165,2024-08-26,15,29,23,52,Spen475_T,"-37.80953359, 144.94939004"
1311120250715,131,2025-07-15,11,114,181,295,King2_T,"-37.82009057, 144.95758725"
143320240928,143,2024-09-28,3,55,13,68,Spencer_T,"-37.821728, 144.95557015"
143720241217,143,2024-12-17,7,78,81,159,Spencer_T,"-37.821728, 144.95557015"
1321820240813,132,2024-08-13,18,168,190,358,King335_T,"-37.81267639, 144.95386444"
1342220250417,134,2025-04-17,22,297,288,585,Spen201_T,"-37.81694221, 144.95303935"
1341820250614,134,2025-06-14,18,466,361,827,Spen201_T,"-37.81694221, 144.95303935"
1341920240225,134,2024-02-25,19,329,321,650,Spen201_T,"-37.81694221, 144.95303935"
1341020241030,134,2024-10-30,10,385,457,842,Spen201_T,"-37.81694221, 144.95303935"
1181620231129,118,2023-11-29,16,22,33,55,Fli114C_T,"-37.81632783, 144.97090512"
1821720250602,182,2025-06-02,17,298,200,498,King163_T,"-37.81627451, 144.95550503"
1661120241214,166,2024-12-14,11,41,63,104,Spen484_T,"-37.80896733, 144.94931703"
84020250111,84,2025-01-11,0,204,224,428,ElFi_T,"-37.81798049, 144.96503383"
841020250827,84,2025-08-27,10,661,504,1165,ElFi_T,"-37.81798049, 144.96503383"
662320240331,66,2024-03-31,23,239,211,450,QVN_T,"-37.81057846, 144.96444294"
70920241019,70,2024-10-19,9,88,104,192,Errol20_T,"-37.80456984, 144.94946228"
39020240927,39,2024-09-27,0,0,1,1,AlfPl_T,"-37.81379749, 144.96995745"
411720231111,41,2023-11-11,17,1719,1465,3184,Swa31,"-37.81668634, 144.96689733"
82220250523,8,2025-05-23,22,0,3,3,WebBN_T,"-37.82293543, 144.9471751"
78220251009,78,2025-10-09,2,1,4,5,HarEsB_T,"-37.81471642, 144.9446508"
772020250704,77,2025-07-04,20,2063,2326,4389,HarEsP_T,"-37.81441438, 144.94433026"
291620231119,29,2023-11-19,16,621,671,1292,AG_T,"-37.8199817, 144.96872865"
14320241014,14,2024-10-14,3,12,2,14,SanBri_T,"-37.82011242, 144.96291897"
31820250328,31,2025-03-28,8,65,70,135,Lyg161_T,"-37.80169681, 144.96658911"
311220240823,31,2024-08-23,12,118,95,213,Lyg161_T,"-37.80169681, 144.96658911"
541720231029,54,2023-10-29,17,129,150,279,Swa607_T,"-37.804024, 144.96308399"
281220250911,28,2025-09-11,12,565,683,1248,VAC_T,"-37.82129925, 144.96879309"
28620240623,28,2024-06-23,6,6,29,35,VAC_T,"-37.82129925, 144.96879309"
21320250426,21,2025-04-26,3,34,39,73,Bourke155_T,"-37.81267313, 144.96788288"
361620250128,36,2025-01-28,16,195,163,358,Que85_T,"-37.81652527, 144.96121062"
671220251015,67,2025-10-15,12,616,804,1420,FLDegS_T,"-37.81688755, 144.96562569"
85720240703,85,2024-07-03,7,44,19,63,488Mac_T,"-37.79432415, 144.92973378"
721120240713,72,2024-07-13,11,233,314,547,ACMI_T,"-37.81726338, 144.96872809"
12420240712,12,2024-07-12,4,1,0,1,NewQ_T,"-37.81457988, 144.94292398"
581020241029,58,2024-10-29,10,710,188,898,Bou688_T,"-37.81686075, 144.95358075"
761120250308,76,2025-03-08,11,65,67,132,KenMac_T,"-37.79453803, 144.93036194"
76220241005,76,2024-10-05,2,0,1,1,KenMac_T,"-37.79453803, 144.93036194"
2520250310,2,2025-03-10,5,3,8,11,Bou283_T,"-37.81380668, 144.96516718"
531120250420,53,2025-04-20,11,427,376,803,Col254_T,"-37.81564191, 144.965499"
301020240707,30,2024-07-07,10,71,250,321,Lon189_T,"-37.8112185, 144.96656806"
9920250502,9,2025-05-02,9,131,1203,1334,Col700_T,"-37.81982992, 144.95102555"
51820250329,51,2025-03-29,8,46,43,89,Fra118_T,"-37.80841815, 144.95906316"
201320250529,20,2025-05-29,13,291,318,609,LtB170_T,"-37.81172914, 144.9682466"
25620250629,25,2025-06-29,6,22,33,55,MCEC_T,"-37.82401776, 144.95604426"
462220250911,46,2025-09-11,22,1,0,1,Pel147_T,"-37.80240719, 144.9615673"
201720241205,20,2024-12-05,17,416,110,526,LtB170_T,"-37.81172914, 144.9682466"
461020250326,46,2025-03-26,10,140,54,194,Pel147_T,"-37.80240719, 144.9615673"
1371820250306,137,2025-03-06,18,27,65,92,BouHbr2353_T,"-37.81894815, 144.94612292"
1391820240623,139,2024-06-23,18,15,19,34,Signal1647_T,"-37.81959923, 144.9632832"
142120250302,142,2025-03-02,1,13,2,15,Hammer1584_T,"-37.81970749, 144.96795734"
161920240918,161,2024-09-18,9,101,103,204,BirArt1109_T,"-37.81851276, 144.97131336"
1641120250806,164,2025-08-06,11,88,40,128,Lat526_T,"-37.813005, 144.95160411"
191220240902,19,2024-09-02,12,388,325,713,LtB210_T,"-37.81237202, 144.96550671"
661320240904,66,2024-09-04,13,996,1016,2012,QVN_T,"-37.81057846, 144.96444294"
691220240804,69,2024-08-04,12,288,170,458,FLDegC_T,"-37.81687226, 144.96559144"
702220240105,70,2024-01-05,22,52,53,105,Errol20_T,"-37.80456984, 144.94946228"
70620240917,70,2024-09-17,6,17,8,25,Errol20_T,"-37.80456984, 144.94946228"
391520240321,39,2024-03-21,15,127,102,229,AlfPl_T,"-37.81379749, 144.96995745"
81120240516,8,2024-05-16,11,116,196,312,WebBN_T,"-37.82293543, 144.9471751"
82020241205,8,2024-12-05,20,79,140,219,WebBN_T,"-37.82293543, 144.9471751"
81020250722,8,2025-07-22,10,64,67,131,WebBN_T,"-37.82293543, 144.9471751"
75220250210,75,2025-02-10,2,3,0,3,SprFli_T,"-37.81515276, 144.97467661"
411320241010,41,2024-10-10,13,438,344,782,Swa31,"-37.81668634, 144.96689733"
412320241221,41,2024-12-21,23,1207,1134,2341,Swa31,"-37.81668634, 144.96689733"
781520231226,78,2023-12-26,15,23,24,47,HarEsB_T,"-37.81471642, 144.9446508"
591720240321,59,2024-03-21,17,1275,1655,2930,RMIT_T,"-37.80825648, 144.96304859"
42520241127,42,2024-11-27,5,9,3,12,UM1_T,"-37.80008566, 144.96386412"
142120250315,14,2025-03-15,21,543,154,697,SanBri_T,"-37.82011242, 144.96291897"
14420231030,14,2023-10-30,4,34,1,35,SanBri_T,"-37.82011242, 144.96291897"
541320240615,54,2024-06-15,13,132,87,219,Swa607_T,"-37.804024, 144.96308399"
281120250526,28,2025-05-26,11,300,270,570,VAC_T,"-37.82129925, 144.96879309"
282220240110,28,2024-01-10,22,135,215,350,VAC_T,"-37.82129925, 144.96879309"
40520250810,40,2025-08-10,5,15,4,19,Spr201_T,"-37.80999341, 144.97227587"
361420250418,36,2025-04-18,14,101,94,195,Que85_T,"-37.81652527, 144.96121062"
361920250204,36,2025-02-04,19,95,117,212,Que85_T,"-37.81652527, 144.96121062"
87120250715,87,2025-07-15,1,1,0,1,Errol23_T,"-37.80454949, 144.94921863"
61320240417,61,2024-04-17,3,13,3,16,RMIT14_T,"-37.80767455, 144.96309114"
44720250728,44,2025-07-28,7,25,19,44,UM3_T,"-37.79698741, 144.96441306"
502220240417,50,2024-04-17,22,66,33,99,Lyg309_T,"-37.79808192, 144.96721013"
44520240316,44,2024-03-16,5,2,0,2,UM3_T,"-37.79698741, 144.96441306"
45520231109,45,2023-11-09,5,15,29,44,Swa148_T,"-37.81414075, 144.96609379"
131320240826,131,2024-08-26,3,3,8,11,King2_T,"-37.82009057, 144.95758725"
1621420250724,162,2025-07-24,14,470,780,1250,Eli489_T,"-37.80740397, 144.95987909"
1321920241025,132,2024-10-25,19,145,152,297,King335_T,"-37.81267639, 144.95386444"
1322120250311,132,2025-03-11,21,96,122,218,King335_T,"-37.81267639, 144.95386444"
181820250811,18,2025-08-11,18,131,43,174,Col12_T,"-37.81344862, 144.97305353"
56720231019,56,2023-10-19,7,34,36,70,Lon364_T,"-37.81234775, 144.96153311"
622120240407,62,2024-04-07,21,152,111,263,Lat224_T,"-37.80996494, 144.96216521"
622120250117,62,2025-01-17,21,184,167,351,Lat224_T,"-37.80996494, 144.96216521"
24520240904,24,2024-09-04,5,136,56,192,Col620_T,"-37.81887963, 144.95449198"
241720250904,24,2025-09-04,17,584,2899,3483,Col620_T,"-37.81887963, 144.95449198"
761920241025,76,2024-10-25,19,43,48,91,KenMac_T,"-37.79453803, 144.93036194"
722020241111,72,2024-11-11,20,88,92,180,ACMI_T,"-37.81726338, 144.96872809"
581320231101,58,2023-11-01,13,725,469,1194,Bou688_T,"-37.81686075, 144.95358075"
351320250405,35,2025-04-05,13,1401,1615,3016,SouthB_T,"-37.82018685, 144.96508508"
581720240921,58,2024-09-21,17,645,325,970,Bou688_T,"-37.81686075, 144.95358075"
22120250901,2,2025-09-01,21,80,120,200,Bou283_T,"-37.81380668, 144.96516718"
79820240121,79,2024-01-21,8,176,111,287,FliSS_T,"-37.81794046, 144.96616678"
79520240214,79,2024-02-14,5,46,34,80,FliSS_T,"-37.81794046, 144.96616678"
30620240527,30,2024-05-27,6,12,19,31,Lon189_T,"-37.8112185, 144.96656806"
522120240125,52,2024-01-25,21,260,227,487,Eli263_T,"-37.81252157, 144.9619401"
232220250413,23,2025-04-13,22,40,69,109,Col623_T,"-37.81909256, 144.95452748"
232020241004,23,2024-10-04,20,93,246,339,Col623_T,"-37.81909256, 144.95452748"
201320240319,20,2024-03-19,13,172,232,404,LtB170_T,"-37.81172914, 144.9682466"
522120251002,52,2025-10-02,21,203,182,385,Eli263_T,"-37.81252157, 144.9619401"
201920240114,20,2024-01-14,19,317,351,668,LtB170_T,"-37.81172914, 144.9682466"
461320250119,46,2025-01-19,13,19,14,33,Pel147_T,"-37.80240719, 144.9615673"
461220250316,46,2025-03-16,12,9,11,20,Pel147_T,"-37.80240719, 144.9615673"
1172120240814,117,2024-08-14,21,95,106,201,Fli114F_T,"-37.81629332, 144.97090877"
1091220251010,109,2025-10-10,12,171,179,350,LatWill_T,"-37.81193681, 144.95621105"
109320240121,109,2024-01-21,3,19,10,29,LatWill_T,"-37.81193681, 144.95621105"
49220241221,49,2024-12-21,2,32,24,56,Eli501_T,"-37.80730068, 144.95956055"
481920240707,48,2024-07-07,19,109,95,204,QVMQ_T,"-37.80631581, 144.95866697"
1371820250826,137,2025-08-26,18,0,5,5,BouHbr2353_T,"-37.81894815, 144.94612292"
139820250904,139,2025-09-04,8,29,574,603,Signal1647_T,"-37.81959923, 144.9632832"
164120250915,164,2025-09-15,1,2,2,4,Lat526_T,"-37.813005, 144.95160411"
69420240423,69,2024-04-23,4,2,1,3,FLDegC_T,"-37.81687226, 144.96559144"
691920250205,69,2025-02-05,19,58,44,102,FLDegC_T,"-37.81687226, 144.96559144"
69720250804,69,2025-08-04,7,79,21,100,FLDegC_T,"-37.81687226, 144.96559144"
702020250725,70,2025-07-25,20,96,130,226,Errol20_T,"-37.80456984, 144.94946228"
751320241211,75,2024-12-11,13,91,105,196,SprFli_T,"-37.81515276, 144.97467661"
712020231028,71,2023-10-28,20,13,13,26,WestWP_T,"-37.81235775, 144.97136962"
31020250818,31,2025-08-18,0,4,14,18,Lyg161_T,"-37.80169681, 144.96658911"
47220250903,47,2025-09-03,2,12,24,36,Eli250_T,"-37.81258467, 144.9625775"
371320250429,37,2025-04-29,13,96,109,205,Lyg260_T,"-37.80107122, 144.96704554"
43120250126,43,2025-01-26,1,6,2,8,UM2_T,"-37.79844526, 144.96411782"
45120240515,45,2024-05-15,1,4,29,33,Swa148_T,"-37.81414075, 144.96609379"
45120240705,45,2024-07-05,1,24,42,66,Swa148_T,"-37.81414075, 144.96609379"
441620250409,44,2025-04-09,16,152,112,264,UM3_T,"-37.79698741, 144.96441306"
45120231103,45,2023-11-03,1,4,33,37,Swa148_T,"-37.81414075, 144.96609379"
1671920240915,167,2024-09-15,19,11,21,32,Lat526_T,"-37.81304149, 144.95155955"
1082020250516,108,2025-05-16,20,182,129,311,261Will_T,"-37.81295822, 144.95678789"
1341020250824,134,2025-08-24,10,382,500,882,Spen201_T,"-37.81694221, 144.95303935"
1351620241222,135,2024-12-22,16,370,421,791,Spen161_T,"-37.8172861, 144.95319102"
1332220250106,133,2025-01-06,22,199,173,372,Spen229_T,"-37.81531435, 144.95227769"
118720240712,118,2024-07-12,7,6,4,10,Fli114C_T,"-37.81632783, 144.97090512"
1661620241224,166,2024-12-24,16,50,57,107,Spen484_T,"-37.80896733, 144.94931703"
851420240130,85,2024-01-30,14,65,70,135,488Mac_T,"-37.79432415, 144.92973378"
172020250326,17,2025-03-26,20,101,129,230,Col15_T,"-37.81362543, 144.97323591"
63520241008,63,2024-10-08,5,0,4,4,Bou231_T,"-37.81333081, 144.96675571"
181420240817,18,2024-08-17,14,86,91,177,Col12_T,"-37.81344862, 144.97305353"
18020250128,18,2025-01-28,0,2,0,2,Col12_T,"-37.81344862, 144.97305353"
62320240210,62,2024-02-10,3,48,17,65,Lat224_T,"-37.80996494, 144.96216521"
62520250213,62,2025-02-13,5,16,14,30,Lat224_T,"-37.80996494, 144.96216521"
111520240726,11,2024-07-26,15,60,79,139,WatCit_T,"-37.81564989, 144.93970694"
762020240320,76,2024-03-20,20,18,31,49,KenMac_T,"-37.79453803, 144.93036194"
76820240624,76,2024-06-24,8,92,46,138,KenMac_T,"-37.79453803, 144.93036194"
581620240717,58,2024-07-17,16,636,996,1632,Bou688_T,"-37.81686075, 144.95358075"
532220250821,53,2025-08-21,22,86,195,281,Col254_T,"-37.81564191, 144.965499"
522120240215,52,2024-02-15,21,309,169,478,Eli263_T,"-37.81252157, 144.9619401"
52520240505,52,2024-05-05,5,26,4,30,Eli263_T,"-37.81252157, 144.9619401"
138920250803,138,2025-08-03,9,2,3,5,EntPark1671_T,"-37.81996544, 144.95981454"
1171720250927,117,2025-09-27,17,211,466,677,Fli114F_T,"-37.81629332, 144.97090877"
491420240819,49,2024-08-19,14,256,207,463,Eli501_T,"-37.80730068, 144.95956055"
1091620241122,109,2024-11-22,16,282,121,403,LatWill_T,"-37.81193681, 144.95621105"
109720250428,109,2025-04-28,7,38,247,285,LatWill_T,"-37.81193681, 144.95621105"
482220240722,48,2024-07-22,22,47,21,68,QVMQ_T,"-37.80631581, 144.95866697"
481320240404,48,2024-04-04,13,464,324,788,QVMQ_T,"-37.80631581, 144.95866697"
1391820240706,139,2024-07-06,18,24,17,41,Signal1647_T,"-37.81959923, 144.9632832"
139720250905,139,2025-09-05,7,28,83,111,Signal1647_T,"-37.81959923, 144.9632832"
1231120231027,123,2023-10-27,11,30,19,49,BirBridge_T,"-37.81753741, 144.97329734"
84620241109,84,2024-11-09,6,99,54,153,ElFi_T,"-37.81798049, 144.96503383"
62320250928,6,2025-09-28,23,203,108,311,FliS_T,"-37.81911705, 144.96558255"
391620241021,39,2024-10-21,16,90,76,166,AlfPl_T,"-37.81379749, 144.96995745"
292320240918,29,2024-09-18,23,4,14,18,AG_T,"-37.8199817, 144.96872865"
14420241116,14,2024-11-16,4,20,8,28,SanBri_T,"-37.82011242, 144.96291897"
142020250215,14,2025-02-15,20,324,99,423,SanBri_T,"-37.82011242, 144.96291897"
142320250926,14,2025-09-26,23,193,34,227,SanBri_T,"-37.82011242, 144.96291897"
14020250710,14,2025-07-10,0,1,0,1,SanBri_T,"-37.82011242, 144.96291897"
311720240726,31,2024-07-26,17,182,89,271,Lyg161_T,"-37.80169681, 144.96658911"
54420240810,54,2024-08-10,4,12,4,16,Swa607_T,"-37.804024, 144.96308399"
28520250820,28,2025-08-20,5,32,34,66,VAC_T,"-37.82129925, 144.96879309"
471320240810,47,2024-08-10,13,1088,1202,2290,Eli250_T,"-37.81258467, 144.9625775"
211320251011,21,2025-10-11,13,372,453,825,Bourke155_T,"-37.81267313, 144.96788288"
362220241126,36,2024-11-26,22,43,64,107,Que85_T,"-37.81652527, 144.96121062"
361520250306,36,2025-03-06,15,186,229,415,Que85_T,"-37.81652527, 144.96121062"
87520240420,87,2024-04-20,5,3,1,4,Errol23_T,"-37.80454949, 144.94921863"
502220250204,50,2025-02-04,22,101,42,143,Lyg309_T,"-37.79808192, 144.96721013"
502220231109,50,2023-11-09,22,108,57,165,Lyg309_T,"-37.79808192, 144.96721013"
134220240227,134,2024-02-27,2,24,16,40,Spen201_T,"-37.81694221, 144.95303935"
1082120241209,108,2024-12-09,21,93,55,148,261Will_T,"-37.81295822, 144.95678789"
1331120231231,133,2023-12-31,11,429,482,911,Spen229_T,"-37.81531435, 144.95227769"
1802120250726,180,2025-07-26,21,2,3,5,Mac330_T,"-37.79497059, 144.93530329"
851420240207,85,2024-02-07,14,69,64,133,488Mac_T,"-37.79432415, 144.92973378"
852220240913,85,2024-09-13,22,12,22,34,488Mac_T,"-37.79432415, 144.92973378"
631520250123,63,2025-01-23,15,432,454,886,Bou231_T,"-37.81333081, 144.96675571"
861920240214,86,2024-02-14,19,73,74,147,574Qub_T,"-37.80309992, 144.94908064"
122120241221,12,2024-12-21,21,265,226,491,NewQ_T,"-37.81457988, 144.94292398"
12020250724,12,2025-07-24,0,1,8,9,NewQ_T,"-37.81457988, 144.94292398"
24520250707,24,2025-07-07,5,100,60,160,Col620_T,"-37.81887963, 144.95449198"
102120250903,10,2025-09-03,21,19,19,38,BouHbr_T,"-37.81876474, 144.94710545"
241820240423,24,2024-04-23,18,564,1355,1919,Col620_T,"-37.81887963, 144.95449198"
111020250518,11,2025-05-18,10,75,104,179,WatCit_T,"-37.81564989, 144.93970694"
102320240331,10,2024-03-31,23,9,2,11,BouHbr_T,"-37.81876474, 144.94710545"
72820231030,72,2023-10-30,8,637,125,762,ACMI_T,"-37.81726338, 144.96872809"
24620251014,24,2025-10-14,6,403,154,557,Col620_T,"-37.81887963, 144.95449198"
76320240524,76,2024-05-24,3,1,0,1,KenMac_T,"-37.79453803, 144.93036194"
761220240831,76,2024-08-31,12,69,58,127,KenMac_T,"-37.79453803, 144.93036194"
271820240817,27,2024-08-17,18,163,114,277,Vic_T,"-37.80606888, 144.95644692"
53420241030,53,2024-10-30,4,2,6,8,Col254_T,"-37.81564191, 144.965499"
9620250225,9,2025-02-25,6,43,358,401,Col700_T,"-37.81982992, 144.95102555"
232220250224,23,2025-02-24,22,18,79,97,Col623_T,"-37.81909256, 144.95452748"
51220240513,51,2024-05-13,2,6,15,21,Fra118_T,"-37.80841815, 144.95906316"
23520250814,23,2025-08-14,5,30,26,56,Col623_T,"-37.81909256, 144.95452748"
481720250223,48,2025-02-23,17,167,161,328,QVMQ_T,"-37.80631581, 144.95866697"
20220240511,20,2024-05-11,2,22,24,46,LtB170_T,"-37.81172914, 144.9682466"
201820240226,20,2024-02-26,18,270,262,532,LtB170_T,"-37.81172914, 144.9682466"
141520250810,141,2025-08-10,5,17,15,32,474Fl_T,"-37.81997273, 144.95834911"
130820231128,130,2023-11-28,8,7,3,10,Bou892T,"-37.8204637, 144.94126826"
161720240704,161,2024-07-04,7,74,97,171,BirArt1109_T,"-37.81851276, 144.97131336"
1381720241201,138,2024-12-01,17,6,4,10,EntPark1671_T,"-37.81996544, 144.95981454"
491320250904,49,2025-09-04,13,333,532,865,Eli501_T,"-37.80730068, 144.95956055"
711420241112,71,2024-11-12,14,13,13,26,WestWP_T,"-37.81235775, 144.97136962"
281720250801,28,2025-08-01,17,518,948,1466,VAC_T,"-37.82129925, 144.96879309"
28520231113,28,2023-11-13,5,27,27,54,VAC_T,"-37.82129925, 144.96879309"
471520250930,47,2025-09-30,15,958,995,1953,Eli250_T,"-37.81258467, 144.9625775"
401420241028,40,2024-10-28,14,184,145,329,Spr201_T,"-37.80999341, 144.97227587"
312320240119,31,2024-01-19,23,105,171,276,Lyg161_T,"-37.80169681, 144.96658911"
5220240807,5,2024-08-07,2,2,10,12,PriNW_T,"-37.81874249, 144.96787656"
362020250223,36,2025-02-23,20,56,57,113,Que85_T,"-37.81652527, 144.96121062"
871120251016,87,2025-10-16,11,98,94,192,Errol23_T,"-37.80454949, 144.94921863"
871420250120,87,2025-01-20,14,102,129,231,Errol23_T,"-37.80454949, 144.94921863"
87020231021,87,2023-10-21,0,7,12,19,Errol23_T,"-37.80454949, 144.94921863"
441420240315,44,2024-03-15,14,32,40,72,UM3_T,"-37.79698741, 144.96441306"
1671320250325,167,2025-03-25,13,10,22,32,Lat526_T,"-37.81304149, 144.95155955"
1431320250912,143,2025-09-12,13,160,168,328,Spencer_T,"-37.821728, 144.95557015"
162820240920,162,2024-09-20,8,294,192,486,Eli489_T,"-37.80740397, 144.95987909"
1071520240930,107,2024-09-30,15,124,100,224,280Will_T,"-37.81246271, 144.95690188"
701720240717,70,2024-07-17,17,160,152,312,Errol20_T,"-37.80456984, 144.94946228"
702020250612,70,2025-06-12,20,89,101,190,Errol20_T,"-37.80456984, 144.94946228"
3820250927,3,2025-09-27,8,90,128,218,Swa295_T,"-37.81101524, 144.96429485"
8820251008,8,2025-10-08,8,290,176,466,WebBN_T,"-37.82293543, 144.9471751"
751420250121,75,2025-01-21,14,48,59,107,SprFli_T,"-37.81515276, 144.97467661"
422220240809,42,2024-08-09,22,60,78,138,UM1_T,"-37.80008566, 144.96386412"
78720250906,78,2025-09-06,7,32,19,51,HarEsB_T,"-37.81471642, 144.9446508"
78420240820,78,2024-08-20,4,1,1,2,HarEsB_T,"-37.81471642, 144.9446508"
591320250102,59,2025-01-02,13,292,291,583,RMIT_T,"-37.80825648, 144.96304859"
282120240622,28,2024-06-22,21,253,365,618,VAC_T,"-37.82129925, 144.96879309"
29520241219,29,2024-12-19,5,10,24,34,AG_T,"-37.8199817, 144.96872865"
361220250411,36,2025-04-11,12,307,297,604,Que85_T,"-37.81652527, 144.96121062"
5820241228,5,2024-12-28,8,214,270,484,PriNW_T,"-37.81874249, 144.96787656"
211120241022,21,2024-10-22,11,255,127,382,Bourke155_T,"-37.81267313, 144.96788288"
87720240822,87,2024-08-22,7,43,43,86,Errol23_T,"-37.80454949, 144.94921863"
87920241028,87,2024-10-28,9,58,56,114,Errol23_T,"-37.80454949, 144.94921863"
502020241104,50,2024-11-04,20,251,195,446,Lyg309_T,"-37.79808192, 144.96721013"
441020250705,44,2025-07-05,10,19,42,61,UM3_T,"-37.79698741, 144.96441306"
431220250429,43,2025-04-29,12,208,265,473,UM2_T,"-37.79844526, 144.96411782"
1671220250102,167,2025-01-02,12,7,12,19,Lat526_T,"-37.81304149, 144.95155955"
1321220231108,132,2023-11-08,12,144,125,269,King335_T,"-37.81267639, 144.95386444"
1332320240827,133,2024-08-27,23,60,43,103,Spen229_T,"-37.81531435, 144.95227769"
1181120250227,118,2025-02-27,11,11,28,39,Fli114C_T,"-37.81632783, 144.97090512"
118620250714,118,2025-07-14,6,2,0,2,Fli114C_T,"-37.81632783, 144.97090512"
171920240418,17,2024-04-18,19,128,195,323,Col15_T,"-37.81362543, 144.97323591"
671920250716,67,2025-07-16,19,191,304,495,FLDegS_T,"-37.81688755, 144.96562569"
181120250220,18,2025-02-20,11,212,214,426,Col12_T,"-37.81344862, 144.97305353"
182020250327,18,2025-03-27,20,50,23,73,Col12_T,"-37.81344862, 144.97305353"
631520231028,63,2023-10-28,15,326,465,791,Bou231_T,"-37.81333081, 144.96675571"
68820240809,68,2024-08-09,8,98,67,165,FLDegN_T,"-37.8168479, 144.96559789"
67920240712,67,2024-07-12,9,361,350,711,FLDegS_T,"-37.81688755, 144.96562569"
561820240418,56,2024-04-18,18,363,377,740,Lon364_T,"-37.81234775, 144.96153311"
10720241101,10,2024-11-01,7,27,68,95,BouHbr_T,"-37.81876474, 144.94710545"
271420250222,27,2025-02-22,14,207,181,388,Vic_T,"-37.80606888, 144.95644692"
9520241006,9,2024-10-06,5,12,4,16,Col700_T,"-37.81982992, 144.95102555"
91120250514,9,2025-05-14,11,281,327,608,Col700_T,"-37.81982992, 144.95102555"
91520231108,9,2023-11-08,15,712,129,841,Col700_T,"-37.81982992, 144.95102555"
91820240616,9,2024-06-16,18,66,31,97,Col700_T,"-37.81982992, 144.95102555"
791620240814,79,2024-08-14,16,518,502,1020,FliSS_T,"-37.81794046, 144.96616678"
791820240218,79,2024-02-18,18,625,412,1037,FliSS_T,"-37.81794046, 144.96616678"
231720240429,23,2024-04-29,17,225,760,985,Col623_T,"-37.81909256, 144.95452748"
201220250210,20,2025-02-10,12,193,233,426,LtB170_T,"-37.81172914, 144.9682466"
201320240414,20,2024-04-14,13,306,393,699,LtB170_T,"-37.81172914, 144.9682466"
52820240614,52,2024-06-14,8,144,262,406,Eli263_T,"-37.81252157, 144.9619401"
46520240110,46,2024-01-10,5,0,7,7,Pel147_T,"-37.80240719, 144.9615673"
461020241022,46,2024-10-22,10,99,39,138,Pel147_T,"-37.80240719, 144.9615673"
461920250904,46,2025-09-04,19,15,20,35,Pel147_T,"-37.80240719, 144.9615673"
1091520231202,109,2023-12-02,15,71,102,173,LatWill_T,"-37.81193681, 144.95621105"
251120250310,25,2025-03-10,11,346,647,993,MCEC_T,"-37.82401776, 144.95604426"
252120250711,25,2025-07-11,21,575,331,906,MCEC_T,"-37.82401776, 144.95604426"
1412120250113,141,2025-01-13,21,76,188,264,474Fl_T,"-37.81997273, 144.95834911"
66320250807,66,2025-08-07,3,20,5,25,QVN_T,"-37.81057846, 144.96444294"
69820241117,69,2024-11-17,8,72,43,115,FLDegC_T,"-37.81687226, 144.96559144"
62020240127,6,2024-01-27,20,790,754,1544,FliS_T,"-37.81911705, 144.96558255"
6220240401,6,2024-04-01,2,43,50,93,FliS_T,"-37.81911705, 144.96558255"
32220240215,3,2024-02-15,22,853,580,1433,Swa295_T,"-37.81101524, 144.96429485"
32020240907,3,2024-09-07,20,1015,1249,2264,Swa295_T,"-37.81101524, 144.96429485"
8920241002,8,2024-10-02,9,168,125,293,WebBN_T,"-37.82293543, 144.9471751"
81520250801,8,2025-08-01,15,153,290,443,WebBN_T,"-37.82293543, 144.9471751"
8820231110,8,2023-11-10,8,148,130,278,WebBN_T,"-37.82293543, 144.9471751"
8920231222,8,2023-12-22,9,119,115,234,WebBN_T,"-37.82293543, 144.9471751"
411420250403,41,2025-04-03,14,1398,1710,3108,Swa31,"-37.81668634, 144.96689733"
422120250430,42,2025-04-30,21,80,118,198,UM1_T,"-37.80008566, 144.96386412"
14120231019,14,2023-10-19,1,28,8,36,SanBri_T,"-37.82011242, 144.96291897"
682320251002,68,2025-10-02,23,17,6,23,FLDegN_T,"-37.8168479, 144.96559789"
172120241206,17,2024-12-06,21,96,102,198,Col15_T,"-37.81362543, 144.97323591"
11620240429,1,2024-04-29,16,992,828,1820,Bou292_T,"-37.81349441, 144.96515323"
18820250528,18,2025-05-28,8,75,1246,1321,Col12_T,"-37.81344862, 144.97305353"
62220240908,62,2024-09-08,2,50,24,74,Lat224_T,"-37.80996494, 144.96216521"
112120240911,11,2024-09-11,21,7,7,14,WatCit_T,"-37.81564989, 144.93970694"
581220241101,58,2024-11-01,12,848,370,1218,Bou688_T,"-37.81686075, 144.95358075"
761520250618,76,2025-06-18,15,50,73,123,KenMac_T,"-37.79453803, 144.93036194"
761820250724,76,2025-07-24,18,45,58,103,KenMac_T,"-37.79453803, 144.93036194"
271720231105,27,2023-11-05,17,142,78,220,Vic_T,"-37.80606888, 144.95644692"
9920240617,9,2024-06-17,9,148,1488,1636,Col700_T,"-37.81982992, 144.95102555"
791320250219,79,2025-02-19,13,476,418,894,FliSS_T,"-37.81794046, 144.96616678"
791620240702,79,2024-07-02,16,532,509,1041,FliSS_T,"-37.81794046, 144.96616678"
231720240508,23,2024-05-08,17,279,914,1193,Col623_T,"-37.81909256, 144.95452748"
481220240104,48,2024-01-04,12,450,367,817,QVMQ_T,"-37.80631581, 144.95866697"
46120251015,46,2025-10-15,1,1,0,1,Pel147_T,"-37.80240719, 144.9615673"
461520240417,46,2024-04-17,15,142,145,287,Pel147_T,"-37.80240719, 144.9615673"
20220240420,20,2024-04-20,2,36,50,86,LtB170_T,"-37.81172914, 144.9682466"
201420240513,20,2024-05-13,14,148,184,332,LtB170_T,"-37.81172914, 144.9682466"
202120231118,20,2023-11-18,21,321,512,833,LtB170_T,"-37.81172914, 144.9682466"
20120231230,20,2023-12-30,1,49,61,110,LtB170_T,"-37.81172914, 144.9682466"
521320250123,52,2025-01-23,13,425,418,843,Eli263_T,"-37.81252157, 144.9619401"
1391620250505,139,2025-05-05,16,142,40,182,Signal1647_T,"-37.81959923, 144.9632832"
1392020250608,139,2025-06-08,20,12,14,26,Signal1647_T,"-37.81959923, 144.9632832"
1421620240416,142,2024-04-16,16,341,259,600,Hammer1584_T,"-37.81970749, 144.96795734"
1381920241215,138,2024-12-15,19,6,1,7,EntPark1671_T,"-37.81996544, 144.95981454"
117220250218,117,2025-02-18,2,11,3,14,Fli114F_T,"-37.81629332, 144.97090877"
117820250611,117,2025-06-11,8,355,88,443,Fli114F_T,"-37.81629332, 144.97090877"
1231520251001,123,2025-10-01,15,42,37,79,BirBridge_T,"-37.81753741, 144.97329734"
1091220241208,109,2024-12-08,12,73,72,145,LatWill_T,"-37.81193681, 144.95621105"
19820250120,19,2025-01-20,8,43,37,80,LtB210_T,"-37.81237202, 144.96550671"
69020250225,69,2025-02-25,0,3,3,6,FLDegC_T,"-37.81687226, 144.96559144"
42320240426,4,2024-04-26,23,448,494,942,Swa123_T,"-37.81487988, 144.9660878"
751120240426,75,2024-04-26,11,18,57,75,SprFli_T,"-37.81515276, 144.97467661"
452120240424,45,2024-04-24,21,170,499,669,Swa148_T,"-37.81414075, 144.96609379"
5820240301,5,2024-03-01,8,433,817,1250,PriNW_T,"-37.81874249, 144.96787656"
51620240318,5,2024-03-18,16,1214,838,2052,PriNW_T,"-37.81874249, 144.96787656"
1651820250707,165,2025-07-07,18,18,8,26,Spen475_T,"-37.80953359, 144.94939004"
1401820240229,140,2024-02-29,18,128,172,300,Boyd2837_T,"-37.82590962, 144.96185972"
132720250316,132,2025-03-16,7,14,3,17,King335_T,"-37.81267639, 144.95386444"
1331120250722,133,2025-07-22,11,305,303,608,Spen229_T,"-37.81531435, 144.95227769"
107220240916,107,2024-09-16,2,0,3,3,280Will_T,"-37.81246271, 144.95690188"
185320250912,185,2025-09-12,3,25,10,35,Eli197_T,"-37.81374643, 144.96276183"
1792020250929,179,2025-09-29,20,34,48,82,Pow61_T,"-37.82392385, 144.96299677"
691420240408,69,2024-04-08,14,181,155,336,FLDegC_T,"-37.81687226, 144.96559144"
691920250307,69,2025-03-07,19,122,110,232,FLDegC_T,"-37.81687226, 144.96559144"
84120240218,84,2024-02-18,1,218,324,542,ElFi_T,"-37.81798049, 144.96503383"
62320250924,6,2025-09-24,23,219,129,348,FliS_T,"-37.81911705, 144.96558255"
41720250401,4,2025-04-01,17,2075,1526,3601,Swa123_T,"-37.81487988, 144.9660878"
4820250604,4,2025-06-04,8,520,289,809,Swa123_T,"-37.81487988, 144.9660878"
751320241128,75,2024-11-28,13,85,98,183,SprFli_T,"-37.81515276, 144.97467661"
8720241012,8,2024-10-12,7,36,49,85,WebBN_T,"-37.82293543, 144.9471751"
651520231018,65,2023-10-18,15,362,613,975,SwaCs_T,"-37.81569416, 144.9668064"
291720241005,29,2024-10-05,17,111,140,251,AG_T,"-37.8199817, 144.96872865"
291820250105,29,2025-01-05,18,121,149,270,AG_T,"-37.8199817, 144.96872865"
711320241019,71,2024-10-19,13,3,3,6,WestWP_T,"-37.81235775, 144.97136962"
281620240712,28,2024-07-12,16,411,1250,1661,VAC_T,"-37.82129925, 144.96879309"
401520231123,40,2023-11-23,15,196,194,390,Spr201_T,"-37.80999341, 144.97227587"
36220240219,36,2024-02-19,2,2,7,9,Que85_T,"-37.81652527, 144.96121062"
36420240222,36,2024-02-22,4,7,4,11,Que85_T,"-37.81652527, 144.96121062"
361420240313,36,2024-03-13,14,233,349,582,Que85_T,"-37.81652527, 144.96121062"
44820240911,44,2024-09-11,8,33,82,115,UM3_T,"-37.79698741, 144.96441306"
431320250403,43,2025-04-03,13,290,392,682,UM2_T,"-37.79844526, 144.96411782"
431020250608,43,2025-06-08,10,43,32,75,UM2_T,"-37.79844526, 144.96411782"
1432120240904,143,2024-09-04,21,127,100,227,Spencer_T,"-37.821728, 144.95557015"
1321120250910,132,2025-09-10,11,125,92,217,King335_T,"-37.81267639, 144.95386444"
1351420241202,135,2024-12-02,14,397,441,838,Spen161_T,"-37.8172861, 144.95319102"
1181220240201,118,2024-02-01,12,22,16,38,Fli114C_T,"-37.81632783, 144.97090512"
871520251010,87,2025-10-10,15,90,155,245,Errol23_T,"-37.80454949, 144.94921863"
1082220231221,108,2023-12-21,22,129,89,218,261Will_T,"-37.81295822, 144.95678789"
1661120250109,166,2025-01-09,11,46,41,87,Spen484_T,"-37.80896733, 144.94931703"
1792120250304,179,2025-03-04,21,60,63,123,Pow61_T,"-37.82392385, 144.96299677"
1791620250311,179,2025-03-11,16,82,74,156,Pow61_T,"-37.82392385, 144.96299677"
17920250430,17,2025-04-30,9,683,250,933,Col15_T,"-37.81362543, 144.97323591"
671620250709,67,2025-07-09,16,407,629,1036,FLDegS_T,"-37.81688755, 144.96562569"
631820240510,63,2024-05-10,18,301,360,661,Bou231_T,"-37.81333081, 144.96675571"
681520241117,68,2024-11-17,15,238,173,411,FLDegN_T,"-37.8168479, 144.96559789"
562220240516,56,2024-05-16,22,140,158,298,Lon364_T,"-37.81234775, 144.96153311"
861220240524,86,2024-05-24,12,83,68,151,574Qub_T,"-37.80309992, 144.94908064"
142820250705,142,2025-07-05,8,207,184,391,Hammer1584_T,"-37.81970749, 144.96795734"
130820240328,130,2024-03-28,8,6,8,14,Bou892T,"-37.8204637, 144.94126826"
138620240101,138,2024-01-01,6,2,3,5,EntPark1671_T,"-37.81996544, 144.95981454"
1611220250429,161,2025-04-29,12,144,129,273,BirArt1109_T,"-37.81851276, 144.97131336"
691020250629,69,2025-06-29,10,219,155,374,FLDegC_T,"-37.81687226, 144.96559144"
41920240726,4,2024-07-26,19,901,581,1482,Swa123_T,"-37.81487988, 144.9660878"
31120250921,3,2025-09-21,11,572,786,1358,Swa295_T,"-37.81101524, 144.96429485"
31920241201,3,2024-12-01,19,917,964,1881,Swa295_T,"-37.81101524, 144.96429485"
8920250501,8,2025-05-01,9,214,159,373,WebBN_T,"-37.82293543, 144.9471751"
412220240730,41,2024-07-30,22,22,21,43,Swa31,"-37.81668634, 144.96689733"
41420241109,41,2024-11-09,4,61,80,141,Swa31,"-37.81668634, 144.96689733"
411420250115,41,2025-01-15,14,1581,1527,3108,Swa31,"-37.81668634, 144.96689733"
412320250219,41,2025-02-19,23,177,356,533,Swa31,"-37.81668634, 144.96689733"
77720250724,77,2025-07-24,7,63,128,191,HarEsP_T,"-37.81441438, 144.94433026"
142220250414,14,2025-04-14,22,153,55,208,SanBri_T,"-37.82011242, 144.96291897"
712220241120,71,2024-11-20,22,8,10,18,WestWP_T,"-37.81235775, 144.97136962"
71720240223,71,2024-02-23,7,6,6,12,WestWP_T,"-37.81235775, 144.97136962"
28720240506,28,2024-05-06,7,382,142,524,VAC_T,"-37.82129925, 144.96879309"
361120231119,36,2023-11-19,11,99,52,151,Que85_T,"-37.81652527, 144.96121062"
36220240303,36,2024-03-03,2,102,52,154,Que85_T,"-37.81652527, 144.96121062"
361520241218,36,2024-12-18,15,175,180,355,Que85_T,"-37.81652527, 144.96121062"
361820250627,36,2025-06-27,18,257,208,465,Que85_T,"-37.81652527, 144.96121062"
362020240929,36,2024-09-29,20,51,68,119,Que85_T,"-37.81652527, 144.96121062"
371220240402,37,2024-04-02,12,117,106,223,Lyg260_T,"-37.80107122, 144.96704554"
471620250117,47,2025-01-17,16,961,762,1723,Eli250_T,"-37.81258467, 144.9625775"
5120240808,5,2024-08-08,1,7,22,29,PriNW_T,"-37.81874249, 144.96787656"
21520250309,21,2025-03-09,5,5,29,34,Bourke155_T,"-37.81267313, 144.96788288"
107120240908,107,2024-09-08,1,32,14,46,280Will_T,"-37.81246271, 144.95690188"
1081020250228,108,2025-02-28,10,297,445,742,261Will_T,"-37.81295822, 144.95678789"
871820240420,87,2024-04-20,18,105,84,189,Errol23_T,"-37.80454949, 144.94921863"
61520240802,61,2024-08-02,5,10,22,32,RMIT14_T,"-37.80767455, 144.96309114"
61820240808,61,2024-08-08,8,332,343,675,RMIT14_T,"-37.80767455, 144.96309114"
43020250204,43,2025-02-04,0,2,2,4,UM2_T,"-37.79844526, 144.96411782"
1821520250707,182,2025-07-07,15,184,168,352,King163_T,"-37.81627451, 144.95550503"
1852120250715,185,2025-07-15,21,269,359,628,Eli197_T,"-37.81374643, 144.96276183"
1791320250916,179,2025-09-16,13,43,44,87,Pow61_T,"-37.82392385, 144.96299677"
165620251014,165,2025-10-14,6,5,4,9,Spen475_T,"-37.80953359, 144.94939004"
1401620240821,140,2024-08-21,16,84,134,218,Boyd2837_T,"-37.82590962, 144.96185972"
131320240402,131,2024-04-02,3,1,8,9,King2_T,"-37.82009057, 144.95758725"
1341320250719,134,2025-07-19,13,296,246,542,Spen201_T,"-37.81694221, 144.95303935"
1341420250825,134,2025-08-25,14,440,352,792,Spen201_T,"-37.81694221, 144.95303935"
1182320241110,118,2024-11-10,23,13,3,16,Fli114C_T,"-37.81632783, 144.97090512"
67220240721,67,2024-07-21,2,19,46,65,FLDegS_T,"-37.81688755, 144.96562569"
851220241012,85,2024-10-12,12,128,104,232,488Mac_T,"-37.79432415, 144.92973378"
17920250530,17,2025-05-30,9,489,168,657,Col15_T,"-37.81362543, 144.97323591"
672120231102,67,2023-11-02,21,118,226,344,FLDegS_T,"-37.81688755, 144.96562569"
86520240307,86,2024-03-07,5,2,2,4,574Qub_T,"-37.80309992, 144.94908064"
861920240912,86,2024-09-12,19,29,46,75,574Qub_T,"-37.80309992, 144.94908064"
862320250801,86,2025-08-01,23,3,18,21,574Qub_T,"-37.80309992, 144.94908064"
121720241112,12,2024-11-12,17,180,213,393,NewQ_T,"-37.81457988, 144.94292398"
561620250616,56,2025-06-16,16,295,281,576,Lon364_T,"-37.81234775, 144.96153311"
352020240413,35,2024-04-13,20,1240,1791,3031,SouthB_T,"-37.82018685, 144.96508508"
272320240726,27,2024-07-26,23,48,29,77,Vic_T,"-37.80606888, 144.95644692"
9120251001,9,2025-10-01,1,2,11,13,Col700_T,"-37.81982992, 144.95102555"
521820241206,52,2024-12-06,18,359,410,769,Eli263_T,"-37.81252157, 144.9619401"
109120231227,109,2023-12-27,1,11,17,28,LatWill_T,"-37.81193681, 144.95621105"
82120250930,8,2025-09-30,21,12,9,21,WebBN_T,"-37.82293543, 144.9471751"
8420240905,8,2024-09-05,4,1,0,1,WebBN_T,"-37.82293543, 144.9471751"
77520250807,77,2025-08-07,5,3,11,14,HarEsP_T,"-37.81441438, 144.94433026"
78920250106,78,2025-01-06,9,9,5,14,HarEsB_T,"-37.81471642, 144.9446508"
59820231230,59,2023-12-30,8,78,97,175,RMIT_T,"-37.80825648, 144.96304859"
591620241125,59,2024-11-25,16,231,367,598,RMIT_T,"-37.80825648, 144.96304859"
421520250911,42,2025-09-11,15,242,379,621,UM1_T,"-37.80008566, 144.96386412"
421220250917,42,2025-09-17,12,295,400,695,UM1_T,"-37.80008566, 144.96386412"
71920240626,71,2024-06-26,9,36,31,67,WestWP_T,"-37.81235775, 144.97136962"
541420241116,54,2024-11-16,14,51,72,123,Swa607_T,"-37.804024, 144.96308399"
51520240718,5,2024-07-18,15,893,638,1531,PriNW_T,"-37.81874249, 144.96787656"
212320250529,21,2025-05-29,23,80,122,202,Bourke155_T,"-37.81267313, 144.96788288"
87120240218,87,2024-02-18,1,7,8,15,Errol23_T,"-37.80454949, 144.94921863"
61820231119,61,2023-11-19,8,32,120,152,RMIT14_T,"-37.80767455, 144.96309114"
43220240926,43,2024-09-26,2,1,1,2,UM2_T,"-37.79844526, 144.96411782"
431720250907,43,2025-09-07,17,79,94,173,UM2_T,"-37.79844526, 144.96411782"
451220240829,45,2024-08-29,12,740,776,1516,Swa148_T,"-37.81414075, 144.96609379"
44920240620,44,2024-06-20,9,30,51,81,UM3_T,"-37.79698741, 144.96441306"
131220231103,131,2023-11-03,2,12,7,19,King2_T,"-37.82009057, 144.95758725"
1351720240509,135,2024-05-09,17,538,423,961,Spen161_T,"-37.8172861, 144.95319102"
1331720250120,133,2025-01-20,17,770,644,1414,Spen229_T,"-37.81531435, 144.95227769"
133920250320,133,2025-03-20,9,412,416,828,Spen229_T,"-37.81531435, 144.95227769"
1181920240928,118,2024-09-28,19,15,2,17,Fli114C_T,"-37.81632783, 144.97090512"
11820240111,1,2024-01-11,18,1229,938,2167,Bou292_T,"-37.81349441, 144.96515323"
85620250527,85,2025-05-27,6,24,11,35,488Mac_T,"-37.79432415, 144.92973378"
171820241216,17,2024-12-16,18,120,205,325,Col15_T,"-37.81362543, 144.97323591"
12320250123,1,2025-01-23,23,57,81,138,Bou292_T,"-37.81349441, 144.96515323"
181220250825,18,2025-08-25,12,231,213,444,Col12_T,"-37.81344862, 144.97305353"
631220250129,63,2025-01-29,12,475,592,1067,Bou231_T,"-37.81333081, 144.96675571"
861720250830,86,2025-08-30,17,32,47,79,574Qub_T,"-37.80309992, 144.94908064"
11120240301,11,2024-03-01,1,0,1,1,WatCit_T,"-37.81564989, 144.93970694"
101420250401,10,2025-04-01,14,114,72,186,BouHbr_T,"-37.81876474, 144.94710545"
72520240514,72,2024-05-14,5,16,14,30,ACMI_T,"-37.81726338, 144.96872809"
721720240918,72,2024-09-18,17,175,946,1121,ACMI_T,"-37.81726338, 144.96872809"
21720231029,2,2023-10-29,17,580,463,1043,Bou283_T,"-37.81380668, 144.96516718"
22320240307,2,2024-03-07,23,12,83,95,Bou283_T,"-37.81380668, 144.96516718"
21720240727,2,2024-07-27,17,601,503,1104,Bou283_T,"-37.81380668, 144.96516718"
27320250824,27,2025-08-24,3,21,6,27,Vic_T,"-37.80606888, 144.95644692"
9020250330,9,2025-03-30,0,14,12,26,Col700_T,"-37.81982992, 144.95102555"
512320251006,51,2025-10-06,23,45,25,70,Fra118_T,"-37.80841815, 144.95906316"
511920241018,51,2024-10-18,19,74,73,147,Fra118_T,"-37.80841815, 144.95906316"
482220250119,48,2025-01-19,22,35,81,116,QVMQ_T,"-37.80631581, 144.95866697"
302020251014,30,2025-10-14,20,172,409,581,Lon189_T,"-37.8112185, 144.96656806"
11020250209,11,2025-02-09,0,32,30,62,WatCit_T,"-37.81564989, 144.93970694"
24020240713,24,2024-07-13,0,118,256,374,Col620_T,"-37.81887963, 144.95449198"
722120241218,72,2024-12-18,21,179,268,447,ACMI_T,"-37.81726338, 144.96872809"
721320250214,72,2025-02-14,13,298,239,537,ACMI_T,"-37.81726338, 144.96872809"
351420241108,35,2024-11-08,14,777,921,1698,SouthB_T,"-37.82018685, 144.96508508"
21220240811,2,2024-08-11,12,593,544,1137,Bou283_T,"-37.81380668, 144.96516718"
532220250920,53,2025-09-20,22,108,187,295,Col254_T,"-37.81564191, 144.965499"
91320250731,9,2025-07-31,13,570,579,1149,Col700_T,"-37.81982992, 144.95102555"
79220241226,79,2024-12-26,2,36,52,88,FliSS_T,"-37.81794046, 144.96616678"
79420240701,79,2024-07-01,4,12,11,23,FliSS_T,"-37.81794046, 144.96616678"
301620231030,30,2023-10-30,16,195,299,494,Lon189_T,"-37.8112185, 144.96656806"
25120240302,25,2024-03-02,1,35,54,89,MCEC_T,"-37.82401776, 144.95604426"
25720240917,25,2024-09-17,7,198,310,508,MCEC_T,"-37.82401776, 144.95604426"
52820250317,52,2025-03-17,8,141,379,520,Eli263_T,"-37.81252157, 144.9619401"
521720250112,52,2025-01-12,17,204,236,440,Eli263_T,"-37.81252157, 144.9619401"
46720250907,46,2025-09-07,7,6,3,9,Pel147_T,"-37.80240719, 144.9615673"
49820250716,49,2025-07-16,8,121,144,265,Eli501_T,"-37.80730068, 144.95956055"
180720250604,180,2025-06-04,7,68,16,84,Mac330_T,"-37.79497059, 144.93530329"
1301220240725,130,2024-07-25,12,18,13,31,Bou892T,"-37.8204637, 144.94126826"
1302320250919,130,2025-09-19,23,6,1,7,Bou892T,"-37.8204637, 144.94126826"
1171520240619,117,2024-06-19,15,152,188,340,Fli114F_T,"-37.81629332, 144.97090877"
117220250719,117,2025-07-19,2,11,12,23,Fli114F_T,"-37.81629332, 144.97090877"
691520240625,69,2024-06-25,15,154,166,320,FLDegC_T,"-37.81687226, 144.96559144"
84620241001,84,2024-10-01,6,362,130,492,ElFi_T,"-37.81798049, 144.96503383"
31820240204,3,2024-02-04,18,641,813,1454,Swa295_T,"-37.81101524, 144.96429485"
82020250203,8,2025-02-03,20,72,75,147,WebBN_T,"-37.82293543, 144.9471751"
81620250422,8,2025-04-22,16,235,300,535,WebBN_T,"-37.82293543, 144.9471751"
752120250902,75,2025-09-02,21,8,14,22,SprFli_T,"-37.81515276, 144.97467661"
78120241030,78,2024-10-30,1,0,2,2,HarEsB_T,"-37.81471642, 144.9446508"
78220250905,78,2025-09-05,2,1,3,4,HarEsB_T,"-37.81471642, 144.9446508"
78420250925,78,2025-09-25,4,0,1,1,HarEsB_T,"-37.81471642, 144.9446508"
54220250605,54,2025-06-05,2,24,10,34,Swa607_T,"-37.804024, 144.96308399"
541120240628,54,2024-06-28,11,63,71,134,Swa607_T,"-37.804024, 144.96308399"
281720250214,28,2025-02-14,17,624,1026,1650,VAC_T,"-37.82129925, 144.96879309"
31820250809,31,2025-08-09,8,34,29,63,Lyg161_T,"-37.80169681, 144.96658911"
311720240127,31,2024-01-27,17,283,172,455,Lyg161_T,"-37.80169681, 144.96658911"
212020240224,21,2024-02-24,20,666,761,1427,Bourke155_T,"-37.81267313, 144.96788288"
61420251003,61,2025-10-03,4,12,8,20,RMIT14_T,"-37.80767455, 144.96309114"
5120241211,5,2024-12-11,1,14,36,50,PriNW_T,"-37.81874249, 144.96787656"
21320250812,21,2025-08-12,3,4,4,8,Bourke155_T,"-37.81267313, 144.96788288"
211620251007,21,2025-10-07,16,263,289,552,Bourke155_T,"-37.81267313, 144.96788288"
1401620250913,140,2025-09-13,16,93,87,180,Boyd2837_T,"-37.82590962, 144.96185972"
1622220250822,162,2025-08-22,22,189,130,319,Eli489_T,"-37.80740397, 144.95987909"
143220240903,143,2024-09-03,2,7,2,9,Spencer_T,"-37.821728, 144.95557015"
1431420241013,143,2024-10-13,14,396,404,800,Spencer_T,"-37.821728, 144.95557015"
133520240508,133,2024-05-08,5,74,53,127,Spen229_T,"-37.81531435, 144.95227769"
251920241005,25,2024-10-05,19,287,421,708,MCEC_T,"-37.82401776, 144.95604426"
251320250113,25,2025-01-13,13,528,560,1088,MCEC_T,"-37.82401776, 144.95604426"
25820250702,25,2025-07-02,8,216,254,470,MCEC_T,"-37.82401776, 144.95604426"
30720250605,30,2025-06-05,7,46,61,107,Lon189_T,"-37.8112185, 144.96656806"
1802120250617,180,2025-06-17,21,1,2,3,Mac330_T,"-37.79497059, 144.93530329"
141720241127,141,2024-11-27,7,18,13,31,474Fl_T,"-37.81997273, 144.95834911"
139720250810,139,2025-08-10,7,10,5,15,Signal1647_T,"-37.81959923, 144.9632832"
1361620240318,136,2024-03-18,16,105,37,142,BirFed1120_T,"-37.8184141, 144.97357915"
136220241219,136,2024-12-19,2,0,1,1,BirFed1120_T,"-37.8184141, 144.97357915"
1421920231203,142,2023-12-03,19,694,1074,1768,Hammer1584_T,"-37.81970749, 144.96795734"
1302020251008,130,2025-10-08,20,16,16,32,Bou892T,"-37.8204637, 144.94126826"
138920240424,138,2024-04-24,9,1,22,23,EntPark1671_T,"-37.81996544, 144.95981454"
1381020250621,138,2025-06-21,10,4,7,11,EntPark1671_T,"-37.81996544, 144.95981454"
661720250405,66,2025-04-05,17,1497,1950,3447,QVN_T,"-37.81057846, 144.96444294"
661520250727,66,2025-07-27,15,1581,1788,3369,QVN_T,"-37.81057846, 144.96444294"
691020250108,69,2025-01-08,10,308,208,516,FLDegC_T,"-37.81687226, 144.96559144"
6420231019,6,2023-10-19,4,31,5,36,FliS_T,"-37.81911705, 144.96558255"
61520240325,6,2024-03-25,15,1014,802,1816,FliS_T,"-37.81911705, 144.96558255"
661320240601,66,2024-06-01,13,1119,1173,2292,QVN_T,"-37.81057846, 144.96444294"
66220240224,66,2024-02-24,2,72,42,114,QVN_T,"-37.81057846, 144.96444294"
3520231223,3,2023-12-23,5,45,40,85,Swa295_T,"-37.81101524, 144.96429485"
3420240217,3,2024-02-17,4,94,69,163,Swa295_T,"-37.81101524, 144.96429485"
81520240401,8,2024-04-01,15,174,261,435,WebBN_T,"-37.82293543, 144.9471751"
412320240917,41,2024-09-17,23,40,34,74,Swa31,"-37.81668634, 144.96689733"
411320250331,41,2025-03-31,13,1608,1651,3259,Swa31,"-37.81668634, 144.96689733"
141520240405,14,2024-04-05,15,403,137,540,SanBri_T,"-37.82011242, 144.96291897"
59320250416,59,2025-04-16,3,11,6,17,RMIT_T,"-37.80825648, 144.96304859"
711220231201,71,2023-12-01,12,31,31,62,WestWP_T,"-37.81235775, 144.97136962"
59920241026,59,2024-10-26,9,61,39,100,RMIT_T,"-37.80825648, 144.96304859"
592020240227,59,2024-02-27,20,503,534,1037,RMIT_T,"-37.80825648, 144.96304859"
592020240414,59,2024-04-14,20,399,277,676,RMIT_T,"-37.80825648, 144.96304859"
651020240423,65,2024-04-23,10,320,243,563,SwaCs_T,"-37.81569416, 144.9668064"
541720240514,54,2024-05-14,17,202,518,720,Swa607_T,"-37.804024, 144.96308399"
47120231223,47,2023-12-23,1,117,140,257,Eli250_T,"-37.81258467, 144.9625775"
471220231204,47,2023-12-04,12,1036,1014,2050,Eli250_T,"-37.81258467, 144.9625775"
401920250411,40,2025-04-11,19,131,187,318,Spr201_T,"-37.80999341, 144.97227587"
31620240723,31,2024-07-23,6,3,8,11,Lyg161_T,"-37.80169681, 144.96658911"
471920250429,47,2025-04-29,19,488,456,944,Eli250_T,"-37.81258467, 144.9625775"
1071320240729,107,2024-07-29,13,168,164,332,280Will_T,"-37.81246271, 144.95690188"
1082220250820,108,2025-08-20,22,112,89,201,261Will_T,"-37.81295822, 144.95678789"
50620250227,50,2025-02-27,6,3,19,22,Lyg309_T,"-37.79808192, 144.96721013"
43220250112,43,2025-01-12,2,4,0,4,UM2_T,"-37.79844526, 144.96411782"
441320240312,44,2024-03-12,13,82,31,113,UM3_T,"-37.79698741, 144.96441306"
1841020250812,184,2025-08-12,10,494,478,972,Eli124_T,"-37.81512416, 144.96371988"
166620251011,166,2025-10-11,6,1,7,8,Spen484_T,"-37.80896733, 144.94931703"
140920241220,140,2024-12-20,9,79,38,117,Boyd2837_T,"-37.82590962, 144.96185972"
1431120240521,143,2024-05-21,11,124,225,349,Spencer_T,"-37.821728, 144.95557015"
132420250729,132,2025-07-29,4,3,1,4,King335_T,"-37.81267639, 144.95386444"
1341320241016,134,2024-10-16,13,453,416,869,Spen201_T,"-37.81694221, 144.95303935"
118920241013,118,2024-10-13,9,4,6,10,Fli114C_T,"-37.81632783, 144.97090512"
671620231109,67,2023-11-09,16,321,530,851,FLDegS_T,"-37.81688755, 144.96562569"
851020240723,85,2024-07-23,10,32,17,49,488Mac_T,"-37.79432415, 144.92973378"
85920250206,85,2025-02-06,9,88,63,151,488Mac_T,"-37.79432415, 144.92973378"
11020240828,1,2024-08-28,10,461,430,891,Bou292_T,"-37.81349441, 144.96515323"
67520251002,67,2025-10-02,5,10,16,26,FLDegS_T,"-37.81688755, 144.96562569"
671520250424,67,2025-04-24,15,446,640,1086,FLDegS_T,"-37.81688755, 144.96562569"
1181920250209,118,2025-02-09,19,16,25,41,Fli114C_T,"-37.81632783, 144.97090512"
1082020250210,108,2025-02-10,20,169,108,277,261Will_T,"-37.81295822, 144.95678789"
85920250525,85,2025-05-25,9,79,55,134,488Mac_T,"-37.79432415, 144.92973378"
171520250921,17,2025-09-21,15,174,89,263,Col15_T,"-37.81362543, 144.97323591"
12120241007,1,2024-10-07,21,136,153,289,Bou292_T,"-37.81349441, 144.96515323"
631820240506,63,2024-05-06,18,191,255,446,Bou231_T,"-37.81333081, 144.96675571"
86520241125,86,2024-11-25,5,1,2,3,574Qub_T,"-37.80309992, 144.94908064"
111520250814,11,2025-08-14,15,80,80,160,WatCit_T,"-37.81564989, 144.93970694"
122220240319,12,2024-03-19,22,87,134,221,NewQ_T,"-37.81457988, 144.94292398"
121020250610,12,2025-06-10,10,87,88,175,NewQ_T,"-37.81457988, 144.94292398"
121220250613,12,2025-06-13,12,112,173,285,NewQ_T,"-37.81457988, 144.94292398"
102220241130,10,2024-11-30,22,128,108,236,BouHbr_T,"-37.81876474, 144.94710545"
72820251002,72,2025-10-02,8,668,100,768,ACMI_T,"-37.81726338, 144.96872809"
35120250918,35,2025-09-18,1,8,18,26,SouthB_T,"-37.82018685, 144.96508508"
352020240417,35,2024-04-17,20,563,865,1428,SouthB_T,"-37.82018685, 144.96508508"
58820241025,58,2024-10-25,8,1248,155,1403,Bou688_T,"-37.81686075, 144.95358075"
27820240203,27,2024-02-03,8,77,57,134,Vic_T,"-37.80606888, 144.95644692"
27720240122,27,2024-01-22,7,17,28,45,Vic_T,"-37.80606888, 144.95644692"
581220250804,58,2025-08-04,12,680,428,1108,Bou688_T,"-37.81686075, 144.95358075"
91820240203,9,2024-02-03,18,68,76,144,Col700_T,"-37.81982992, 144.95102555"
79120240624,79,2024-06-24,1,16,13,29,FliSS_T,"-37.81794046, 144.96616678"
30620240310,30,2024-03-10,6,30,94,124,Lon189_T,"-37.8112185, 144.96656806"
461020250612,46,2025-06-12,10,85,50,135,Pel147_T,"-37.80240719, 144.9615673"
512020240716,51,2024-07-16,20,48,37,85,Fra118_T,"-37.80841815, 144.95906316"
109320250301,109,2025-03-01,3,9,10,19,LatWill_T,"-37.81193681, 144.95621105"
109820250527,109,2025-05-27,8,98,633,731,LatWill_T,"-37.81193681, 144.95621105"
192120240913,19,2024-09-13,21,546,568,1114,LtB210_T,"-37.81237202, 144.96550671"
202220250928,20,2025-09-28,22,71,210,281,LtB170_T,"-37.81172914, 144.9682466"
1801320250428,180,2025-04-28,13,36,23,59,Mac330_T,"-37.79497059, 144.93530329"
1421420250218,142,2025-02-18,14,440,446,886,Hammer1584_T,"-37.81970749, 144.96795734"
1611920250818,161,2025-08-18,19,4,2,6,BirArt1109_T,"-37.81851276, 144.97131336"
1642220241209,164,2024-12-09,22,33,54,87,Lat526_T,"-37.813005, 144.95160411"
117520240811,117,2024-08-11,5,3,9,12,Fli114F_T,"-37.81629332, 144.97090877"
66020250523,66,2025-05-23,0,59,40,99,QVN_T,"-37.81057846, 144.96444294"
66020250929,66,2025-09-29,0,60,44,104,QVN_T,"-37.81057846, 144.96444294"
69020240910,69,2024-09-10,0,1,1,2,FLDegC_T,"-37.81687226, 144.96559144"
6220231029,6,2023-10-29,2,115,95,210,FliS_T,"-37.81911705, 144.96558255"
31620240622,3,2024-06-22,16,1248,1373,2621,Swa295_T,"-37.81101524, 144.96429485"
32120241209,3,2024-12-09,21,865,463,1328,Swa295_T,"-37.81101524, 144.96429485"
411020241007,41,2024-10-07,10,147,200,347,Swa31,"-37.81668634, 144.96689733"
81820250828,8,2025-08-28,18,174,120,294,WebBN_T,"-37.82293543, 144.9471751"
78620241023,78,2024-10-23,6,5,6,11,HarEsB_T,"-37.81471642, 144.9446508"
421220241219,42,2024-12-19,12,100,163,263,UM1_T,"-37.80008566, 144.96386412"
772020250613,77,2025-06-13,20,91,72,163,HarEsP_T,"-37.81441438, 144.94433026"
59120241213,59,2024-12-13,1,35,8,43,RMIT_T,"-37.80825648, 144.96304859"
59720240521,59,2024-05-21,7,215,108,323,RMIT_T,"-37.80825648, 144.96304859"
591020241104,59,2024-11-04,10,218,195,413,RMIT_T,"-37.80825648, 144.96304859"
541720240817,54,2024-08-17,17,181,195,376,Swa607_T,"-37.804024, 144.96308399"
281120240611,28,2024-06-11,11,410,232,642,VAC_T,"-37.82129925, 144.96879309"
37020240426,37,2024-04-26,0,21,8,29,Lyg260_T,"-37.80107122, 144.96704554"
502120240526,50,2024-05-26,21,129,39,168,Lyg309_T,"-37.79808192, 144.96721013"
501620240918,50,2024-09-18,16,180,177,357,Lyg309_T,"-37.79808192, 144.96721013"
56720250613,56,2025-06-13,7,60,53,113,Lon364_T,"-37.81234775, 144.96153311"
241720241011,24,2024-10-11,17,733,1702,2435,Col620_T,"-37.81887963, 144.95449198"
10020250531,10,2025-05-31,0,29,8,37,BouHbr_T,"-37.81876474, 144.94710545"
22020240923,2,2024-09-23,20,124,216,340,Bou283_T,"-37.81380668, 144.96516718"
91220231214,9,2023-12-14,12,799,702,1501,Col700_T,"-37.81982992, 144.95102555"
792220240317,79,2024-03-17,22,167,248,415,FliSS_T,"-37.81794046, 144.96616678"
532220250617,53,2025-06-17,22,38,44,82,Col254_T,"-37.81564191, 144.965499"
511220250212,51,2025-02-12,12,88,98,186,Fra118_T,"-37.80841815, 144.95906316"
23620240217,23,2024-02-17,6,23,27,50,Col623_T,"-37.81909256, 144.95452748"
522120231230,52,2023-12-30,21,283,203,486,Eli263_T,"-37.81252157, 144.9619401"
19120250724,19,2025-07-24,1,33,33,66,LtB210_T,"-37.81237202, 144.96550671"
191620240501,19,2024-05-01,16,475,372,847,LtB210_T,"-37.81237202, 144.96550671"
482220241220,48,2024-12-20,22,59,126,185,QVMQ_T,"-37.80631581, 144.95866697"
481620240928,48,2024-09-28,16,243,127,370,QVMQ_T,"-37.80631581, 144.95866697"
1411920240812,141,2024-08-12,19,65,51,116,474Fl_T,"-37.81997273, 144.95834911"
1361720241207,136,2024-12-07,17,98,129,227,BirFed1120_T,"-37.8184141, 144.97357915"
1231620250804,123,2025-08-04,16,34,23,57,BirBridge_T,"-37.81753741, 144.97329734"
661120240311,66,2024-03-11,11,578,766,1344,QVN_T,"-37.81057846, 144.96444294"
66620250515,66,2025-05-15,6,18,70,88,QVN_T,"-37.81057846, 144.96444294"
842120231229,84,2023-12-29,21,802,1036,1838,ElFi_T,"-37.81798049, 144.96503383"
702020250608,70,2025-06-08,20,96,93,189,Errol20_T,"-37.80456984, 144.94946228"
701920250905,70,2025-09-05,19,150,230,380,Errol20_T,"-37.80456984, 144.94946228"
751520240802,75,2024-08-02,15,43,50,93,SprFli_T,"-37.81515276, 144.97467661"
39920250922,39,2025-09-22,9,74,52,126,AlfPl_T,"-37.81379749, 144.96995745"
391620240804,39,2024-08-04,16,37,19,56,AlfPl_T,"-37.81379749, 144.96995745"
39720241027,39,2024-10-27,7,34,14,48,AlfPl_T,"-37.81379749, 144.96995745"
751720250417,75,2025-04-17,17,99,63,162,SprFli_T,"-37.81515276, 144.97467661"
412120250102,41,2025-01-02,21,653,833,1486,Swa31,"-37.81668634, 144.96689733"
771020240522,77,2024-05-22,10,77,96,173,HarEsP_T,"-37.81441438, 144.94433026"
782020250324,78,2025-03-24,20,5,5,10,HarEsB_T,"-37.81471642, 144.9446508"
652320240815,65,2024-08-15,23,270,173,443,SwaCs_T,"-37.81569416, 144.9668064"
71520240104,71,2024-01-04,5,1,9,10,WestWP_T,"-37.81235775, 144.97136962"
711720240307,71,2024-03-07,17,36,40,76,WestWP_T,"-37.81235775, 144.97136962"
65720240602,65,2024-06-02,7,17,42,59,SwaCs_T,"-37.81569416, 144.9668064"
421620241220,42,2024-12-20,16,62,69,131,UM1_T,"-37.80008566, 144.96386412"
281220241023,28,2024-10-23,12,380,459,839,VAC_T,"-37.82129925, 144.96879309"
311920250228,31,2025-02-28,19,353,261,614,Lyg161_T,"-37.80169681, 144.96658911"
311820250629,31,2025-06-29,18,230,168,398,Lyg161_T,"-37.80169681, 144.96658911"
37520250103,37,2025-01-03,5,5,9,14,Lyg260_T,"-37.80107122, 144.96704554"
51620250821,5,2025-08-21,16,1261,1004,2265,PriNW_T,"-37.81874249, 144.96787656"
1081020250211,108,2025-02-11,10,351,433,784,261Will_T,"-37.81295822, 144.95678789"
1651920241212,165,2024-12-12,19,50,32,82,Spen475_T,"-37.80953359, 144.94939004"
1621620250821,162,2025-08-21,16,324,437,761,Eli489_T,"-37.80740397, 144.95987909"
1671720250426,167,2025-04-26,17,26,50,76,Lat526_T,"-37.81304149, 144.95155955"
68920231119,68,2023-11-19,9,120,70,190,FLDegN_T,"-37.8168479, 144.96559789"
11920241107,1,2024-11-07,19,739,563,1302,Bou292_T,"-37.81349441, 144.96515323"
50020241011,50,2024-10-11,0,2,2,4,Lyg309_T,"-37.79808192, 144.96721013"
43220240424,43,2024-04-24,2,1,1,2,UM2_T,"-37.79844526, 144.96411782"
5820240314,5,2024-03-14,8,465,1112,1577,PriNW_T,"-37.81874249, 144.96787656"
1812320250428,181,2025-04-28,23,153,142,295,Eli368_T,"-37.81009465, 144.96143149"
1401020250728,140,2025-07-28,10,95,50,145,Boyd2837_T,"-37.82590962, 144.96185972"
1431920240901,143,2024-09-01,19,97,155,252,Spencer_T,"-37.821728, 144.95557015"
1431220250510,143,2025-05-10,12,199,289,488,Spencer_T,"-37.821728, 144.95557015"
1342120240308,134,2024-03-08,21,317,202,519,Spen201_T,"-37.81694221, 144.95303935"
134520240522,134,2024-05-22,5,31,21,52,Spen201_T,"-37.81694221, 144.95303935"
1352120231101,135,2023-11-01,21,126,130,256,Spen161_T,"-37.8172861, 144.95319102"
107120240826,107,2024-08-26,1,7,12,19,280Will_T,"-37.81246271, 144.95690188"
1181620250215,118,2025-02-15,16,19,27,46,Fli114C_T,"-37.81632783, 144.97090512"
67820240331,67,2024-03-31,8,87,105,192,FLDegS_T,"-37.81688755, 144.96562569"
68820231124,68,2023-11-24,8,151,104,255,FLDegN_T,"-37.8168479, 144.96559789"
181820240329,18,2024-03-29,18,35,50,85,Col12_T,"-37.81344862, 144.97305353"
631920241107,63,2024-11-07,19,260,362,622,Bou231_T,"-37.81333081, 144.96675571"
632020250103,63,2025-01-03,20,334,282,616,Bou231_T,"-37.81333081, 144.96675571"
631620250322,63,2025-03-22,16,497,580,1077,Bou231_T,"-37.81333081, 144.96675571"
681820250323,68,2025-03-23,18,187,166,353,FLDegN_T,"-37.8168479, 144.96559789"
86320240211,86,2024-02-11,3,1,0,1,574Qub_T,"-37.80309992, 144.94908064"
111020240130,11,2024-01-30,10,54,47,101,WatCit_T,"-37.81564989, 144.93970694"
241120250211,24,2025-02-11,11,516,443,959,Col620_T,"-37.81887963, 144.95449198"
56720250609,56,2025-06-09,7,27,8,35,Lon364_T,"-37.81234775, 144.96153311"
76520250611,76,2025-06-11,5,3,2,5,KenMac_T,"-37.79453803, 144.93036194"
721920240816,72,2024-08-16,19,168,258,426,ACMI_T,"-37.81726338, 144.96872809"
352220240214,35,2024-02-14,22,585,1507,2092,SouthB_T,"-37.82018685, 144.96508508"
2720241030,2,2024-10-30,7,54,92,146,Bou283_T,"-37.81380668, 144.96516718"
58120250420,58,2025-04-20,1,54,88,142,Bou688_T,"-37.81686075, 144.95358075"
531420240608,53,2024-06-08,14,858,738,1596,Col254_T,"-37.81564191, 144.965499"
532020231030,53,2023-10-30,20,102,135,237,Col254_T,"-37.81564191, 144.965499"
91620250402,9,2025-04-02,16,2643,163,2806,Col700_T,"-37.81982992, 144.95102555"
30420240925,30,2024-09-25,4,11,8,19,Lon189_T,"-37.8112185, 144.96656806"
301320240618,30,2024-06-18,13,284,429,713,Lon189_T,"-37.8112185, 144.96656806"
301420240122,30,2024-01-22,14,224,360,584,Lon189_T,"-37.8112185, 144.96656806"
791920240323,79,2024-03-23,19,703,681,1384,FliSS_T,"-37.81794046, 144.96616678"
201820250329,20,2025-03-29,18,740,782,1522,LtB170_T,"-37.81172914, 144.9682466"
512020240712,51,2024-07-12,20,63,66,129,Fra118_T,"-37.80841815, 144.95906316"
492120241001,49,2024-10-01,21,152,110,262,Eli501_T,"-37.80730068, 144.95956055"
491220240127,49,2024-01-27,12,433,766,1199,Eli501_T,"-37.80730068, 144.95956055"
481920240321,48,2024-03-21,19,124,174,298,QVMQ_T,"-37.80631581, 144.95866697"
1371320240217,137,2024-02-17,13,13,17,30,BouHbr2353_T,"-37.81894815, 144.94612292"
1371520231104,137,2023-11-04,15,0,1,1,BouHbr2353_T,"-37.81894815, 144.94612292"
1421020241114,142,2024-11-14,10,241,239,480,Hammer1584_T,"-37.81970749, 144.96795734"
1382020250707,138,2025-07-07,20,0,1,1,EntPark1671_T,"-37.81996544, 144.95981454"
123820231020,123,2023-10-20,8,59,26,85,BirBridge_T,"-37.81753741, 144.97329734"
661520250315,66,2025-03-15,15,1409,1870,3279,QVN_T,"-37.81057846, 144.96444294"
691520240225,69,2024-02-25,15,174,194,368,FLDegC_T,"-37.81687226, 144.96559144"
692220241031,69,2024-10-31,22,5,5,10,FLDegC_T,"-37.81687226, 144.96559144"
6120240415,6,2024-04-15,1,26,33,59,FliS_T,"-37.81911705, 144.96558255"
842220250602,84,2025-06-02,22,228,336,564,ElFi_T,"-37.81798049, 144.96503383"
4220231022,4,2023-10-22,2,79,128,207,Swa123_T,"-37.81487988, 144.9660878"
32020240916,3,2024-09-16,20,637,662,1299,Swa295_T,"-37.81101524, 144.96429485"
3520231210,3,2023-12-10,5,56,50,106,Swa295_T,"-37.81101524, 144.96429485"
63820250808,63,2025-08-08,8,187,767,954,Bou231_T,"-37.81333081, 144.96675571"
631120250819,63,2025-08-19,11,266,350,616,Bou231_T,"-37.81333081, 144.96675571"
621820240924,62,2024-09-24,18,265,171,436,Lat224_T,"-37.80996494, 144.96216521"
622220250313,62,2025-03-13,22,216,178,394,Lat224_T,"-37.80996494, 144.96216521"
111520250926,11,2025-09-26,15,132,96,228,WatCit_T,"-37.81564989, 144.93970694"
561720251016,56,2025-10-16,17,383,416,799,Lon364_T,"-37.81234775, 144.96153311"
581720250202,58,2025-02-02,17,374,229,603,Bou688_T,"-37.81686075, 144.95358075"
762120231114,76,2023-11-14,21,9,15,24,KenMac_T,"-37.79453803, 144.93036194"
76920240507,76,2024-05-07,9,75,71,146,KenMac_T,"-37.79453803, 144.93036194"
271520250311,27,2025-03-11,15,85,96,181,Vic_T,"-37.80606888, 144.95644692"
9520240117,9,2024-01-17,5,12,48,60,Col700_T,"-37.81982992, 144.95102555"
30320240715,30,2024-07-15,3,17,57,74,Lon189_T,"-37.8112185, 144.96656806"
30720250204,30,2025-02-04,7,42,40,82,Lon189_T,"-37.8112185, 144.96656806"
51020241120,51,2024-11-20,0,24,15,39,Fra118_T,"-37.80841815, 144.95906316"
231920250618,23,2025-06-18,19,128,221,349,Col623_T,"-37.81909256, 144.95452748"
23420250926,23,2025-09-26,4,6,21,27,Col623_T,"-37.81909256, 144.95452748"
1091220231225,109,2023-12-25,12,4,13,17,LatWill_T,"-37.81193681, 144.95621105"
109720240730,109,2024-07-30,7,41,256,297,LatWill_T,"-37.81193681, 144.95621105"
141420250424,141,2025-04-24,4,5,7,12,474Fl_T,"-37.81997273, 144.95834911"
137620240824,137,2024-08-24,6,0,2,2,BouHbr2353_T,"-37.81894815, 144.94612292"
1422120250528,142,2025-05-28,21,3,0,3,Hammer1584_T,"-37.81970749, 144.96795734"
1301820250613,130,2025-06-13,18,29,21,50,Bou892T,"-37.8204637, 144.94126826"
1641320250312,164,2025-03-12,13,118,92,210,Lat526_T,"-37.813005, 144.95160411"
1381220231203,138,2023-12-03,12,4,6,10,EntPark1671_T,"-37.81996544, 144.95981454"
1381520240430,138,2024-04-30,15,4,3,7,EntPark1671_T,"-37.81996544, 144.95981454"
161620250424,161,2025-04-24,6,35,17,52,BirArt1109_T,"-37.81851276, 144.97131336"
1231620250213,123,2025-02-13,16,23,20,43,BirBridge_T,"-37.81753741, 144.97329734"
132620231120,132,2023-11-20,6,23,14,37,King335_T,"-37.81267639, 144.95386444"
134320251001,134,2025-10-01,3,17,15,32,Spen201_T,"-37.81694221, 144.95303935"
1321620250327,132,2025-03-27,16,166,170,336,King335_T,"-37.81267639, 144.95386444"
1351520250101,135,2025-01-01,15,305,357,662,Spen161_T,"-37.8172861, 144.95319102"
1181520240130,118,2024-01-30,15,12,16,28,Fli114C_T,"-37.81632783, 144.97090512"
1181020240715,118,2024-07-15,10,7,16,23,Fli114C_T,"-37.81632783, 144.97090512"
118820250305,118,2025-03-05,8,35,15,50,Fli114C_T,"-37.81632783, 144.97090512"
1181320250922,118,2025-09-22,13,11,20,31,Fli114C_T,"-37.81632783, 144.97090512"
12620250207,12,2025-02-07,6,47,37,84,NewQ_T,"-37.81457988, 144.94292398"
121820250327,12,2025-03-27,18,645,406,1051,NewQ_T,"-37.81457988, 144.94292398"
111820250802,11,2025-08-02,18,157,93,250,WatCit_T,"-37.81564989, 144.93970694"
24920250301,24,2025-03-01,9,496,343,839,Col620_T,"-37.81887963, 144.95449198"
241620250130,24,2025-01-30,16,494,1918,2412,Col620_T,"-37.81887963, 144.95449198"
721120241207,72,2024-12-07,11,184,242,426,ACMI_T,"-37.81726338, 144.96872809"
10420240622,10,2024-06-22,4,1,0,1,BouHbr_T,"-37.81876474, 144.94710545"
76520250206,76,2025-02-06,5,2,1,3,KenMac_T,"-37.79453803, 144.93036194"
53220240112,53,2024-01-12,2,7,4,11,Col254_T,"-37.81564191, 144.965499"
9020240124,9,2024-01-24,0,9,8,17,Col700_T,"-37.81982992, 144.95102555"
30320240312,30,2024-03-12,3,6,16,22,Lon189_T,"-37.8112185, 144.96656806"
232220250121,23,2025-01-21,22,27,100,127,Col623_T,"-37.81909256, 144.95452748"
23020240304,23,2024-03-04,0,11,19,30,Col623_T,"-37.81909256, 144.95452748"
23620231019,23,2023-10-19,6,116,61,177,Col623_T,"-37.81909256, 144.95452748"
51420240330,51,2024-03-30,4,5,2,7,Fra118_T,"-37.80841815, 144.95906316"
52220240519,52,2024-05-19,2,116,61,177,Eli263_T,"-37.81252157, 144.9619401"
522020231024,52,2023-10-24,20,328,181,509,Eli263_T,"-37.81252157, 144.9619401"
492120240429,49,2024-04-29,21,138,106,244,Eli501_T,"-37.80730068, 144.95956055"
461620250425,46,2025-04-25,16,21,29,50,Pel147_T,"-37.80240719, 144.9615673"
252220231111,25,2023-11-11,22,400,198,598,MCEC_T,"-37.82401776, 144.95604426"
462120241109,46,2024-11-09,21,5,1,6,Pel147_T,"-37.80240719, 144.9615673"
1361320240703,136,2024-07-03,13,69,76,145,BirFed1120_T,"-37.8184141, 144.97357915"
142020240123,142,2024-01-23,0,9,13,22,Hammer1584_T,"-37.81970749, 144.96795734"
142520250530,142,2025-05-30,5,4,0,4,Hammer1584_T,"-37.81970749, 144.96795734"
49920250628,49,2025-06-28,9,225,202,427,Eli501_T,"-37.80730068, 144.95956055"
491020241022,49,2024-10-22,10,205,317,522,Eli501_T,"-37.80730068, 144.95956055"
1091120240710,109,2024-07-10,11,112,121,233,LatWill_T,"-37.81193681, 144.95621105"
661620231129,66,2023-11-29,16,1016,1004,2020,QVN_T,"-37.81057846, 144.96444294"
4820250405,4,2025-04-05,8,279,189,468,Swa123_T,"-37.81487988, 144.9660878"
75620231122,75,2023-11-22,6,34,40,74,SprFli_T,"-37.81515276, 144.97467661"
772220251004,77,2025-10-04,22,148,63,211,HarEsP_T,"-37.81441438, 144.94433026"
782220250529,78,2025-05-29,22,0,11,11,HarEsB_T,"-37.81471642, 144.9446508"
59820240120,59,2024-01-20,8,91,81,172,RMIT_T,"-37.80825648, 144.96304859"
292320240229,29,2024-02-29,23,1,2,3,AG_T,"-37.8199817, 144.96872865"
711020241003,71,2024-10-03,10,31,35,66,WestWP_T,"-37.81235775, 144.97136962"
711220231101,71,2023-11-01,12,50,60,110,WestWP_T,"-37.81235775, 144.97136962"
31120250205,31,2025-02-05,1,6,2,8,Lyg161_T,"-37.80169681, 144.96658911"
47720250614,47,2025-06-14,7,42,69,111,Eli250_T,"-37.81258467, 144.9625775"
471020250705,47,2025-07-05,10,555,588,1143,Eli250_T,"-37.81258467, 144.9625775"
401120240124,40,2024-01-24,11,181,237,418,Spr201_T,"-37.80999341, 144.97227587"
311220250604,31,2025-06-04,12,155,133,288,Lyg161_T,"-37.80169681, 144.96658911"
21820251012,21,2025-10-12,8,22,44,66,Bourke155_T,"-37.81267313, 144.96788288"
108820241018,108,2024-10-18,8,138,1553,1691,261Will_T,"-37.81295822, 144.95678789"
612320251010,61,2025-10-10,23,176,132,308,RMIT14_T,"-37.80767455, 144.96309114"
501920250223,50,2025-02-23,19,279,213,492,Lyg309_T,"-37.79808192, 144.96721013"
501020240616,50,2024-06-16,10,116,170,286,Lyg309_T,"-37.79808192, 144.96721013"
45320250106,45,2025-01-06,3,7,8,15,Swa148_T,"-37.81414075, 144.96609379"
451020250628,45,2025-06-28,10,259,303,562,Swa148_T,"-37.81414075, 144.96609379"
1311020240728,131,2024-07-28,10,50,110,160,King2_T,"-37.82009057, 144.95758725"
1621720241211,162,2024-12-11,17,555,521,1076,Eli489_T,"-37.80740397, 144.95987909"
135020251017,135,2025-10-17,0,25,43,68,Spen161_T,"-37.8172861, 144.95319102"
135820250514,135,2025-05-14,8,255,456,711,Spen161_T,"-37.8172861, 144.95319102"
135820250617,135,2025-06-17,8,280,272,552,Spen161_T,"-37.8172861, 144.95319102"
133220240613,133,2024-06-13,2,3,5,8,Spen229_T,"-37.81531435, 144.95227769"
1331620250822,133,2025-08-22,16,551,559,1110,Spen229_T,"-37.81531435, 144.95227769"
1181720240611,118,2024-06-11,17,9,30,39,Fli114C_T,"-37.81632783, 144.97090512"
108620231201,108,2023-12-01,6,36,209,245,261Will_T,"-37.81295822, 144.95678789"
671020250414,67,2025-04-14,10,316,326,642,FLDegS_T,"-37.81688755, 144.96562569"
18220240204,18,2024-02-04,2,6,2,8,Col12_T,"-37.81344862, 144.97305353"
18020241229,18,2024-12-29,0,5,2,7,Col12_T,"-37.81344862, 144.97305353"
672220240310,67,2024-03-10,22,173,209,382,FLDegS_T,"-37.81688755, 144.96562569"
562120240425,56,2024-04-25,21,151,252,403,Lon364_T,"-37.81234775, 144.96153311"
561220240614,56,2024-06-14,12,329,260,589,Lon364_T,"-37.81234775, 144.96153311"
561120250201,56,2025-02-01,11,298,213,511,Lon364_T,"-37.81234775, 144.96153311"
111020231214,11,2023-12-14,10,47,64,111,WatCit_T,"-37.81564989, 144.93970694"
241920241025,24,2024-10-25,19,418,603,1021,Col620_T,"-37.81887963, 144.95449198"
10320250910,10,2025-09-10,3,0,1,1,BouHbr_T,"-37.81876474, 144.94710545"
241820240930,24,2024-09-30,18,479,1136,1615,Col620_T,"-37.81887963, 144.95449198"
10920240210,10,2024-02-10,9,34,41,75,BouHbr_T,"-37.81876474, 144.94710545"
721920241106,72,2024-11-06,19,85,214,299,ACMI_T,"-37.81726338, 144.96872809"
58020241009,58,2024-10-09,0,55,52,107,Bou688_T,"-37.81686075, 144.95358075"
21420250815,2,2025-08-15,14,880,885,1765,Bou283_T,"-37.81380668, 144.96516718"
2020231229,2,2023-12-29,0,13,73,86,Bou283_T,"-37.81380668, 144.96516718"
53420241203,53,2024-12-03,4,3,7,10,Col254_T,"-37.81564191, 144.965499"
30920250108,30,2025-01-08,9,57,106,163,Lon189_T,"-37.8112185, 144.96656806"
301620240415,30,2024-04-15,16,187,312,499,Lon189_T,"-37.8112185, 144.96656806"
302120231205,30,2023-12-05,21,212,380,592,Lon189_T,"-37.8112185, 144.96656806"
23320240826,23,2024-08-26,3,1,5,6,Col623_T,"-37.81909256, 144.95452748"
232220251011,23,2025-10-11,22,55,121,176,Col623_T,"-37.81909256, 144.95452748"
512120240705,51,2024-07-05,21,63,64,127,Fra118_T,"-37.80841815, 144.95906316"
481220250531,48,2025-05-31,12,616,488,1104,QVMQ_T,"-37.80631581, 144.95866697"
19420231105,19,2023-11-05,4,259,174,433,LtB210_T,"-37.81237202, 144.96550671"
20020240417,20,2024-04-17,0,20,16,36,LtB170_T,"-37.81172914, 144.9682466"
201220240427,20,2024-04-27,12,329,272,601,LtB170_T,"-37.81172914, 144.9682466"
25320231214,25,2023-12-14,3,2,5,7,MCEC_T,"-37.82401776, 144.95604426"
461020240913,46,2024-09-13,10,111,56,167,Pel147_T,"-37.80240719, 144.9615673"
1411620240822,141,2024-08-22,16,129,120,249,474Fl_T,"-37.81997273, 144.95834911"
139520240424,139,2024-04-24,5,1,3,4,Signal1647_T,"-37.81959923, 144.9632832"
1422320241124,142,2024-11-24,23,7,8,15,Hammer1584_T,"-37.81970749, 144.96795734"
1641720250929,164,2025-09-29,17,135,79,214,Lat526_T,"-37.813005, 144.95160411"
1091020241122,109,2024-11-22,10,162,155,317,LatWill_T,"-37.81193681, 144.95621105"
19520250109,19,2025-01-09,5,3,6,9,LtB210_T,"-37.81237202, 144.96550671"
66320250910,66,2025-09-10,3,19,6,25,QVN_T,"-37.81057846, 144.96444294"
69420240410,69,2024-04-10,4,1,1,2,FLDegC_T,"-37.81687226, 144.96559144"
6120231120,6,2023-11-20,1,29,29,58,FliS_T,"-37.81911705, 144.96558255"
841020250320,84,2025-03-20,10,754,559,1313,ElFi_T,"-37.81798049, 144.96503383"
4020250622,4,2025-06-22,0,279,334,613,Swa123_T,"-37.81487988, 144.9660878"
70120250127,70,2025-01-27,1,3,1,4,Errol20_T,"-37.80456984, 144.94946228"
3520250723,3,2025-07-23,5,15,18,33,Swa295_T,"-37.81101524, 144.96429485"
392120250314,39,2025-03-14,21,43,27,70,AlfPl_T,"-37.81379749, 144.96995745"
391820240105,39,2024-01-05,18,107,64,171,AlfPl_T,"-37.81379749, 144.96995745"
81720250411,8,2025-04-11,17,269,441,710,WebBN_T,"-37.82293543, 144.9471751"
41020241103,41,2024-11-03,0,379,552,931,Swa31,"-37.81668634, 144.96689733"
41320241201,41,2024-12-01,3,139,268,407,Swa31,"-37.81668634, 144.96689733"
771520250210,77,2025-02-10,15,116,67,183,HarEsP_T,"-37.81441438, 144.94433026"
77020250411,77,2025-04-11,0,20,33,53,HarEsP_T,"-37.81441438, 144.94433026"
77820250818,77,2025-08-18,8,123,128,251,HarEsP_T,"-37.81441438, 144.94433026"
78820250412,78,2025-04-12,8,29,45,74,HarEsB_T,"-37.81471642, 144.9446508"
78420250622,78,2025-06-22,4,0,3,3,HarEsB_T,"-37.81471642, 144.9446508"
591720250203,59,2025-02-03,17,233,394,627,RMIT_T,"-37.80825648, 144.96304859"
14420250806,14,2025-08-06,4,1,0,1,SanBri_T,"-37.82011242, 144.96291897"
312120240427,31,2024-04-27,21,316,394,710,Lyg161_T,"-37.80169681, 144.96658911"
311620231105,31,2023-11-05,16,329,278,607,Lyg161_T,"-37.80169681, 144.96658911"
311220250625,31,2025-06-25,12,95,102,197,Lyg161_T,"-37.80169681, 144.96658911"
51420240727,5,2024-07-27,14,397,480,877,PriNW_T,"-37.81874249, 144.96787656"
36720240220,36,2024-02-20,7,94,69,163,Que85_T,"-37.81652527, 144.96121062"
37220231213,37,2023-12-13,2,1,1,2,Lyg260_T,"-37.80107122, 144.96704554"
871320250405,87,2025-04-05,13,138,179,317,Errol23_T,"-37.80454949, 144.94921863"
611620250209,61,2025-02-09,16,443,501,944,RMIT14_T,"-37.80767455, 144.96309114"
167220250504,167,2025-05-04,2,3,5,8,Lat526_T,"-37.81304149, 144.95155955"
1622220250921,162,2025-09-21,22,89,53,142,Eli489_T,"-37.80740397, 144.95987909"
1402020240226,140,2024-02-26,20,22,19,41,Boyd2837_T,"-37.82590962, 144.96185972"
1091120250521,109,2025-05-21,11,118,137,255,LatWill_T,"-37.81193681, 144.95621105"
492020241111,49,2024-11-11,20,186,163,349,Eli501_T,"-37.80730068, 144.95956055"
251620240924,25,2024-09-24,16,948,553,1501,MCEC_T,"-37.82401776, 144.95604426"
481920241222,48,2024-12-22,19,107,107,214,QVMQ_T,"-37.80631581, 144.95866697"
1411420250527,141,2025-05-27,14,123,99,222,474Fl_T,"-37.81997273, 144.95834911"
1371420240403,137,2024-04-03,14,11,60,71,BouHbr2353_T,"-37.81894815, 144.94612292"
1371520250108,137,2025-01-08,15,13,110,123,BouHbr2353_T,"-37.81894815, 144.94612292"
1411220231224,141,2023-12-24,12,121,98,219,474Fl_T,"-37.81997273, 144.95834911"
1392220241215,139,2024-12-15,22,70,66,136,Signal1647_T,"-37.81959923, 144.9632832"
1422220231127,142,2023-11-27,22,162,140,302,Hammer1584_T,"-37.81970749, 144.96795734"
1421020240212,142,2024-02-12,10,227,182,409,Hammer1584_T,"-37.81970749, 144.96795734"
142420241130,142,2024-11-30,4,2,2,4,Hammer1584_T,"-37.81970749, 144.96795734"
1301120240221,130,2024-02-21,11,25,27,52,Bou892T,"-37.8204637, 144.94126826"
1301720240623,130,2024-06-23,17,1,3,4,Bou892T,"-37.8204637, 144.94126826"
138920231208,138,2023-12-08,9,1,1,2,EntPark1671_T,"-37.81996544, 144.95981454"
1381320240627,138,2024-06-27,13,4,15,19,EntPark1671_T,"-37.81996544, 144.95981454"
1171920250130,117,2025-01-30,19,78,107,185,Fli114F_T,"-37.81629332, 144.97090877"
67220231019,67,2023-10-19,2,7,3,10,FLDegS_T,"-37.81688755, 144.96562569"
67020250520,67,2025-05-20,0,5,16,21,FLDegS_T,"-37.81688755, 144.96562569"
681720240606,68,2024-06-06,17,116,33,149,FLDegN_T,"-37.8168479, 144.96559789"
661720250306,66,2025-03-06,17,1808,2211,4019,QVN_T,"-37.81057846, 144.96444294"
6020250211,6,2025-02-11,0,93,81,174,FliS_T,"-37.81911705, 144.96558255"
84520250409,84,2025-04-09,5,48,24,72,ElFi_T,"-37.81798049, 144.96503383"
42020250116,4,2025-01-16,20,926,834,1760,Swa123_T,"-37.81487988, 144.9660878"
701620250422,70,2025-04-22,16,134,130,264,Errol20_T,"-37.80456984, 144.94946228"
39520240825,39,2024-08-25,5,1,4,5,AlfPl_T,"-37.81379749, 144.96995745"
391920250418,39,2025-04-18,19,37,32,69,AlfPl_T,"-37.81379749, 144.96995745"
411420250520,41,2025-05-20,14,342,298,640,Swa31,"-37.81668634, 144.96689733"
651320241007,65,2024-10-07,13,770,709,1479,SwaCs_T,"-37.81569416, 144.9668064"
71020231225,71,2023-12-25,0,12,8,20,WestWP_T,"-37.81235775, 144.97136962"
71520240508,71,2024-05-08,5,5,0,5,WestWP_T,"-37.81235775, 144.97136962"
65020231221,65,2023-12-21,0,24,87,111,SwaCs_T,"-37.81569416, 144.9668064"
421520250915,42,2025-09-15,15,261,322,583,UM1_T,"-37.80008566, 144.96386412"
281420240618,28,2024-06-18,14,547,654,1201,VAC_T,"-37.82129925, 144.96879309"
282020240729,28,2024-07-29,20,85,101,186,VAC_T,"-37.82129925, 144.96879309"
28220240118,28,2024-01-18,2,5,8,13,VAC_T,"-37.82129925, 144.96879309"
47620240605,47,2024-06-05,6,49,93,142,Eli250_T,"-37.81258467, 144.9625775"
471920240809,47,2024-08-09,19,909,759,1668,Eli250_T,"-37.81258467, 144.9625775"
311220240308,31,2024-03-08,12,179,162,341,Lyg161_T,"-37.80169681, 144.96658911"
311220240707,31,2024-07-07,12,215,143,358,Lyg161_T,"-37.80169681, 144.96658911"
541820241213,54,2024-12-13,18,105,115,220,Swa607_T,"-37.804024, 144.96308399"
37420231021,37,2023-10-21,4,0,3,3,Lyg260_T,"-37.80107122, 144.96704554"
472020250725,47,2025-07-25,20,579,590,1169,Eli250_T,"-37.81258467, 144.9625775"
451820250405,45,2025-04-05,18,715,1258,1973,Swa148_T,"-37.81414075, 144.96609379"
451420231225,45,2023-12-25,14,219,397,616,Swa148_T,"-37.81414075, 144.96609379"
451220241002,45,2024-10-02,12,1034,846,1880,Swa148_T,"-37.81414075, 144.96609379"
5420240224,5,2024-02-24,4,18,18,36,PriNW_T,"-37.81874249, 144.96787656"
1071020241016,107,2024-10-16,10,98,142,240,280Will_T,"-37.81246271, 144.95690188"
87720240423,87,2024-04-23,7,41,50,91,Errol23_T,"-37.80454949, 144.94921863"
871320250117,87,2025-01-17,13,139,156,295,Errol23_T,"-37.80454949, 144.94921863"
502020240706,50,2024-07-06,20,265,226,491,Lyg309_T,"-37.79808192, 144.96721013"
43420231025,43,2023-10-25,4,0,1,1,UM2_T,"-37.79844526, 144.96411782"
70320240429,70,2024-04-29,3,0,2,2,Errol20_T,"-37.80456984, 144.94946228"
1821820250924,182,2025-09-24,18,308,227,535,King163_T,"-37.81627451, 144.95550503"
1852020250907,185,2025-09-07,20,289,377,666,Eli197_T,"-37.81374643, 144.96276183"
1661220250410,166,2025-04-10,12,73,51,124,Spen484_T,"-37.80896733, 144.94931703"
1401020241025,140,2024-10-25,10,98,41,139,Boyd2837_T,"-37.82590962, 144.96185972"
131420250227,131,2025-02-27,4,3,7,10,King2_T,"-37.82009057, 144.95758725"
78120241013,78,2024-10-13,1,1,7,8,HarEsB_T,"-37.81471642, 144.9446508"
77120250218,77,2025-02-18,1,7,5,12,HarEsP_T,"-37.81441438, 144.94433026"
291720240922,29,2024-09-22,17,331,382,713,AG_T,"-37.8199817, 144.96872865"
14620250201,14,2025-02-01,6,54,23,77,SanBri_T,"-37.82011242, 144.96291897"
14420240402,14,2024-04-02,4,16,2,18,SanBri_T,"-37.82011242, 144.96291897"
14720240413,14,2024-04-13,7,87,38,125,SanBri_T,"-37.82011242, 144.96291897"
141720250101,14,2025-01-01,17,447,143,590,SanBri_T,"-37.82011242, 144.96291897"
591720250212,59,2025-02-12,17,265,391,656,RMIT_T,"-37.80825648, 144.96304859"
401620241230,40,2024-12-30,16,82,107,189,Spr201_T,"-37.80999341, 144.97227587"
612320250906,61,2025-09-06,23,101,94,195,RMIT14_T,"-37.80767455, 144.96309114"
45320250222,45,2025-02-22,3,10,69,79,Swa148_T,"-37.81414075, 144.96609379"
211020250718,21,2025-07-18,10,160,152,312,Bourke155_T,"-37.81267313, 144.96788288"
1351120241225,135,2024-12-25,11,208,280,488,Spen161_T,"-37.8172861, 144.95319102"
133220241128,133,2024-11-28,2,15,5,20,Spen229_T,"-37.81531435, 144.95227769"
1331620250925,133,2025-09-25,16,555,623,1178,Spen229_T,"-37.81531435, 144.95227769"
182720251001,182,2025-10-01,7,55,86,141,King163_T,"-37.81627451, 144.95550503"
1791820241231,179,2024-12-31,18,90,109,199,Pow61_T,"-37.82392385, 144.96299677"
1420240515,1,2024-05-15,4,5,6,11,Bou292_T,"-37.81349441, 144.96515323"
631120250815,63,2025-08-15,11,265,320,585,Bou231_T,"-37.81333081, 144.96675571"
671120240407,67,2024-04-07,11,384,449,833,FLDegS_T,"-37.81688755, 144.96562569"
622320231222,62,2023-12-22,23,52,23,75,Lat224_T,"-37.80996494, 144.96216521"
11720250502,11,2025-05-02,7,55,39,94,WatCit_T,"-37.81564989, 144.93970694"
12220240812,12,2024-08-12,2,2,2,4,NewQ_T,"-37.81457988, 144.94292398"
12720241225,12,2024-12-25,7,39,34,73,NewQ_T,"-37.81457988, 144.94292398"
101420250916,10,2025-09-16,14,102,41,143,BouHbr_T,"-37.81876474, 144.94710545"
242320241025,24,2024-10-25,23,243,391,634,Col620_T,"-37.81887963, 144.95449198"
76820251007,76,2025-10-07,8,90,44,134,KenMac_T,"-37.79453803, 144.93036194"
721920250105,72,2025-01-05,19,71,134,205,ACMI_T,"-37.81726338, 144.96872809"
351820240216,35,2024-02-16,18,2711,1832,4543,SouthB_T,"-37.82018685, 144.96508508"
58620231031,58,2023-10-31,6,242,60,302,Bou688_T,"-37.81686075, 144.95358075"
58820250909,58,2025-09-09,8,1605,171,1776,Bou688_T,"-37.81686075, 144.95358075"
92220250407,9,2025-04-07,22,54,30,84,Col700_T,"-37.81982992, 144.95102555"
79720250912,79,2025-09-12,7,156,122,278,FliSS_T,"-37.81794046, 144.96616678"
791420250510,79,2025-05-10,14,715,535,1250,FliSS_T,"-37.81794046, 144.96616678"
201020240224,20,2024-02-24,10,168,116,284,LtB170_T,"-37.81172914, 144.9682466"
461720240914,46,2024-09-14,17,38,74,112,Pel147_T,"-37.80240719, 144.9615673"
46520240127,46,2024-01-27,5,0,1,1,Pel147_T,"-37.80240719, 144.9615673"
46020240603,46,2024-06-03,0,11,8,19,Pel147_T,"-37.80240719, 144.9615673"
23520250316,23,2025-03-16,5,6,25,31,Col623_T,"-37.81909256, 144.95452748"
231720240412,23,2024-04-12,17,282,712,994,Col623_T,"-37.81909256, 144.95452748"
1091120240124,109,2024-01-24,11,140,105,245,LatWill_T,"-37.81193681, 144.95621105"
1091820240210,109,2024-02-10,18,62,83,145,LatWill_T,"-37.81193681, 144.95621105"
491020250326,49,2025-03-26,10,155,275,430,Eli501_T,"-37.80730068, 144.95956055"
191020240701,19,2024-07-01,10,182,97,279,LtB210_T,"-37.81237202, 144.96550671"
140720250508,140,2025-05-08,7,89,19,108,Boyd2837_T,"-37.82590962, 144.96185972"
1851720250823,185,2025-08-23,17,906,670,1576,Eli197_T,"-37.81374643, 144.96276183"
162820241011,162,2024-10-11,8,253,178,431,Eli489_T,"-37.80740397, 144.95987909"
133120241021,133,2024-10-21,1,35,14,49,Spen229_T,"-37.81531435, 144.95227769"
124720231031,124,2023-10-31,7,1,0,1,BirBridge_T,"-37.81757416, 144.97329934"
1071320231019,107,2023-10-19,13,199,264,463,280Will_T,"-37.81246271, 144.95690188"
1181720250405,118,2025-04-05,17,43,34,77,Fli114C_T,"-37.81632783, 144.97090512"
17620231024,17,2023-10-24,6,124,43,167,Col15_T,"-37.81362543, 144.97323591"
18720250801,18,2025-08-01,7,34,233,267,Col12_T,"-37.81344862, 144.97305353"
62020240802,62,2024-08-02,0,67,55,122,Lat224_T,"-37.80996494, 144.96216521"
561020240215,56,2024-02-15,10,262,134,396,Lon364_T,"-37.81234775, 144.96153311"
86620250119,86,2025-01-19,6,3,5,8,574Qub_T,"-37.80309992, 144.94908064"
24220240429,24,2024-04-29,2,18,23,41,Col620_T,"-37.81887963, 144.95449198"
11920250126,11,2025-01-26,9,93,94,187,WatCit_T,"-37.81564989, 144.93970694"
58220231211,58,2023-12-11,2,20,24,44,Bou688_T,"-37.81686075, 144.95358075"
27920231226,27,2023-12-26,9,30,44,74,Vic_T,"-37.80606888, 144.95644692"
581720250521,58,2025-05-21,17,813,1237,2050,Bou688_T,"-37.81686075, 144.95358075"
53820240125,53,2024-01-25,8,314,295,609,Col254_T,"-37.81564191, 144.965499"
9120241112,9,2024-11-12,1,2,6,8,Col700_T,"-37.81982992, 144.95102555"
791020240624,79,2024-06-24,10,312,286,598,FliSS_T,"-37.81794046, 144.96616678"
512120231224,51,2023-12-24,21,36,50,86,Fra118_T,"-37.80841815, 144.95906316"
231720250310,23,2025-03-10,17,77,117,194,Col623_T,"-37.81909256, 144.95452748"
51020250107,51,2025-01-07,0,18,7,25,Fra118_T,"-37.80841815, 144.95906316"
23720250418,23,2025-04-18,7,46,50,96,Col623_T,"-37.81909256, 144.95452748"
201520240331,20,2024-03-31,15,219,321,540,LtB170_T,"-37.81172914, 144.9682466"
25220231223,25,2023-12-23,2,34,43,77,MCEC_T,"-37.82401776, 144.95604426"
46420240510,46,2024-05-10,4,0,2,2,Pel147_T,"-37.80240719, 144.9615673"
1362220231206,136,2023-12-06,22,9,170,179,BirFed1120_T,"-37.8184141, 144.97357915"
130320250623,130,2025-06-23,3,1,0,1,Bou892T,"-37.8204637, 144.94126826"
1641120241116,164,2024-11-16,11,108,55,163,Lat526_T,"-37.813005, 144.95160411"
1381220250628,138,2025-06-28,12,5,8,13,EntPark1671_T,"-37.81996544, 144.95981454"
1171720240329,117,2024-03-29,17,223,244,467,Fli114F_T,"-37.81629332, 144.97090877"
1092320250123,109,2025-01-23,23,40,45,85,LatWill_T,"-37.81193681, 144.95621105"
6120240706,6,2024-07-06,1,133,113,246,FliS_T,"-37.81911705, 144.96558255"
84820240209,84,2024-02-09,8,1129,378,1507,ElFi_T,"-37.81798049, 144.96503383"
841420250416,84,2025-04-16,14,999,1452,2451,ElFi_T,"-37.81798049, 144.96503383"
4820241214,4,2024-12-14,8,293,206,499,Swa123_T,"-37.81487988, 144.9660878"
39620250718,39,2025-07-18,6,7,0,7,AlfPl_T,"-37.81379749, 144.96995745"
8120231024,8,2023-10-24,1,1,3,4,WebBN_T,"-37.82293543, 144.9471751"
411020250710,41,2025-07-10,10,1212,647,1859,Swa31,"-37.81668634, 144.96689733"
78020240606,78,2024-06-06,0,1,1,2,HarEsB_T,"-37.81471642, 144.9446508"
781020241030,78,2024-10-30,10,37,46,83,HarEsB_T,"-37.81471642, 144.9446508"
78120250313,78,2025-03-13,1,6,2,8,HarEsB_T,"-37.81471642, 144.9446508"
78220240115,78,2024-01-15,2,0,3,3,HarEsB_T,"-37.81471642, 144.9446508"
65020240619,65,2024-06-19,0,13,12,25,SwaCs_T,"-37.81569416, 144.9668064"
71820240306,71,2024-03-06,8,22,18,40,WestWP_T,"-37.81235775, 144.97136962"
71320240505,71,2024-05-05,3,1,1,2,WestWP_T,"-37.81235775, 144.97136962"
28820240626,28,2024-06-26,8,578,263,841,VAC_T,"-37.82129925, 144.96879309"
28520241213,28,2024-12-13,5,38,28,66,VAC_T,"-37.82129925, 144.96879309"
282220241215,28,2024-12-15,22,251,483,734,VAC_T,"-37.82129925, 144.96879309"
281820240125,28,2024-01-25,18,784,438,1222,VAC_T,"-37.82129925, 144.96879309"
402320240911,40,2024-09-11,23,31,15,46,Spr201_T,"-37.80999341, 144.97227587"
211720250209,21,2025-02-09,17,355,305,660,Bourke155_T,"-37.81267313, 144.96788288"
1392220250921,139,2025-09-21,22,3,6,9,Signal1647_T,"-37.81959923, 144.9632832"
1382320240217,138,2024-02-17,23,0,1,1,EntPark1671_T,"-37.81996544, 144.95981454"
1171720240515,117,2024-05-15,17,194,524,718,Fli114F_T,"-37.81629332, 144.97090877"
6720250625,6,2025-06-25,7,402,789,1191,FliS_T,"-37.81911705, 144.96558255"
3120250521,3,2025-05-21,1,61,30,91,Swa295_T,"-37.81101524, 144.96429485"
751020240210,75,2024-02-10,10,27,24,51,SprFli_T,"-37.81515276, 144.97467661"
391820240221,39,2024-02-21,18,201,112,313,AlfPl_T,"-37.81379749, 144.96995745"
81720240713,8,2024-07-13,17,124,148,272,WebBN_T,"-37.82293543, 144.9471751"
421520250430,42,2025-04-30,15,275,401,676,UM1_T,"-37.80008566, 144.96386412"
291620250702,29,2025-07-02,16,429,218,647,AG_T,"-37.8199817, 144.96872865"
712020250618,71,2025-06-18,20,9,12,21,WestWP_T,"-37.81235775, 144.97136962"
591120240609,59,2024-06-09,11,323,300,623,RMIT_T,"-37.80825648, 144.96304859"
65220240718,65,2024-07-18,2,7,7,14,SwaCs_T,"-37.81569416, 144.9668064"
40720250315,40,2025-03-15,7,26,38,64,Spr201_T,"-37.80999341, 144.97227587"
21620250403,21,2025-04-03,6,9,19,28,Bourke155_T,"-37.81267313, 144.96788288"
21320250409,21,2025-04-09,3,5,11,16,Bourke155_T,"-37.81267313, 144.96788288"
361620240826,36,2024-08-26,16,187,175,362,Que85_T,"-37.81652527, 144.96121062"
471620240802,47,2024-08-02,16,1072,957,2029,Eli250_T,"-37.81258467, 144.9625775"
611020240222,61,2024-02-22,10,393,564,957,RMIT14_T,"-37.80767455, 144.96309114"
501420240422,50,2024-04-22,14,209,163,372,Lyg309_T,"-37.79808192, 144.96721013"
501620241005,50,2024-10-05,16,243,222,465,Lyg309_T,"-37.79808192, 144.96721013"
44120240426,44,2024-04-26,1,2,0,2,UM3_T,"-37.79698741, 144.96441306"
451220250622,45,2025-06-22,12,658,846,1504,Swa148_T,"-37.81414075, 144.96609379"
451720240303,45,2024-03-03,17,504,835,1339,Swa148_T,"-37.81414075, 144.96609379"
68020241230,68,2024-12-30,0,7,6,13,FLDegN_T,"-37.8168479, 144.96559789"
851520240117,85,2024-01-17,15,77,60,137,488Mac_T,"-37.79432415, 144.92973378"
171220240601,17,2024-06-01,12,194,179,373,Col15_T,"-37.81362543, 144.97323591"
17720240820,17,2024-08-20,7,451,87,538,Col15_T,"-37.81362543, 144.97323591"
181020240721,18,2024-07-21,10,58,62,120,Col12_T,"-37.81344862, 144.97305353"
631220240706,63,2024-07-06,12,342,380,722,Bou231_T,"-37.81333081, 144.96675571"
11820250308,1,2025-03-08,18,1493,922,2415,Bou292_T,"-37.81349441, 144.96515323"
622020250424,62,2025-04-24,20,240,196,436,Lat224_T,"-37.80996494, 144.96216521"
111220241130,11,2024-11-30,12,72,38,110,WatCit_T,"-37.81564989, 144.93970694"
111220241217,11,2024-12-17,12,127,158,285,WatCit_T,"-37.81564989, 144.93970694"
121120250113,12,2025-01-13,11,129,158,287,NewQ_T,"-37.81457988, 144.94292398"
761820250909,76,2025-09-09,18,42,42,84,KenMac_T,"-37.79453803, 144.93036194"
76620240501,76,2024-05-01,6,12,16,28,KenMac_T,"-37.79453803, 144.93036194"
722320250221,72,2025-02-21,23,168,227,395,ACMI_T,"-37.81726338, 144.96872809"
2420250327,2,2025-03-27,4,3,9,12,Bou283_T,"-37.81380668, 144.96516718"
22320240402,2,2024-04-02,23,15,43,58,Bou283_T,"-37.81380668, 144.96516718"
35620250513,35,2025-05-13,6,201,193,394,SouthB_T,"-37.82018685, 144.96508508"
9720241026,9,2024-10-26,7,29,28,57,Col700_T,"-37.81982992, 144.95102555"
791720231105,79,2023-11-05,17,551,429,980,FliSS_T,"-37.81794046, 144.96616678"
301320231220,30,2023-12-20,13,310,441,751,Lon189_T,"-37.8112185, 144.96656806"
521220250123,52,2025-01-23,12,427,342,769,Eli263_T,"-37.81252157, 144.9619401"
511520250206,51,2025-02-06,15,71,54,125,Fra118_T,"-37.80841815, 144.95906316"
23320240710,23,2024-07-10,3,7,3,10,Col623_T,"-37.81909256, 144.95452748"
491620250210,49,2025-02-10,16,188,174,362,Eli501_T,"-37.80730068, 144.95956055"
251620250731,25,2025-07-31,16,580,452,1032,MCEC_T,"-37.82401776, 144.95604426"
1351520241128,135,2024-11-28,15,442,432,874,Spen161_T,"-37.8172861, 144.95319102"
1331020250205,133,2025-02-05,10,376,336,712,Spen229_T,"-37.81531435, 144.95227769"
133720250304,133,2025-03-04,7,702,394,1096,Spen229_T,"-37.81531435, 144.95227769"
1332220240218,133,2024-02-18,22,294,204,498,Spen229_T,"-37.81531435, 144.95227769"
118720240425,118,2024-04-25,7,0,2,2,Fli114C_T,"-37.81632783, 144.97090512"
851520240923,85,2024-09-23,15,58,72,130,488Mac_T,"-37.79432415, 144.92973378"
17020240608,17,2024-06-08,0,11,9,20,Col15_T,"-37.81362543, 144.97323591"
11820240502,1,2024-05-02,18,995,727,1722,Bou292_T,"-37.81349441, 144.96515323"
11920241021,1,2024-10-21,19,587,390,977,Bou292_T,"-37.81349441, 144.96515323"
182320241017,18,2024-10-17,23,4,12,16,Col12_T,"-37.81344862, 144.97305353"
18020240201,18,2024-02-01,0,0,2,2,Col12_T,"-37.81344862, 144.97305353"
56520231102,56,2023-11-02,5,12,9,21,Lon364_T,"-37.81234775, 144.96153311"
861420250226,86,2025-02-26,14,23,44,67,574Qub_T,"-37.80309992, 144.94908064"
11620251001,11,2025-10-01,6,31,29,60,WatCit_T,"-37.81564989, 144.93970694"
762120251012,76,2025-10-12,21,5,14,19,KenMac_T,"-37.79453803, 144.93036194"
761920250511,76,2025-05-11,19,11,18,29,KenMac_T,"-37.79453803, 144.93036194"
9720240619,9,2024-06-19,7,60,1297,1357,Col700_T,"-37.81982992, 144.95102555"
532120231227,53,2023-12-27,21,178,242,420,Col254_T,"-37.81564191, 144.965499"
531520240608,53,2024-06-08,15,997,701,1698,Col254_T,"-37.81564191, 144.965499"
791920250428,79,2025-04-28,19,216,218,434,FliSS_T,"-37.81794046, 144.96616678"
79520241021,79,2024-10-21,5,25,15,40,FliSS_T,"-37.81794046, 144.96616678"
23520240626,23,2024-06-26,5,33,21,54,Col623_T,"-37.81909256, 144.95452748"
109420250914,109,2025-09-14,4,2,8,10,LatWill_T,"-37.81193681, 144.95621105"
117320231024,117,2023-10-24,3,0,1,1,Fli114F_T,"-37.81629332, 144.97090877"
251120250221,25,2025-02-21,11,381,653,1034,MCEC_T,"-37.82401776, 144.95604426"
20520250715,20,2025-07-15,5,2,2,4,LtB170_T,"-37.81172914, 144.9682466"
1412120250916,141,2025-09-16,21,53,59,112,474Fl_T,"-37.81997273, 144.95834911"
137820231216,137,2023-12-16,8,9,7,16,BouHbr2353_T,"-37.81894815, 144.94612292"
139820251004,139,2025-10-04,8,22,41,63,Signal1647_T,"-37.81959923, 144.9632832"
1421120250129,142,2025-01-29,11,361,293,654,Hammer1584_T,"-37.81970749, 144.96795734"
1301320240109,130,2024-01-09,13,45,34,79,Bou892T,"-37.8204637, 144.94126826"
164220250504,164,2025-05-04,2,1,8,9,Lat526_T,"-37.813005, 144.95160411"
1382020240210,138,2024-02-10,20,7,15,22,EntPark1671_T,"-37.81996544, 144.95981454"
1611320241103,161,2024-11-03,13,347,179,526,BirArt1109_T,"-37.81851276, 144.97131336"
1171220240122,117,2024-01-22,12,224,245,469,Fli114F_T,"-37.81629332, 144.97090877"
66320250504,66,2025-05-04,3,88,56,144,QVN_T,"-37.81057846, 144.96444294"
842120240115,84,2024-01-15,21,683,723,1406,ElFi_T,"-37.81798049, 144.96503383"
84520241205,84,2024-12-05,5,64,54,118,ElFi_T,"-37.81798049, 144.96503383"
4820240313,4,2024-03-13,8,651,296,947,Swa123_T,"-37.81487988, 144.9660878"
702020250207,70,2025-02-07,20,130,138,268,Errol20_T,"-37.80456984, 144.94946228"
751620250922,75,2025-09-22,16,58,45,103,SprFli_T,"-37.81515276, 144.97467661"
42720240628,42,2024-06-28,7,26,30,56,UM1_T,"-37.80008566, 144.96386412"
422320240914,42,2024-09-14,23,24,51,75,UM1_T,"-37.80008566, 144.96386412"
78020240202,78,2024-02-02,0,3,9,12,HarEsB_T,"-37.81471642, 144.9446508"
781220240422,78,2024-04-22,12,34,44,78,HarEsB_T,"-37.81471642, 144.9446508"
592320240305,59,2024-03-05,23,191,114,305,RMIT_T,"-37.80825648, 144.96304859"
541520240102,54,2024-01-02,15,82,74,156,Swa607_T,"-37.804024, 144.96308399"
54520240628,54,2024-06-28,5,6,11,17,Swa607_T,"-37.804024, 144.96308399"
281120240203,28,2024-02-03,11,574,640,1214,VAC_T,"-37.82129925, 144.96879309"
29320241120,29,2024-11-20,3,10,8,18,AG_T,"-37.8199817, 144.96872865"
29720251011,29,2025-10-11,7,88,161,249,AG_T,"-37.8199817, 144.96872865"
47520240623,47,2024-06-23,5,21,44,65,Eli250_T,"-37.81258467, 144.9625775"
40820250522,40,2025-05-22,8,268,338,606,Spr201_T,"-37.80999341, 144.97227587"
40220231130,40,2023-11-30,2,7,2,9,Spr201_T,"-37.80999341, 144.97227587"
311720241012,31,2024-10-12,17,358,230,588,Lyg161_T,"-37.80169681, 144.96658911"
54720250922,54,2025-09-22,7,55,15,70,Swa607_T,"-37.804024, 144.96308399"
1411020250322,141,2025-03-22,10,107,111,218,474Fl_T,"-37.81997273, 144.95834911"
1411520250514,141,2025-05-14,15,180,89,269,474Fl_T,"-37.81997273, 144.95834911"
137020240503,137,2024-05-03,0,0,1,1,BouHbr2353_T,"-37.81894815, 144.94612292"
1421120250629,142,2025-06-29,11,440,300,740,Hammer1584_T,"-37.81970749, 144.96795734"
1231620241015,123,2024-10-15,16,9,1,10,BirBridge_T,"-37.81753741, 144.97329734"
134720241209,134,2024-12-09,7,371,294,665,Spen201_T,"-37.81694221, 144.95303935"
134020250522,134,2025-05-22,0,31,55,86,Spen201_T,"-37.81694221, 144.95303935"
135020250114,135,2025-01-14,0,30,49,79,Spen161_T,"-37.8172861, 144.95319102"
1352020250313,135,2025-03-13,20,272,301,573,Spen161_T,"-37.8172861, 144.95319102"
135720240803,135,2024-08-03,7,57,65,122,Spen161_T,"-37.8172861, 144.95319102"
1081720240806,108,2024-08-06,17,470,220,690,261Will_T,"-37.81295822, 144.95678789"
172120250527,17,2025-05-27,21,49,113,162,Col15_T,"-37.81362543, 144.97323591"
671320240611,67,2024-06-11,13,375,517,892,FLDegS_T,"-37.81688755, 144.96562569"
681720250408,68,2025-04-08,17,388,271,659,FLDegN_T,"-37.8168479, 144.96559789"
56620240314,56,2024-03-14,6,33,25,58,Lon364_T,"-37.81234775, 144.96153311"
561820240518,56,2024-05-18,18,417,397,814,Lon364_T,"-37.81234775, 144.96153311"
561120250227,56,2025-02-27,11,296,215,511,Lon364_T,"-37.81234775, 144.96153311"
861720231223,86,2023-12-23,17,13,20,33,574Qub_T,"-37.80309992, 144.94908064"
862120250618,86,2025-06-18,21,6,18,24,574Qub_T,"-37.80309992, 144.94908064"
111920240328,11,2024-03-28,19,99,122,221,WatCit_T,"-37.81564989, 144.93970694"
12820240501,12,2024-05-01,8,136,112,248,NewQ_T,"-37.81457988, 144.94292398"
10820250112,10,2025-01-12,8,7,20,27,BouHbr_T,"-37.81876474, 144.94710545"
58520250319,58,2025-03-19,5,96,29,125,Bou688_T,"-37.81686075, 144.95358075"
2520231209,2,2023-12-09,5,3,8,11,Bou283_T,"-37.81380668, 144.96516718"
35620250509,35,2025-05-09,6,199,208,407,SouthB_T,"-37.82018685, 144.96508508"
91120231214,9,2023-12-14,11,354,457,811,Col700_T,"-37.81982992, 144.95102555"
271820250602,27,2025-06-02,18,102,43,145,Vic_T,"-37.80606888, 144.95644692"
792020250819,79,2025-08-19,20,190,242,432,FliSS_T,"-37.81794046, 144.96616678"
301820240427,30,2024-04-27,18,518,535,1053,Lon189_T,"-37.8112185, 144.96656806"
251620240911,25,2024-09-11,16,2,7,9,MCEC_T,"-37.82401776, 144.95604426"
522220251006,52,2025-10-06,22,59,120,179,Eli263_T,"-37.81252157, 144.9619401"
201620240107,20,2024-01-07,16,115,121,236,LtB170_T,"-37.81172914, 144.9682466"
52820241112,52,2024-11-12,8,148,308,456,Eli263_T,"-37.81252157, 144.9619401"
461720240828,46,2024-08-28,17,87,149,236,Pel147_T,"-37.80240719, 144.9615673"
512320241125,51,2024-11-25,23,15,14,29,Fra118_T,"-37.80841815, 144.95906316"
231620250525,23,2025-05-25,16,109,248,357,Col623_T,"-37.81909256, 144.95452748"
25320250731,25,2025-07-31,3,4,6,10,MCEC_T,"-37.82401776, 144.95604426"
481920240810,48,2024-08-10,19,143,147,290,QVMQ_T,"-37.80631581, 144.95866697"
461920250423,46,2025-04-23,19,3,0,3,Pel147_T,"-37.80240719, 144.9615673"
1371120231123,137,2023-11-23,11,24,82,106,BouHbr2353_T,"-37.81894815, 144.94612292"
1361020250515,136,2025-05-15,10,242,33,275,BirFed1120_T,"-37.8184141, 144.97357915"
1642220250327,164,2025-03-27,22,141,51,192,Lat526_T,"-37.813005, 144.95160411"
1641120250503,164,2025-05-03,11,132,54,186,Lat526_T,"-37.813005, 144.95160411"
1382220241105,138,2024-11-05,22,0,2,2,EntPark1671_T,"-37.81996544, 144.95981454"
109420250910,109,2025-09-10,4,0,1,1,LatWill_T,"-37.81193681, 144.95621105"
67520250915,67,2025-09-15,5,15,12,27,FLDegS_T,"-37.81688755, 144.96562569"
851720240429,85,2024-04-29,17,64,98,162,488Mac_T,"-37.79432415, 144.92973378"
171420240902,17,2024-09-02,14,200,194,394,Col15_T,"-37.81362543, 144.97323591"
45520250306,45,2025-03-06,5,12,22,34,Swa148_T,"-37.81414075, 144.96609379"
51220250911,5,2025-09-11,12,962,802,1764,PriNW_T,"-37.81874249, 144.96787656"
21020250719,21,2025-07-19,0,162,106,268,Bourke155_T,"-37.81267313, 144.96788288"
107620240516,107,2024-05-16,6,12,26,38,280Will_T,"-37.81246271, 144.95690188"
502120250114,50,2025-01-14,21,167,98,265,Lyg309_T,"-37.79808192, 144.96721013"
432220231113,43,2023-11-13,22,12,18,30,UM2_T,"-37.79844526, 144.96411782"
44720231102,44,2023-11-02,7,2,17,19,UM3_T,"-37.79698741, 144.96441306"
70320231209,70,2023-12-09,3,0,3,3,Errol20_T,"-37.80456984, 144.94946228"
166520251012,166,2025-10-12,5,2,2,4,Spen484_T,"-37.80896733, 144.94931703"
1671320250329,167,2025-03-29,13,60,107,167,Lat526_T,"-37.81304149, 144.95155955"
1401120251012,140,2025-10-12,11,171,72,243,Boyd2837_T,"-37.82590962, 144.96185972"
131020240914,131,2024-09-14,0,121,66,187,King2_T,"-37.82009057, 144.95758725"
1431720250828,143,2025-08-28,17,298,297,595,Spencer_T,"-37.821728, 144.95557015"
1431920240819,143,2024-08-19,19,90,165,255,Spencer_T,"-37.821728, 144.95557015"
132620240826,132,2024-08-26,6,17,17,34,King335_T,"-37.81267639, 144.95386444"
135520250611,135,2025-06-11,5,28,23,51,Spen161_T,"-37.8172861, 144.95319102"
1332220240709,133,2024-07-09,22,132,105,237,Spen229_T,"-37.81531435, 144.95227769"
133720240124,133,2024-01-24,7,691,436,1127,Spen229_T,"-37.81531435, 144.95227769"
1181020241204,118,2024-12-04,10,19,14,33,Fli114C_T,"-37.81632783, 144.97090512"
671320250305,67,2025-03-05,13,645,795,1440,FLDegS_T,"-37.81688755, 144.96562569"
67820231127,67,2023-11-27,8,104,143,247,FLDegS_T,"-37.81688755, 144.96562569"
851920250523,85,2025-05-23,19,58,68,126,488Mac_T,"-37.79432415, 144.92973378"
181020231019,18,2023-10-19,10,224,316,540,Col12_T,"-37.81344862, 144.97305353"
62520241228,62,2024-12-28,5,7,3,10,Lat224_T,"-37.80996494, 144.96216521"
622320250518,62,2025-05-18,23,67,50,117,Lat224_T,"-37.80996494, 144.96216521"
12420240229,12,2024-02-29,4,2,8,10,NewQ_T,"-37.81457988, 144.94292398"
242020250906,24,2025-09-06,20,299,349,648,Col620_T,"-37.81887963, 144.95449198"
722320250208,72,2025-02-08,23,112,144,256,ACMI_T,"-37.81726338, 144.96872809"
58820240705,58,2024-07-05,8,1200,166,1366,Bou688_T,"-37.81686075, 144.95358075"
351120240811,35,2024-08-11,11,1691,1198,2889,SouthB_T,"-37.82018685, 144.96508508"
30620250329,30,2025-03-29,6,41,82,123,Lon189_T,"-37.8112185, 144.96656806"
791920250110,79,2025-01-10,19,713,419,1132,FliSS_T,"-37.81794046, 144.96616678"
79420240315,79,2024-03-15,4,21,24,45,FliSS_T,"-37.81794046, 144.96616678"
531020250413,53,2025-04-13,10,499,304,803,Col254_T,"-37.81564191, 144.965499"
231920250127,23,2025-01-27,19,72,94,166,Col623_T,"-37.81909256, 144.95452748"
51920240109,51,2024-01-09,9,85,73,158,Fra118_T,"-37.80841815, 144.95906316"
46820231217,46,2023-12-17,8,14,10,24,Pel147_T,"-37.80240719, 144.9615673"
46620241011,46,2024-10-11,6,6,4,10,Pel147_T,"-37.80240719, 144.9615673"
491920240816,49,2024-08-16,19,202,193,395,Eli501_T,"-37.80730068, 144.95956055"
492120250621,49,2025-06-21,21,162,104,266,Eli501_T,"-37.80730068, 144.95956055"
1411120250201,141,2025-02-01,11,173,101,274,474Fl_T,"-37.81997273, 144.95834911"
1372120231104,137,2023-11-04,21,4,4,8,BouHbr2353_T,"-37.81894815, 144.94612292"
1372320231222,137,2023-12-22,23,4,4,8,BouHbr2353_T,"-37.81894815, 144.94612292"
141520240205,141,2024-02-05,5,12,6,18,474Fl_T,"-37.81997273, 144.95834911"
21220250518,21,2025-05-18,2,139,106,245,Bourke155_T,"-37.81267313, 144.96788288"
362320250217,36,2025-02-17,23,21,12,33,Que85_T,"-37.81652527, 144.96121062"
872320240223,87,2024-02-23,23,28,14,42,Errol23_T,"-37.80454949, 144.94921863"
431720240113,43,2024-01-13,17,54,38,92,UM2_T,"-37.79844526, 144.96411782"
44820241007,44,2024-10-07,8,56,62,118,UM3_T,"-37.79698741, 144.96441306"
1661320250131,166,2025-01-31,13,66,57,123,Spen484_T,"-37.80896733, 144.94931703"
131920250416,131,2025-04-16,9,98,133,231,King2_T,"-37.82009057, 144.95758725"
132320241010,132,2024-10-10,3,9,5,14,King335_T,"-37.81267639, 144.95386444"
1321520250710,132,2025-07-10,15,131,137,268,King335_T,"-37.81267639, 144.95386444"
134920240328,134,2024-03-28,9,268,362,630,Spen201_T,"-37.81694221, 144.95303935"
1171020250119,117,2025-01-19,10,217,266,483,Fli114F_T,"-37.81629332, 144.97090877"
123620250129,123,2025-01-29,6,17,16,33,BirBridge_T,"-37.81753741, 144.97329734"
69920250309,69,2025-03-09,9,115,86,201,FLDegC_T,"-37.81687226, 144.96559144"
41820240804,4,2024-08-04,18,822,627,1449,Swa123_T,"-37.81487988, 144.9660878"
42120250101,4,2025-01-01,21,688,636,1324,Swa123_T,"-37.81487988, 144.9660878"
4820251016,4,2025-10-16,8,711,426,1137,Swa123_T,"-37.81487988, 144.9660878"
70420241108,70,2024-11-08,4,1,4,5,Errol20_T,"-37.80456984, 144.94946228"
3520241102,3,2024-11-02,5,23,10,33,Swa295_T,"-37.81101524, 144.96429485"
39420250423,39,2025-04-23,4,4,0,4,AlfPl_T,"-37.81379749, 144.96995745"
391420250430,39,2025-04-30,14,79,121,200,AlfPl_T,"-37.81379749, 144.96995745"
391620250724,39,2025-07-24,16,74,64,138,AlfPl_T,"-37.81379749, 144.96995745"
41720250321,41,2025-03-21,7,702,306,1008,Swa31,"-37.81668634, 144.96689733"
781520251002,78,2025-10-02,15,31,72,103,HarEsB_T,"-37.81471642, 144.9446508"
781820231122,78,2023-11-22,18,30,113,143,HarEsB_T,"-37.81471642, 144.9446508"
592020250214,59,2025-02-14,20,131,122,253,RMIT_T,"-37.80825648, 144.96304859"
422120240913,42,2024-09-13,21,38,125,163,UM1_T,"-37.80008566, 144.96386412"
14420241129,14,2024-11-29,4,29,3,32,SanBri_T,"-37.82011242, 144.96291897"
71720250211,71,2025-02-11,7,8,10,18,WestWP_T,"-37.81235775, 144.97136962"
711920250314,71,2025-03-14,19,9,16,25,WestWP_T,"-37.81235775, 144.97136962"
471020241118,47,2024-11-18,10,381,543,924,Eli250_T,"-37.81258467, 144.9625775"
40220250430,40,2025-04-30,2,5,0,5,Spr201_T,"-37.80999341, 144.97227587"
21920240517,21,2024-05-17,9,114,98,212,Bourke155_T,"-37.81267313, 144.96788288"
371920250711,37,2025-07-11,19,150,112,262,Lyg260_T,"-37.80107122, 144.96704554"
37520240706,37,2024-07-06,5,0,6,6,Lyg260_T,"-37.80107122, 144.96704554"
108620240612,108,2024-06-12,6,5,166,171,261Will_T,"-37.81295822, 144.95678789"
681220240208,68,2024-02-08,12,381,334,715,FLDegN_T,"-37.8168479, 144.96559789"
66920250417,66,2025-04-17,9,445,449,894,QVN_T,"-37.81057846, 144.96444294"
69020240425,69,2024-04-25,0,6,5,11,FLDegC_T,"-37.81687226, 144.96559144"
84820240110,84,2024-01-10,8,1281,384,1665,ElFi_T,"-37.81798049, 144.96503383"
39820250923,39,2025-09-23,8,105,127,232,AlfPl_T,"-37.81379749, 144.96995745"
412220250502,41,2025-05-02,22,512,868,1380,Swa31,"-37.81668634, 144.96689733"
42920240916,42,2024-09-16,9,385,103,488,UM1_T,"-37.80008566, 144.96386412"
281320250704,28,2025-07-04,13,612,646,1258,VAC_T,"-37.82129925, 144.96879309"
471220231121,47,2023-11-21,12,830,923,1753,Eli250_T,"-37.81258467, 144.9625775"
131220240818,131,2024-08-18,2,40,103,143,King2_T,"-37.82009057, 144.95758725"
1341920240708,134,2024-07-08,19,207,247,454,Spen201_T,"-37.81694221, 144.95303935"
1341120240812,134,2024-08-12,11,281,329,610,Spen201_T,"-37.81694221, 144.95303935"
1081820241102,108,2024-11-02,18,95,129,224,261Will_T,"-37.81295822, 144.95678789"
134720241113,134,2024-11-13,7,354,291,645,Spen201_T,"-37.81694221, 144.95303935"
134520250415,134,2025-04-15,5,52,51,103,Spen201_T,"-37.81694221, 144.95303935"
1351620251011,135,2025-10-11,16,473,480,953,Spen161_T,"-37.8172861, 144.95319102"
841620240217,84,2024-02-17,16,1265,2128,3393,ElFi_T,"-37.81798049, 144.96503383"
841520250729,84,2025-07-29,15,795,1303,2098,ElFi_T,"-37.81798049, 144.96503383"
31820231019,3,2023-10-19,18,1211,1394,2605,Swa295_T,"-37.81101524, 144.96429485"
701320241130,70,2024-11-30,13,122,144,266,Errol20_T,"-37.80456984, 144.94946228"
752120231230,75,2023-12-30,21,4,4,8,SprFli_T,"-37.81515276, 144.97467661"
311120240407,31,2024-04-07,11,156,120,276,Lyg161_T,"-37.80169681, 144.96658911"
472020250820,47,2025-08-20,20,606,499,1105,Eli250_T,"-37.81258467, 144.9625775"
31720250115,31,2025-01-15,7,25,31,56,Lyg161_T,"-37.80169681, 144.96658911"
312320250416,31,2025-04-16,23,20,48,68,Lyg161_T,"-37.80169681, 144.96658911"
441420240514,44,2024-05-14,14,119,101,220,UM3_T,"-37.79698741, 144.96441306"
451720240307,45,2024-03-07,17,787,1253,2040,Swa148_T,"-37.81414075, 144.96609379"
1401620240907,140,2024-09-07,16,93,101,194,Boyd2837_T,"-37.82590962, 144.96185972"
162720250210,162,2025-02-10,7,110,79,189,Eli489_T,"-37.80740397, 144.95987909"
762220240827,76,2024-08-27,22,2,1,3,KenMac_T,"-37.79453803, 144.93036194"
91620231107,9,2023-11-07,16,199,85,284,Col700_T,"-37.81982992, 144.95102555"
791520240319,79,2024-03-19,15,484,423,907,FliSS_T,"-37.81794046, 144.96616678"
201920240826,20,2024-08-26,19,190,239,429,LtB170_T,"-37.81172914, 144.9682466"
1172120241025,117,2024-10-25,21,184,132,316,Fli114F_T,"-37.81629332, 144.97090877"
117820250906,117,2025-09-06,8,53,44,97,Fli114F_T,"-37.81629332, 144.97090877"
492220250905,49,2025-09-05,22,171,138,309,Eli501_T,"-37.80730068, 144.95956055"
49620250329,49,2025-03-29,6,48,41,89,Eli501_T,"-37.80730068, 144.95956055"
141820250804,141,2025-08-04,8,109,164,273,474Fl_T,"-37.81997273, 144.95834911"
1391020250424,139,2025-04-24,10,48,63,111,Signal1647_T,"-37.81959923, 144.9632832"
61220250310,6,2025-03-10,12,780,833,1613,FliS_T,"-37.81911705, 144.96558255"
842120240503,84,2024-05-03,21,707,1179,1886,ElFi_T,"-37.81798049, 144.96503383"
84820250228,84,2025-02-28,8,1316,402,1718,ElFi_T,"-37.81798049, 144.96503383"
841320251015,84,2025-10-15,13,1116,1276,2392,ElFi_T,"-37.81798049, 144.96503383"
41820241106,4,2024-11-06,18,1421,1052,2473,Swa123_T,"-37.81487988, 144.9660878"
702020231216,70,2023-12-16,20,142,185,327,Errol20_T,"-37.80456984, 144.94946228"
8320241230,8,2024-12-30,3,0,1,1,WebBN_T,"-37.82293543, 144.9471751"
411220240831,41,2024-08-31,12,369,343,712,Swa31,"-37.81668634, 144.96689733"
41720240411,41,2024-04-11,7,842,282,1124,Swa31,"-37.81668634, 144.96689733"
771520241130,77,2024-11-30,15,178,234,412,HarEsP_T,"-37.81441438, 144.94433026"
782120250711,78,2025-07-11,21,16,206,222,HarEsB_T,"-37.81471642, 144.9446508"
77920231020,77,2023-10-20,9,109,134,243,HarEsP_T,"-37.81441438, 144.94433026"
711920250720,71,2025-07-20,19,7,4,11,WestWP_T,"-37.81235775, 144.97136962"
652020240601,65,2024-06-01,20,254,362,616,SwaCs_T,"-37.81569416, 144.9668064"
281220241219,28,2024-12-19,12,810,868,1678,VAC_T,"-37.82129925, 144.96879309"
401520241231,40,2024-12-31,15,100,130,230,Spr201_T,"-37.80999341, 144.97227587"
401920240902,40,2024-09-02,19,55,52,107,Spr201_T,"-37.80999341, 144.97227587"
37520250816,37,2025-08-16,5,0,12,12,Lyg260_T,"-37.80107122, 144.96704554"
47420240912,47,2024-09-12,4,10,22,32,Eli250_T,"-37.81258467, 144.9625775"
472220241014,47,2024-10-14,22,231,168,399,Eli250_T,"-37.81258467, 144.9625775"
47920240413,47,2024-04-13,9,320,419,739,Eli250_T,"-37.81258467, 144.9625775"
452020240427,45,2024-04-27,20,688,1007,1695,Swa148_T,"-37.81414075, 144.96609379"
45320250501,45,2025-05-01,3,5,19,24,Swa148_T,"-37.81414075, 144.96609379"
51720250103,5,2025-01-03,17,1724,1423,3147,PriNW_T,"-37.81874249, 144.96787656"
5020250311,5,2025-03-11,0,79,63,142,PriNW_T,"-37.81874249, 144.96787656"
21620240224,21,2024-02-24,6,27,36,63,Bourke155_T,"-37.81267313, 144.96788288"
211820240429,21,2024-04-29,18,378,406,784,Bourke155_T,"-37.81267313, 144.96788288"
1081620240907,108,2024-09-07,16,111,144,255,261Will_T,"-37.81295822, 144.95678789"
871220240924,87,2024-09-24,12,152,112,264,Errol23_T,"-37.80454949, 144.94921863"
612220250828,61,2025-08-28,22,206,112,318,RMIT14_T,"-37.80767455, 144.96309114"
1841420250728,184,2025-07-28,14,821,866,1687,Eli124_T,"-37.81512416, 144.96371988"
1401620241017,140,2024-10-17,16,83,102,185,Boyd2837_T,"-37.82590962, 144.96185972"
66420250901,66,2025-09-01,4,15,4,19,QVN_T,"-37.81057846, 144.96444294"
69420240813,69,2024-08-13,4,1,2,3,FLDegC_T,"-37.81687226, 144.96559144"
672120241212,67,2024-12-12,21,253,450,703,FLDegS_T,"-37.81688755, 144.96562569"
171320240201,17,2024-02-01,13,808,733,1541,Col15_T,"-37.81362543, 144.97323591"
171720241205,17,2024-12-05,17,260,583,843,Col15_T,"-37.81362543, 144.97323591"
1420231220,1,2023-12-20,4,3,6,9,Bou292_T,"-37.81349441, 144.96515323"
181020250622,18,2025-06-22,10,81,54,135,Col12_T,"-37.81344862, 144.97305353"
621720251006,62,2025-10-06,17,339,333,672,Lat224_T,"-37.80996494, 144.96216521"
63920231109,63,2023-11-09,9,151,180,331,Bou231_T,"-37.81333081, 144.96675571"
111920250504,11,2025-05-04,19,105,96,201,WatCit_T,"-37.81564989, 144.93970694"
561420240617,56,2024-06-17,14,298,275,573,Lon364_T,"-37.81234775, 144.96153311"
241420240513,24,2024-05-13,14,478,777,1255,Col620_T,"-37.81887963, 144.95449198"
24820250109,24,2025-01-09,8,1698,265,1963,Col620_T,"-37.81887963, 144.95449198"
761620240702,76,2024-07-02,16,50,45,95,KenMac_T,"-37.79453803, 144.93036194"
2220240526,2,2024-05-26,2,19,91,110,Bou283_T,"-37.81380668, 144.96516718"
58620240520,58,2024-05-20,6,163,49,212,Bou688_T,"-37.81686075, 144.95358075"
27720241210,27,2024-12-10,7,27,45,72,Vic_T,"-37.80606888, 144.95644692"
91520240901,9,2024-09-01,15,61,58,119,Col700_T,"-37.81982992, 144.95102555"
9120240907,9,2024-09-07,1,2,13,15,Col700_T,"-37.81982992, 144.95102555"
202020250421,20,2025-04-21,20,193,337,530,LtB170_T,"-37.81172914, 144.9682466"
522020250922,52,2025-09-22,20,177,127,304,Eli263_T,"-37.81252157, 144.9619401"
1372320241015,137,2024-10-15,23,2,3,5,BouHbr2353_T,"-37.81894815, 144.94612292"
1301820240204,130,2024-02-04,18,8,8,16,Bou892T,"-37.8204637, 144.94126826"
1302220241208,130,2024-12-08,22,5,2,7,Bou892T,"-37.8204637, 144.94126826"
1301920250309,130,2025-03-09,19,37,43,80,Bou892T,"-37.8204637, 144.94126826"
1641720250704,164,2025-07-04,17,185,108,293,Lat526_T,"-37.813005, 144.95160411"
123920240812,123,2024-08-12,9,5,0,5,BirBridge_T,"-37.81753741, 144.97329734"
1231520250719,123,2025-07-19,15,37,15,52,BirBridge_T,"-37.81753741, 144.97329734"
1381320241221,138,2024-12-21,13,8,7,15,EntPark1671_T,"-37.81996544, 144.95981454"
109120250113,109,2025-01-13,1,2,13,15,LatWill_T,"-37.81193681, 144.95621105"
109120250623,109,2025-06-23,1,8,7,15,LatWill_T,"-37.81193681, 144.95621105"
84720231029,84,2023-10-29,7,106,126,232,ElFi_T,"-37.81798049, 144.96503383"
84720231115,84,2023-11-15,7,694,216,910,ElFi_T,"-37.81798049, 144.96503383"
842020240812,84,2024-08-12,20,593,821,1414,ElFi_T,"-37.81798049, 144.96503383"
41520240422,4,2024-04-22,15,1494,1181,2675,Swa123_T,"-37.81487988, 144.9660878"
701620240318,70,2024-03-18,16,134,136,270,Errol20_T,"-37.80456984, 144.94946228"
391520241223,39,2024-12-23,15,57,32,89,AlfPl_T,"-37.81379749, 144.96995745"
411320240623,41,2024-06-23,13,335,273,608,Swa31,"-37.81668634, 144.96689733"
77520231117,77,2023-11-17,5,3,9,12,HarEsP_T,"-37.81441438, 144.94433026"
71320250723,71,2025-07-23,3,2,1,3,WestWP_T,"-37.81235775, 144.97136962"
651720240917,65,2024-09-17,17,1127,1519,2646,SwaCs_T,"-37.81569416, 144.9668064"
29420241223,29,2024-12-23,4,5,4,9,AG_T,"-37.8199817, 144.96872865"
40520250125,40,2025-01-25,5,20,6,26,Spr201_T,"-37.80999341, 144.97227587"
54920250113,54,2025-01-13,9,55,37,92,Swa607_T,"-37.804024, 144.96308399"
401520240920,40,2024-09-20,15,139,160,299,Spr201_T,"-37.80999341, 144.97227587"
451820240521,45,2024-05-21,18,402,603,1005,Swa148_T,"-37.81414075, 144.96609379"
52320241116,5,2024-11-16,23,668,750,1418,PriNW_T,"-37.81874249, 144.96787656"
162120250918,162,2025-09-18,1,21,15,36,Eli489_T,"-37.80740397, 144.95987909"
140920240713,140,2024-07-13,9,89,33,122,Boyd2837_T,"-37.82590962, 144.96185972"
58520240923,58,2024-09-23,5,74,23,97,Bou688_T,"-37.81686075, 144.95358075"
76120250907,76,2025-09-07,1,2,1,3,KenMac_T,"-37.79453803, 144.93036194"
72320250610,72,2025-06-10,3,2,6,8,ACMI_T,"-37.81726338, 144.96872809"
271020241123,27,2024-11-23,10,185,192,377,Vic_T,"-37.80606888, 144.95644692"
21420240831,2,2024-08-31,14,864,862,1726,Bou283_T,"-37.81380668, 144.96516718"
21120240215,2,2024-02-15,11,645,673,1318,Bou283_T,"-37.81380668, 144.96516718"
91320240613,9,2024-06-13,13,379,417,796,Col700_T,"-37.81982992, 144.95102555"
272320251005,27,2025-10-05,23,21,7,28,Vic_T,"-37.80606888, 144.95644692"
272020251011,27,2025-10-11,20,195,84,279,Vic_T,"-37.80606888, 144.95644692"
532020240904,53,2024-09-04,20,135,167,302,Col254_T,"-37.81564191, 144.965499"
232220240220,23,2024-02-20,22,31,88,119,Col623_T,"-37.81909256, 144.95452748"
52520240212,52,2024-02-12,5,10,14,24,Eli263_T,"-37.81252157, 144.9619401"
462020240401,46,2024-04-01,20,17,15,32,Pel147_T,"-37.80240719, 144.9615673"
1091420250109,109,2025-01-09,14,119,101,220,LatWill_T,"-37.81193681, 144.95621105"
49420250328,49,2025-03-28,4,22,47,69,Eli501_T,"-37.80730068, 144.95956055"
48720240315,48,2024-03-15,7,62,52,114,QVMQ_T,"-37.80631581, 144.95866697"
139720240925,139,2024-09-25,7,13,100,113,Signal1647_T,"-37.81959923, 144.9632832"
1302120250827,130,2025-08-27,21,15,16,31,Bou892T,"-37.8204637, 144.94126826"
117020250530,117,2025-05-30,0,22,21,43,Fli114F_T,"-37.81629332, 144.97090877"
117320250731,117,2025-07-31,3,1,3,4,Fli114F_T,"-37.81629332, 144.97090877"
1232020241118,123,2024-11-18,20,4,0,4,BirBridge_T,"-37.81753741, 144.97329734"
1231120241210,123,2024-12-10,11,8,3,11,BirBridge_T,"-37.81753741, 144.97329734"
84320231119,84,2023-11-19,3,90,128,218,ElFi_T,"-37.81798049, 144.96503383"
61320250702,6,2025-07-02,13,394,389,783,FliS_T,"-37.81911705, 144.96558255"
39820231221,39,2023-12-21,8,175,107,282,AlfPl_T,"-37.81379749, 144.96995745"
391720250125,39,2025-01-25,17,135,101,236,AlfPl_T,"-37.81379749, 144.96995745"
751920250618,75,2025-06-18,19,10,19,29,SprFli_T,"-37.81515276, 144.97467661"
65620231231,65,2023-12-31,6,16,43,59,SwaCs_T,"-37.81569416, 144.9668064"
711820250414,71,2025-04-14,18,37,35,72,WestWP_T,"-37.81235775, 144.97136962"
54220241029,54,2024-10-29,2,7,5,12,Swa607_T,"-37.804024, 144.96308399"
541520241030,54,2024-10-30,15,106,117,223,Swa607_T,"-37.804024, 144.96308399"
28120250823,28,2025-08-23,1,36,18,54,VAC_T,"-37.82129925, 144.96879309"
5120240506,5,2024-05-06,1,19,29,48,PriNW_T,"-37.81874249, 144.96787656"
51520240827,5,2024-08-27,15,1277,614,1891,PriNW_T,"-37.81874249, 144.96787656"
36620240131,36,2024-01-31,6,39,20,59,Que85_T,"-37.81652527, 144.96121062"
37820241006,37,2024-10-06,8,19,12,31,Lyg260_T,"-37.80107122, 144.96704554"
50520241025,50,2024-10-25,5,11,1,12,Lyg309_T,"-37.79808192, 144.96721013"
502020250923,50,2025-09-23,20,180,111,291,Lyg309_T,"-37.79808192, 144.96721013"
451120241201,45,2024-12-01,11,525,571,1096,Swa148_T,"-37.81414075, 144.96609379"
45420250217,45,2025-02-17,4,5,22,27,Swa148_T,"-37.81414075, 144.96609379"
107720240528,107,2024-05-28,7,45,92,137,280Will_T,"-37.81246271, 144.95690188"
1331620250605,133,2025-06-05,16,567,695,1262,Spen229_T,"-37.81531435, 144.95227769"
1351120231029,135,2023-10-29,11,453,439,892,Spen161_T,"-37.8172861, 144.95319102"
118020250122,118,2025-01-22,0,6,0,6,Fli114C_T,"-37.81632783, 144.97090512"
1181220240418,118,2024-04-18,12,23,17,40,Fli114C_T,"-37.81632783, 144.97090512"
118020241106,118,2024-11-06,0,0,2,2,Fli114C_T,"-37.81632783, 144.97090512"
87620250911,87,2025-09-11,6,15,6,21,Errol23_T,"-37.80454949, 144.94921863"
182720250720,182,2025-07-20,7,22,36,58,King163_T,"-37.81627451, 144.95550503"
1321720241228,132,2024-12-28,17,60,86,146,King335_T,"-37.81267639, 144.95386444"
1081120250419,108,2025-04-19,11,136,137,273,261Will_T,"-37.81295822, 144.95678789"
132420240325,132,2024-03-25,4,6,4,10,King335_T,"-37.81267639, 144.95386444"
134520240925,134,2024-09-25,5,57,56,113,Spen201_T,"-37.81694221, 144.95303935"
135320240502,135,2024-05-02,3,8,6,14,Spen161_T,"-37.8172861, 144.95319102"
107920240617,107,2024-06-17,9,60,168,228,280Will_T,"-37.81246271, 144.95690188"
1071420241129,107,2024-11-29,14,118,158,276,280Will_T,"-37.81246271, 144.95690188"
1791820250925,179,2025-09-25,18,68,75,143,Pow61_T,"-37.82392385, 144.96299677"
671220240129,67,2024-01-29,12,330,379,709,FLDegS_T,"-37.81688755, 144.96562569"
171820241119,17,2024-11-19,18,210,375,585,Col15_T,"-37.81362543, 144.97323591"
181720250316,18,2025-03-16,17,41,40,81,Col12_T,"-37.81344862, 144.97305353"
121520240503,12,2024-05-03,15,97,176,273,NewQ_T,"-37.81457988, 144.94292398"
86820241106,86,2024-11-06,8,49,30,79,574Qub_T,"-37.80309992, 144.94908064"
621920240421,62,2024-04-21,19,221,133,354,Lat224_T,"-37.80996494, 144.96216521"
62920241204,62,2024-12-04,9,127,139,266,Lat224_T,"-37.80996494, 144.96216521"
86020250622,86,2025-06-22,0,0,7,7,574Qub_T,"-37.80309992, 144.94908064"
101620251002,10,2025-10-02,16,186,57,243,BouHbr_T,"-37.81876474, 144.94710545"
101520250114,10,2025-01-14,15,175,40,215,BouHbr_T,"-37.81876474, 144.94710545"
581520240605,58,2024-06-05,15,505,623,1128,Bou688_T,"-37.81686075, 144.95358075"
581720241121,58,2024-11-21,17,979,1338,2317,Bou688_T,"-37.81686075, 144.95358075"
791420240608,79,2024-06-08,14,630,408,1038,FliSS_T,"-37.81794046, 144.96616678"
301920241015,30,2024-10-15,19,264,382,646,Lon189_T,"-37.8112185, 144.96656806"
301620231212,30,2023-12-12,16,232,387,619,Lon189_T,"-37.8112185, 144.96656806"
46920240414,46,2024-04-14,9,24,35,59,Pel147_T,"-37.80240719, 144.9615673"
20720250110,20,2025-01-10,7,13,19,32,LtB170_T,"-37.81172914, 144.9682466"
521820240317,52,2024-03-17,18,246,285,531,Eli263_T,"-37.81252157, 144.9619401"
23720231223,23,2023-12-23,7,42,34,76,Col623_T,"-37.81909256, 144.95452748"
1371420251003,137,2025-10-03,14,21,68,89,BouHbr2353_T,"-37.81894815, 144.94612292"
1361820240614,136,2024-06-14,18,1,4,5,BirFed1120_T,"-37.8184141, 144.97357915"
1301320241227,130,2024-12-27,13,52,18,70,Bou892T,"-37.8204637, 144.94126826"
1302020250414,130,2025-04-14,20,27,9,36,Bou892T,"-37.8204637, 144.94126826"
1612120240812,161,2024-08-12,21,1,0,1,BirArt1109_T,"-37.81851276, 144.97131336"
1232020240203,123,2024-02-03,20,10,11,21,BirBridge_T,"-37.81753741, 144.97329734"
1381420250701,138,2025-07-01,14,10,6,16,EntPark1671_T,"-37.81996544, 144.95981454"
1171220250324,117,2025-03-24,12,170,201,371,Fli114F_T,"-37.81629332, 144.97090877"
1172320240210,117,2024-02-10,23,190,114,304,Fli114F_T,"-37.81629332, 144.97090877"
1171320250106,117,2025-01-06,13,124,75,199,Fli114F_T,"-37.81629332, 144.97090877"
66920250304,66,2025-03-04,9,384,594,978,QVN_T,"-37.81057846, 144.96444294"
6420240327,6,2024-03-27,4,36,8,44,FliS_T,"-37.81911705, 144.96558255"
41720240413,4,2024-04-13,17,2134,1231,3365,Swa123_T,"-37.81487988, 144.9660878"
702020231212,70,2023-12-12,20,157,168,325,Errol20_T,"-37.80456984, 144.94946228"
39720240416,39,2024-04-16,7,78,84,162,AlfPl_T,"-37.81379749, 144.96995745"
81220250216,8,2025-02-16,12,159,171,330,WebBN_T,"-37.82293543, 144.9471751"
118520231214,118,2023-12-14,5,0,2,2,Fli114C_T,"-37.81632783, 144.97090512"
851720241125,85,2024-11-25,17,74,114,188,488Mac_T,"-37.79432415, 144.92973378"
632020250312,63,2025-03-12,20,95,195,290,Bou231_T,"-37.81333081, 144.96675571"
62820251007,62,2025-10-07,8,112,99,211,Lat224_T,"-37.80996494, 144.96216521"
861720240720,86,2024-07-20,17,63,72,135,574Qub_T,"-37.80309992, 144.94908064"
681820240213,68,2024-02-13,18,194,144,338,FLDegN_T,"-37.8168479, 144.96559789"
62420241116,62,2024-11-16,4,16,11,27,Lat224_T,"-37.80996494, 144.96216521"
24020241006,24,2024-10-06,0,205,243,448,Col620_T,"-37.81887963, 144.95449198"
10620240412,10,2024-04-12,6,9,22,31,BouHbr_T,"-37.81876474, 144.94710545"
21720250322,2,2025-03-22,17,897,796,1693,Bou283_T,"-37.81380668, 144.96516718"
23620250227,23,2025-02-27,6,82,77,159,Col623_T,"-37.81909256, 144.95452748"
251720240325,25,2024-03-25,17,911,543,1454,MCEC_T,"-37.82401776, 144.95604426"
521620231030,52,2023-10-30,16,340,339,679,Eli263_T,"-37.81252157, 144.9619401"
491620241117,49,2024-11-17,16,181,313,494,Eli501_T,"-37.80730068, 144.95956055"
192020250223,19,2025-02-23,20,519,546,1065,LtB210_T,"-37.81237202, 144.96550671"
1371520231214,137,2023-12-14,15,29,171,200,BouHbr2353_T,"-37.81894815, 144.94612292"
1391320240126,139,2024-01-26,13,137,79,216,Signal1647_T,"-37.81959923, 144.9632832"
1422220240108,142,2024-01-08,22,95,62,157,Hammer1584_T,"-37.81970749, 144.96795734"
1381020250427,138,2025-04-27,10,2,1,3,EntPark1671_T,"-37.81996544, 144.95981454"
661820241026,66,2024-10-26,18,1373,1437,2810,QVN_T,"-37.81057846, 144.96444294"
691320240426,69,2024-04-26,13,269,224,493,FLDegC_T,"-37.81687226, 144.96559144"
841420240819,84,2024-08-19,14,752,1247,1999,ElFi_T,"-37.81798049, 144.96503383"
4120240424,4,2024-04-24,1,10,19,29,Swa123_T,"-37.81487988, 144.9660878"
31620250811,3,2025-08-11,16,1194,1317,2511,Swa295_T,"-37.81101524, 144.96429485"
31620250211,3,2025-02-11,16,902,841,1743,Swa295_T,"-37.81101524, 144.96429485"
752320240411,75,2024-04-11,23,19,11,30,SprFli_T,"-37.81515276, 144.97467661"
31820250814,3,2025-08-14,18,1475,1398,2873,Swa295_T,"-37.81101524, 144.96429485"
41820250808,41,2025-08-08,8,1390,400,1790,Swa31,"-37.81668634, 144.96689733"
77120250527,77,2025-05-27,1,2,3,5,HarEsP_T,"-37.81441438, 144.94433026"
78620250614,78,2025-06-14,6,0,1,1,HarEsB_T,"-37.81471642, 144.9446508"
782220240418,78,2024-04-18,22,3,78,81,HarEsB_T,"-37.81471642, 144.9446508"
29920240426,29,2024-04-26,9,108,241,349,AG_T,"-37.8199817, 144.96872865"
47520240317,47,2024-03-17,5,31,57,88,Eli250_T,"-37.81258467, 144.9625775"
51520240325,5,2024-03-25,15,1219,989,2208,PriNW_T,"-37.81874249, 144.96787656"
5620240927,5,2024-09-27,6,53,85,138,PriNW_T,"-37.81874249, 144.96787656"
1081720240513,108,2024-05-13,17,416,234,650,261Will_T,"-37.81295822, 144.95678789"
61120250313,61,2025-03-13,1,64,16,80,RMIT14_T,"-37.80767455, 144.96309114"
502120250922,50,2025-09-22,21,89,54,143,Lyg309_T,"-37.79808192, 144.96721013"
1662120250919,166,2025-09-19,21,15,11,26,Spen484_T,"-37.80896733, 144.94931703"
1791020250507,179,2025-05-07,10,47,32,79,Pow61_T,"-37.82392385, 144.96299677"
1672320250604,167,2025-06-04,23,6,8,14,Lat526_T,"-37.81304149, 144.95155955"
1311320250416,131,2025-04-16,13,216,188,404,King2_T,"-37.82009057, 144.95758725"
132120240304,132,2024-03-04,1,16,8,24,King335_T,"-37.81267639, 144.95386444"
1322020240611,132,2024-06-11,20,70,74,144,King335_T,"-37.81267639, 144.95386444"
1341920250925,134,2025-09-25,19,421,326,747,Spen201_T,"-37.81694221, 144.95303935"
1351220241216,135,2024-12-16,12,366,460,826,Spen161_T,"-37.8172861, 144.95319102"
1352220250427,135,2025-04-27,22,70,86,156,Spen161_T,"-37.8172861, 144.95319102"
671320231027,67,2023-10-27,13,496,490,986,FLDegS_T,"-37.81688755, 144.96562569"
17920240228,17,2024-02-28,9,732,211,943,Col15_T,"-37.81362543, 144.97323591"
56020250301,56,2025-03-01,0,82,102,184,Lon364_T,"-37.81234775, 144.96153311"
24820241102,24,2024-11-02,8,316,225,541,Col620_T,"-37.81887963, 144.95449198"
58020240420,58,2024-04-20,0,101,142,243,Bou688_T,"-37.81686075, 144.95358075"
761120241220,76,2024-12-20,11,42,49,91,KenMac_T,"-37.79453803, 144.93036194"
35620240322,35,2024-03-22,6,256,267,523,SouthB_T,"-37.82018685, 144.96508508"
2320240716,2,2024-07-16,3,5,2,7,Bou283_T,"-37.81380668, 144.96516718"
302020240214,30,2024-02-14,20,279,465,744,Lon189_T,"-37.8112185, 144.96656806"
302020240319,30,2024-03-19,20,214,315,529,Lon189_T,"-37.8112185, 144.96656806"
531220250416,53,2025-04-16,12,1175,801,1976,Col254_T,"-37.81564191, 144.965499"
791020250902,79,2025-09-02,10,316,241,557,FliSS_T,"-37.81794046, 144.96616678"
492120250923,49,2025-09-23,21,172,126,298,Eli501_T,"-37.80730068, 144.95956055"
251020241203,25,2024-12-03,10,158,355,513,MCEC_T,"-37.82401776, 144.95604426"
251020241220,25,2024-12-20,10,181,401,582,MCEC_T,"-37.82401776, 144.95604426"
252220240124,25,2024-01-24,22,188,176,364,MCEC_T,"-37.82401776, 144.95604426"
1642120250912,164,2025-09-12,21,52,78,130,Lat526_T,"-37.813005, 144.95160411"
1372320250928,137,2025-09-28,23,3,0,3,BouHbr2353_T,"-37.81894815, 144.94612292"
142620231215,142,2023-12-15,6,125,47,172,Hammer1584_T,"-37.81970749, 144.96795734"
130920250218,130,2025-02-18,9,33,18,51,Bou892T,"-37.8204637, 144.94126826"
1382120241122,138,2024-11-22,21,0,2,2,EntPark1671_T,"-37.81996544, 144.95981454"
117820250201,117,2025-02-01,8,59,44,103,Fli114F_T,"-37.81629332, 144.97090877"
691520250726,69,2025-07-26,15,247,250,497,FLDegC_T,"-37.81687226, 144.96559144"
69020250816,69,2025-08-16,0,12,16,28,FLDegC_T,"-37.81687226, 144.96559144"
31720231018,3,2023-10-18,17,1301,1400,2701,Swa295_T,"-37.81101524, 144.96429485"
391520250301,39,2025-03-01,15,63,54,117,AlfPl_T,"-37.81379749, 144.96995745"
281720240731,28,2024-07-31,17,368,1347,1715,VAC_T,"-37.82129925, 144.96879309"
311420250602,31,2025-06-02,14,81,67,148,Lyg161_T,"-37.80169681, 144.96658911"
31620250816,31,2025-08-16,6,2,3,5,Lyg161_T,"-37.80169681, 144.96658911"
312320250112,31,2025-01-12,23,42,96,138,Lyg161_T,"-37.80169681, 144.96658911"
212320241121,21,2024-11-21,23,131,127,258,Bourke155_T,"-37.81267313, 144.96788288"
37820250419,37,2025-04-19,8,24,17,41,Lyg260_T,"-37.80107122, 144.96704554"
1071920250212,107,2025-02-12,19,138,116,254,280Will_T,"-37.81246271, 144.95690188"
132720250801,132,2025-08-01,7,58,21,79,King335_T,"-37.81267639, 144.95386444"
135820231018,135,2023-10-18,8,345,456,801,Spen161_T,"-37.8172861, 144.95319102"
1081320241106,108,2024-11-06,13,480,567,1047,261Will_T,"-37.81295822, 144.95678789"
108720240112,108,2024-01-12,7,55,340,395,261Will_T,"-37.81295822, 144.95678789"
50220240122,50,2024-01-22,2,6,0,6,Lyg309_T,"-37.79808192, 144.96721013"
1821620250619,182,2025-06-19,16,239,204,443,King163_T,"-37.81627451, 144.95550503"
1622120240706,162,2024-07-06,21,280,130,410,Eli489_T,"-37.80740397, 144.95987909"
1621220241013,162,2024-10-13,12,725,943,1668,Eli489_T,"-37.80740397, 144.95987909"
131820250516,131,2025-05-16,8,149,55,204,King2_T,"-37.82009057, 144.95758725"
135520240420,135,2024-04-20,5,16,23,39,Spen161_T,"-37.8172861, 144.95319102"
1331320240604,133,2024-06-04,13,534,523,1057,Spen229_T,"-37.81531435, 144.95227769"
118820240629,118,2024-06-29,8,4,5,9,Fli114C_T,"-37.81632783, 144.97090512"
851520250127,85,2025-01-27,15,26,37,63,488Mac_T,"-37.79432415, 144.92973378"
181120241112,18,2024-11-12,11,202,266,468,Col12_T,"-37.81344862, 144.97305353"
18520241004,18,2024-10-04,5,0,9,9,Col12_T,"-37.81344862, 144.97305353"
86920241125,86,2024-11-25,9,20,12,32,574Qub_T,"-37.80309992, 144.94908064"
24120231228,24,2023-12-28,1,46,45,91,Col620_T,"-37.81887963, 144.95449198"
122220240608,12,2024-06-08,22,129,429,558,NewQ_T,"-37.81457988, 144.94292398"
24020240603,24,2024-06-03,0,81,70,151,Col620_T,"-37.81887963, 144.95449198"
721720250425,72,2025-04-25,17,82,159,241,ACMI_T,"-37.81726338, 144.96872809"
581920250202,58,2025-02-02,19,244,141,385,Bou688_T,"-37.81686075, 144.95358075"
35420250807,35,2025-08-07,4,5,1,6,SouthB_T,"-37.82018685, 144.96508508"
2720250610,2,2025-06-10,7,44,69,113,Bou283_T,"-37.81380668, 144.96516718"
91620250306,9,2025-03-06,16,2735,164,2899,Col700_T,"-37.81982992, 144.95102555"
53620240404,53,2024-04-04,6,39,31,70,Col254_T,"-37.81564191, 144.965499"
791720240630,79,2024-06-30,17,362,293,655,FliSS_T,"-37.81794046, 144.96616678"
232020240202,23,2024-02-02,20,101,158,259,Col623_T,"-37.81909256, 144.95452748"
201220250919,20,2025-09-19,12,283,223,506,LtB170_T,"-37.81172914, 144.9682466"
521020241211,52,2024-12-11,10,184,161,345,Eli263_T,"-37.81252157, 144.9619401"
49620240514,49,2024-05-14,6,37,57,94,Eli501_T,"-37.80730068, 144.95956055"
49920240114,49,2024-01-14,9,150,178,328,Eli501_T,"-37.80730068, 144.95956055"
192320240917,19,2024-09-17,23,74,195,269,LtB210_T,"-37.81237202, 144.96550671"
252220250425,25,2025-04-25,22,149,146,295,MCEC_T,"-37.82401776, 144.95604426"
141620240423,141,2024-04-23,6,15,24,39,474Fl_T,"-37.81997273, 144.95834911"
1411620240611,141,2024-06-11,16,122,96,218,474Fl_T,"-37.81997273, 144.95834911"
1231620250426,123,2025-04-26,16,32,63,95,BirBridge_T,"-37.81753741, 144.97329734"
692220240208,69,2024-02-08,22,13,20,33,FLDegC_T,"-37.81687226, 144.96559144"
62220241126,6,2024-11-26,22,562,357,919,FliS_T,"-37.81911705, 144.96558255"
42220231221,4,2023-12-21,22,1791,1088,2879,Swa123_T,"-37.81487988, 144.9660878"
4720240927,4,2024-09-27,7,69,88,157,Swa123_T,"-37.81487988, 144.9660878"
391520240608,39,2024-06-08,15,89,80,169,AlfPl_T,"-37.81379749, 144.96995745"
81020240611,8,2024-06-11,10,97,104,201,WebBN_T,"-37.82293543, 144.9471751"
411720251008,41,2025-10-08,17,1767,2857,4624,Swa31,"-37.81668634, 144.96689733"
772320250415,77,2025-04-15,23,29,21,50,HarEsP_T,"-37.81441438, 144.94433026"
781420240824,78,2024-08-24,14,79,92,171,HarEsB_T,"-37.81471642, 144.9446508"
782020250418,78,2025-04-18,20,7,15,22,HarEsB_T,"-37.81471642, 144.9446508"
612220240528,61,2024-05-28,22,136,70,206,RMIT14_T,"-37.80767455, 144.96309114"
162620241120,162,2024-11-20,6,56,41,97,Eli489_T,"-37.80740397, 144.95987909"
184320250808,184,2025-08-08,3,10,14,24,Eli124_T,"-37.81512416, 144.96371988"
1661020250101,166,2025-01-01,10,31,34,65,Spen484_T,"-37.80896733, 144.94931703"
1671220240829,167,2024-08-29,12,32,83,115,Lat526_T,"-37.81304149, 144.95155955"
1311520241014,131,2024-10-14,15,124,102,226,King2_T,"-37.82009057, 144.95758725"
130820240719,130,2024-07-19,8,5,7,12,Bou892T,"-37.8204637, 144.94126826"
622320240513,62,2024-05-13,23,95,59,154,Lat224_T,"-37.80996494, 144.96216521"
621420241018,62,2024-10-18,14,241,240,481,Lat224_T,"-37.80996494, 144.96216521"
1120250930,1,2025-09-30,1,7,23,30,Bou292_T,"-37.81349441, 144.96515323"
581220240213,58,2024-02-13,12,770,461,1231,Bou688_T,"-37.81686075, 144.95358075"
27320240524,27,2024-05-24,3,4,3,7,Vic_T,"-37.80606888, 144.95644692"
58920251008,58,2025-10-08,9,1192,182,1374,Bou688_T,"-37.81686075, 144.95358075"
21020250918,2,2025-09-18,10,338,406,744,Bou283_T,"-37.81380668, 144.96516718"
301020240207,30,2024-02-07,10,97,177,274,Lon189_T,"-37.8112185, 144.96656806"
9320250711,9,2025-07-11,3,0,2,2,Col700_T,"-37.81982992, 144.95102555"
531520250324,53,2025-03-24,15,587,517,1104,Col254_T,"-37.81564191, 144.965499"
532120241024,53,2024-10-24,21,121,268,389,Col254_T,"-37.81564191, 144.965499"
23220250312,23,2025-03-12,2,3,4,7,Col623_T,"-37.81909256, 144.95452748"
23620250917,23,2025-09-17,6,122,100,222,Col623_T,"-37.81909256, 144.95452748"
511820240508,51,2024-05-08,18,147,165,312,Fra118_T,"-37.80841815, 144.95906316"
109120240330,109,2024-03-30,1,13,15,28,LatWill_T,"-37.81193681, 144.95621105"
491520240905,49,2024-09-05,15,181,326,507,Eli501_T,"-37.80730068, 144.95956055"
25620250304,25,2025-03-04,6,74,116,190,MCEC_T,"-37.82401776, 144.95604426"
251220240221,25,2024-02-21,12,335,335,670,MCEC_T,"-37.82401776, 144.95604426"
137120231207,137,2023-12-07,1,1,0,1,BouHbr2353_T,"-37.81894815, 144.94612292"
1391120240525,139,2024-05-25,11,52,53,105,Signal1647_T,"-37.81959923, 144.9632832"
1361120250613,136,2025-06-13,11,59,45,104,BirFed1120_T,"-37.8184141, 144.97357915"
69320240129,69,2024-01-29,3,3,1,4,FLDegC_T,"-37.81687226, 144.96559144"
6120231230,6,2023-12-30,1,155,93,248,FliS_T,"-37.81911705, 144.96558255"
841620240910,84,2024-09-10,16,910,1832,2742,ElFi_T,"-37.81798049, 144.96503383"
4120240928,4,2024-09-28,1,48,52,100,Swa123_T,"-37.81487988, 144.9660878"
70820241231,70,2024-12-31,8,51,40,91,Errol20_T,"-37.80456984, 144.94946228"
391620240730,39,2024-07-30,16,85,67,152,AlfPl_T,"-37.81379749, 144.96995745"
391720250211,39,2025-02-11,17,157,87,244,AlfPl_T,"-37.81379749, 144.96995745"
751420231208,75,2023-12-08,14,50,51,101,SprFli_T,"-37.81515276, 144.97467661"
771820240324,77,2024-03-24,18,345,131,476,HarEsP_T,"-37.81441438, 144.94433026"
42820240727,42,2024-07-27,8,26,24,50,UM1_T,"-37.80008566, 144.96386412"
65520240815,65,2024-08-15,5,38,18,56,SwaCs_T,"-37.81569416, 144.9668064"
59020240228,59,2024-02-28,0,88,35,123,RMIT_T,"-37.80825648, 144.96304859"
291720250927,29,2025-09-27,17,478,808,1286,AG_T,"-37.8199817, 144.96872865"
311020240621,31,2024-06-21,10,81,90,171,Lyg161_T,"-37.80169681, 144.96658911"
54020231028,54,2023-10-28,0,38,56,94,Swa607_T,"-37.804024, 144.96308399"
28320231206,28,2023-12-06,3,4,22,26,VAC_T,"-37.82129925, 144.96879309"
47120250809,47,2025-08-09,1,156,126,282,Eli250_T,"-37.81258467, 144.9625775"
40720250613,40,2025-06-13,7,113,76,189,Spr201_T,"-37.80999341, 144.97227587"
401120240411,40,2024-04-11,11,243,305,548,Spr201_T,"-37.80999341, 144.97227587"
402320240504,40,2024-05-04,23,93,47,140,Spr201_T,"-37.80999341, 144.97227587"
401620240324,40,2024-03-24,16,103,234,337,Spr201_T,"-37.80999341, 144.97227587"
78120241018,78,2024-10-18,1,1,4,5,HarEsB_T,"-37.81471642, 144.9446508"
71620251010,71,2025-10-10,6,7,5,12,WestWP_T,"-37.81235775, 144.97136962"
59420240502,59,2024-05-02,4,9,16,25,RMIT_T,"-37.80825648, 144.96304859"
28420250413,28,2025-04-13,4,12,5,17,VAC_T,"-37.82129925, 144.96879309"
312120241024,31,2024-10-24,21,123,198,321,Lyg161_T,"-37.80169681, 144.96658911"
371320250227,37,2025-02-27,13,145,160,305,Lyg260_T,"-37.80107122, 144.96704554"
871120240729,87,2024-07-29,11,104,86,190,Errol23_T,"-37.80454949, 144.94921863"
87820241011,87,2024-10-11,8,104,47,151,Errol23_T,"-37.80454949, 144.94921863"
612220241011,61,2024-10-11,22,370,165,535,RMIT14_T,"-37.80767455, 144.96309114"
61820250201,61,2025-02-01,8,91,125,216,RMIT14_T,"-37.80767455, 144.96309114"
611420250923,61,2025-09-23,14,503,808,1311,RMIT14_T,"-37.80767455, 144.96309114"
611220250427,61,2025-04-27,12,555,510,1065,RMIT14_T,"-37.80767455, 144.96309114"
61620250802,61,2025-08-02,6,5,23,28,RMIT14_T,"-37.80767455, 144.96309114"
50920251006,50,2025-10-06,9,59,90,149,Lyg309_T,"-37.79808192, 144.96721013"
43020240811,43,2024-08-11,0,15,2,17,UM2_T,"-37.79844526, 144.96411782"
452320250310,45,2025-03-10,23,66,224,290,Swa148_T,"-37.81414075, 144.96609379"
1622120250214,162,2025-02-14,21,111,78,189,Eli489_T,"-37.80740397, 144.95987909"
132220250208,132,2025-02-08,2,27,7,34,King335_T,"-37.81267639, 144.95386444"
143320241124,143,2024-11-24,3,58,33,91,Spencer_T,"-37.821728, 144.95557015"
1322120231128,132,2023-11-28,21,125,123,248,King335_T,"-37.81267639, 144.95386444"
134120241121,134,2024-11-21,1,42,38,80,Spen201_T,"-37.81694221, 144.95303935"
1312120240525,131,2024-05-25,21,157,114,271,King2_T,"-37.82009057, 144.95758725"
1311620240814,131,2024-08-14,16,100,128,228,King2_T,"-37.82009057, 144.95758725"
1351720240726,135,2024-07-26,17,591,463,1054,Spen161_T,"-37.8172861, 144.95319102"
1071120241205,107,2024-12-05,11,127,148,275,280Will_T,"-37.81246271, 144.95690188"
1332120240601,133,2024-06-01,21,279,205,484,Spen229_T,"-37.81531435, 144.95227769"
1241220250913,124,2025-09-13,12,4,2,6,BirBridge_T,"-37.81757416, 144.97329934"
1361020240713,136,2024-07-13,10,119,94,213,BirFed1120_T,"-37.8184141, 144.97357915"
1301420250724,130,2025-07-24,14,88,57,145,Bou892T,"-37.8204637, 144.94126826"
130320250918,130,2025-09-18,3,1,0,1,Bou892T,"-37.8204637, 144.94126826"
123720231111,123,2023-11-11,7,16,18,34,BirBridge_T,"-37.81753741, 144.97329734"
1381620240619,138,2024-06-19,16,8,5,13,EntPark1671_T,"-37.81996544, 144.95981454"
1091720250209,109,2025-02-09,17,46,76,122,LatWill_T,"-37.81193681, 144.95621105"
49320250309,49,2025-03-09,3,35,56,91,Eli501_T,"-37.80730068, 144.95956055"
19320240608,19,2024-06-08,3,26,55,81,LtB210_T,"-37.81237202, 144.96550671"
191520240203,19,2024-02-03,15,647,665,1312,LtB210_T,"-37.81237202, 144.96550671"
681920250113,68,2025-01-13,19,211,153,364,FLDegN_T,"-37.8168479, 144.96559789"
851120250428,85,2025-04-28,11,92,68,160,488Mac_T,"-37.79432415, 144.92973378"
17920240419,17,2024-04-19,9,502,212,714,Col15_T,"-37.81362543, 144.97323591"
17320241126,17,2024-11-26,3,3,2,5,Col15_T,"-37.81362543, 144.97323591"
672320250827,67,2025-08-27,23,18,32,50,FLDegS_T,"-37.81688755, 144.96562569"
682120250530,68,2025-05-30,21,119,60,179,FLDegN_T,"-37.8168479, 144.96559789"
63020250821,63,2025-08-21,0,3,17,20,Bou231_T,"-37.81333081, 144.96675571"
622120240819,62,2024-08-19,21,149,84,233,Lat224_T,"-37.80996494, 144.96216521"
561420240704,56,2024-07-04,14,366,423,789,Lon364_T,"-37.81234775, 144.96153311"
561220241129,56,2024-11-29,12,422,350,772,Lon364_T,"-37.81234775, 144.96153311"
12920250311,12,2025-03-11,9,123,119,242,NewQ_T,"-37.81457988, 144.94292398"
12720250919,12,2025-09-19,7,102,64,166,NewQ_T,"-37.81457988, 144.94292398"
121820241227,12,2024-12-27,18,236,328,564,NewQ_T,"-37.81457988, 144.94292398"
11320231227,11,2023-12-27,3,1,1,2,WatCit_T,"-37.81564989, 144.93970694"
722320231109,72,2023-11-09,23,39,72,111,ACMI_T,"-37.81726338, 144.96872809"
762320240709,76,2024-07-09,23,1,1,2,KenMac_T,"-37.79453803, 144.93036194"
72020250513,72,2025-05-13,0,2,6,8,ACMI_T,"-37.81726338, 144.96872809"
58820240110,58,2024-01-10,8,1492,174,1666,Bou688_T,"-37.81686075, 144.95358075"
21520250103,2,2025-01-03,15,772,823,1595,Bou283_T,"-37.81380668, 144.96516718"
21120240207,2,2024-02-07,11,409,454,863,Bou283_T,"-37.81380668, 144.96516718"
22020231031,2,2023-10-31,20,115,146,261,Bou283_T,"-37.81380668, 144.96516718"
791420231109,79,2023-11-09,14,459,407,866,FliSS_T,"-37.81794046, 144.96616678"
791320231129,79,2023-11-29,13,332,285,617,FliSS_T,"-37.81794046, 144.96616678"
52320240219,52,2024-02-19,3,3,13,16,Eli263_T,"-37.81252157, 144.9619401"
19920250917,19,2025-09-17,9,122,53,175,LtB210_T,"-37.81237202, 144.96550671"
691920231115,69,2023-11-15,19,53,26,79,FLDegC_T,"-37.81687226, 144.96559144"
84920250523,84,2025-05-23,9,1014,408,1422,ElFi_T,"-37.81798049, 144.96503383"
41620241205,4,2024-12-05,16,2025,1415,3440,Swa123_T,"-37.81487988, 144.9660878"
391920240327,39,2024-03-27,19,56,46,102,AlfPl_T,"-37.81379749, 144.96995745"
411520240428,41,2024-04-28,15,1630,2063,3693,Swa31,"-37.81668634, 144.96689733"
41620250412,41,2025-04-12,6,245,106,351,Swa31,"-37.81668634, 144.96689733"
782320231027,78,2023-10-27,23,11,25,36,HarEsB_T,"-37.81471642, 144.9446508"
421020241112,42,2024-11-12,10,153,172,325,UM1_T,"-37.80008566, 144.96386412"
281920250508,28,2025-05-08,19,275,425,700,VAC_T,"-37.82129925, 144.96879309"
281720240610,28,2024-06-10,17,242,336,578,VAC_T,"-37.82129925, 144.96879309"
40320250704,40,2025-07-04,3,3,1,4,Spr201_T,"-37.80999341, 144.97227587"
542020240421,54,2024-04-21,20,105,146,251,Swa607_T,"-37.804024, 144.96308399"
37020231205,37,2023-12-05,0,15,18,33,Lyg260_T,"-37.80107122, 144.96704554"
471720250311,47,2025-03-11,17,1146,834,1980,Eli250_T,"-37.81258467, 144.9625775"
471620240430,47,2024-04-30,16,824,678,1502,Eli250_T,"-37.81258467, 144.9625775"
451120241218,45,2024-12-18,11,741,645,1386,Swa148_T,"-37.81414075, 144.96609379"
451620250128,45,2025-01-28,16,439,691,1130,Swa148_T,"-37.81414075, 144.96609379"
51020240408,5,2024-04-08,10,350,650,1000,PriNW_T,"-37.81874249, 144.96787656"
51320250616,5,2025-06-16,13,626,824,1450,PriNW_T,"-37.81874249, 144.96787656"
1081320240830,108,2024-08-30,13,134,364,498,261Will_T,"-37.81295822, 144.95678789"
1081320240916,108,2024-09-16,13,329,439,768,261Will_T,"-37.81295822, 144.95678789"
871720250909,87,2025-09-09,17,125,104,229,Errol23_T,"-37.80454949, 144.94921863"
50520240628,50,2024-06-28,5,2,2,4,Lyg309_T,"-37.79808192, 144.96721013"
442320241216,44,2024-12-16,23,1,2,3,UM3_T,"-37.79698741, 144.96441306"
140620250213,140,2025-02-13,6,29,8,37,Boyd2837_T,"-37.82590962, 144.96185972"
132020250303,132,2025-03-03,0,25,24,49,King335_T,"-37.81267639, 144.95386444"
134620240522,134,2024-05-22,6,77,99,176,Spen201_T,"-37.81694221, 144.95303935"
1342220250825,134,2025-08-25,22,136,128,264,Spen201_T,"-37.81694221, 144.95303935"
135720250713,135,2025-07-13,7,53,130,183,Spen161_T,"-37.8172861, 144.95319102"
133020241026,133,2024-10-26,0,82,47,129,Spen229_T,"-37.81531435, 144.95227769"
1662320250630,166,2025-06-30,23,2,0,2,Spen484_T,"-37.80896733, 144.94931703"
672320250110,67,2025-01-10,23,111,220,331,FLDegS_T,"-37.81688755, 144.96562569"
171720250722,17,2025-07-22,17,242,767,1009,Col15_T,"-37.81362543, 144.97323591"
862120240508,86,2024-05-08,21,7,37,44,574Qub_T,"-37.80309992, 144.94908064"
561220250205,56,2025-02-05,12,440,310,750,Lon364_T,"-37.81234775, 144.96153311"
861220250512,86,2025-05-12,12,69,87,156,574Qub_T,"-37.80309992, 144.94908064"
10120240312,10,2024-03-12,1,4,3,7,BouHbr_T,"-37.81876474, 144.94710545"
211920241005,21,2024-10-05,19,293,397,690,Bourke155_T,"-37.81267313, 144.96788288"
211620241105,21,2024-11-05,16,244,251,495,Bourke155_T,"-37.81267313, 144.96788288"
44720240118,44,2024-01-18,7,6,15,21,UM3_T,"-37.79698741, 144.96441306"
45220250519,45,2025-05-19,2,3,14,17,Swa148_T,"-37.81414075, 144.96609379"
107120241228,107,2024-12-28,1,10,6,16,280Will_T,"-37.81246271, 144.95690188"
1332020240118,133,2024-01-18,20,451,322,773,Spen229_T,"-37.81531435, 144.95227769"
872320240511,87,2024-05-11,23,26,20,46,Errol23_T,"-37.80454949, 144.94921863"
871720251013,87,2025-10-13,17,115,110,225,Errol23_T,"-37.80454949, 144.94921863"
1821420250503,182,2025-05-03,14,255,228,483,King163_T,"-37.81627451, 144.95550503"
1651120240910,165,2024-09-10,11,23,41,64,Spen475_T,"-37.80953359, 144.94939004"
181820250731,181,2025-07-31,8,581,431,1012,Eli368_T,"-37.81009465, 144.96143149"
1312020241017,131,2024-10-17,20,78,115,193,King2_T,"-37.82009057, 144.95758725"
1432120250928,143,2025-09-28,21,127,103,230,Spencer_T,"-37.821728, 144.95557015"
1401520240723,140,2024-07-23,15,85,106,191,Boyd2837_T,"-37.82590962, 144.96185972"
1322020240525,132,2024-05-25,20,121,90,211,King335_T,"-37.81267639, 144.95386444"
1321220240614,132,2024-06-14,12,174,147,321,King335_T,"-37.81267639, 144.95386444"
1352220250902,135,2025-09-02,22,94,100,194,Spen161_T,"-37.8172861, 144.95319102"
1351520231124,135,2023-11-24,15,724,734,1458,Spen161_T,"-37.8172861, 144.95319102"
671720231219,67,2023-12-19,17,437,652,1089,FLDegS_T,"-37.81688755, 144.96562569"
67820250913,67,2025-09-13,8,134,135,269,FLDegS_T,"-37.81688755, 144.96562569"
681320250706,68,2025-07-06,13,450,307,757,FLDegN_T,"-37.8168479, 144.96559789"
171320231212,17,2023-12-12,13,771,732,1503,Col15_T,"-37.81362543, 144.97323591"
631320240822,63,2024-08-22,13,505,659,1164,Bou231_T,"-37.81333081, 144.96675571"
181520240714,18,2024-07-14,15,71,64,135,Col12_T,"-37.81344862, 144.97305353"
681120250519,68,2025-05-19,11,312,241,553,FLDegN_T,"-37.8168479, 144.96559789"
621620240402,62,2024-04-02,16,204,100,304,Lat224_T,"-37.80996494, 144.96216521"
56620240218,56,2024-02-18,6,19,23,42,Lon364_T,"-37.81234775, 144.96153311"
121120250605,12,2025-06-05,11,100,138,238,NewQ_T,"-37.81457988, 144.94292398"
12720240523,12,2024-05-23,7,110,81,191,NewQ_T,"-37.81457988, 144.94292398"
121220231018,12,2023-10-18,12,170,234,404,NewQ_T,"-37.81457988, 144.94292398"
721420240121,72,2024-01-21,14,284,508,792,ACMI_T,"-37.81726338, 144.96872809"
351720240622,35,2024-06-22,17,1372,1655,3027,SouthB_T,"-37.82018685, 144.96508508"
761520231101,76,2023-11-01,15,47,77,124,KenMac_T,"-37.79453803, 144.93036194"
27520240801,27,2024-08-01,5,8,7,15,Vic_T,"-37.80606888, 144.95644692"
272320241116,27,2024-11-16,23,58,38,96,Vic_T,"-37.80606888, 144.95644692"
58920250904,58,2025-09-04,9,1089,189,1278,Bou688_T,"-37.81686075, 144.95358075"
272320250918,27,2025-09-18,23,43,13,56,Vic_T,"-37.80606888, 144.95644692"
30720240725,30,2024-07-25,7,47,34,81,Lon189_T,"-37.8112185, 144.96656806"
532020250827,53,2025-08-27,20,125,197,322,Col254_T,"-37.81564191, 144.965499"
231620240328,23,2024-03-28,16,258,575,833,Col623_T,"-37.81909256, 144.95452748"
79120250422,79,2025-04-22,1,12,12,24,FliSS_T,"-37.81794046, 144.96616678"
522220250102,52,2025-01-02,22,81,103,184,Eli263_T,"-37.81252157, 144.9619401"
521820240229,52,2024-02-29,18,391,379,770,Eli263_T,"-37.81252157, 144.9619401"
491120240222,49,2024-02-22,11,254,332,586,Eli501_T,"-37.80730068, 144.95956055"
109620250202,109,2025-02-02,6,16,16,32,LatWill_T,"-37.81193681, 144.95621105"
1171320231031,117,2023-10-31,13,192,183,375,Fli114F_T,"-37.81629332, 144.97090877"
191520240308,19,2024-03-08,15,406,531,937,LtB210_T,"-37.81237202, 144.96550671"
481820250725,48,2025-07-25,18,140,170,310,QVMQ_T,"-37.80631581, 144.95866697"
481420240529,48,2024-05-29,14,163,153,316,QVMQ_T,"-37.80631581, 144.95866697"
482320240618,48,2024-06-18,23,24,19,43,QVMQ_T,"-37.80631581, 144.95866697"
1641620250728,164,2025-07-28,16,143,102,245,Lat526_T,"-37.813005, 144.95160411"
139120250410,139,2025-04-10,1,2,2,4,Signal1647_T,"-37.81959923, 144.9632832"
136620231116,136,2023-11-16,6,37,29,66,BirFed1120_T,"-37.8184141, 144.97357915"
1421220240521,142,2024-05-21,12,446,392,838,Hammer1584_T,"-37.81970749, 144.96795734"
1422220231122,142,2023-11-22,22,105,97,202,Hammer1584_T,"-37.81970749, 144.96795734"
117520250921,117,2025-09-21,5,6,4,10,Fli114F_T,"-37.81629332, 144.97090877"
1231020240826,123,2024-08-26,10,3,1,4,BirBridge_T,"-37.81753741, 144.97329734"
117320240722,117,2024-07-22,3,3,0,3,Fli114F_T,"-37.81629332, 144.97090877"
691420250225,69,2025-02-25,14,271,221,492,FLDegC_T,"-37.81687226, 144.96559144"
591720240608,59,2024-06-08,17,586,601,1187,RMIT_T,"-37.80825648, 144.96304859"
711820250226,71,2025-02-26,18,14,17,31,WestWP_T,"-37.81235775, 144.97136962"
29620250627,29,2025-06-27,6,37,50,87,AG_T,"-37.8199817, 144.96872865"
14020241231,14,2024-12-31,0,81,21,102,SanBri_T,"-37.82011242, 144.96291897"
54120250321,54,2025-03-21,1,12,13,25,Swa607_T,"-37.804024, 144.96308399"
45320241129,45,2024-11-29,3,17,17,34,Swa148_T,"-37.81414075, 144.96609379"
5420241015,5,2024-10-15,4,17,8,25,PriNW_T,"-37.81874249, 144.96787656"
107420250110,107,2025-01-10,4,7,2,9,280Will_T,"-37.81246271, 144.95690188"
108820250210,108,2025-02-10,8,205,2278,2483,261Will_T,"-37.81295822, 144.95678789"
50320250901,50,2025-09-01,3,3,0,3,Lyg309_T,"-37.79808192, 144.96721013"
1812320250802,181,2025-08-02,23,386,425,811,Eli368_T,"-37.81009465, 144.96143149"
179920250403,179,2025-04-03,9,53,37,90,Pow61_T,"-37.82392385, 144.96299677"
134720231114,134,2023-11-14,7,225,175,400,Spen201_T,"-37.81694221, 144.95303935"
1341620231221,134,2023-12-21,16,462,506,968,Spen201_T,"-37.81694221, 144.95303935"
1182020231123,118,2023-11-23,20,20,49,69,Fli114C_T,"-37.81632783, 144.97090512"
1181220240926,118,2024-09-26,12,18,18,36,Fli114C_T,"-37.81632783, 144.97090512"
1181920241218,118,2024-12-18,19,18,18,36,Fli114C_T,"-37.81632783, 144.97090512"
1181020250223,118,2025-02-23,10,8,26,34,Fli114C_T,"-37.81632783, 144.97090512"
167120250401,167,2025-04-01,1,2,5,7,Lat526_T,"-37.81304149, 144.95155955"
1671220250729,167,2025-07-29,12,39,56,95,Lat526_T,"-37.81304149, 144.95155955"
1401020240717,140,2024-07-17,10,66,33,99,Boyd2837_T,"-37.82590962, 144.96185972"
1822020250902,182,2025-09-02,20,199,201,400,King163_T,"-37.81627451, 144.95550503"
1351920241026,135,2024-10-26,19,337,388,725,Spen161_T,"-37.8172861, 144.95319102"
1351220250704,135,2025-07-04,12,482,465,947,Spen161_T,"-37.8172861, 144.95319102"
133820231019,133,2023-10-19,8,457,542,999,Spen229_T,"-37.81531435, 144.95227769"
85020250228,85,2025-02-28,0,1,1,2,488Mac_T,"-37.79432415, 144.92973378"
11920240301,1,2024-03-01,19,1204,833,2037,Bou292_T,"-37.81349441, 144.96515323"
63720250422,63,2025-04-22,7,57,54,111,Bou231_T,"-37.81333081, 144.96675571"
682120250922,68,2025-09-22,21,54,43,97,FLDegN_T,"-37.8168479, 144.96559789"
182220250503,18,2025-05-03,22,14,44,58,Col12_T,"-37.81344862, 144.97305353"
181520250725,18,2025-07-25,15,326,117,443,Col12_T,"-37.81344862, 144.97305353"
621220250817,62,2025-08-17,12,295,306,601,Lat224_T,"-37.80996494, 144.96216521"
861620240210,86,2024-02-10,16,42,51,93,574Qub_T,"-37.80309992, 144.94908064"
682320250609,68,2025-06-09,23,6,0,6,FLDegN_T,"-37.8168479, 144.96559789"
62720240109,62,2024-01-09,7,63,59,122,Lat224_T,"-37.80996494, 144.96216521"
622120240612,62,2024-06-12,21,134,89,223,Lat224_T,"-37.80996494, 144.96216521"
562120240116,56,2024-01-16,21,161,231,392,Lon364_T,"-37.81234775, 144.96153311"
11320250731,11,2025-07-31,3,1,4,5,WatCit_T,"-37.81564989, 144.93970694"
121420240110,12,2024-01-10,14,144,142,286,NewQ_T,"-37.81457988, 144.94292398"
721520240715,72,2024-07-15,15,89,195,284,ACMI_T,"-37.81726338, 144.96872809"
351520250617,35,2025-06-17,15,1292,715,2007,SouthB_T,"-37.82018685, 144.96508508"
272020240607,27,2024-06-07,20,89,57,146,Vic_T,"-37.80606888, 144.95644692"
91720241027,9,2024-10-27,17,64,53,117,Col700_T,"-37.81982992, 144.95102555"
251120240215,25,2024-02-15,11,336,498,834,MCEC_T,"-37.82401776, 144.95604426"
302220250826,30,2025-08-26,22,123,128,251,Lon189_T,"-37.8112185, 144.96656806"
201520241111,20,2024-11-11,15,158,233,391,LtB170_T,"-37.81172914, 144.9682466"
521120250126,52,2025-01-26,11,246,174,420,Eli263_T,"-37.81252157, 144.9619401"
122320250212,12,2025-02-12,23,79,67,146,NewQ_T,"-37.81457988, 144.94292398"
121920250216,12,2025-02-16,19,223,241,464,NewQ_T,"-37.81457988, 144.94292398"
241220250525,24,2025-05-25,12,647,405,1052,Col620_T,"-37.81887963, 144.95449198"
241320250220,24,2025-02-20,13,721,805,1526,Col620_T,"-37.81887963, 144.95449198"
762120250817,76,2025-08-17,21,4,11,15,KenMac_T,"-37.79453803, 144.93036194"
271920250110,27,2025-01-10,19,105,65,170,Vic_T,"-37.80606888, 144.95644692"
53920240831,53,2024-08-31,9,309,205,514,Col254_T,"-37.81564191, 144.965499"
301520250713,30,2025-07-13,15,224,563,787,Lon189_T,"-37.8112185, 144.96656806"
25420251002,25,2025-10-02,4,7,4,11,MCEC_T,"-37.82401776, 144.95604426"
52920250123,52,2025-01-23,9,155,153,308,Eli263_T,"-37.81252157, 144.9619401"
522120250508,52,2025-05-08,21,199,188,387,Eli263_T,"-37.81252157, 144.9619401"
511720231206,51,2023-12-06,17,99,129,228,Fra118_T,"-37.80841815, 144.95906316"
191620250925,19,2025-09-25,16,551,435,986,LtB210_T,"-37.81237202, 144.96550671"
164520250219,164,2025-02-19,5,4,2,6,Lat526_T,"-37.813005, 144.95160411"
117620250612,117,2025-06-12,6,44,18,62,Fli114F_T,"-37.81629332, 144.97090877"
1171120241016,117,2024-10-16,11,114,156,270,Fli114F_T,"-37.81629332, 144.97090877"
84920250227,84,2025-02-27,9,1170,413,1583,ElFi_T,"-37.81798049, 144.96503383"
84120250729,84,2025-07-29,1,19,19,38,ElFi_T,"-37.81798049, 144.96503383"
66120240207,66,2024-02-07,1,35,26,61,QVN_T,"-37.81057846, 144.96444294"
4420251001,4,2025-10-01,4,9,22,31,Swa123_T,"-37.81487988, 144.9660878"
70120240920,70,2024-09-20,1,1,2,3,Errol20_T,"-37.80456984, 144.94946228"
701520250214,70,2025-02-14,15,158,142,300,Errol20_T,"-37.80456984, 144.94946228"
411720240427,41,2024-04-27,17,1879,1427,3306,Swa31,"-37.81668634, 144.96689733"
141520231201,14,2023-12-01,15,494,158,652,SanBri_T,"-37.82011242, 144.96291897"
59920250318,59,2025-03-18,9,769,234,1003,RMIT_T,"-37.80825648, 144.96304859"
14720240522,14,2024-05-22,7,228,245,473,SanBri_T,"-37.82011242, 144.96291897"
711220250808,71,2025-08-08,12,19,37,56,WestWP_T,"-37.81235775, 144.97136962"
421520240824,42,2024-08-24,15,99,103,202,UM1_T,"-37.80008566, 144.96386412"
281220240116,28,2024-01-16,12,613,588,1201,VAC_T,"-37.82129925, 144.96879309"
281920250628,28,2025-06-28,19,532,747,1279,VAC_T,"-37.82129925, 144.96879309"
291920240429,29,2024-04-29,19,88,94,182,AG_T,"-37.8199817, 144.96872865"
311520250115,31,2025-01-15,15,148,98,246,Lyg161_T,"-37.80169681, 144.96658911"
54920241123,54,2024-11-23,9,37,19,56,Swa607_T,"-37.804024, 144.96308399"
452220250116,45,2025-01-16,22,241,393,634,Swa148_T,"-37.81414075, 144.96609379"
5420241026,5,2024-10-26,4,11,11,22,PriNW_T,"-37.81874249, 144.96787656"
51620250609,5,2025-06-09,16,922,697,1619,PriNW_T,"-37.81874249, 144.96787656"
51620250713,5,2025-07-13,16,1182,1049,2231,PriNW_T,"-37.81874249, 144.96787656"
372320240816,37,2024-08-16,23,60,107,167,Lyg260_T,"-37.80107122, 144.96704554"
37420241130,37,2024-11-30,4,3,0,3,Lyg260_T,"-37.80107122, 144.96704554"
501920250818,50,2025-08-18,19,142,127,269,Lyg309_T,"-37.79808192, 144.96721013"
1621220250427,162,2025-04-27,12,692,844,1536,Eli489_T,"-37.80740397, 144.95987909"
167020240922,167,2024-09-22,0,4,5,9,Lat526_T,"-37.81304149, 144.95155955"
1812020250616,181,2025-06-16,20,349,397,746,Eli368_T,"-37.81009465, 144.96143149"
1401320240703,140,2024-07-03,13,93,64,157,Boyd2837_T,"-37.82590962, 144.96185972"
182720250616,182,2025-06-16,7,52,67,119,King163_T,"-37.81627451, 144.95550503"
162720240710,162,2024-07-10,7,77,69,146,Eli489_T,"-37.80740397, 144.95987909"
108820250529,108,2025-05-29,8,198,2469,2667,261Will_T,"-37.81295822, 144.95678789"
1321220250416,132,2025-04-16,12,221,171,392,King335_T,"-37.81267639, 144.95386444"
1321320240502,132,2024-05-02,13,217,183,400,King335_T,"-37.81267639, 144.95386444"
1351220240328,135,2024-03-28,12,588,681,1269,Spen161_T,"-37.8172861, 144.95319102"
135420241029,135,2024-10-29,4,15,18,33,Spen161_T,"-37.8172861, 144.95319102"
1352320250904,135,2025-09-04,23,25,54,79,Spen161_T,"-37.8172861, 144.95319102"
1332020240412,133,2024-04-12,20,350,292,642,Spen229_T,"-37.81531435, 144.95227769"
1331320241018,133,2024-10-18,13,582,524,1106,Spen229_T,"-37.81531435, 144.95227769"
118920240125,118,2024-01-25,9,24,17,41,Fli114C_T,"-37.81632783, 144.97090512"
1241420250505,124,2025-05-05,14,3,3,6,BirBridge_T,"-37.81757416, 144.97329934"
482020240222,48,2024-02-22,20,60,154,214,QVMQ_T,"-37.80631581, 144.95866697"
1412220241028,141,2024-10-28,22,39,63,102,474Fl_T,"-37.81997273, 144.95834911"
130120250419,130,2025-04-19,1,1,2,3,Bou892T,"-37.8204637, 144.94126826"
1612120241209,161,2024-12-09,21,1,2,3,BirArt1109_T,"-37.81851276, 144.97131336"
1231720241230,123,2024-12-30,17,78,43,121,BirBridge_T,"-37.81753741, 144.97329734"
1381320250820,138,2025-08-20,13,27,8,35,EntPark1671_T,"-37.81996544, 144.95981454"
661120250222,66,2025-02-22,11,640,918,1558,QVN_T,"-37.81057846, 144.96444294"
66320240828,66,2024-08-28,3,12,3,15,QVN_T,"-37.81057846, 144.96444294"
6620250906,6,2025-09-06,6,85,91,176,FliS_T,"-37.81911705, 144.96558255"
701620231030,70,2023-10-30,16,146,124,270,Errol20_T,"-37.80456984, 144.94946228"
31320241116,3,2024-11-16,13,932,1011,1943,Swa295_T,"-37.81101524, 144.96429485"
3420250726,3,2025-07-26,4,39,40,79,Swa295_T,"-37.81101524, 144.96429485"
391720250319,39,2025-03-19,17,172,94,266,AlfPl_T,"-37.81379749, 144.96995745"
751520231225,75,2023-12-25,15,25,10,35,SprFli_T,"-37.81515276, 144.97467661"
75920240131,75,2024-01-31,9,45,32,77,SprFli_T,"-37.81515276, 144.97467661"
412220240421,41,2024-04-21,22,278,549,827,Swa31,"-37.81668634, 144.96689733"
77020250616,77,2025-06-16,0,5,7,12,HarEsP_T,"-37.81441438, 144.94433026"
591720250910,59,2025-09-10,17,1062,1309,2371,RMIT_T,"-37.80825648, 144.96304859"
141720250730,14,2025-07-30,17,611,147,758,SanBri_T,"-37.82011242, 144.96291897"
712020240527,71,2024-05-27,20,2,2,4,WestWP_T,"-37.81235775, 144.97136962"
42020241006,42,2024-10-06,0,11,21,32,UM1_T,"-37.80008566, 144.96386412"
42720250221,42,2025-02-21,7,27,54,81,UM1_T,"-37.80008566, 144.96386412"
54220231213,54,2023-12-13,2,4,6,10,Swa607_T,"-37.804024, 144.96308399"
401720241111,40,2024-11-11,17,163,202,365,Spr201_T,"-37.80999341, 144.97227587"
40020250619,40,2025-06-19,0,7,4,11,Spr201_T,"-37.80999341, 144.97227587"
402020240609,40,2024-06-09,20,94,63,157,Spr201_T,"-37.80999341, 144.97227587"
362220250821,36,2025-08-21,22,69,99,168,Que85_T,"-37.81652527, 144.96121062"
1082020241024,108,2024-10-24,20,102,142,244,261Will_T,"-37.81295822, 144.95678789"
611820250912,61,2025-09-12,18,385,391,776,RMIT14_T,"-37.80767455, 144.96309114"
50620241024,50,2024-10-24,6,4,18,22,Lyg309_T,"-37.79808192, 144.96721013"
441420250508,44,2025-05-08,14,88,123,211,UM3_T,"-37.79698741, 144.96441306"
179520250222,179,2025-02-22,5,10,3,13,Pow61_T,"-37.82392385, 144.96299677"
842120231104,84,2023-11-04,21,1044,845,1889,ElFi_T,"-37.81798049, 144.96503383"
84920250223,84,2025-02-23,9,515,387,902,ElFi_T,"-37.81798049, 144.96503383"
41820240524,4,2024-05-24,18,1647,765,2412,Swa123_T,"-37.81487988, 144.9660878"
6320250815,6,2025-08-15,3,9,11,20,FliS_T,"-37.81911705, 144.96558255"
41020231101,4,2023-11-01,10,871,513,1384,Swa123_T,"-37.81487988, 144.9660878"
81220240113,8,2024-01-13,12,146,269,415,WebBN_T,"-37.82293543, 144.9471751"
78420231128,78,2023-11-28,4,1,0,1,HarEsB_T,"-37.81471642, 144.9446508"
141020241106,14,2024-11-06,10,317,90,407,SanBri_T,"-37.82011242, 144.96291897"
711120240310,71,2024-03-10,11,5,9,14,WestWP_T,"-37.81235775, 144.97136962"
65720240406,65,2024-04-06,7,42,26,68,SwaCs_T,"-37.81569416, 144.9668064"
422020240714,42,2024-07-14,20,13,16,29,UM1_T,"-37.80008566, 144.96386412"
42820250818,42,2025-08-18,8,232,74,306,UM1_T,"-37.80008566, 144.96386412"
281020250518,28,2025-05-18,10,459,303,762,VAC_T,"-37.82129925, 144.96879309"
401820240911,40,2024-09-11,18,165,177,342,Spr201_T,"-37.80999341, 144.97227587"
311620240131,31,2024-01-31,16,110,77,187,Lyg161_T,"-37.80169681, 144.96658911"
1651220250130,165,2025-01-30,12,61,47,108,Spen475_T,"-37.80953359, 144.94939004"
672120241229,67,2024-12-29,21,211,292,503,FLDegS_T,"-37.81688755, 144.96562569"
681520250924,68,2025-09-24,15,297,321,618,FLDegN_T,"-37.8168479, 144.96559789"
181820241231,18,2024-12-31,18,167,66,233,Col12_T,"-37.81344862, 144.97305353"
63020241114,63,2024-11-14,0,6,50,56,Bou231_T,"-37.81333081, 144.96675571"
11420241203,1,2024-12-03,14,1319,1132,2451,Bou292_T,"-37.81349441, 144.96515323"
861220240925,86,2024-09-25,12,41,36,77,574Qub_T,"-37.80309992, 144.94908064"
111520231220,11,2023-12-20,15,103,113,216,WatCit_T,"-37.81564989, 144.93970694"
67520240615,67,2024-06-15,5,11,3,14,FLDegS_T,"-37.81688755, 144.96562569"
112020250713,11,2025-07-13,20,18,21,39,WatCit_T,"-37.81564989, 144.93970694"
111620250803,11,2025-08-03,16,276,243,519,WatCit_T,"-37.81564989, 144.93970694"
122320250404,12,2025-04-04,23,77,74,151,NewQ_T,"-37.81457988, 144.94292398"
12720241126,12,2024-11-26,7,93,79,172,NewQ_T,"-37.81457988, 144.94292398"
101920250909,10,2025-09-09,19,52,51,103,BouHbr_T,"-37.81876474, 144.94710545"
35220250819,35,2025-08-19,2,2,1,3,SouthB_T,"-37.82018685, 144.96508508"
351920250821,35,2025-08-21,19,810,618,1428,SouthB_T,"-37.82018685, 144.96508508"
2520250803,2,2025-08-03,5,9,18,27,Bou283_T,"-37.81380668, 144.96516718"
91920231205,9,2023-12-05,19,236,77,313,Col700_T,"-37.81982992, 144.95102555"
531220250520,53,2025-05-20,12,832,671,1503,Col254_T,"-37.81564191, 144.965499"
461020240411,46,2024-04-11,10,87,198,285,Pel147_T,"-37.80240719, 144.9615673"
52920241116,52,2024-11-16,9,132,101,233,Eli263_T,"-37.81252157, 144.9619401"
512120250716,51,2025-07-16,21,116,60,176,Fra118_T,"-37.80841815, 144.95906316"
1391420240709,139,2024-07-09,14,16,9,25,Signal1647_T,"-37.81959923, 144.9632832"
1421420240327,142,2024-03-27,14,333,299,632,Hammer1584_T,"-37.81970749, 144.96795734"
130620250912,130,2025-09-12,6,40,2,42,Bou892T,"-37.8204637, 144.94126826"
1611320250218,161,2025-02-18,13,239,247,486,BirArt1109_T,"-37.81851276, 144.97131336"
1381420241114,138,2024-11-14,14,14,7,21,EntPark1671_T,"-37.81996544, 144.95981454"
49520241120,49,2024-11-20,5,27,17,44,Eli501_T,"-37.80730068, 144.95956055"
1092320240821,109,2024-08-21,23,19,29,48,LatWill_T,"-37.81193681, 144.95621105"
180720250626,180,2025-06-26,7,33,13,46,Mac330_T,"-37.79497059, 144.93530329"
61920250212,6,2025-02-12,19,778,637,1415,FliS_T,"-37.81911705, 144.96558255"
39320250601,39,2025-06-01,3,1,2,3,AlfPl_T,"-37.81379749, 144.96995745"
412020231130,41,2023-11-30,20,754,1139,1893,Swa31,"-37.81668634, 144.96689733"
752320250821,75,2025-08-21,23,6,7,13,SprFli_T,"-37.81515276, 144.97467661"
771520250616,77,2025-06-16,15,143,98,241,HarEsP_T,"-37.81441438, 144.94433026"
281020241201,28,2024-12-01,10,348,271,619,VAC_T,"-37.82129925, 144.96879309"
282120250922,28,2025-09-22,21,82,156,238,VAC_T,"-37.82129925, 144.96879309"
281920240628,28,2024-06-28,19,467,579,1046,VAC_T,"-37.82129925, 144.96879309"
28420240827,28,2024-08-27,4,5,39,44,VAC_T,"-37.82129925, 144.96879309"
40820240616,40,2024-06-16,8,17,34,51,Spr201_T,"-37.80999341, 144.97227587"
47620250313,47,2025-03-13,6,51,261,312,Eli250_T,"-37.81258467, 144.9625775"
51720240204,5,2024-02-04,17,1062,647,1709,PriNW_T,"-37.81874249, 144.96787656"
51020241210,5,2024-12-10,10,332,685,1017,PriNW_T,"-37.81874249, 144.96787656"
471120240828,47,2024-08-28,11,425,573,998,Eli250_T,"-37.81258467, 144.9625775"
1072320241021,107,2024-10-21,23,27,48,75,280Will_T,"-37.81246271, 144.95690188"
871820240223,87,2024-02-23,18,130,125,255,Errol23_T,"-37.80454949, 144.94921863"
502020250128,50,2025-01-28,20,160,135,295,Lyg309_T,"-37.79808192, 144.96721013"
43820250912,43,2025-09-12,8,166,69,235,UM2_T,"-37.79844526, 144.96411782"
442020231101,44,2023-11-01,20,23,7,30,UM3_T,"-37.79698741, 144.96441306"
166220250302,166,2025-03-02,2,1,1,2,Spen484_T,"-37.80896733, 144.94931703"
179820250826,179,2025-08-26,8,63,18,81,Pow61_T,"-37.82392385, 144.96299677"
1651220250109,165,2025-01-09,12,43,52,95,Spen475_T,"-37.80953359, 144.94939004"
162820241229,162,2024-12-29,8,198,116,314,Eli489_T,"-37.80740397, 144.95987909"
131620250922,131,2025-09-22,6,27,16,43,King2_T,"-37.82009057, 144.95758725"
131820240729,131,2024-07-29,8,83,25,108,King2_T,"-37.82009057, 144.95758725"
134020250718,134,2025-07-18,0,61,70,131,Spen201_T,"-37.81694221, 144.95303935"
1341420240831,134,2024-08-31,14,373,341,714,Spen201_T,"-37.81694221, 144.95303935"
1351420240425,135,2024-04-25,14,432,435,867,Spen161_T,"-37.8172861, 144.95319102"
107120251004,107,2025-10-04,1,22,23,45,280Will_T,"-37.81246271, 144.95690188"
138720250524,138,2025-05-24,7,1,1,2,EntPark1671_T,"-37.81996544, 144.95981454"
11020240118,1,2024-01-18,10,563,612,1175,Bou292_T,"-37.81349441, 144.96515323"
68220231225,68,2023-12-25,2,3,0,3,FLDegN_T,"-37.8168479, 144.96559789"
68720250823,68,2025-08-23,7,30,26,56,FLDegN_T,"-37.8168479, 144.96559789"
682220240615,68,2024-06-15,22,76,25,101,FLDegN_T,"-37.8168479, 144.96559789"
62820240121,62,2024-01-21,8,51,65,116,Lat224_T,"-37.80996494, 144.96216521"
24920231225,24,2023-12-25,9,221,189,410,Col620_T,"-37.81887963, 144.95449198"
24720241019,24,2024-10-19,7,136,140,276,Col620_T,"-37.81887963, 144.95449198"
72320231106,72,2023-11-06,3,4,8,12,ACMI_T,"-37.81726338, 144.96872809"
58720240317,58,2024-03-17,7,138,214,352,Bou688_T,"-37.81686075, 144.95358075"
9320240727,9,2024-07-27,3,2,11,13,Col700_T,"-37.81982992, 144.95102555"
30620231216,30,2023-12-16,6,34,58,92,Lon189_T,"-37.8112185, 144.96656806"
301220240407,30,2024-04-07,12,297,371,668,Lon189_T,"-37.8112185, 144.96656806"
79320240427,79,2024-04-27,3,48,44,92,FliSS_T,"-37.81794046, 144.96616678"
512020240922,51,2024-09-22,20,53,53,106,Fra118_T,"-37.80841815, 144.95906316"
51420250521,51,2025-05-21,4,1,1,2,Fra118_T,"-37.80841815, 144.95906316"
231620250915,23,2025-09-15,16,162,386,548,Col623_T,"-37.81909256, 144.95452748"
522320250908,52,2025-09-08,23,36,32,68,Eli263_T,"-37.81252157, 144.9619401"
201120240301,20,2024-03-01,11,163,138,301,LtB170_T,"-37.81172914, 144.9682466"
251520240514,25,2024-05-14,15,613,519,1132,MCEC_T,"-37.82401776, 144.95604426"
202020250220,20,2025-02-20,20,256,386,642,LtB170_T,"-37.81172914, 144.9682466"
201720250309,20,2025-03-09,17,427,283,710,LtB170_T,"-37.81172914, 144.9682466"
20320250424,20,2025-04-24,3,3,5,8,LtB170_T,"-37.81172914, 144.9682466"
52420240229,52,2024-02-29,4,4,5,9,Eli263_T,"-37.81252157, 144.9619401"
481120241020,48,2024-10-20,11,502,423,925,QVMQ_T,"-37.80631581, 144.95866697"
1412120240507,141,2024-05-07,21,76,67,143,474Fl_T,"-37.81997273, 144.95834911"
136520240528,136,2024-05-28,5,2,1,3,BirFed1120_T,"-37.8184141, 144.97357915"
871920250617,87,2025-06-17,19,78,75,153,Errol23_T,"-37.80454949, 144.94921863"
452320250603,45,2025-06-03,23,32,74,106,Swa148_T,"-37.81414075, 144.96609379"
1621220250704,162,2025-07-04,12,548,739,1287,Eli489_T,"-37.80740397, 144.95987909"
1621420250320,162,2025-03-20,14,428,716,1144,Eli489_T,"-37.80740397, 144.95987909"
131220250426,131,2025-04-26,2,43,57,100,King2_T,"-37.82009057, 144.95758725"
1321620240615,132,2024-06-15,16,150,161,311,King335_T,"-37.81267639, 144.95386444"
134620250315,134,2025-03-15,6,80,120,200,Spen201_T,"-37.81694221, 144.95303935"
135020240301,135,2024-03-01,0,35,34,69,Spen161_T,"-37.8172861, 144.95319102"
1351220241112,135,2024-11-12,12,542,665,1207,Spen161_T,"-37.8172861, 144.95319102"
1071420241216,107,2024-12-16,14,96,73,169,280Will_T,"-37.81246271, 144.95690188"
1332120240428,133,2024-04-28,21,256,172,428,Spen229_T,"-37.81531435, 144.95227769"
124620250925,124,2025-09-25,6,0,1,1,BirBridge_T,"-37.81757416, 144.97329934"
682120241030,68,2024-10-30,21,50,22,72,FLDegN_T,"-37.8168479, 144.96559789"
682020250514,68,2025-05-14,20,92,86,178,FLDegN_T,"-37.8168479, 144.96559789"
111520240209,11,2024-02-09,15,55,54,109,WatCit_T,"-37.81564989, 144.93970694"
561420231101,56,2023-11-01,14,265,126,391,Lon364_T,"-37.81234775, 144.96153311"
56320240605,56,2024-06-05,3,5,8,13,Lon364_T,"-37.81234775, 144.96153311"
63320240918,63,2024-09-18,3,0,3,3,Bou231_T,"-37.81333081, 144.96675571"
11520250529,11,2025-05-29,5,6,2,8,WatCit_T,"-37.81564989, 144.93970694"
122020250514,12,2025-05-14,20,202,171,373,NewQ_T,"-37.81457988, 144.94292398"
35220231019,35,2023-10-19,2,20,34,54,SouthB_T,"-37.82018685, 144.96508508"
581820250112,58,2025-01-12,18,516,789,1305,Bou688_T,"-37.81686075, 144.95358075"
271320240116,27,2024-01-16,13,146,95,241,Vic_T,"-37.80606888, 144.95644692"
271320240202,27,2024-02-02,13,146,125,271,Vic_T,"-37.80606888, 144.95644692"
91220241011,9,2024-10-11,12,600,478,1078,Col700_T,"-37.81982992, 144.95102555"
531220250503,53,2025-05-03,12,647,472,1119,Col254_T,"-37.81564191, 144.965499"
30120250216,30,2025-02-16,1,221,265,486,Lon189_T,"-37.8112185, 144.96656806"
30420240731,30,2024-07-31,4,8,5,13,Lon189_T,"-37.8112185, 144.96656806"
791720240915,79,2024-09-15,17,357,386,743,FliSS_T,"-37.81794046, 144.96616678"
23820250707,23,2025-07-07,8,784,340,1124,Col623_T,"-37.81909256, 144.95452748"
1391420240829,139,2024-08-29,14,49,53,102,Signal1647_T,"-37.81959923, 144.9632832"
139820250427,139,2025-04-27,8,9,14,23,Signal1647_T,"-37.81959923, 144.9632832"
1361020250210,136,2025-02-10,10,31,29,60,BirFed1120_T,"-37.8184141, 144.97357915"
142020240614,142,2024-06-14,0,11,12,23,Hammer1584_T,"-37.81970749, 144.96795734"
1301020231210,130,2023-12-10,10,11,26,37,Bou892T,"-37.8204637, 144.94126826"
1611320250201,161,2025-02-01,13,291,83,374,BirArt1109_T,"-37.81851276, 144.97131336"
1611320250625,161,2025-06-25,13,70,78,148,BirArt1109_T,"-37.81851276, 144.97131336"
1611220250902,161,2025-09-02,12,172,204,376,BirArt1109_T,"-37.81851276, 144.97131336"
1641720241031,164,2024-10-31,17,135,162,297,Lat526_T,"-37.813005, 144.95160411"
1232220240601,123,2024-06-01,22,2,0,2,BirBridge_T,"-37.81753741, 144.97329734"
1232320240302,123,2024-03-02,23,3,0,3,BirBridge_T,"-37.81753741, 144.97329734"
1091420241119,109,2024-11-19,14,245,183,428,LatWill_T,"-37.81193681, 144.95621105"
1091820250124,109,2025-01-24,18,150,97,247,LatWill_T,"-37.81193681, 144.95621105"
692120240624,69,2024-06-24,21,14,16,30,FLDegC_T,"-37.81687226, 144.96559144"
691220250611,69,2025-06-11,12,278,241,519,FLDegC_T,"-37.81687226, 144.96559144"
62120241129,6,2024-11-29,21,1506,1250,2756,FliS_T,"-37.81911705, 144.96558255"
39320250308,39,2025-03-08,3,5,0,5,AlfPl_T,"-37.81379749, 144.96995745"
75520240816,75,2024-08-16,5,8,1,9,SprFli_T,"-37.81515276, 144.97467661"
75920241211,75,2024-12-11,9,51,39,90,SprFli_T,"-37.81515276, 144.97467661"
1361420231219,136,2023-12-19,14,76,57,133,BirFed1120_T,"-37.8184141, 144.97357915"
136620231222,136,2023-12-22,6,39,28,67,BirFed1120_T,"-37.8184141, 144.97357915"
1421220250221,142,2025-02-21,12,417,531,948,Hammer1584_T,"-37.81970749, 144.96795734"
66320240925,66,2024-09-25,3,51,4,55,QVN_T,"-37.81057846, 144.96444294"
61020240520,6,2024-05-20,10,416,307,723,FliS_T,"-37.81911705, 144.96558255"
6720250418,6,2025-04-18,7,136,92,228,FliS_T,"-37.81911705, 144.96558255"
841620250728,84,2025-07-28,16,776,1421,2197,ElFi_T,"-37.81798049, 144.96503383"
41820240105,4,2024-01-05,18,2063,1331,3394,Swa123_T,"-37.81487988, 144.9660878"
42120241014,4,2024-10-14,21,391,245,636,Swa123_T,"-37.81487988, 144.9660878"
702220250117,70,2025-01-17,22,196,89,285,Errol20_T,"-37.80456984, 144.94946228"
75520240605,75,2024-06-05,5,15,3,18,SprFli_T,"-37.81515276, 144.97467661"
8720240805,8,2024-08-05,7,139,95,234,WebBN_T,"-37.82293543, 144.9471751"
752120251012,75,2025-10-12,21,1,5,6,SprFli_T,"-37.81515276, 144.97467661"
781620250815,78,2025-08-15,16,33,91,124,HarEsB_T,"-37.81471642, 144.9446508"
781720240104,78,2024-01-04,17,73,156,229,HarEsB_T,"-37.81471642, 144.9446508"
652120231107,65,2023-11-07,21,63,219,282,SwaCs_T,"-37.81569416, 144.9668064"
651620240415,65,2024-04-15,16,386,622,1008,SwaCs_T,"-37.81569416, 144.9668064"
422020240811,42,2024-08-11,20,51,46,97,UM1_T,"-37.80008566, 144.96386412"
29320231114,29,2023-11-14,3,1,0,1,AG_T,"-37.8199817, 144.96872865"
402220240327,40,2024-03-27,22,180,33,213,Spr201_T,"-37.80999341, 144.97227587"
36920231230,36,2023-12-30,9,60,56,116,Que85_T,"-37.81652527, 144.96121062"
36720241024,36,2024-10-24,7,126,67,193,Que85_T,"-37.81652527, 144.96121062"
47220240327,47,2024-03-27,2,24,15,39,Eli250_T,"-37.81258467, 144.9625775"
21420240326,21,2024-03-26,4,12,9,21,Bourke155_T,"-37.81267313, 144.96788288"
211620250226,21,2025-02-26,16,266,262,528,Bourke155_T,"-37.81267313, 144.96788288"
1071720240918,107,2024-09-18,17,251,136,387,280Will_T,"-37.81246271, 144.95690188"
871620240709,87,2024-07-09,16,81,81,162,Errol23_T,"-37.80454949, 144.94921863"
611620250909,61,2025-09-09,16,505,783,1288,RMIT14_T,"-37.80767455, 144.96309114"
43020231230,43,2023-12-30,0,5,0,5,UM2_T,"-37.79844526, 144.96411782"
43620250306,43,2025-03-06,6,24,11,35,UM2_T,"-37.79844526, 144.96411782"
1791820250423,179,2025-04-23,18,113,89,202,Pow61_T,"-37.82392385, 144.96299677"
1791620251003,179,2025-10-03,16,82,58,140,Pow61_T,"-37.82392385, 144.96299677"
1652320250906,165,2025-09-06,23,18,17,35,Spen475_T,"-37.80953359, 144.94939004"
167420250912,167,2025-09-12,4,0,1,1,Lat526_T,"-37.81304149, 144.95155955"
131720250421,131,2025-04-21,7,16,36,52,King2_T,"-37.82009057, 144.95758725"
1311320231212,131,2023-12-12,13,157,169,326,King2_T,"-37.82009057, 144.95758725"
131820240701,131,2024-07-01,8,117,44,161,King2_T,"-37.82009057, 144.95758725"
132820240224,132,2024-02-24,8,87,53,140,King335_T,"-37.81267639, 144.95386444"
1341520250616,134,2025-06-16,15,416,407,823,Spen201_T,"-37.81694221, 144.95303935"
135620240331,135,2024-03-31,6,33,19,52,Spen161_T,"-37.8172861, 144.95319102"
1351020231112,135,2023-11-12,10,273,320,593,Spen161_T,"-37.8172861, 144.95319102"
1182020231108,118,2023-11-08,20,1,10,11,Fli114C_T,"-37.81632783, 144.97090512"
67320241020,67,2024-10-20,3,14,44,58,FLDegS_T,"-37.81688755, 144.96562569"
852020250103,85,2025-01-03,20,52,21,73,488Mac_T,"-37.79432415, 144.92973378"
171320240823,17,2024-08-23,13,455,407,862,Col15_T,"-37.81362543, 144.97323591"
17220250804,17,2025-08-04,2,1,1,2,Col15_T,"-37.81362543, 144.97323591"
18020231225,18,2023-12-25,0,1,9,10,Col12_T,"-37.81344862, 144.97305353"
121220240505,12,2024-05-05,12,191,211,402,NewQ_T,"-37.81457988, 144.94292398"
242220250428,24,2025-04-28,22,145,223,368,Col620_T,"-37.81887963, 144.95449198"
56720250915,56,2025-09-15,7,64,74,138,Lon364_T,"-37.81234775, 144.96153311"
72820250223,72,2025-02-23,8,101,62,163,ACMI_T,"-37.81726338, 144.96872809"
72120231107,72,2023-11-07,1,20,26,46,ACMI_T,"-37.81726338, 144.96872809"
722220241006,72,2024-10-06,22,26,130,156,ACMI_T,"-37.81726338, 144.96872809"
91220250524,9,2025-05-24,12,97,167,264,Col700_T,"-37.81982992, 144.95102555"
91620250724,9,2025-07-24,16,2372,216,2588,Col700_T,"-37.81982992, 144.95102555"
772020250220,77,2025-02-20,20,216,161,377,HarEsP_T,"-37.81441438, 144.94433026"
781320240629,78,2024-06-29,13,51,30,81,HarEsB_T,"-37.81471642, 144.9446508"
14020231110,14,2023-11-10,0,60,11,71,SanBri_T,"-37.82011242, 144.96291897"
592220240814,59,2024-08-14,22,150,173,323,RMIT_T,"-37.80825648, 144.96304859"
42320240917,42,2024-09-17,3,8,3,11,UM1_T,"-37.80008566, 144.96386412"
42920250822,42,2025-08-22,9,283,99,382,UM1_T,"-37.80008566, 144.96386412"
42320241228,42,2024-12-28,3,3,1,4,UM1_T,"-37.80008566, 144.96386412"
40020241106,40,2024-11-06,0,8,4,12,Spr201_T,"-37.80999341, 144.97227587"
37820250902,37,2025-09-02,8,19,37,56,Lyg260_T,"-37.80107122, 144.96704554"
451620240613,45,2024-06-13,16,358,640,998,Swa148_T,"-37.81414075, 144.96609379"
371620250220,37,2025-02-20,16,107,129,236,Lyg260_T,"-37.80107122, 144.96704554"
1082020240501,108,2024-05-01,20,63,73,136,261Will_T,"-37.81295822, 144.95678789"
1081620240107,108,2024-01-07,16,48,39,87,261Will_T,"-37.81295822, 144.95678789"
87520241005,87,2024-10-05,5,5,5,10,Errol23_T,"-37.80454949, 144.94921863"
44920241209,44,2024-12-09,9,30,18,48,UM3_T,"-37.79698741, 144.96441306"
442320250802,44,2025-08-02,23,25,9,34,UM3_T,"-37.79698741, 144.96441306"
44020240302,44,2024-03-02,0,2,2,4,UM3_T,"-37.79698741, 144.96441306"
452320250327,45,2025-03-27,23,55,185,240,Swa148_T,"-37.81414075, 144.96609379"
1811020250704,181,2025-07-04,10,291,477,768,Eli368_T,"-37.81009465, 144.96143149"
182720250530,182,2025-05-30,7,46,61,107,King163_T,"-37.81627451, 144.95550503"
1321420240309,132,2024-03-09,14,146,80,226,King335_T,"-37.81267639, 144.95386444"
1341420231214,134,2023-12-14,14,369,361,730,Spen201_T,"-37.81694221, 144.95303935"
135520250330,135,2025-03-30,5,41,46,87,Spen161_T,"-37.8172861, 144.95319102"
1351320240119,135,2024-01-19,13,512,563,1075,Spen161_T,"-37.8172861, 144.95319102"
1071120250928,107,2025-09-28,11,93,106,199,280Will_T,"-37.81246271, 144.95690188"
1181920250809,118,2025-08-09,19,16,3,19,Fli114C_T,"-37.81632783, 144.97090512"
124720240203,124,2024-02-03,7,0,1,1,BirBridge_T,"-37.81757416, 144.97329934"
165320250217,165,2025-02-17,3,3,0,3,Spen475_T,"-37.80953359, 144.94939004"
166020241001,166,2024-10-01,0,0,1,1,Spen484_T,"-37.80896733, 144.94931703"
166520250418,166,2025-04-18,5,0,1,1,Spen484_T,"-37.80896733, 144.94931703"
851220250131,85,2025-01-31,12,125,139,264,488Mac_T,"-37.79432415, 144.92973378"
171120231128,17,2023-11-28,11,400,281,681,Col15_T,"-37.81362543, 144.97323591"
12020231222,1,2023-12-22,20,1005,1741,2746,Bou292_T,"-37.81349441, 144.96515323"
11420240315,1,2024-03-15,14,1239,1135,2374,Bou292_T,"-37.81349441, 144.96515323"
1620241029,1,2024-10-29,6,47,64,111,Bou292_T,"-37.81349441, 144.96515323"
62420240327,62,2024-03-27,4,22,15,37,Lat224_T,"-37.80996494, 144.96216521"
121120250829,12,2025-08-29,11,90,85,175,NewQ_T,"-37.81457988, 144.94292398"
351420231117,35,2023-11-17,14,1018,1173,2191,SouthB_T,"-37.82018685, 144.96508508"
21520250223,2,2025-02-23,15,536,555,1091,Bou283_T,"-37.81380668, 144.96516718"
2120231224,2,2023-12-24,1,27,46,73,Bou283_T,"-37.81380668, 144.96516718"
792020240402,79,2024-04-02,20,246,199,445,FliSS_T,"-37.81794046, 144.96616678"
25420250726,25,2025-07-26,4,10,12,22,MCEC_T,"-37.82401776, 144.95604426"
201720231031,20,2023-10-31,17,291,197,488,LtB170_T,"-37.81172914, 144.9682466"
20620231102,20,2023-11-02,6,16,17,33,LtB170_T,"-37.81172914, 144.9682466"
136820250619,136,2025-06-19,8,136,238,374,BirFed1120_T,"-37.8184141, 144.97357915"
136520240424,136,2024-04-24,5,1,1,2,BirFed1120_T,"-37.8184141, 144.97357915"
1641520250515,164,2025-05-15,15,122,81,203,Lat526_T,"-37.813005, 144.95160411"
138820241006,138,2024-10-06,8,1,0,1,EntPark1671_T,"-37.81996544, 144.95981454"
1612320250218,161,2025-02-18,23,0,8,8,BirArt1109_T,"-37.81851276, 144.97131336"
48620250812,48,2025-08-12,6,30,30,60,QVMQ_T,"-37.80631581, 144.95866697"
1171120240213,117,2024-02-13,11,130,159,289,Fli114F_T,"-37.81629332, 144.97090877"
1802220250910,180,2025-09-10,22,0,3,3,Mac330_T,"-37.79497059, 144.93530329"
691220250818,69,2025-08-18,12,366,323,689,FLDegC_T,"-37.81687226, 144.96559144"
842120241112,84,2024-11-12,21,455,764,1219,ElFi_T,"-37.81798049, 144.96503383"
841220250522,84,2025-05-22,12,923,974,1897,ElFi_T,"-37.81798049, 144.96503383"
392120240828,39,2024-08-28,21,27,21,48,AlfPl_T,"-37.81379749, 144.96995745"
391620240402,39,2024-04-02,16,113,56,169,AlfPl_T,"-37.81379749, 144.96995745"
77120250206,77,2025-02-06,1,4,3,7,HarEsP_T,"-37.81441438, 144.94433026"
59720250530,59,2025-05-30,7,161,64,225,RMIT_T,"-37.80825648, 144.96304859"
71020250115,71,2025-01-15,0,4,3,7,WestWP_T,"-37.81235775, 144.97136962"
651220240122,65,2024-01-22,12,564,599,1163,SwaCs_T,"-37.81569416, 144.9668064"
40320250807,40,2025-08-07,3,2,6,8,Spr201_T,"-37.80999341, 144.97227587"
37120250911,37,2025-09-11,1,1,4,5,Lyg260_T,"-37.80107122, 144.96704554"
401320240925,40,2024-09-25,13,301,236,537,Spr201_T,"-37.80999341, 144.97227587"
5620240311,5,2024-03-11,6,35,58,93,PriNW_T,"-37.81874249, 144.96787656"
51620250523,5,2025-05-23,16,582,443,1025,PriNW_T,"-37.81874249, 144.96787656"
5220250618,5,2025-06-18,2,5,29,34,PriNW_T,"-37.81874249, 144.96787656"
21120231123,21,2023-11-23,1,61,51,112,Bourke155_T,"-37.81267313, 144.96788288"
871220240503,87,2024-05-03,12,177,167,344,Errol23_T,"-37.80454949, 144.94921863"
61720240916,61,2024-09-16,7,221,281,502,RMIT14_T,"-37.80767455, 144.96309114"
1401720250228,140,2025-02-28,17,129,126,255,Boyd2837_T,"-37.82590962, 144.96185972"
124620250105,124,2025-01-05,6,2,6,8,BirBridge_T,"-37.81757416, 144.97329934"
166020250111,166,2025-01-11,0,2,1,3,Spen484_T,"-37.80896733, 144.94931703"
179020250715,179,2025-07-15,0,3,3,6,Pow61_T,"-37.82392385, 144.96299677"
165020250329,165,2025-03-29,0,9,9,18,Spen475_T,"-37.80953359, 144.94939004"
1171520250525,117,2025-05-25,15,216,233,449,Fli114F_T,"-37.81629332, 144.97090877"
491320240427,49,2024-04-27,13,451,848,1299,Eli501_T,"-37.80730068, 144.95956055"
191720241022,19,2024-10-22,17,529,306,835,LtB210_T,"-37.81237202, 144.96550671"
671620240820,67,2024-08-20,16,324,556,880,FLDegS_T,"-37.81688755, 144.96562569"
671920250711,67,2025-07-11,19,332,396,728,FLDegS_T,"-37.81688755, 144.96562569"
1120250413,1,2025-04-13,1,28,72,100,Bou292_T,"-37.81349441, 144.96515323"
121820240512,12,2024-05-12,18,242,252,494,NewQ_T,"-37.81457988, 144.94292398"
86920240124,86,2024-01-24,9,38,26,64,574Qub_T,"-37.80309992, 144.94908064"
11520240822,11,2024-08-22,5,2,3,5,WatCit_T,"-37.81564989, 144.93970694"
562320240405,56,2024-04-05,23,155,216,371,Lon364_T,"-37.81234775, 144.96153311"
121220240819,12,2024-08-19,12,166,176,342,NewQ_T,"-37.81457988, 144.94292398"
10520250711,10,2025-07-11,5,6,5,11,BouHbr_T,"-37.81876474, 144.94710545"
24120241215,24,2024-12-15,1,102,168,270,Col620_T,"-37.81887963, 144.95449198"
35120240310,35,2024-03-10,1,171,275,446,SouthB_T,"-37.82018685, 144.96508508"
21120231114,2,2023-11-14,11,453,496,949,Bou283_T,"-37.81380668, 144.96516718"
532320250511,53,2025-05-11,23,22,33,55,Col254_T,"-37.81564191, 144.965499"
252220251004,25,2025-10-04,22,591,554,1145,MCEC_T,"-37.82401776, 144.95604426"
461920240114,46,2024-01-14,19,33,24,57,Pel147_T,"-37.80240719, 144.9615673"
462220240211,46,2024-02-11,22,11,24,35,Pel147_T,"-37.80240719, 144.9615673"
201720240616,20,2024-06-16,17,259,231,490,LtB170_T,"-37.81172914, 144.9682466"
842320250409,84,2025-04-09,23,201,213,414,ElFi_T,"-37.81798049, 144.96503383"
70820240825,70,2024-08-25,8,32,30,62,Errol20_T,"-37.80456984, 144.94946228"
39820241108,39,2024-11-08,8,100,120,220,AlfPl_T,"-37.81379749, 144.96995745"
751520240308,75,2024-03-08,15,57,62,119,SprFli_T,"-37.81515276, 144.97467661"
8720250913,8,2025-09-13,7,57,76,133,WebBN_T,"-37.82293543, 144.9471751"
771920240202,77,2024-02-02,19,170,115,285,HarEsP_T,"-37.81441438, 144.94433026"
281820231129,28,2023-11-29,18,326,631,957,VAC_T,"-37.82129925, 144.96879309"
401320231030,40,2023-10-30,13,263,199,462,Spr201_T,"-37.80999341, 144.97227587"
51720240809,5,2024-08-09,17,1212,1238,2450,PriNW_T,"-37.81874249, 144.96787656"
501820241111,50,2024-11-11,18,157,195,352,Lyg309_T,"-37.79808192, 144.96721013"
50320240515,50,2024-05-15,3,3,1,4,Lyg309_T,"-37.79808192, 144.96721013"
1071120240825,107,2024-08-25,11,88,166,254,280Will_T,"-37.81246271, 144.95690188"
133920240217,133,2024-02-17,9,396,398,794,Spen229_T,"-37.81531435, 144.95227769"
1331920250530,133,2025-05-30,19,452,541,993,Spen229_T,"-37.81531435, 144.95227769"
108220241220,108,2024-12-20,2,6,12,18,261Will_T,"-37.81295822, 144.95678789"
61020250521,61,2025-05-21,0,38,10,48,RMIT14_T,"-37.80767455, 144.96309114"
1841720250903,184,2025-09-03,17,891,942,1833,Eli124_T,"-37.81512416, 144.96371988"
1661320250621,166,2025-06-21,13,50,34,84,Spen484_T,"-37.80896733, 144.94931703"
135720240626,135,2024-06-26,7,166,173,339,Spen161_T,"-37.8172861, 144.95319102"
1351920250908,135,2025-09-08,19,153,207,360,Spen161_T,"-37.8172861, 144.95319102"
68920241225,68,2024-12-25,9,53,69,122,FLDegN_T,"-37.8168479, 144.96559789"
851920241102,85,2024-11-02,19,75,65,140,488Mac_T,"-37.79432415, 144.92973378"
17020241123,17,2024-11-23,0,28,35,63,Col15_T,"-37.81362543, 144.97323591"
17620250118,17,2025-01-18,6,21,15,36,Col15_T,"-37.81362543, 144.97323591"
12220231222,1,2023-12-22,22,796,1125,1921,Bou292_T,"-37.81349441, 144.96515323"
11120240622,1,2024-06-22,11,1037,960,1997,Bou292_T,"-37.81349441, 144.96515323"
181420231225,18,2023-12-25,14,7,10,17,Col12_T,"-37.81344862, 144.97305353"
18020250727,18,2025-07-27,0,10,20,30,Col12_T,"-37.81344862, 144.97305353"
63020250424,63,2025-04-24,0,2,26,28,Bou231_T,"-37.81333081, 144.96675571"
62120250513,62,2025-05-13,1,38,26,64,Lat224_T,"-37.80996494, 144.96216521"
24220241104,24,2024-11-04,2,17,11,28,Col620_T,"-37.81887963, 144.95449198"
72820240506,72,2024-05-06,8,556,110,666,ACMI_T,"-37.81726338, 144.96872809"
721120240213,72,2024-02-13,11,103,156,259,ACMI_T,"-37.81726338, 144.96872809"
58920250118,58,2025-01-18,9,460,128,588,Bou688_T,"-37.81686075, 144.95358075"
762220250221,76,2025-02-21,22,5,23,28,KenMac_T,"-37.79453803, 144.93036194"
761520251013,76,2025-10-13,15,68,91,159,KenMac_T,"-37.79453803, 144.93036194"
72920251006,72,2025-10-06,9,299,70,369,ACMI_T,"-37.81726338, 144.96872809"
271520250110,27,2025-01-10,15,129,96,225,Vic_T,"-37.80606888, 144.95644692"
2920251008,2,2025-10-08,9,162,295,457,Bou283_T,"-37.81380668, 144.96516718"
301520231223,30,2023-12-23,15,294,399,693,Lon189_T,"-37.8112185, 144.96656806"
53220250417,53,2025-04-17,2,7,3,10,Col254_T,"-37.81564191, 144.965499"
232020240514,23,2024-05-14,20,80,155,235,Col623_T,"-37.81909256, 144.95452748"
23420231220,23,2023-12-20,4,5,5,10,Col623_T,"-37.81909256, 144.95452748"
23220240320,23,2024-03-20,2,2,12,14,Col623_T,"-37.81909256, 144.95452748"
511820240516,51,2024-05-16,18,95,91,186,Fra118_T,"-37.80841815, 144.95906316"
462120240607,46,2024-06-07,21,42,39,81,Pel147_T,"-37.80240719, 144.9615673"
1091120241014,109,2024-10-14,11,133,151,284,LatWill_T,"-37.81193681, 144.95621105"
531820250326,53,2025-03-26,18,448,368,816,Col254_T,"-37.81564191, 144.965499"
79120240913,79,2024-09-13,1,69,66,135,FliSS_T,"-37.81794046, 144.96616678"
251420241126,25,2024-11-26,14,705,784,1489,MCEC_T,"-37.82401776, 144.95604426"
522320231223,52,2023-12-23,23,224,244,468,Eli263_T,"-37.81252157, 144.9619401"
491220240917,49,2024-09-17,12,378,531,909,Eli501_T,"-37.80730068, 144.95956055"
1171820250419,117,2025-04-19,18,205,194,399,Fli114F_T,"-37.81629332, 144.97090877"
109220250129,109,2025-01-29,2,3,6,9,LatWill_T,"-37.81193681, 144.95621105"
481220240823,48,2024-08-23,12,374,285,659,QVMQ_T,"-37.80631581, 144.95866697"
46620240216,46,2024-02-16,6,8,19,27,Pel147_T,"-37.80240719, 144.9615673"
164820240904,164,2024-09-04,8,104,68,172,Lat526_T,"-37.813005, 144.95160411"
1801320250802,180,2025-08-02,13,43,30,73,Mac330_T,"-37.79497059, 144.93530329"
1411820250429,141,2025-04-29,18,100,112,212,474Fl_T,"-37.81997273, 144.95834911"
1392020250410,139,2025-04-10,20,42,36,78,Signal1647_T,"-37.81959923, 144.9632832"
1421420250317,142,2025-03-17,14,584,592,1176,Hammer1584_T,"-37.81970749, 144.96795734"
1422020240322,142,2024-03-22,20,301,157,458,Hammer1584_T,"-37.81970749, 144.96795734"
1301020250813,130,2025-08-13,10,86,38,124,Bou892T,"-37.8204637, 144.94126826"
130820250921,130,2025-09-21,8,19,21,40,Bou892T,"-37.8204637, 144.94126826"
161920241116,161,2024-11-16,9,107,218,325,BirArt1109_T,"-37.81851276, 144.97131336"
1381720240920,138,2024-09-20,17,3,3,6,EntPark1671_T,"-37.81996544, 144.95981454"
841820231208,84,2023-12-08,18,1054,1342,2396,ElFi_T,"-37.81798049, 144.96503383"
41820251001,4,2025-10-01,18,1435,1382,2817,Swa123_T,"-37.81487988, 144.9660878"
702320231110,70,2023-11-10,23,50,33,83,Errol20_T,"-37.80456984, 144.94946228"
702220250908,70,2025-09-08,22,20,20,40,Errol20_T,"-37.80456984, 144.94946228"
701020250917,70,2025-09-17,10,99,90,189,Errol20_T,"-37.80456984, 144.94946228"
751220250503,75,2025-05-03,12,45,57,102,SprFli_T,"-37.81515276, 144.97467661"
8420251006,8,2025-10-06,4,1,0,1,WebBN_T,"-37.82293543, 144.9471751"
771020250110,77,2025-01-10,10,80,58,138,HarEsP_T,"-37.81441438, 144.94433026"
592220231116,59,2023-11-16,22,361,195,556,RMIT_T,"-37.80825648, 144.96304859"
541120231212,54,2023-12-12,11,67,86,153,Swa607_T,"-37.804024, 144.96308399"
40220240116,40,2024-01-16,2,2,1,3,Spr201_T,"-37.80999341, 144.97227587"
471120251010,47,2025-10-10,11,624,731,1355,Eli250_T,"-37.81258467, 144.9625775"
501320250624,50,2025-06-24,13,235,225,460,Lyg309_T,"-37.79808192, 144.96721013"
44920250804,44,2025-08-04,9,74,101,175,UM3_T,"-37.79698741, 144.96441306"
5120240902,5,2024-09-02,1,15,11,26,PriNW_T,"-37.81874249, 144.96787656"
1431720250625,143,2025-06-25,17,135,94,229,Spencer_T,"-37.821728, 144.95557015"
143420250928,143,2025-09-28,4,30,18,48,Spencer_T,"-37.821728, 144.95557015"
1331020250723,133,2025-07-23,10,336,362,698,Spen229_T,"-37.81531435, 144.95227769"
1331220240820,133,2024-08-20,12,478,460,938,Spen229_T,"-37.81531435, 144.95227769"
1071020240727,107,2024-07-27,10,80,87,167,280Will_T,"-37.81246271, 144.95690188"
1071720250124,107,2025-01-24,17,219,129,348,280Will_T,"-37.81246271, 144.95690188"
1182120241018,118,2024-10-18,21,7,8,15,Fli114C_T,"-37.81632783, 144.97090512"
87320250409,87,2025-04-09,3,2,2,4,Errol23_T,"-37.80454949, 144.94921863"
184720250719,184,2025-07-19,7,49,61,110,Eli124_T,"-37.81512416, 144.96371988"
162020241202,162,2024-12-02,0,37,24,61,Eli489_T,"-37.80740397, 144.95987909"
1371920240812,137,2024-08-12,19,1,6,7,BouHbr2353_T,"-37.81894815, 144.94612292"
139920250108,139,2025-01-08,9,22,124,146,Signal1647_T,"-37.81959923, 144.9632832"
1391920231217,139,2023-12-17,19,90,48,138,Signal1647_T,"-37.81959923, 144.9632832"
1421820250325,142,2025-03-25,18,876,388,1264,Hammer1584_T,"-37.81970749, 144.96795734"
1422120250809,142,2025-08-09,21,4,3,7,Hammer1584_T,"-37.81970749, 144.96795734"
130920250401,130,2025-04-01,9,40,32,72,Bou892T,"-37.8204637, 144.94126826"
662220250220,66,2025-02-20,22,488,374,862,QVN_T,"-37.81057846, 144.96444294"
69620250830,69,2025-08-30,6,9,3,12,FLDegC_T,"-37.81687226, 144.96559144"
70020250227,70,2025-02-27,0,5,4,9,Errol20_T,"-37.80456984, 144.94946228"
3920231112,3,2023-11-12,9,221,257,478,Swa295_T,"-37.81101524, 144.96429485"
75620240101,75,2024-01-01,6,3,3,6,SprFli_T,"-37.81515276, 144.97467661"
41420250903,41,2025-09-03,4,6,32,38,Swa31,"-37.81668634, 144.96689733"
14120250920,14,2025-09-20,1,71,15,86,SanBri_T,"-37.82011242, 144.96291897"
59720240513,59,2024-05-13,7,175,98,273,RMIT_T,"-37.80825648, 144.96304859"
281720231025,28,2023-10-25,17,400,794,1194,VAC_T,"-37.82129925, 144.96879309"
281120250903,28,2025-09-03,11,556,415,971,VAC_T,"-37.82129925, 144.96879309"
281220240202,28,2024-02-02,12,587,594,1181,VAC_T,"-37.82129925, 144.96879309"
29720240312,29,2024-03-12,7,127,114,241,AG_T,"-37.8199817, 144.96872865"
472020240107,47,2024-01-07,20,370,393,763,Eli250_T,"-37.81258467, 144.9625775"
451920240624,45,2024-06-24,19,236,460,696,Swa148_T,"-37.81414075, 144.96609379"
451820240314,45,2024-03-14,18,550,990,1540,Swa148_T,"-37.81414075, 144.96609379"
211620250112,21,2025-01-12,16,207,183,390,Bourke155_T,"-37.81267313, 144.96788288"
50820231230,50,2023-12-30,8,16,27,43,Lyg309_T,"-37.79808192, 144.96721013"
431620250207,43,2025-02-07,16,124,100,224,UM2_T,"-37.79844526, 144.96411782"
44720240723,44,2024-07-23,7,20,31,51,UM3_T,"-37.79698741, 144.96441306"
1312320240924,131,2024-09-24,23,37,34,71,King2_T,"-37.82009057, 144.95758725"
1671920241220,167,2024-12-20,19,39,81,120,Lat526_T,"-37.81304149, 144.95155955"
1341220240510,134,2024-05-10,12,336,279,615,Spen201_T,"-37.81694221, 144.95303935"
1351820240822,135,2024-08-22,18,226,294,520,Spen161_T,"-37.8172861, 144.95319102"
135020240929,135,2024-09-29,0,57,52,109,Spen161_T,"-37.8172861, 144.95319102"
1351520231228,135,2023-12-28,15,460,494,954,Spen161_T,"-37.8172861, 144.95319102"
107920240721,107,2024-07-21,9,78,63,141,280Will_T,"-37.81246271, 144.95690188"
133820231028,133,2023-10-28,8,302,337,639,Spen229_T,"-37.81531435, 144.95227769"
1332320240112,133,2024-01-12,23,166,100,266,Spen229_T,"-37.81531435, 144.95227769"
1181520240412,118,2024-04-12,15,35,33,68,Fli114C_T,"-37.81632783, 144.97090512"
185120250909,185,2025-09-09,1,32,18,50,Eli197_T,"-37.81374643, 144.96276183"
1661020241224,166,2024-12-24,10,35,46,81,Spen484_T,"-37.80896733, 144.94931703"
69120251016,69,2025-10-16,1,1,2,3,FLDegC_T,"-37.81687226, 144.96559144"
6620231104,6,2023-11-04,6,55,78,133,FliS_T,"-37.81911705, 144.96558255"
62220240329,6,2024-03-29,22,616,540,1156,FliS_T,"-37.81911705, 144.96558255"
6220250210,6,2025-02-10,2,30,23,53,FliS_T,"-37.81911705, 144.96558255"
84420231018,84,2023-10-18,4,9,19,28,ElFi_T,"-37.81798049, 144.96503383"
661420231102,66,2023-11-02,14,1096,1044,2140,QVN_T,"-37.81057846, 144.96444294"
42220250113,4,2025-01-13,22,605,346,951,Swa123_T,"-37.81487988, 144.9660878"
70220250101,70,2025-01-01,2,2,20,22,Errol20_T,"-37.80456984, 144.94946228"
3020240910,3,2024-09-10,0,151,68,219,Swa295_T,"-37.81101524, 144.96429485"
751020240406,75,2024-04-06,10,34,31,65,SprFli_T,"-37.81515276, 144.97467661"
192020250118,19,2025-01-18,20,677,681,1358,LtB210_T,"-37.81237202, 144.96550671"
49620240828,49,2024-08-28,6,43,31,74,Eli501_T,"-37.80730068, 144.95956055"
481820250527,48,2025-05-27,18,129,141,270,QVMQ_T,"-37.80631581, 144.95866697"
252120231021,25,2023-10-21,21,317,242,559,MCEC_T,"-37.82401776, 144.95604426"
141420250429,141,2025-04-29,4,6,1,7,474Fl_T,"-37.81997273, 144.95834911"
141320251014,141,2025-10-14,3,6,5,11,474Fl_T,"-37.81997273, 144.95834911"
1371520240415,137,2024-04-15,15,16,106,122,BouHbr2353_T,"-37.81894815, 144.94612292"
141620241016,141,2024-10-16,6,30,19,49,474Fl_T,"-37.81997273, 144.95834911"
1422220251009,142,2025-10-09,22,3,4,7,Hammer1584_T,"-37.81970749, 144.96795734"
130820241202,130,2024-12-02,8,15,6,21,Bou892T,"-37.8204637, 144.94126826"
142320231204,142,2023-12-04,3,2,3,5,Hammer1584_T,"-37.81970749, 144.96795734"
1232120240202,123,2024-02-02,21,1,0,1,BirBridge_T,"-37.81753741, 144.97329734"
1231120250207,123,2025-02-07,11,15,22,37,BirBridge_T,"-37.81753741, 144.97329734"
70820250117,70,2025-01-17,8,61,45,106,Errol20_T,"-37.80456984, 144.94946228"
391120241119,39,2024-11-19,11,120,85,205,AlfPl_T,"-37.81379749, 144.96995745"
781520250130,78,2025-01-30,15,42,98,140,HarEsB_T,"-37.81471642, 144.9446508"
781220250423,78,2025-04-23,12,48,64,112,HarEsB_T,"-37.81471642, 144.9446508"
65120240321,65,2024-03-21,1,5,20,25,SwaCs_T,"-37.81569416, 144.9668064"
651420240619,65,2024-06-19,14,756,642,1398,SwaCs_T,"-37.81569416, 144.9668064"
42020250206,42,2025-02-06,0,9,6,15,UM1_T,"-37.80008566, 144.96386412"
421120240721,42,2024-07-21,11,71,60,131,UM1_T,"-37.80008566, 144.96386412"
711520250629,71,2025-06-29,15,14,11,25,WestWP_T,"-37.81235775, 144.97136962"
291420250629,29,2025-06-29,14,296,368,664,AG_T,"-37.8199817, 144.96872865"
541320241113,54,2024-11-13,13,125,108,233,Swa607_T,"-37.804024, 144.96308399"
362320250731,36,2025-07-31,23,27,65,92,Que85_T,"-37.81652527, 144.96121062"
361720240112,36,2024-01-12,17,239,224,463,Que85_T,"-37.81652527, 144.96121062"
37920250309,37,2025-03-09,9,40,31,71,Lyg260_T,"-37.80107122, 144.96704554"
44920250614,44,2025-06-14,9,23,35,58,UM3_T,"-37.79698741, 144.96441306"
431020240810,43,2024-08-10,10,56,69,125,UM2_T,"-37.79844526, 144.96411782"
107620250301,107,2025-03-01,6,7,13,20,280Will_T,"-37.81246271, 144.95690188"
1072320250331,107,2025-03-31,23,33,28,61,280Will_T,"-37.81246271, 144.95690188"
1071420250725,107,2025-07-25,14,132,122,254,280Will_T,"-37.81246271, 144.95690188"
1081820250411,108,2025-04-11,18,441,240,681,261Will_T,"-37.81295822, 144.95678789"
108620241024,108,2024-10-24,6,21,242,263,261Will_T,"-37.81295822, 144.95678789"
872320250923,87,2025-09-23,23,3,13,16,Errol23_T,"-37.80454949, 144.94921863"
87120240701,87,2024-07-01,1,1,0,1,Errol23_T,"-37.80454949, 144.94921863"
611720250507,61,2025-05-07,17,868,816,1684,RMIT14_T,"-37.80767455, 144.96309114"
135820240509,135,2024-05-09,8,316,455,771,Spen161_T,"-37.8172861, 144.95319102"
1351020240928,135,2024-09-28,10,384,596,980,Spen161_T,"-37.8172861, 144.95319102"
1351120251002,135,2025-10-02,11,308,448,756,Spen161_T,"-37.8172861, 144.95319102"
662120250816,66,2025-08-16,21,984,740,1724,QVN_T,"-37.81057846, 144.96444294"
41720240517,4,2024-05-17,17,1666,829,2495,Swa123_T,"-37.81487988, 144.9660878"
3920240222,3,2024-02-22,9,257,497,754,Swa295_T,"-37.81101524, 144.96429485"
701620240801,70,2024-08-01,16,237,218,455,Errol20_T,"-37.80456984, 144.94946228"
67320240225,67,2024-02-25,3,15,28,43,FLDegS_T,"-37.81688755, 144.96562569"
671720231021,67,2023-10-21,17,415,583,998,FLDegS_T,"-37.81688755, 144.96562569"
17220240108,17,2024-01-08,2,6,10,16,Col15_T,"-37.81362543, 144.97323591"
17220240125,17,2024-01-25,2,19,9,28,Col15_T,"-37.81362543, 144.97323591"
171620240316,17,2024-03-16,16,375,191,566,Col15_T,"-37.81362543, 144.97323591"
17820250315,17,2025-03-15,8,32,25,57,Col15_T,"-37.81362543, 144.97323591"
171120250412,17,2025-04-12,11,149,141,290,Col15_T,"-37.81362543, 144.97323591"
1920240303,1,2024-03-03,9,208,281,489,Bou292_T,"-37.81349441, 144.96515323"
621420250621,62,2025-06-21,14,242,217,459,Lat224_T,"-37.80996494, 144.96216521"
562020240722,56,2024-07-22,20,258,290,548,Lon364_T,"-37.81234775, 144.96153311"
17520231216,17,2023-12-16,5,24,8,32,Col15_T,"-37.81362543, 144.97323591"
181720240427,18,2024-04-27,17,34,31,65,Col12_T,"-37.81344862, 144.97305353"
62720250224,62,2025-02-24,7,43,42,85,Lat224_T,"-37.80996494, 144.96216521"
56120241121,56,2024-11-21,1,32,28,60,Lon364_T,"-37.81234775, 144.96153311"
56920250112,56,2025-01-12,9,195,59,254,Lon364_T,"-37.81234775, 144.96153311"
861420240127,86,2024-01-27,14,48,55,103,574Qub_T,"-37.80309992, 144.94908064"
122120240116,12,2024-01-16,21,278,244,522,NewQ_T,"-37.81457988, 144.94292398"
101520250209,10,2025-02-09,15,20,27,47,BouHbr_T,"-37.81876474, 144.94710545"
121720250511,12,2025-05-11,17,249,300,549,NewQ_T,"-37.81457988, 144.94292398"
24820240429,24,2024-04-29,8,2086,267,2353,Col620_T,"-37.81887963, 144.95449198"
241720250102,24,2025-01-02,17,472,943,1415,Col620_T,"-37.81887963, 144.95449198"
10220251002,10,2025-10-02,2,1,0,1,BouHbr_T,"-37.81876474, 144.94710545"
76620250227,76,2025-02-27,6,14,10,24,KenMac_T,"-37.79453803, 144.93036194"
352120240719,35,2024-07-19,21,392,761,1153,SouthB_T,"-37.82018685, 144.96508508"
76020250518,76,2025-05-18,0,0,2,2,KenMac_T,"-37.79453803, 144.93036194"
21820250821,2,2025-08-21,18,836,631,1467,Bou283_T,"-37.81380668, 144.96516718"
27820240816,27,2024-08-16,8,85,86,171,Vic_T,"-37.80606888, 144.95644692"
531820250201,53,2025-02-01,18,310,211,521,Col254_T,"-37.81564191, 144.965499"
9320241106,9,2024-11-06,3,3,5,8,Col700_T,"-37.81982992, 144.95102555"
231320250810,23,2025-08-10,13,140,277,417,Col623_T,"-37.81909256, 144.95452748"
25820241206,25,2024-12-06,8,176,322,498,MCEC_T,"-37.82401776, 144.95604426"
19820231116,19,2023-11-16,8,89,56,145,LtB210_T,"-37.81237202, 144.96550671"
481320250705,48,2025-07-05,13,687,391,1078,QVMQ_T,"-37.80631581, 144.95866697"
20120250622,20,2025-06-22,1,165,237,402,LtB170_T,"-37.81172914, 144.9682466"
1372020231220,137,2023-12-20,20,13,22,35,BouHbr2353_T,"-37.81894815, 144.94612292"
1421120240203,142,2024-02-03,11,380,425,805,Hammer1584_T,"-37.81970749, 144.96795734"
1172120240112,117,2024-01-12,21,148,138,286,Fli114F_T,"-37.81629332, 144.97090877"
1091720240616,109,2024-06-16,17,70,100,170,LatWill_T,"-37.81193681, 144.95621105"
661520240522,66,2024-05-22,15,1156,1175,2331,QVN_T,"-37.81057846, 144.96444294"
32220231117,3,2023-11-17,22,1054,974,2028,Swa295_T,"-37.81101524, 144.96429485"
3720231126,3,2023-11-26,7,52,58,110,Swa295_T,"-37.81101524, 144.96429485"
41620240601,4,2024-06-01,16,1966,1474,3440,Swa123_T,"-37.81487988, 144.9660878"
41820250214,4,2025-02-14,18,2050,1339,3389,Swa123_T,"-37.81487988, 144.9660878"
701220240524,70,2024-05-24,12,159,132,291,Errol20_T,"-37.80456984, 144.94946228"
41620240610,41,2024-06-10,6,95,89,184,Swa31,"-37.81668634, 144.96689733"
8020241225,8,2024-12-25,0,9,2,11,WebBN_T,"-37.82293543, 144.9471751"
14520240415,14,2024-04-15,5,41,31,72,SanBri_T,"-37.82011242, 144.96291897"
71720240823,71,2024-08-23,7,6,1,7,WestWP_T,"-37.81235775, 144.97136962"
59120241230,59,2024-12-30,1,110,10,120,RMIT_T,"-37.80825648, 144.96304859"
401020250803,40,2025-08-03,10,94,86,180,Spr201_T,"-37.80999341, 144.97227587"
40720250510,40,2025-05-10,7,23,20,43,Spr201_T,"-37.80999341, 144.97227587"
31920240305,31,2024-03-05,9,96,99,195,Lyg161_T,"-37.80169681, 144.96658911"
312220240422,31,2024-04-22,22,35,69,104,Lyg161_T,"-37.80169681, 144.96658911"
36120240801,36,2024-08-01,1,5,2,7,Que85_T,"-37.81652527, 144.96121062"
471020240730,47,2024-07-30,10,299,448,747,Eli250_T,"-37.81258467, 144.9625775"
471420240305,47,2024-03-05,14,745,767,1512,Eli250_T,"-37.81258467, 144.9625775"
41620240706,41,2024-07-06,6,39,32,71,Swa31,"-37.81668634, 144.96689733"
771420250428,77,2025-04-28,14,128,66,194,HarEsP_T,"-37.81441438, 144.94433026"
78120250708,78,2025-07-08,1,2,3,5,HarEsB_T,"-37.81471642, 144.9446508"
282120251009,28,2025-10-09,21,485,395,880,VAC_T,"-37.82129925, 144.96879309"
292320240615,29,2024-06-15,23,60,95,155,AG_T,"-37.8199817, 144.96872865"
471420240417,47,2024-04-17,14,638,719,1357,Eli250_T,"-37.81258467, 144.9625775"
451320250101,45,2025-01-01,13,481,673,1154,Swa148_T,"-37.81414075, 144.96609379"
361520240104,36,2024-01-04,15,140,143,283,Que85_T,"-37.81652527, 144.96121062"
36620240225,36,2024-02-25,6,19,11,30,Que85_T,"-37.81652527, 144.96121062"
871920251014,87,2025-10-14,19,120,132,252,Errol23_T,"-37.80454949, 144.94921863"
1082320240305,108,2024-03-05,23,78,38,116,261Will_T,"-37.81295822, 144.95678789"
871220240520,87,2024-05-20,12,154,134,288,Errol23_T,"-37.80454949, 144.94921863"
43020231226,43,2023-12-26,0,1,2,3,UM2_T,"-37.79844526, 144.96411782"
162320250825,162,2025-08-25,3,6,10,16,Eli489_T,"-37.80740397, 144.95987909"
1671020250301,167,2025-03-01,10,33,93,126,Lat526_T,"-37.81304149, 144.95155955"
132620241230,132,2024-12-30,6,20,10,30,King335_T,"-37.81267639, 144.95386444"
1322020231129,132,2023-11-29,20,126,138,264,King335_T,"-37.81267639, 144.95386444"
1341220240717,134,2024-07-17,12,389,350,739,Spen201_T,"-37.81694221, 144.95303935"
134120240406,134,2024-04-06,1,59,54,113,Spen201_T,"-37.81694221, 144.95303935"
135520240830,135,2024-08-30,5,9,6,15,Spen161_T,"-37.8172861, 144.95319102"
1071020240718,107,2024-07-18,10,62,122,184,280Will_T,"-37.81246271, 144.95690188"
108320250625,108,2025-06-25,3,8,8,16,261Will_T,"-37.81295822, 144.95678789"
165620250125,165,2025-01-25,6,5,10,15,Spen475_T,"-37.80953359, 144.94939004"
671020241214,67,2024-12-14,10,396,418,814,FLDegS_T,"-37.81688755, 144.96562569"
671820231022,67,2023-10-22,18,233,281,514,FLDegS_T,"-37.81688755, 144.96562569"
85820240624,85,2024-06-24,8,105,51,156,488Mac_T,"-37.79432415, 144.92973378"
851520250125,85,2025-01-25,15,89,91,180,488Mac_T,"-37.79432415, 144.92973378"
17120250401,17,2025-04-01,1,1,2,3,Col15_T,"-37.81362543, 144.97323591"
17320250730,17,2025-07-30,3,7,4,11,Col15_T,"-37.81362543, 144.97323591"
181720250419,18,2025-04-19,17,55,101,156,Col12_T,"-37.81344862, 144.97305353"
62320250910,62,2025-09-10,3,9,11,20,Lat224_T,"-37.80996494, 144.96216521"
63820250122,63,2025-01-22,8,161,161,322,Bou231_T,"-37.81333081, 144.96675571"
62520231207,62,2023-12-07,5,16,23,39,Lat224_T,"-37.80996494, 144.96216521"
561820250719,56,2025-07-19,18,408,501,909,Lon364_T,"-37.81234775, 144.96153311"
58420250821,58,2025-08-21,4,8,8,16,Bou688_T,"-37.81686075, 144.95358075"
91920231222,9,2023-12-22,19,115,66,181,Col700_T,"-37.81982992, 144.95102555"
53920240624,53,2024-06-24,9,390,278,668,Col254_T,"-37.81564191, 144.965499"
481420231211,48,2023-12-11,14,133,126,259,QVMQ_T,"-37.80631581, 144.95866697"
481320231214,48,2023-12-14,13,387,256,643,QVMQ_T,"-37.80631581, 144.95866697"
48920240301,48,2024-03-01,9,215,142,357,QVMQ_T,"-37.80631581, 144.95866697"
521220250925,52,2025-09-25,12,480,307,787,Eli263_T,"-37.81252157, 144.9619401"
25820240920,25,2024-09-20,8,131,373,504,MCEC_T,"-37.82401776, 144.95604426"
521320250606,52,2025-06-06,13,402,394,796,Eli263_T,"-37.81252157, 144.9619401"
52920241030,52,2024-10-30,9,164,222,386,Eli263_T,"-37.81252157, 144.9619401"
461420250513,46,2025-05-13,14,153,105,258,Pel147_T,"-37.80240719, 144.9615673"
441920250625,44,2025-06-25,19,9,11,20,UM3_T,"-37.79698741, 144.96441306"
441520250719,44,2025-07-19,15,75,41,116,UM3_T,"-37.79698741, 144.96441306"
44020240223,44,2024-02-23,0,9,1,10,UM3_T,"-37.79698741, 144.96441306"
451520241218,45,2024-12-18,15,647,900,1547,Swa148_T,"-37.81414075, 144.96609379"
5820250909,5,2025-09-09,8,252,1046,1298,PriNW_T,"-37.81874249, 144.96787656"
51820241009,5,2024-10-09,18,1181,979,2160,PriNW_T,"-37.81874249, 144.96787656"
5220241023,5,2024-10-23,2,11,10,21,PriNW_T,"-37.81874249, 144.96787656"
143420250705,143,2025-07-05,4,20,6,26,Spencer_T,"-37.821728, 144.95557015"
1341820240417,134,2024-04-17,18,411,364,775,Spen201_T,"-37.81694221, 144.95303935"
1352020240325,135,2024-03-25,20,102,152,254,Spen161_T,"-37.8172861, 144.95319102"
1241920250105,124,2025-01-05,19,1,4,5,BirBridge_T,"-37.81757416, 144.97329934"
1241820250907,124,2025-09-07,18,2,2,4,BirBridge_T,"-37.81757416, 144.97329934"
1181320231220,118,2023-12-20,13,22,26,48,Fli114C_T,"-37.81632783, 144.97090512"
67720240911,67,2024-09-11,7,219,190,409,FLDegS_T,"-37.81688755, 144.96562569"
671220250612,67,2025-06-12,12,551,757,1308,FLDegS_T,"-37.81688755, 144.96562569"
10020240413,10,2024-04-13,0,18,14,32,BouHbr_T,"-37.81876474, 144.94710545"
10020240810,10,2024-08-10,0,24,3,27,BouHbr_T,"-37.81876474, 144.94710545"
101920241124,10,2024-11-24,19,30,23,53,BouHbr_T,"-37.81876474, 144.94710545"
101320250406,10,2025-04-06,13,157,54,211,BouHbr_T,"-37.81876474, 144.94710545"
10520250909,10,2025-09-09,5,2,7,9,BouHbr_T,"-37.81876474, 144.94710545"
721620231111,72,2023-11-11,16,343,532,875,ACMI_T,"-37.81726338, 144.96872809"
92020240327,9,2024-03-27,20,105,32,137,Col700_T,"-37.81982992, 144.95102555"
532320240829,53,2024-08-29,23,25,61,86,Col254_T,"-37.81564191, 144.965499"
271120250326,27,2025-03-26,11,85,112,197,Vic_T,"-37.80606888, 144.95644692"
271420250510,27,2025-05-10,14,247,176,423,Vic_T,"-37.80606888, 144.95644692"
301020240415,30,2024-04-15,10,129,225,354,Lon189_T,"-37.8112185, 144.96656806"
461920231115,46,2023-11-15,19,43,58,101,Pel147_T,"-37.80240719, 144.9615673"
302020251009,30,2025-10-09,20,318,457,775,Lon189_T,"-37.8112185, 144.96656806"
251120231113,25,2023-11-13,11,265,502,767,MCEC_T,"-37.82401776, 144.95604426"
19320240218,19,2024-02-18,3,33,81,114,LtB210_T,"-37.81237202, 144.96550671"
19920240608,19,2024-06-08,9,87,76,163,LtB210_T,"-37.81237202, 144.96550671"
192020250818,19,2025-08-18,20,367,382,749,LtB210_T,"-37.81237202, 144.96550671"
1421120240428,142,2024-04-28,11,568,500,1068,Hammer1584_T,"-37.81970749, 144.96795734"
1422020240914,142,2024-09-14,20,136,79,215,Hammer1584_T,"-37.81970749, 144.96795734"
130920250201,130,2025-02-01,9,92,26,118,Bou892T,"-37.8204637, 144.94126826"
161520241129,161,2024-11-29,5,16,8,24,BirArt1109_T,"-37.81851276, 144.97131336"
691320250516,69,2025-05-16,13,301,339,640,FLDegC_T,"-37.81687226, 144.96559144"
62120241017,6,2024-10-17,21,487,561,1048,FliS_T,"-37.81911705, 144.96558255"
41620231120,4,2023-11-20,16,1535,1351,2886,Swa123_T,"-37.81487988, 144.9660878"
70020231206,70,2023-12-06,0,6,6,12,Errol20_T,"-37.80456984, 144.94946228"
1362320250326,136,2025-03-26,23,1,1,2,BirFed1120_T,"-37.8184141, 144.97357915"
139420231209,139,2023-12-09,4,2,1,3,Signal1647_T,"-37.81959923, 144.9632832"
1421320240520,142,2024-05-20,13,346,252,598,Hammer1584_T,"-37.81970749, 144.96795734"
130720250103,130,2025-01-03,7,10,12,22,Bou892T,"-37.8204637, 144.94126826"
1611020240711,161,2024-07-11,10,131,89,220,BirArt1109_T,"-37.81851276, 144.97131336"
164120250504,164,2025-05-04,1,5,15,20,Lat526_T,"-37.813005, 144.95160411"
164520250601,164,2025-06-01,5,3,2,5,Lat526_T,"-37.813005, 144.95160411"
1171220250531,117,2025-05-31,12,162,157,319,Fli114F_T,"-37.81629332, 144.97090877"
1091020231105,109,2023-11-05,10,102,61,163,LatWill_T,"-37.81193681, 144.95621105"
19820231211,19,2023-12-11,8,75,62,137,LtB210_T,"-37.81237202, 144.96550671"
19620240309,19,2024-03-09,6,12,3,15,LtB210_T,"-37.81237202, 144.96550671"
661420240109,66,2024-01-09,14,1013,959,1972,QVN_T,"-37.81057846, 144.96444294"
31420240529,3,2024-05-29,14,1023,1070,2093,Swa295_T,"-37.81101524, 144.96429485"
3320241128,3,2024-11-28,3,18,12,30,Swa295_T,"-37.81101524, 144.96429485"
771320250501,77,2025-05-01,13,155,111,266,HarEsP_T,"-37.81441438, 144.94433026"
781420241014,78,2024-10-14,14,35,62,97,HarEsB_T,"-37.81471642, 144.9446508"
141120250802,14,2025-08-02,11,301,104,405,SanBri_T,"-37.82011242, 144.96291897"
711220241015,71,2024-10-15,12,40,28,68,WestWP_T,"-37.81235775, 144.97136962"
281120250817,28,2025-08-17,11,799,602,1401,VAC_T,"-37.82129925, 144.96879309"
401920231103,40,2023-11-03,19,73,240,313,Spr201_T,"-37.80999341, 144.97227587"
31920241115,31,2024-11-15,9,76,61,137,Lyg161_T,"-37.80169681, 144.96658911"
54820250312,54,2025-03-12,8,310,45,355,Swa607_T,"-37.804024, 144.96308399"
371620240326,37,2024-03-26,16,85,113,198,Lyg260_T,"-37.80107122, 144.96704554"
471120240423,47,2024-04-23,11,535,602,1137,Eli250_T,"-37.81258467, 144.9625775"
52220241011,5,2024-10-11,22,436,494,930,PriNW_T,"-37.81874249, 144.96787656"
108420240826,108,2024-08-26,4,1,5,6,261Will_T,"-37.81295822, 144.95678789"
61720240623,61,2024-06-23,7,16,48,64,RMIT14_T,"-37.80767455, 144.96309114"
501720231128,50,2023-11-28,17,211,154,365,Lyg309_T,"-37.79808192, 144.96721013"
431120250624,43,2025-06-24,11,136,108,244,UM2_T,"-37.79844526, 144.96411782"
431320250811,43,2025-08-11,13,311,383,694,UM2_T,"-37.79844526, 144.96411782"
431720240607,43,2024-06-07,17,102,181,283,UM2_T,"-37.79844526, 144.96411782"
44520241004,44,2024-10-04,5,0,2,2,UM3_T,"-37.79698741, 144.96441306"
1621520250611,162,2025-06-11,15,302,330,632,Eli489_T,"-37.80740397, 144.95987909"
1811020250807,181,2025-08-07,10,384,595,979,Eli368_T,"-37.81009465, 144.96143149"
1081420250310,108,2025-03-10,14,129,147,276,261Will_T,"-37.81295822, 144.95678789"
1071420250102,107,2025-01-02,14,109,119,228,280Will_T,"-37.81246271, 144.95690188"
1662320250923,166,2025-09-23,23,3,2,5,Spen484_T,"-37.80896733, 144.94931703"
166020241018,166,2024-10-18,0,0,4,4,Spen484_T,"-37.80896733, 144.94931703"
851120250705,85,2025-07-05,11,153,123,276,488Mac_T,"-37.79432415, 144.92973378"
171420240811,17,2024-08-11,14,163,144,307,Col15_T,"-37.81362543, 144.97323591"
682120240926,68,2024-09-26,21,118,47,165,FLDegN_T,"-37.8168479, 144.96559789"
68620231108,68,2023-11-08,6,24,9,33,FLDegN_T,"-37.8168479, 144.96559789"
18620250301,18,2025-03-01,6,4,5,9,Col12_T,"-37.81344862, 144.97305353"
11220250707,1,2025-07-07,12,1414,1314,2728,Bou292_T,"-37.81349441, 144.96515323"
12220231114,12,2023-11-14,2,0,2,2,NewQ_T,"-37.81457988, 144.94292398"
121020240618,12,2024-06-18,10,58,46,104,NewQ_T,"-37.81457988, 144.94292398"
242020241125,24,2024-11-25,20,269,463,732,Col620_T,"-37.81887963, 144.95449198"
10620240427,10,2024-04-27,6,6,5,11,BouHbr_T,"-37.81876474, 144.94710545"
101820241124,10,2024-11-24,18,38,31,69,BouHbr_T,"-37.81876474, 144.94710545"
72420250302,72,2025-03-02,4,7,13,20,ACMI_T,"-37.81726338, 144.96872809"
532020240119,53,2024-01-19,20,307,234,541,Col254_T,"-37.81564191, 144.965499"
532120240326,53,2024-03-26,21,125,297,422,Col254_T,"-37.81564191, 144.965499"
232120240530,23,2024-05-30,21,76,146,222,Col623_T,"-37.81909256, 144.95452748"
461920240225,46,2024-02-25,19,51,66,117,Pel147_T,"-37.80240719, 144.9615673"
252020240720,25,2024-07-20,20,194,223,417,MCEC_T,"-37.82401776, 144.95604426"
201020250422,20,2025-04-22,10,64,103,167,LtB170_T,"-37.81172914, 144.9682466"
137620250812,137,2025-08-12,6,4,1,5,BouHbr2353_T,"-37.81894815, 144.94612292"
1371820240829,137,2024-08-29,18,8,12,20,BouHbr2353_T,"-37.81894815, 144.94612292"
139720240209,139,2024-02-09,7,25,90,115,Signal1647_T,"-37.81959923, 144.9632832"
1361920240528,136,2024-05-28,19,13,0,13,BirFed1120_T,"-37.8184141, 144.97357915"
130820250624,130,2025-06-24,8,20,8,28,Bou892T,"-37.8204637, 144.94126826"
142220240729,142,2024-07-29,2,0,1,1,Hammer1584_T,"-37.81970749, 144.96795734"
691620240119,69,2024-01-19,16,193,224,417,FLDegC_T,"-37.81687226, 144.96559144"
841920240421,84,2024-04-21,19,608,929,1537,ElFi_T,"-37.81798049, 144.96503383"
391720250911,39,2025-09-11,17,131,55,186,AlfPl_T,"-37.81379749, 144.96995745"
75520240919,75,2024-09-19,5,13,4,17,SprFli_T,"-37.81515276, 144.97467661"
42320250131,42,2025-01-31,3,2,9,11,UM1_T,"-37.80008566, 144.96386412"
142220240409,14,2024-04-09,22,152,53,205,SanBri_T,"-37.82011242, 144.96291897"
28020240209,28,2024-02-09,0,22,11,33,VAC_T,"-37.82129925, 144.96879309"
291920241206,29,2024-12-06,19,215,899,1114,AG_T,"-37.8199817, 144.96872865"
29920250307,29,2025-03-07,9,159,298,457,AG_T,"-37.8199817, 144.96872865"
31720240319,31,2024-03-19,7,22,50,72,Lyg161_T,"-37.80169681, 144.96658911"
471820231115,47,2023-11-15,18,1012,824,1836,Eli250_T,"-37.81258467, 144.9625775"
52020241226,5,2024-12-26,20,884,1304,2188,PriNW_T,"-37.81874249, 144.96787656"
51620250515,5,2025-05-15,16,1112,736,1848,PriNW_T,"-37.81874249, 144.96787656"
211620241226,21,2024-12-26,16,291,337,628,Bourke155_T,"-37.81267313, 144.96788288"
501020250216,50,2025-02-16,10,141,162,303,Lyg309_T,"-37.79808192, 144.96721013"
1331920250616,133,2025-06-16,19,268,234,502,Spen229_T,"-37.81531435, 144.95227769"
1182120240725,118,2024-07-25,21,6,7,13,Fli114C_T,"-37.81632783, 144.97090512"
118020250314,118,2025-03-14,0,0,3,3,Fli114C_T,"-37.81632783, 144.97090512"
1081720250514,108,2025-05-14,17,1832,326,2158,261Will_T,"-37.81295822, 144.95678789"
108220241108,108,2024-11-08,2,2,6,8,261Will_T,"-37.81295822, 144.95678789"
87220240504,87,2024-05-04,2,3,0,3,Errol23_T,"-37.80454949, 144.94921863"
611320250505,61,2025-05-05,13,749,698,1447,RMIT14_T,"-37.80767455, 144.96309114"
61920240117,61,2024-01-17,9,81,185,266,RMIT14_T,"-37.80767455, 144.96309114"
1651220250512,165,2025-05-12,12,31,31,62,Spen475_T,"-37.80953359, 144.94939004"
1661920250522,166,2025-05-22,19,32,41,73,Spen484_T,"-37.80896733, 144.94931703"
167720250318,167,2025-03-18,7,16,76,92,Lat526_T,"-37.81304149, 144.95155955"
1431320250717,143,2025-07-17,13,192,259,451,Spencer_T,"-37.821728, 144.95557015"
691420240711,69,2024-07-11,14,253,238,491,FLDegC_T,"-37.81687226, 144.96559144"
84620231130,84,2023-11-30,6,258,129,387,ElFi_T,"-37.81798049, 144.96503383"
8720250707,8,2025-07-07,7,95,54,149,WebBN_T,"-37.82293543, 144.9471751"
781320240603,78,2024-06-03,13,18,44,62,HarEsB_T,"-37.81471642, 144.9446508"
711920240906,71,2024-09-06,19,12,14,26,WestWP_T,"-37.81235775, 144.97136962"
541720240418,54,2024-04-18,17,229,525,754,Swa607_T,"-37.804024, 144.96308399"
281620240729,28,2024-07-29,16,265,847,1112,VAC_T,"-37.82129925, 144.96879309"
471120240103,47,2024-01-03,11,563,793,1356,Eli250_T,"-37.81258467, 144.9625775"
441020241128,44,2024-11-28,10,34,35,69,UM3_T,"-37.79698741, 144.96441306"
451420250910,45,2025-09-10,14,354,628,982,Swa148_T,"-37.81414075, 144.96609379"
452120241030,45,2024-10-30,21,141,436,577,Swa148_T,"-37.81414075, 144.96609379"
21820240828,21,2024-08-28,8,86,121,207,Bourke155_T,"-37.81267313, 144.96788288"
21820250205,21,2025-02-05,8,59,81,140,Bourke155_T,"-37.81267313, 144.96788288"
362020240123,36,2024-01-23,20,98,149,247,Que85_T,"-37.81652527, 144.96121062"
36320240328,36,2024-03-28,3,3,4,7,Que85_T,"-37.81652527, 144.96121062"
1431020241224,143,2024-12-24,10,133,148,281,Spencer_T,"-37.821728, 144.95557015"
1401520240412,140,2024-04-12,15,98,93,191,Boyd2837_T,"-37.82590962, 144.96185972"
1321620250225,132,2025-02-25,16,172,149,321,King335_T,"-37.81267639, 144.95386444"
1321720250909,132,2025-09-09,17,202,193,395,King335_T,"-37.81267639, 144.95386444"
1342020250227,134,2025-02-27,20,377,326,703,Spen201_T,"-37.81694221, 144.95303935"
1311620241013,131,2024-10-13,16,166,77,243,King2_T,"-37.82009057, 144.95758725"
1071420250811,107,2025-08-11,14,199,184,383,280Will_T,"-37.81246271, 144.95690188"
1071020231210,107,2023-12-10,10,58,118,176,280Will_T,"-37.81246271, 144.95690188"
1082320241202,108,2024-12-02,23,36,32,68,261Will_T,"-37.81295822, 144.95678789"
108120250216,108,2025-02-16,1,18,16,34,261Will_T,"-37.81295822, 144.95678789"
108520250316,108,2025-03-16,5,26,10,36,261Will_T,"-37.81295822, 144.95678789"
87820250503,87,2025-05-03,8,75,55,130,Errol23_T,"-37.80454949, 144.94921863"
871220241011,87,2024-10-11,12,151,154,305,Errol23_T,"-37.80454949, 144.94921863"
1841920250922,184,2025-09-22,19,276,586,862,Eli124_T,"-37.81512416, 144.96371988"
167620250926,167,2025-09-26,6,2,14,16,Lat526_T,"-37.81304149, 144.95155955"
1311220250727,131,2025-07-27,12,165,169,334,King2_T,"-37.82009057, 144.95758725"
671320240103,67,2024-01-03,13,484,657,1141,FLDegS_T,"-37.81688755, 144.96562569"
681820250701,68,2025-07-01,18,151,89,240,FLDegN_T,"-37.8168479, 144.96559789"
851620240107,85,2024-01-07,16,30,30,60,488Mac_T,"-37.79432415, 144.92973378"
851920240525,85,2024-05-25,19,55,56,111,488Mac_T,"-37.79432415, 144.92973378"
172320240505,17,2024-05-05,23,16,11,27,Col15_T,"-37.81362543, 144.97323591"
171420250913,17,2025-09-13,14,191,138,329,Col15_T,"-37.81362543, 144.97323591"
681620250214,68,2025-02-14,16,266,226,492,FLDegN_T,"-37.8168479, 144.96559789"
68620240513,68,2024-05-13,6,6,3,9,FLDegN_T,"-37.8168479, 144.96559789"
62220250411,62,2025-04-11,2,33,16,49,Lat224_T,"-37.80996494, 144.96216521"
62120250729,62,2025-07-29,1,23,34,57,Lat224_T,"-37.80996494, 144.96216521"
861620250425,86,2025-04-25,16,26,38,64,574Qub_T,"-37.80309992, 144.94908064"
111220231217,11,2023-12-17,12,198,241,439,WatCit_T,"-37.81564989, 144.93970694"
12020231025,12,2023-10-25,0,21,7,28,NewQ_T,"-37.81457988, 144.94292398"
24820250413,24,2025-04-13,8,302,149,451,Col620_T,"-37.81887963, 144.95449198"
562220250910,56,2025-09-10,22,68,132,200,Lon364_T,"-37.81234775, 144.96153311"
21620231027,2,2023-10-27,16,753,737,1490,Bou283_T,"-37.81380668, 144.96516718"
58820231129,58,2023-11-29,8,1321,183,1504,Bou688_T,"-37.81686075, 144.95358075"
271220240211,27,2024-02-11,12,246,182,428,Vic_T,"-37.80606888, 144.95644692"
301120240202,30,2024-02-02,11,123,197,320,Lon189_T,"-37.8112185, 144.96656806"
251320231127,25,2023-11-27,13,616,735,1351,MCEC_T,"-37.82401776, 144.95604426"
68220250214,68,2025-02-14,2,1,0,1,FLDegN_T,"-37.8168479, 144.96559789"
561520240425,56,2024-04-25,15,285,287,572,Lon364_T,"-37.81234775, 144.96153311"
722020231202,72,2023-12-02,20,348,478,826,ACMI_T,"-37.81726338, 144.96872809"
35620231116,35,2023-11-16,6,284,290,574,SouthB_T,"-37.82018685, 144.96508508"
761420250731,76,2025-07-31,14,32,51,83,KenMac_T,"-37.79453803, 144.93036194"
35420250813,35,2025-08-13,4,5,3,8,SouthB_T,"-37.82018685, 144.96508508"
21520240709,2,2024-07-09,15,505,508,1013,Bou283_T,"-37.81380668, 144.96516718"
582020250323,58,2025-03-23,20,227,251,478,Bou688_T,"-37.81686075, 144.95358075"
271820241224,27,2024-12-24,18,91,66,157,Vic_T,"-37.80606888, 144.95644692"
192220241207,19,2024-12-07,22,494,520,1014,LtB210_T,"-37.81237202, 144.96550671"
1371920250605,137,2025-06-05,19,2,20,22,BouHbr2353_T,"-37.81894815, 144.94612292"
137320240214,137,2024-02-14,3,0,1,1,BouHbr2353_T,"-37.81894815, 144.94612292"
136020240627,136,2024-06-27,0,0,3,3,BirFed1120_T,"-37.8184141, 144.97357915"
164020250701,164,2025-07-01,0,9,10,19,Lat526_T,"-37.813005, 144.95160411"
123020250508,123,2025-05-08,0,0,1,1,BirBridge_T,"-37.81753741, 144.97329734"
6020251003,6,2025-10-03,0,54,53,107,FliS_T,"-37.81911705, 144.96558255"
702120240305,70,2024-03-05,21,136,121,257,Errol20_T,"-37.80456984, 144.94946228"
70220240430,70,2024-04-30,2,1,1,2,Errol20_T,"-37.80456984, 144.94946228"
702120240830,70,2024-08-30,21,98,81,179,Errol20_T,"-37.80456984, 144.94946228"
70820240903,70,2024-09-03,8,79,72,151,Errol20_T,"-37.80456984, 144.94946228"
391920240413,39,2024-04-13,19,77,61,138,AlfPl_T,"-37.81379749, 144.96995745"
82120231224,8,2023-12-24,21,5,6,11,WebBN_T,"-37.82293543, 144.9471751"
411820241205,41,2024-12-05,18,1469,1823,3292,Swa31,"-37.81668634, 144.96689733"
77620250807,77,2025-08-07,6,24,43,67,HarEsP_T,"-37.81441438, 144.94433026"
781320240405,78,2024-04-05,13,50,61,111,HarEsB_T,"-37.81471642, 144.9446508"
781120241210,78,2024-12-10,11,42,43,85,HarEsB_T,"-37.81471642, 144.9446508"
78320250528,78,2025-05-28,3,0,2,2,HarEsB_T,"-37.81471642, 144.9446508"
71520250213,71,2025-02-13,5,7,3,10,WestWP_T,"-37.81235775, 144.97136962"
651520240729,65,2024-07-29,15,605,592,1197,SwaCs_T,"-37.81569416, 144.9668064"
28720250215,28,2025-02-15,7,41,54,95,VAC_T,"-37.82129925, 144.96879309"
40020250606,40,2025-06-06,0,7,11,18,Spr201_T,"-37.80999341, 144.97227587"
401820250326,40,2025-03-26,18,187,353,540,Spr201_T,"-37.80999341, 144.97227587"
401820250412,40,2025-04-12,18,120,259,379,Spr201_T,"-37.80999341, 144.97227587"
542320240519,54,2024-05-19,23,27,43,70,Swa607_T,"-37.804024, 144.96308399"
37720241021,37,2024-10-21,7,11,11,22,Lyg260_T,"-37.80107122, 144.96704554"
872220250628,87,2025-06-28,22,24,26,50,Errol23_T,"-37.80454949, 144.94921863"
441420251014,44,2025-10-14,14,130,93,223,UM3_T,"-37.79698741, 144.96441306"
43520241203,43,2024-12-03,5,1,1,2,UM2_T,"-37.79844526, 144.96411782"
451120250528,45,2025-05-28,11,470,394,864,Swa148_T,"-37.81414075, 144.96609379"
1811820250424,181,2025-04-24,18,1081,1135,2216,Eli368_T,"-37.81009465, 144.96143149"
140920240626,140,2024-06-26,9,95,34,129,Boyd2837_T,"-37.82590962, 144.96185972"
481720240715,48,2024-07-15,17,103,115,218,QVMQ_T,"-37.80631581, 144.95866697"
481420240822,48,2024-08-22,14,343,189,532,QVMQ_T,"-37.80631581, 144.95866697"
481720240222,48,2024-02-22,17,136,182,318,QVMQ_T,"-37.80631581, 144.95866697"
201720240712,20,2024-07-12,17,526,333,859,LtB170_T,"-37.81172914, 144.9682466"
201420240825,20,2024-08-25,14,230,418,648,LtB170_T,"-37.81172914, 144.9682466"
20820241130,20,2024-11-30,8,14,17,31,LtB170_T,"-37.81172914, 144.9682466"
52820250416,52,2025-04-16,8,137,196,333,Eli263_T,"-37.81252157, 144.9619401"
49820250815,49,2025-08-15,8,115,217,332,Eli501_T,"-37.80730068, 144.95956055"
1371320240713,137,2024-07-13,13,8,17,25,BouHbr2353_T,"-37.81894815, 144.94612292"
139620241009,139,2024-10-09,6,5,18,23,Signal1647_T,"-37.81959923, 144.9632832"
1301620240530,130,2024-05-30,16,9,7,16,Bou892T,"-37.8204637, 144.94126826"
130520241231,130,2024-12-31,5,1,0,1,Bou892T,"-37.8204637, 144.94126826"
138620250214,138,2025-02-14,6,1,0,1,EntPark1671_T,"-37.81996544, 144.95981454"
117720250321,117,2025-03-21,7,75,44,119,Fli114F_T,"-37.81629332, 144.97090877"
1091720231101,109,2023-11-01,17,481,165,646,LatWill_T,"-37.81193681, 144.95621105"
662120241014,66,2024-10-14,21,677,511,1188,QVN_T,"-37.81057846, 144.96444294"
4720240425,4,2024-04-25,7,587,141,728,Swa123_T,"-37.81487988, 144.9660878"
701620240430,70,2024-04-30,16,140,120,260,Errol20_T,"-37.80456984, 144.94946228"
702020250426,70,2025-04-26,20,95,128,223,Errol20_T,"-37.80456984, 144.94946228"
39020250322,39,2025-03-22,0,5,4,9,AlfPl_T,"-37.81379749, 144.96995745"
392020250528,39,2025-05-28,20,14,9,23,AlfPl_T,"-37.81379749, 144.96995745"
391320240314,39,2024-03-14,13,239,294,533,AlfPl_T,"-37.81379749, 144.96995745"
412220231028,41,2023-10-28,22,1052,975,2027,Swa31,"-37.81668634, 144.96689733"
78020240628,78,2024-06-28,0,4,7,11,HarEsB_T,"-37.81471642, 144.9446508"
77020240320,77,2024-03-20,0,1,0,1,HarEsP_T,"-37.81441438, 144.94433026"
77120250111,77,2025-01-11,1,7,11,18,HarEsP_T,"-37.81441438, 144.94433026"
142120231115,14,2023-11-15,21,286,100,386,SanBri_T,"-37.82011242, 144.96291897"
651020240904,65,2024-09-04,10,544,278,822,SwaCs_T,"-37.81569416, 144.9668064"
591120241017,59,2024-10-17,11,726,716,1442,RMIT_T,"-37.80825648, 144.96304859"
54420240428,54,2024-04-28,4,5,3,8,Swa607_T,"-37.804024, 144.96308399"
312220250319,31,2025-03-19,22,88,153,241,Lyg161_T,"-37.80169681, 144.96658911"
372120240622,37,2024-06-22,21,370,407,777,Lyg260_T,"-37.80107122, 144.96704554"
61120240418,61,2024-04-18,1,20,16,36,RMIT14_T,"-37.80767455, 144.96309114"
431520240704,43,2024-07-04,15,72,126,198,UM2_T,"-37.79844526, 144.96411782"
45220250128,45,2025-01-28,2,11,15,26,Swa148_T,"-37.81414075, 144.96609379"
45320250406,45,2025-04-06,3,9,44,53,Swa148_T,"-37.81414075, 144.96609379"
51020240122,5,2024-01-22,10,562,853,1415,PriNW_T,"-37.81874249, 144.96787656"
1431420240611,143,2024-06-11,14,95,182,277,Spencer_T,"-37.821728, 144.95557015"
1322020250413,132,2025-04-13,20,109,86,195,King335_T,"-37.81267639, 144.95386444"
1351220250708,135,2025-07-08,12,426,458,884,Spen161_T,"-37.8172861, 144.95319102"
1311020250103,131,2025-01-03,10,100,136,236,King2_T,"-37.82009057, 144.95758725"
1352120240514,135,2024-05-14,21,92,89,181,Spen161_T,"-37.8172861, 144.95319102"
1081020240424,108,2024-04-24,10,119,451,570,261Will_T,"-37.81295822, 144.95678789"
182620251010,182,2025-10-10,6,38,56,94,King163_T,"-37.81627451, 144.95550503"
1671420250617,167,2025-06-17,14,35,53,88,Lat526_T,"-37.81304149, 144.95155955"
67420240814,67,2024-08-14,4,1,2,3,FLDegS_T,"-37.81688755, 144.96562569"
852220250103,85,2025-01-03,22,9,13,22,488Mac_T,"-37.79432415, 144.92973378"
172320241220,17,2024-12-20,23,37,87,124,Col15_T,"-37.81362543, 144.97323591"
681020240817,68,2024-08-17,10,173,126,299,FLDegN_T,"-37.8168479, 144.96559789"
1401320250131,140,2025-01-31,13,83,62,145,Boyd2837_T,"-37.82590962, 144.96185972"
1621320240720,162,2024-07-20,13,462,886,1348,Eli489_T,"-37.80740397, 144.95987909"
1321120241013,132,2024-10-13,11,185,108,293,King335_T,"-37.81267639, 144.95386444"
1071020231029,107,2023-10-29,10,66,92,158,280Will_T,"-37.81246271, 144.95690188"
132720240422,132,2024-04-22,7,73,39,112,King335_T,"-37.81267639, 144.95386444"
1341720250313,134,2025-03-13,17,810,639,1449,Spen201_T,"-37.81694221, 144.95303935"
1311020240320,131,2024-03-20,10,101,116,217,King2_T,"-37.82009057, 144.95758725"
1351020250825,135,2025-08-25,10,321,369,690,Spen161_T,"-37.8172861, 144.95319102"
1072320240711,107,2024-07-11,23,22,12,34,280Will_T,"-37.81246271, 144.95690188"
1071420250526,107,2025-05-26,14,130,112,242,280Will_T,"-37.81246271, 144.95690188"
1071420250819,107,2025-08-19,14,145,174,319,280Will_T,"-37.81246271, 144.95690188"
1662020250619,166,2025-06-19,20,4,7,11,Spen484_T,"-37.80896733, 144.94931703"
171420240621,17,2024-06-21,14,339,385,724,Col15_T,"-37.81362543, 144.97323591"
18620240628,18,2024-06-28,6,0,3,3,Col12_T,"-37.81344862, 144.97305353"
861420240430,86,2024-04-30,14,36,57,93,574Qub_T,"-37.80309992, 144.94908064"
24920231113,24,2023-11-13,9,825,228,1053,Col620_T,"-37.81887963, 144.95449198"
121920250130,12,2025-01-30,19,214,261,475,NewQ_T,"-37.81457988, 144.94292398"
721320240418,72,2024-04-18,13,322,375,697,ACMI_T,"-37.81726338, 144.96872809"
761420250920,76,2025-09-20,14,48,76,124,KenMac_T,"-37.79453803, 144.93036194"
351020250523,35,2025-05-23,10,539,504,1043,SouthB_T,"-37.82018685, 144.96508508"
272220251011,27,2025-10-11,22,143,62,205,Vic_T,"-37.80606888, 144.95644692"
9020240914,9,2024-09-14,0,13,17,30,Col700_T,"-37.81982992, 144.95102555"
53820241218,53,2024-12-18,8,352,254,606,Col254_T,"-37.81564191, 144.965499"
301320250313,30,2025-03-13,13,313,410,723,Lon189_T,"-37.8112185, 144.96656806"
79320250120,79,2025-01-20,3,9,13,22,FliSS_T,"-37.81794046, 144.96616678"
791720250726,79,2025-07-26,17,917,449,1366,FliSS_T,"-37.81794046, 144.96616678"
48120240610,48,2024-06-10,1,13,17,30,QVMQ_T,"-37.80631581, 144.95866697"
201820240704,20,2024-07-04,18,416,449,865,LtB170_T,"-37.81172914, 144.9682466"
201020241009,20,2024-10-09,10,105,113,218,LtB170_T,"-37.81172914, 144.9682466"
139920241101,139,2024-11-01,9,23,99,122,Signal1647_T,"-37.81959923, 144.9632832"
1301620240505,130,2024-05-05,16,10,20,30,Bou892T,"-37.8204637, 144.94126826"
1611320241125,161,2024-11-25,13,61,69,130,BirArt1109_T,"-37.81851276, 144.97131336"
123720231128,123,2023-11-28,7,30,8,38,BirBridge_T,"-37.81753741, 144.97329734"
49820240402,49,2024-04-02,8,116,124,240,Eli501_T,"-37.80730068, 144.95956055"
1091420240826,109,2024-08-26,14,246,131,377,LatWill_T,"-37.81193681, 144.95621105"
491120240102,49,2024-01-02,11,296,346,642,Eli501_T,"-37.80730068, 144.95956055"
702020231022,70,2023-10-22,20,86,60,146,Errol20_T,"-37.80456984, 144.94946228"
39520250826,39,2025-08-26,5,18,6,24,AlfPl_T,"-37.81379749, 144.96995745"
75520231127,75,2023-11-27,5,2,5,7,SprFli_T,"-37.81515276, 144.97467661"
75520231214,75,2023-12-14,5,11,3,14,SprFli_T,"-37.81515276, 144.97467661"
41620250203,41,2025-02-03,6,446,133,579,Swa31,"-37.81668634, 144.96689733"
771820250720,77,2025-07-20,18,171,106,277,HarEsP_T,"-37.81441438, 144.94433026"
78820250102,78,2025-01-02,8,47,40,87,HarEsB_T,"-37.81471642, 144.9446508"
781420231222,78,2023-12-22,14,55,102,157,HarEsB_T,"-37.81471642, 144.9446508"
712020240114,71,2024-01-14,20,2,1,3,WestWP_T,"-37.81235775, 144.97136962"
71420231201,71,2023-12-01,4,1,0,1,WestWP_T,"-37.81235775, 144.97136962"
42520240807,42,2024-08-07,5,10,3,13,UM1_T,"-37.80008566, 144.96386412"
42720250422,42,2025-04-22,7,31,45,76,UM1_T,"-37.80008566, 144.96386412"
41220250108,4,2025-01-08,12,2302,1452,3754,Swa123_T,"-37.81487988, 144.9660878"
8020250605,8,2025-06-05,0,0,1,1,WebBN_T,"-37.82293543, 144.9471751"
65620231127,65,2023-11-27,6,65,33,98,SwaCs_T,"-37.81569416, 144.9668064"
652220231208,65,2023-12-08,22,140,665,805,SwaCs_T,"-37.81569416, 144.9668064"
14520240303,14,2024-03-03,5,43,31,74,SanBri_T,"-37.82011242, 144.96291897"
14220240611,14,2024-06-11,2,3,1,4,SanBri_T,"-37.82011242, 144.96291897"
312320240622,31,2024-06-22,23,90,205,295,Lyg161_T,"-37.80169681, 144.96658911"
541320241208,54,2024-12-08,13,98,73,171,Swa607_T,"-37.804024, 144.96308399"
28020231220,28,2023-12-20,0,48,23,71,VAC_T,"-37.82129925, 144.96879309"
472220251004,47,2025-10-04,22,486,309,795,Eli250_T,"-37.81258467, 144.9625775"
47220240707,47,2024-07-07,2,58,67,125,Eli250_T,"-37.81258467, 144.9625775"
36820250228,36,2025-02-28,8,202,141,343,Que85_T,"-37.81652527, 144.96121062"
501620250816,50,2025-08-16,16,230,198,428,Lyg309_T,"-37.79808192, 144.96721013"
442220241101,44,2024-11-01,22,5,9,14,UM3_T,"-37.79698741, 144.96441306"
45920250406,45,2025-04-06,9,152,257,409,Swa148_T,"-37.81414075, 144.96609379"
1071520231207,107,2023-12-07,15,138,138,276,280Will_T,"-37.81246271, 144.95690188"
107920240514,107,2024-05-14,9,92,200,292,280Will_T,"-37.81246271, 144.95690188"
1341120240106,134,2024-01-06,11,223,273,496,Spen201_T,"-37.81694221, 144.95303935"
118020241123,118,2024-11-23,0,5,6,11,Fli114C_T,"-37.81632783, 144.97090512"
871020250127,87,2025-01-27,10,66,61,127,Errol23_T,"-37.80454949, 144.94921863"
61120250918,61,2025-09-18,1,16,9,25,RMIT14_T,"-37.80767455, 144.96309114"
61220240618,61,2024-06-18,2,3,4,7,RMIT14_T,"-37.80767455, 144.96309114"
1841120250715,184,2025-07-15,11,742,730,1472,Eli124_T,"-37.81512416, 144.96371988"
1672320250621,167,2025-06-21,23,10,19,29,Lat526_T,"-37.81304149, 144.95155955"
1311820250316,131,2025-03-16,18,151,81,232,King2_T,"-37.82009057, 144.95758725"
1311320250528,131,2025-05-28,13,106,122,228,King2_T,"-37.82009057, 144.95758725"
1431120240617,143,2024-06-17,11,98,154,252,Spencer_T,"-37.821728, 144.95557015"
1322120240731,132,2024-07-31,21,62,106,168,King335_T,"-37.81267639, 144.95386444"
1341920250908,134,2025-09-08,19,323,327,650,Spen201_T,"-37.81694221, 144.95303935"
63220250427,63,2025-04-27,2,11,158,169,Bou231_T,"-37.81333081, 144.96675571"
11720250303,1,2025-03-03,17,1295,857,2152,Bou292_T,"-37.81349441, 144.96515323"
62620250101,62,2025-01-01,6,26,5,31,Lat224_T,"-37.80996494, 144.96216521"
561120231228,56,2023-12-28,11,260,194,454,Lon364_T,"-37.81234775, 144.96153311"
861620231229,86,2023-12-29,16,28,20,48,574Qub_T,"-37.80309992, 144.94908064"
862120240318,86,2024-03-18,21,8,24,32,574Qub_T,"-37.80309992, 144.94908064"
861020250621,86,2025-06-21,10,72,55,127,574Qub_T,"-37.80309992, 144.94908064"
86520251014,86,2025-10-14,5,1,1,2,574Qub_T,"-37.80309992, 144.94908064"
241920241020,24,2024-10-20,19,281,441,722,Col620_T,"-37.81887963, 144.95449198"
762220250118,76,2025-01-18,22,3,9,12,KenMac_T,"-37.79453803, 144.93036194"
21720241026,2,2024-10-26,17,813,715,1528,Bou283_T,"-37.81380668, 144.96516718"
21320240309,2,2024-03-09,13,643,613,1256,Bou283_T,"-37.81380668, 144.96516718"
301220231108,30,2023-11-08,12,349,450,799,Lon189_T,"-37.8112185, 144.96656806"
232020250227,23,2025-02-27,20,75,139,214,Col623_T,"-37.81909256, 144.95452748"
232020240531,23,2024-05-31,20,83,196,279,Col623_T,"-37.81909256, 144.95452748"
291920250117,29,2025-01-17,19,282,496,778,AG_T,"-37.8199817, 144.96872865"
29920250218,29,2025-02-18,9,130,151,281,AG_T,"-37.8199817, 144.96872865"
40320241221,40,2024-12-21,3,8,5,13,Spr201_T,"-37.80999341, 144.97227587"
40520250403,40,2025-04-03,5,7,11,18,Spr201_T,"-37.80999341, 144.97227587"
311920240506,31,2024-05-06,19,169,171,340,Lyg161_T,"-37.80169681, 144.96658911"
54920240131,54,2024-01-31,9,97,92,189,Swa607_T,"-37.804024, 144.96308399"
361220240301,36,2024-03-01,12,299,244,543,Que85_T,"-37.81652527, 144.96121062"
1081620231221,108,2023-12-21,16,742,196,938,261Will_T,"-37.81295822, 144.95678789"
871420240723,87,2024-07-23,14,101,92,193,Errol23_T,"-37.80454949, 144.94921863"
501720241007,50,2024-10-07,17,186,184,370,Lyg309_T,"-37.79808192, 144.96721013"
1311920241015,131,2024-10-15,19,90,83,173,King2_T,"-37.82009057, 144.95758725"
162820250401,162,2025-04-01,8,357,190,547,Eli489_T,"-37.80740397, 144.95987909"
184120250807,184,2025-08-07,1,16,27,43,Eli124_T,"-37.81512416, 144.96371988"
1432220250818,143,2025-08-18,22,69,58,127,Spencer_T,"-37.821728, 144.95557015"
132320250208,132,2025-02-08,3,18,8,26,King335_T,"-37.81267639, 144.95386444"
132620250219,132,2025-02-19,6,21,10,31,King335_T,"-37.81267639, 144.95386444"
1432220241025,143,2024-10-25,22,168,183,351,Spencer_T,"-37.821728, 144.95557015"
1321620240322,132,2024-03-22,16,158,139,297,King335_T,"-37.81267639, 144.95386444"
1351920250425,135,2025-04-25,19,269,294,563,Spen161_T,"-37.8172861, 144.95319102"
135320240121,135,2024-01-21,3,29,38,67,Spen161_T,"-37.8172861, 144.95319102"
1072020240717,107,2024-07-17,20,58,81,139,280Will_T,"-37.81246271, 144.95690188"
1331320241001,133,2024-10-01,13,560,472,1032,Spen229_T,"-37.81531435, 144.95227769"
70220241215,70,2024-12-15,2,0,3,3,Errol20_T,"-37.80456984, 144.94946228"
67720250507,67,2025-05-07,7,182,130,312,FLDegS_T,"-37.81688755, 144.96562569"
85120250323,85,2025-03-23,1,0,5,5,488Mac_T,"-37.79432415, 144.92973378"
631520240825,63,2024-08-25,15,335,521,856,Bou231_T,"-37.81333081, 144.96675571"
67320240407,67,2024-04-07,3,10,19,29,FLDegS_T,"-37.81688755, 144.96562569"
672120250218,67,2025-02-18,21,90,247,337,FLDegS_T,"-37.81688755, 144.96562569"
12320231114,12,2023-11-14,3,4,3,7,NewQ_T,"-37.81457988, 144.94292398"
86920240616,86,2024-06-16,9,45,40,85,574Qub_T,"-37.80309992, 144.94908064"
861120241204,86,2024-12-04,11,47,51,98,574Qub_T,"-37.80309992, 144.94908064"
861420241215,86,2024-12-15,14,35,55,90,574Qub_T,"-37.80309992, 144.94908064"
11120240725,11,2024-07-25,1,0,2,2,WatCit_T,"-37.81564989, 144.93970694"
62720240321,62,2024-03-21,7,71,55,126,Lat224_T,"-37.80996494, 144.96216521"
101820250123,10,2025-01-23,18,90,67,157,BouHbr_T,"-37.81876474, 144.94710545"
351020250316,35,2025-03-16,10,440,348,788,SouthB_T,"-37.82018685, 144.96508508"
72520241215,72,2024-12-15,5,9,16,25,ACMI_T,"-37.81726338, 144.96872809"
352020250418,35,2025-04-18,20,1228,1713,2941,SouthB_T,"-37.82018685, 144.96508508"
301220250529,30,2025-05-29,12,307,442,749,Lon189_T,"-37.8112185, 144.96656806"
1361620241224,136,2024-12-24,16,73,110,183,BirFed1120_T,"-37.8184141, 144.97357915"
1421420240119,142,2024-01-19,14,592,504,1096,Hammer1584_T,"-37.81970749, 144.96795734"
142120240226,142,2024-02-26,1,11,1,12,Hammer1584_T,"-37.81970749, 144.96795734"
130920240608,130,2024-06-08,9,20,14,34,Bou892T,"-37.8204637, 144.94126826"
1231020240309,123,2024-03-09,10,24,23,47,BirBridge_T,"-37.81753741, 144.97329734"
1231820231212,123,2023-12-12,18,20,21,41,BirBridge_T,"-37.81753741, 144.97329734"
49620250320,49,2025-03-20,6,55,48,103,Eli501_T,"-37.80730068, 144.95956055"
19120231220,19,2023-12-20,1,36,47,83,LtB210_T,"-37.81237202, 144.96550671"
19320241116,19,2024-11-16,3,31,89,120,LtB210_T,"-37.81237202, 144.96550671"
1801920250916,180,2025-09-16,19,5,1,6,Mac330_T,"-37.79497059, 144.93530329"
691620240724,69,2024-07-24,16,137,120,257,FLDegC_T,"-37.81687226, 144.96559144"
84420240810,84,2024-08-10,4,30,42,72,ElFi_T,"-37.81798049, 144.96503383"
841120241214,84,2024-12-14,11,1123,826,1949,ElFi_T,"-37.81798049, 144.96503383"
561420240730,56,2024-07-30,14,336,249,585,Lon364_T,"-37.81234775, 144.96153311"
86420231224,86,2023-12-24,4,1,0,1,574Qub_T,"-37.80309992, 144.94908064"
351320250808,35,2025-08-08,13,900,1182,2082,SouthB_T,"-37.82018685, 144.96508508"
35220250827,35,2025-08-27,2,6,6,12,SouthB_T,"-37.82018685, 144.96508508"
352220231024,35,2023-10-24,22,259,450,709,SouthB_T,"-37.82018685, 144.96508508"
271420231115,27,2023-11-15,14,75,92,167,Vic_T,"-37.80606888, 144.95644692"
91220250623,9,2025-06-23,12,493,499,992,Col700_T,"-37.81982992, 144.95102555"
91520240210,9,2024-02-10,15,107,91,198,Col700_T,"-37.81982992, 144.95102555"
27320250309,27,2025-03-09,3,18,4,22,Vic_T,"-37.80606888, 144.95644692"
302220250725,30,2025-07-25,22,352,467,819,Lon189_T,"-37.8112185, 144.96656806"
53920250513,53,2025-05-13,9,435,244,679,Col254_T,"-37.81564191, 144.965499"
46920250128,46,2025-01-28,9,90,35,125,Pel147_T,"-37.80240719, 144.9615673"
511420240320,51,2024-03-20,14,102,104,206,Fra118_T,"-37.80841815, 144.95906316"
231320241016,23,2024-10-16,13,352,548,900,Col623_T,"-37.81909256, 144.95452748"
48820250927,48,2025-09-27,8,158,127,285,QVMQ_T,"-37.80631581, 144.95866697"
48320240318,48,2024-03-18,3,2,9,11,QVMQ_T,"-37.80631581, 144.95866697"
49820250522,49,2025-05-22,8,132,184,316,Eli501_T,"-37.80730068, 144.95956055"
1231120240208,123,2024-02-08,11,8,8,16,BirBridge_T,"-37.81753741, 144.97329734"
117820240505,117,2024-05-05,8,44,36,80,Fli114F_T,"-37.81629332, 144.97090877"
662020250219,66,2025-02-19,20,970,829,1799,QVN_T,"-37.81057846, 144.96444294"
691220240422,69,2024-04-22,12,279,244,523,FLDegC_T,"-37.81687226, 144.96559144"
691820240813,69,2024-08-13,18,50,35,85,FLDegC_T,"-37.81687226, 144.96559144"
692020241022,69,2024-10-22,20,57,41,98,FLDegC_T,"-37.81687226, 144.96559144"
84220240807,84,2024-08-07,2,12,14,26,ElFi_T,"-37.81798049, 144.96503383"
662120240721,66,2024-07-21,21,625,447,1072,QVN_T,"-37.81057846, 144.96444294"
841720250919,84,2025-09-19,17,1204,1938,3142,ElFi_T,"-37.81798049, 144.96503383"
841420250923,84,2025-09-23,14,767,1250,2017,ElFi_T,"-37.81798049, 144.96503383"
702120250615,70,2025-06-15,21,30,21,51,Errol20_T,"-37.80456984, 144.94946228"
70920251007,70,2025-10-07,9,63,73,136,Errol20_T,"-37.80456984, 144.94946228"
75420250714,75,2025-07-14,4,6,2,8,SprFli_T,"-37.81515276, 144.97467661"
412120240422,41,2024-04-22,21,375,576,951,Swa31,"-37.81668634, 144.96689733"
41620240731,41,2024-07-31,6,25,32,57,Swa31,"-37.81668634, 144.96689733"
781020240801,78,2024-08-01,10,33,20,53,HarEsB_T,"-37.81471642, 144.9446508"
78520250727,78,2025-07-27,5,1,2,3,HarEsB_T,"-37.81471642, 144.9446508"
422020241119,42,2024-11-19,20,62,69,131,UM1_T,"-37.80008566, 144.96386412"
77620241125,77,2024-11-25,6,26,46,72,HarEsP_T,"-37.81441438, 144.94433026"
771120250306,77,2025-03-06,11,76,47,123,HarEsP_T,"-37.81441438, 144.94433026"
771720250503,77,2025-05-03,17,234,148,382,HarEsP_T,"-37.81441438, 144.94433026"
711020250512,71,2025-05-12,10,20,15,35,WestWP_T,"-37.81235775, 144.97136962"
711020240418,71,2024-04-18,10,48,28,76,WestWP_T,"-37.81235775, 144.97136962"
671820250426,67,2025-04-26,18,331,327,658,FLDegS_T,"-37.81688755, 144.96562569"
85420240222,85,2024-02-22,4,0,1,1,488Mac_T,"-37.79432415, 144.92973378"
12220231214,1,2023-12-14,22,622,435,1057,Bou292_T,"-37.81349441, 144.96515323"
18620231103,18,2023-11-03,6,2,62,64,Col12_T,"-37.81344862, 144.97305353"
56320240329,56,2024-03-29,3,82,49,131,Lon364_T,"-37.81234775, 144.96153311"
11020241224,11,2024-12-24,0,1,4,5,WatCit_T,"-37.81564989, 144.93970694"
122220240514,12,2024-05-14,22,30,38,68,NewQ_T,"-37.81457988, 144.94292398"
58820250403,58,2025-04-03,8,1706,213,1919,Bou688_T,"-37.81686075, 144.95358075"
56520250822,56,2025-08-22,5,13,9,22,Lon364_T,"-37.81234775, 144.96153311"
35120240913,35,2024-09-13,1,38,48,86,SouthB_T,"-37.82018685, 144.96508508"
76020231123,76,2023-11-23,0,0,1,1,KenMac_T,"-37.79453803, 144.93036194"
27720241028,27,2024-10-28,7,30,30,60,Vic_T,"-37.80606888, 144.95644692"
9220250624,9,2025-06-24,2,3,0,3,Col700_T,"-37.81982992, 144.95102555"
531320250329,53,2025-03-29,13,893,633,1526,Col254_T,"-37.81564191, 144.965499"
302220250518,30,2025-05-18,22,124,188,312,Lon189_T,"-37.8112185, 144.96656806"
791120240623,79,2024-06-23,11,528,437,965,FliSS_T,"-37.81794046, 144.96616678"
301620231116,30,2023-11-16,16,239,404,643,Lon189_T,"-37.8112185, 144.96656806"
521420231217,52,2023-12-17,14,376,357,733,Eli263_T,"-37.81252157, 144.9619401"
191320240131,19,2024-01-31,13,481,419,900,LtB210_T,"-37.81237202, 144.96550671"
48620241130,48,2024-11-30,6,24,49,73,QVMQ_T,"-37.80631581, 144.95866697"
481120250414,48,2025-04-14,11,218,134,352,QVMQ_T,"-37.80631581, 144.95866697"
20620240731,20,2024-07-31,6,7,11,18,LtB170_T,"-37.81172914, 144.9682466"
521520250824,52,2025-08-24,15,440,374,814,Eli263_T,"-37.81252157, 144.9619401"
49920250411,49,2025-04-11,9,227,248,475,Eli501_T,"-37.80730068, 144.95956055"
1371020250824,137,2025-08-24,10,3,13,16,BouHbr2353_T,"-37.81894815, 144.94612292"
1361220240716,136,2024-07-16,12,43,46,89,BirFed1120_T,"-37.8184141, 144.97357915"
1361120241104,136,2024-11-04,11,83,94,177,BirFed1120_T,"-37.8184141, 144.97357915"
1611320250807,161,2025-08-07,13,142,164,306,BirArt1109_T,"-37.81851276, 144.97131336"
138720250306,138,2025-03-06,7,0,3,3,EntPark1671_T,"-37.81996544, 144.95981454"
1381120250629,138,2025-06-29,11,14,7,21,EntPark1671_T,"-37.81996544, 144.95981454"
1171420251002,117,2025-10-02,14,115,210,325,Fli114F_T,"-37.81629332, 144.97090877"
291520250902,29,2025-09-02,15,168,247,415,AG_T,"-37.8199817, 144.96872865"
29720251002,29,2025-10-02,7,130,118,248,AG_T,"-37.8199817, 144.96872865"
402020250802,40,2025-08-02,20,122,82,204,Spr201_T,"-37.80999341, 144.97227587"
371120240215,37,2024-02-15,11,80,104,184,Lyg260_T,"-37.80107122, 144.96704554"
61820240315,61,2024-03-15,8,492,369,861,RMIT14_T,"-37.80767455, 144.96309114"
432320240811,43,2024-08-11,23,24,7,31,UM2_T,"-37.79844526, 144.96411782"
51020250822,5,2025-08-22,10,394,833,1227,PriNW_T,"-37.81874249, 144.96787656"
211120240107,21,2024-01-07,11,290,180,470,Bourke155_T,"-37.81267313, 144.96788288"
140720240623,140,2024-06-23,7,19,0,19,Boyd2837_T,"-37.82590962, 144.96185972"
135020250904,135,2025-09-04,0,17,37,54,Spen161_T,"-37.8172861, 144.95319102"
1331220250614,133,2025-06-14,12,409,396,805,Spen229_T,"-37.81531435, 144.95227769"
1331520231022,133,2023-10-22,15,502,436,938,Spen229_T,"-37.81531435, 144.95227769"
133020240214,133,2024-02-14,0,53,20,73,Spen229_T,"-37.81531435, 144.95227769"
133120250407,133,2025-04-07,1,23,10,33,Spen229_T,"-37.81531435, 144.95227769"
871720241228,87,2024-12-28,17,55,40,95,Errol23_T,"-37.80454949, 144.94921863"
1652020250508,165,2025-05-08,20,36,24,60,Spen475_T,"-37.80953359, 144.94939004"
111620240216,11,2024-02-16,16,98,107,205,WatCit_T,"-37.81564989, 144.93970694"
101620240623,10,2024-06-23,16,123,132,255,BouHbr_T,"-37.81876474, 144.94710545"
121320231104,12,2023-11-04,13,189,232,421,NewQ_T,"-37.81457988, 144.94292398"
12120240311,12,2024-03-11,1,23,33,56,NewQ_T,"-37.81457988, 144.94292398"
56120250708,56,2025-07-08,1,7,14,21,Lon364_T,"-37.81234775, 144.96153311"
761720240815,76,2024-08-15,17,66,90,156,KenMac_T,"-37.79453803, 144.93036194"
91620250614,9,2025-06-14,16,95,50,145,Col700_T,"-37.81982992, 144.95102555"
9620240910,9,2024-09-10,6,27,377,404,Col700_T,"-37.81982992, 144.95102555"
791920241021,79,2024-10-21,19,311,286,597,FliSS_T,"-37.81794046, 144.96616678"
79620241029,79,2024-10-29,6,152,64,216,FliSS_T,"-37.81794046, 144.96616678"
512020250311,51,2025-03-11,20,48,76,124,Fra118_T,"-37.80841815, 144.95906316"
231920250208,23,2025-02-08,19,48,138,186,Col623_T,"-37.81909256, 144.95452748"
49420231201,49,2023-12-01,4,6,10,16,Eli501_T,"-37.80730068, 144.95956055"
49320240524,49,2024-05-24,3,15,8,23,Eli501_T,"-37.80730068, 144.95956055"
701320241230,70,2024-12-30,13,101,139,240,Errol20_T,"-37.80456984, 144.94946228"
70220250118,70,2025-01-18,2,3,7,10,Errol20_T,"-37.80456984, 144.94946228"
3620241019,3,2024-10-19,6,14,22,36,Swa295_T,"-37.81101524, 144.96429485"
81520250210,8,2025-02-10,15,163,230,393,WebBN_T,"-37.82293543, 144.9471751"
81720250315,8,2025-03-15,17,189,122,311,WebBN_T,"-37.82293543, 144.9471751"
752020250724,75,2025-07-24,20,10,13,23,SprFli_T,"-37.81515276, 144.97467661"
41820240209,41,2024-02-09,8,1534,376,1910,Swa31,"-37.81668634, 144.96689733"
411820241118,41,2024-11-18,18,1060,1586,2646,Swa31,"-37.81668634, 144.96689733"
772020240221,77,2024-02-21,20,217,199,416,HarEsP_T,"-37.81441438, 144.94433026"
782020240705,78,2024-07-05,20,6,10,16,HarEsB_T,"-37.81471642, 144.9446508"
14220250118,14,2025-01-18,2,60,12,72,SanBri_T,"-37.82011242, 144.96291897"
711720250801,71,2025-08-01,17,26,23,49,WestWP_T,"-37.81235775, 144.97136962"
29320240419,29,2024-04-19,3,0,6,6,AG_T,"-37.8199817, 144.96872865"
40020250130,40,2025-01-30,0,17,13,30,Spr201_T,"-37.80999341, 144.97227587"
311520241108,31,2024-11-08,15,123,157,280,Lyg161_T,"-37.80169681, 144.96658911"
37420240329,37,2024-03-29,4,2,0,2,Lyg260_T,"-37.80107122, 144.96704554"
471320240524,47,2024-05-24,13,951,997,1948,Eli250_T,"-37.81258467, 144.9625775"
21220250924,21,2025-09-24,2,5,5,10,Bourke155_T,"-37.81267313, 144.96788288"
21420240324,21,2024-03-24,4,45,45,90,Bourke155_T,"-37.81267313, 144.96788288"
371620241214,37,2024-12-14,16,111,133,244,Lyg260_T,"-37.80107122, 144.96704554"
1082020241026,108,2024-10-26,20,92,117,209,261Will_T,"-37.81295822, 144.95678789"
50120240704,50,2024-07-04,1,0,1,1,Lyg309_T,"-37.79808192, 144.96721013"
43020240112,43,2024-01-12,0,1,2,3,UM2_T,"-37.79844526, 144.96411782"
1812220250608,181,2025-06-08,22,431,333,764,Eli368_T,"-37.81009465, 144.96143149"
1401120240204,140,2024-02-04,11,163,56,219,Boyd2837_T,"-37.82590962, 144.96185972"
1341120240217,134,2024-02-17,11,397,349,746,Spen201_T,"-37.81694221, 144.95303935"
1312020240422,131,2024-04-22,20,37,51,88,King2_T,"-37.82009057, 144.95758725"
1071720251006,107,2025-10-06,17,178,156,334,280Will_T,"-37.81246271, 144.95690188"
1072220250120,107,2025-01-20,22,51,34,85,280Will_T,"-37.81246271, 144.95690188"
107920250218,107,2025-02-18,9,85,198,283,280Will_T,"-37.81246271, 144.95690188"
1072020250303,107,2025-03-03,20,97,71,168,280Will_T,"-37.81246271, 144.95690188"
118820240806,118,2024-08-06,8,22,15,37,Fli114C_T,"-37.81632783, 144.97090512"
124920240303,124,2024-03-03,9,0,1,1,BirBridge_T,"-37.81757416, 144.97329934"
185620250724,185,2025-07-24,6,39,77,116,Eli197_T,"-37.81374643, 144.96276183"
85820250504,85,2025-05-04,8,35,41,76,488Mac_T,"-37.79432415, 144.92973378"
85420240404,85,2024-04-04,4,2,0,2,488Mac_T,"-37.79432415, 144.92973378"
121220240422,12,2024-04-22,12,216,224,440,NewQ_T,"-37.81457988, 144.94292398"
112220250515,11,2025-05-15,22,37,31,68,WatCit_T,"-37.81564989, 144.93970694"
56820240905,56,2024-09-05,8,126,167,293,Lon364_T,"-37.81234775, 144.96153311"
122220250124,12,2025-01-24,22,174,138,312,NewQ_T,"-37.81457988, 144.94292398"
582220250926,58,2025-09-26,22,296,256,552,Bou688_T,"-37.81686075, 144.95358075"
35220250905,35,2025-09-05,2,3,9,12,SouthB_T,"-37.82018685, 144.96508508"
21520250206,2,2025-02-06,15,391,371,762,Bou283_T,"-37.81380668, 144.96516718"
271020250408,27,2025-04-08,10,120,108,228,Vic_T,"-37.80606888, 144.95644692"
9820240528,9,2024-05-28,8,138,3576,3714,Col700_T,"-37.81982992, 144.95102555"
91220250511,9,2025-05-11,12,65,64,129,Col700_T,"-37.81982992, 144.95102555"
30220240823,30,2024-08-23,2,32,46,78,Lon189_T,"-37.8112185, 144.96656806"
481420231124,48,2023-11-24,14,288,202,490,QVMQ_T,"-37.80631581, 144.95866697"
461920240830,46,2024-08-30,19,12,1,13,Pel147_T,"-37.80240719, 144.9615673"
231420241005,23,2024-10-05,14,20,17,37,Col623_T,"-37.81909256, 144.95452748"
201820240531,20,2024-05-31,18,663,549,1212,LtB170_T,"-37.81172914, 144.9682466"
52720240303,52,2024-03-03,7,23,16,39,Eli263_T,"-37.81252157, 144.9619401"
521120250523,52,2025-05-23,11,251,209,460,Eli263_T,"-37.81252157, 144.9619401"
521920231206,52,2023-12-06,19,327,321,648,Eli263_T,"-37.81252157, 144.9619401"
462020240202,46,2024-02-02,20,37,28,65,Pel147_T,"-37.80240719, 144.9615673"
117220240903,117,2024-09-03,2,3,3,6,Fli114F_T,"-37.81629332, 144.97090877"
252120240822,25,2024-08-22,21,284,191,475,MCEC_T,"-37.82401776, 144.95604426"
202020250602,20,2025-06-02,20,156,256,412,LtB170_T,"-37.81172914, 144.9682466"
30220250530,30,2025-05-30,2,49,85,134,Lon189_T,"-37.8112185, 144.96656806"
139620250716,139,2025-07-16,6,5,17,22,Signal1647_T,"-37.81959923, 144.9632832"
1301420250526,130,2025-05-26,14,71,41,112,Bou892T,"-37.8204637, 144.94126826"
1422320231124,142,2023-11-24,23,97,396,493,Hammer1584_T,"-37.81970749, 144.96795734"
1611320241022,161,2024-10-22,13,156,160,316,BirArt1109_T,"-37.81851276, 144.97131336"
1232020231127,123,2023-11-27,20,15,10,25,BirBridge_T,"-37.81753741, 144.97329734"
69820241231,69,2024-12-31,8,68,31,99,FLDegC_T,"-37.81687226, 144.96559144"
69820250421,69,2025-04-21,8,91,25,116,FLDegC_T,"-37.81687226, 144.96559144"
841020240305,84,2024-03-05,10,749,592,1341,ElFi_T,"-37.81798049, 144.96503383"
701520250320,70,2025-03-20,15,139,113,252,Errol20_T,"-37.80456984, 144.94946228"
391120240903,39,2024-09-03,11,121,69,190,AlfPl_T,"-37.81379749, 144.96995745"
81320241201,8,2024-12-01,13,201,378,579,WebBN_T,"-37.82293543, 144.9471751"
41820240417,41,2024-04-17,8,2122,464,2586,Swa31,"-37.81668634, 144.96689733"
59620240122,59,2024-01-22,6,73,57,130,RMIT_T,"-37.80825648, 144.96304859"
54720240111,54,2024-01-11,7,22,17,39,Swa607_T,"-37.804024, 144.96308399"
40820240417,40,2024-04-17,8,243,473,716,Spr201_T,"-37.80999341, 144.97227587"
21020240518,21,2024-05-18,0,190,201,391,Bourke155_T,"-37.81267313, 144.96788288"
361720240914,36,2024-09-14,17,108,113,221,Que85_T,"-37.81652527, 144.96121062"
37820250506,37,2025-05-06,8,24,45,69,Lyg260_T,"-37.80107122, 144.96704554"
37120250705,37,2025-07-05,1,17,12,29,Lyg260_T,"-37.80107122, 144.96704554"
50720250701,50,2025-07-01,7,7,29,36,Lyg309_T,"-37.79808192, 144.96721013"
43720240508,43,2024-05-08,7,79,25,104,UM2_T,"-37.79844526, 144.96411782"
431820250324,43,2025-03-24,18,237,384,621,UM2_T,"-37.79844526, 144.96411782"
451020240714,45,2024-07-14,10,447,240,687,Swa148_T,"-37.81414075, 144.96609379"
1351820231107,135,2023-11-07,18,560,413,973,Spen161_T,"-37.8172861, 144.95319102"
87020240320,87,2024-03-20,0,1,9,10,Errol23_T,"-37.80454949, 144.94921863"
1622220241011,162,2024-10-11,22,246,183,429,Eli489_T,"-37.80740397, 144.95987909"
184920251015,184,2025-10-15,9,447,476,923,Eli124_T,"-37.81512416, 144.96371988"
1671620250103,167,2025-01-03,16,3,5,8,Lat526_T,"-37.81304149, 144.95155955"
1811020250609,181,2025-06-09,10,183,475,658,Eli368_T,"-37.81009465, 144.96143149"
1401420240112,140,2024-01-12,14,86,76,162,Boyd2837_T,"-37.82590962, 144.96185972"
132520240211,132,2024-02-11,5,8,4,12,King335_T,"-37.81267639, 144.95386444"
1351520240122,135,2024-01-22,15,464,433,897,Spen161_T,"-37.8172861, 144.95319102"
671120251011,67,2025-10-11,11,475,453,928,FLDegS_T,"-37.81688755, 144.96562569"
172120231209,17,2023-12-09,21,117,97,214,Col15_T,"-37.81362543, 144.97323591"
231420250315,23,2025-03-15,14,122,181,303,Col623_T,"-37.81909256, 144.95452748"
1411720240902,141,2024-09-02,17,135,78,213,474Fl_T,"-37.81997273, 144.95834911"
139620250708,139,2025-07-08,6,13,20,33,Signal1647_T,"-37.81959923, 144.9632832"
1361020250419,136,2025-04-19,10,148,91,239,BirFed1120_T,"-37.8184141, 144.97357915"
1171820250413,117,2025-04-13,18,290,266,556,Fli114F_T,"-37.81629332, 144.97090877"
491520240612,49,2024-06-12,15,185,245,430,Eli501_T,"-37.80730068, 144.95956055"
1092020240620,109,2024-06-20,20,124,89,213,LatWill_T,"-37.81193681, 144.95621105"
1091020231209,109,2023-12-09,10,48,36,84,LatWill_T,"-37.81193681, 144.95621105"
681020231206,68,2023-12-06,10,126,66,192,FLDegN_T,"-37.8168479, 144.96559789"
851920240213,85,2024-02-13,19,52,52,104,488Mac_T,"-37.79432415, 144.92973378"
181920231103,18,2023-11-03,19,110,62,172,Col12_T,"-37.81344862, 144.97305353"
63220231230,63,2023-12-30,2,39,115,154,Bou231_T,"-37.81333081, 144.96675571"
12520240416,12,2024-04-16,5,8,7,15,NewQ_T,"-37.81457988, 144.94292398"
62620250310,62,2025-03-10,6,14,10,24,Lat224_T,"-37.80996494, 144.96216521"
35720241117,35,2024-11-17,7,219,159,378,SouthB_T,"-37.82018685, 144.96508508"
581820240321,58,2024-03-21,18,852,685,1537,Bou688_T,"-37.81686075, 144.95358075"
25720250720,25,2025-07-20,7,66,68,134,MCEC_T,"-37.82401776, 144.95604426"
48120240714,48,2024-07-14,1,18,29,47,QVMQ_T,"-37.80631581, 144.95866697"
20320231125,20,2023-11-25,3,18,23,41,LtB170_T,"-37.81172914, 144.9682466"
23420240226,23,2024-02-26,4,2,13,15,Col623_T,"-37.81909256, 144.95452748"
137020240203,137,2024-02-03,0,2,2,4,BouHbr2353_T,"-37.81894815, 144.94612292"
1411420240509,141,2024-05-09,14,121,122,243,474Fl_T,"-37.81997273, 144.95834911"
1391020240504,139,2024-05-04,10,49,41,90,Signal1647_T,"-37.81959923, 144.9632832"
1301920240326,130,2024-03-26,19,7,7,14,Bou892T,"-37.8204637, 144.94126826"
1301020240415,130,2024-04-15,10,12,19,31,Bou892T,"-37.8204637, 144.94126826"
1611620241222,161,2024-12-22,16,110,155,265,BirArt1109_T,"-37.81851276, 144.97131336"
138820241213,138,2024-12-13,8,3,2,5,EntPark1671_T,"-37.81996544, 144.95981454"
109220240530,109,2024-05-30,2,6,13,19,LatWill_T,"-37.81193681, 144.95621105"
66720241119,66,2024-11-19,7,71,295,366,QVN_T,"-37.81057846, 144.96444294"
692220231230,69,2023-12-30,22,37,24,61,FLDegC_T,"-37.81687226, 144.96559144"
62120241112,6,2024-11-12,21,547,455,1002,FliS_T,"-37.81911705, 144.96558255"
4820231214,4,2023-12-14,8,571,327,898,Swa123_T,"-37.81487988, 144.9660878"
4620240527,4,2024-05-27,6,120,30,150,Swa123_T,"-37.81487988, 144.9660878"
752220250509,75,2025-05-09,22,132,18,150,SprFli_T,"-37.81515276, 144.97467661"
751920250705,75,2025-07-05,19,26,20,46,SprFli_T,"-37.81515276, 144.97467661"
771920241022,77,2024-10-22,19,259,388,647,HarEsP_T,"-37.81441438, 144.94433026"
771620241028,77,2024-10-28,16,139,119,258,HarEsP_T,"-37.81441438, 144.94433026"
781720250104,78,2025-01-04,17,13,25,38,HarEsB_T,"-37.81471642, 144.9446508"
14020231127,14,2023-11-27,0,68,26,94,SanBri_T,"-37.82011242, 144.96291897"
711220240928,71,2024-09-28,12,4,4,8,WestWP_T,"-37.81235775, 144.97136962"
71520250509,71,2025-05-09,5,4,1,5,WestWP_T,"-37.81235775, 144.97136962"
42820240520,42,2024-05-20,8,264,84,348,UM1_T,"-37.80008566, 144.96386412"
42520240824,42,2024-08-24,5,4,3,7,UM1_T,"-37.80008566, 144.96386412"
292120250707,29,2025-07-07,21,62,48,110,AG_T,"-37.8199817, 144.96872865"
63220240824,63,2024-08-24,2,68,133,201,Bou231_T,"-37.81333081, 144.96675571"
182020250629,18,2025-06-29,20,14,10,24,Col12_T,"-37.81344862, 144.97305353"
11720240717,1,2024-07-17,17,1119,833,1952,Bou292_T,"-37.81349441, 144.96515323"
67820250930,67,2025-09-30,8,334,219,553,FLDegS_T,"-37.81688755, 144.96562569"
621020231124,62,2023-11-24,10,179,144,323,Lat224_T,"-37.80996494, 144.96216521"
622220240207,62,2024-02-07,22,171,101,272,Lat224_T,"-37.80996494, 144.96216521"
86020250511,86,2025-05-11,0,1,7,8,574Qub_T,"-37.80309992, 144.94908064"
241820231124,24,2023-11-24,18,654,1035,1689,Col620_T,"-37.81887963, 144.95449198"
24420231203,24,2023-12-03,4,31,51,82,Col620_T,"-37.81887963, 144.95449198"
722020231107,72,2023-11-07,20,140,83,223,ACMI_T,"-37.81726338, 144.96872809"
102220251015,10,2025-10-15,22,13,7,20,BouHbr_T,"-37.81876474, 144.94710545"
761520250226,76,2025-02-26,15,52,65,117,KenMac_T,"-37.79453803, 144.93036194"
72720250924,72,2025-09-24,7,148,47,195,ACMI_T,"-37.81726338, 144.96872809"
581920250907,58,2025-09-07,19,211,181,392,Bou688_T,"-37.81686075, 144.95358075"
2520250527,2,2025-05-27,5,6,9,15,Bou283_T,"-37.81380668, 144.96516718"
30220241013,30,2024-10-13,2,123,252,375,Lon189_T,"-37.8112185, 144.96656806"
53220250521,53,2025-05-21,2,0,3,3,Col254_T,"-37.81564191, 144.965499"
51720250129,51,2025-01-29,7,16,20,36,Fra118_T,"-37.80841815, 144.95906316"
201820250402,20,2025-04-02,18,525,430,955,LtB170_T,"-37.81172914, 144.9682466"
492020240217,49,2024-02-17,20,189,129,318,Eli501_T,"-37.80730068, 144.95956055"
117720240512,117,2024-05-12,7,14,75,89,Fli114F_T,"-37.81629332, 144.97090877"
49220240912,49,2024-09-12,2,26,32,58,Eli501_T,"-37.80730068, 144.95956055"
25820240714,25,2024-07-14,8,63,127,190,MCEC_T,"-37.82401776, 144.95604426"
251220240309,25,2024-03-09,12,413,467,880,MCEC_T,"-37.82401776, 144.95604426"
1642320250821,164,2025-08-21,23,16,33,49,Lat526_T,"-37.813005, 144.95160411"
1412020251009,141,2025-10-09,20,129,128,257,474Fl_T,"-37.81997273, 144.95834911"
141620240301,141,2024-03-01,6,21,16,37,474Fl_T,"-37.81997273, 144.95834911"
1381620250220,138,2025-02-20,16,11,4,15,EntPark1671_T,"-37.81996544, 144.95981454"
661320250819,66,2025-08-19,13,1144,1335,2479,QVN_T,"-37.81057846, 144.96444294"
69520231020,69,2023-10-20,5,6,5,11,FLDegC_T,"-37.81687226, 144.96559144"
61520240421,6,2024-04-21,15,1118,957,2075,FliS_T,"-37.81911705, 144.96558255"
84420240612,84,2024-06-12,4,7,21,28,ElFi_T,"-37.81798049, 144.96503383"
4320240508,4,2024-05-08,3,10,8,18,Swa123_T,"-37.81487988, 144.9660878"
661820240608,66,2024-06-08,18,1191,1208,2399,QVN_T,"-37.81057846, 144.96444294"
70820250731,70,2025-07-31,8,67,87,154,Errol20_T,"-37.80456984, 144.94946228"
702220250822,70,2025-08-22,22,143,133,276,Errol20_T,"-37.80456984, 144.94946228"
39520251016,39,2025-10-16,5,8,2,10,AlfPl_T,"-37.81379749, 144.96995745"
752220250612,75,2025-06-12,22,4,6,10,SprFli_T,"-37.81515276, 144.97467661"
411420240319,41,2024-03-19,14,1260,1470,2730,Swa31,"-37.81668634, 144.96689733"
78120241225,78,2024-12-25,1,2,7,9,HarEsB_T,"-37.81471642, 144.9446508"
781020250524,78,2025-05-24,10,50,64,114,HarEsB_T,"-37.81471642, 144.9446508"
651120240608,65,2024-06-08,11,479,355,834,SwaCs_T,"-37.81569416, 144.9668064"
71920240110,71,2024-01-10,9,23,25,48,WestWP_T,"-37.81235775, 144.97136962"
291920240118,29,2024-01-18,19,320,1162,1482,AG_T,"-37.8199817, 144.96872865"
291020240312,29,2024-03-12,10,75,121,196,AG_T,"-37.8199817, 144.96872865"
291220240315,29,2024-03-15,12,219,438,657,AG_T,"-37.8199817, 144.96872865"
471520240527,47,2024-05-27,15,738,651,1389,Eli250_T,"-37.81258467, 144.9625775"
21620240523,21,2024-05-23,6,26,36,62,Bourke155_T,"-37.81267313, 144.96788288"
372320250523,37,2025-05-23,23,97,124,221,Lyg260_T,"-37.80107122, 144.96704554"
44720250723,44,2025-07-23,7,20,25,45,UM3_T,"-37.79698741, 144.96441306"
107720240622,107,2024-06-22,7,11,18,29,280Will_T,"-37.81246271, 144.95690188"
132420250807,132,2025-08-07,4,2,0,2,King335_T,"-37.81267639, 144.95386444"
1321820251014,132,2025-10-14,18,215,192,407,King335_T,"-37.81267639, 144.95386444"
124620251012,124,2025-10-12,6,4,6,10,BirBridge_T,"-37.81757416, 144.97329934"
1241920240217,124,2024-02-17,19,0,1,1,BirBridge_T,"-37.81757416, 144.97329934"
871220240416,87,2024-04-16,12,186,168,354,Errol23_T,"-37.80454949, 144.94921863"
872320250906,87,2025-09-06,23,3,26,29,Errol23_T,"-37.80454949, 144.94921863"
87520241108,87,2024-11-08,5,6,3,9,Errol23_T,"-37.80454949, 144.94921863"
61520231208,61,2023-12-08,5,14,29,43,RMIT14_T,"-37.80767455, 144.96309114"
1791220250406,179,2025-04-06,12,79,48,127,Pow61_T,"-37.82392385, 144.96299677"
1431820240721,143,2024-07-21,18,117,119,236,Spencer_T,"-37.821728, 144.95557015"
132820240321,132,2024-03-21,8,193,125,318,King335_T,"-37.81267639, 144.95386444"
851220250711,85,2025-07-11,12,135,160,295,488Mac_T,"-37.79432415, 144.92973378"
56620241220,56,2024-12-20,6,21,14,35,Lon364_T,"-37.81234775, 144.96153311"
561020250211,56,2025-02-11,10,233,173,406,Lon364_T,"-37.81234775, 144.96153311"
241320240714,24,2024-07-14,13,551,547,1098,Col620_T,"-37.81887963, 144.95449198"
101320240423,10,2024-04-23,13,200,109,309,BouHbr_T,"-37.81876474, 144.94710545"
722220241209,72,2024-12-09,22,133,389,522,ACMI_T,"-37.81726338, 144.96872809"
24620250520,24,2025-05-20,6,414,147,561,Col620_T,"-37.81887963, 144.95449198"
101220250519,10,2025-05-19,12,162,133,295,BouHbr_T,"-37.81876474, 144.94710545"
581020240531,58,2024-05-31,10,647,150,797,Bou688_T,"-37.81686075, 144.95358075"
761820250815,76,2025-08-15,18,45,39,84,KenMac_T,"-37.79453803, 144.93036194"
791120240718,79,2024-07-18,11,501,335,836,FliSS_T,"-37.81794046, 144.96616678"
301620240201,30,2024-02-01,16,199,351,550,Lon189_T,"-37.8112185, 144.96656806"
30020240330,30,2024-03-30,0,262,263,525,Lon189_T,"-37.8112185, 144.96656806"
51320231024,51,2023-10-24,3,1,5,6,Fra118_T,"-37.80841815, 144.95906316"
201620240813,20,2024-08-13,16,182,156,338,LtB170_T,"-37.81172914, 144.9682466"
522320250207,52,2025-02-07,23,405,189,594,Eli263_T,"-37.81252157, 144.9619401"
462220240125,46,2024-01-25,22,8,19,27,Pel147_T,"-37.80240719, 144.9615673"
462020240617,46,2024-06-17,20,37,26,63,Pel147_T,"-37.80240719, 144.9615673"
109820231219,109,2023-12-19,8,53,490,543,LatWill_T,"-37.81193681, 144.95621105"
25020250107,25,2025-01-07,0,13,21,34,MCEC_T,"-37.82401776, 144.95604426"
141120250616,141,2025-06-16,1,12,10,22,474Fl_T,"-37.81997273, 144.95834911"
136920250213,136,2025-02-13,9,49,47,96,BirFed1120_T,"-37.8184141, 144.97357915"
130720240510,130,2024-05-10,7,4,2,6,Bou892T,"-37.8204637, 144.94126826"
1381220250411,138,2025-04-11,12,14,17,31,EntPark1671_T,"-37.81996544, 144.95981454"
691820240208,69,2024-02-08,18,75,51,126,FLDegC_T,"-37.81687226, 144.96559144"
691320250420,69,2025-04-20,13,160,62,222,FLDegC_T,"-37.81687226, 144.96559144"
841620240626,84,2024-06-26,16,985,1705,2690,ElFi_T,"-37.81798049, 144.96503383"
701320241213,70,2024-12-13,13,134,152,286,Errol20_T,"-37.80456984, 144.94946228"
31420240512,3,2024-05-12,14,1367,1384,2751,Swa295_T,"-37.81101524, 144.96429485"
31820240906,3,2024-09-06,18,869,1193,2062,Swa295_T,"-37.81101524, 144.96429485"
751820240117,75,2024-01-17,18,73,153,226,SprFli_T,"-37.81515276, 144.97467661"
41820231228,41,2023-12-28,8,548,208,756,Swa31,"-37.81668634, 144.96689733"
781620251001,78,2025-10-01,16,28,153,181,HarEsB_T,"-37.81471642, 144.9446508"
421120240617,42,2024-06-17,11,101,157,258,UM1_T,"-37.80008566, 144.96386412"
252320250816,25,2025-08-16,23,95,138,233,MCEC_T,"-37.82401776, 144.95604426"
491520231018,49,2023-10-18,15,177,133,310,Eli501_T,"-37.80730068, 144.95956055"
52920250918,52,2025-09-18,9,152,211,363,Eli263_T,"-37.81252157, 144.9619401"
1422020231122,142,2023-11-22,20,313,172,485,Hammer1584_T,"-37.81970749, 144.96795734"
492020250304,49,2025-03-04,20,188,151,339,Eli501_T,"-37.80730068, 144.95956055"
1171920240120,117,2024-01-20,19,265,262,527,Fli114F_T,"-37.81629332, 144.97090877"
1171420240303,117,2024-03-03,14,120,199,319,Fli114F_T,"-37.81629332, 144.97090877"
851420240724,85,2024-07-24,14,25,33,58,488Mac_T,"-37.79432415, 144.92973378"
85820250426,85,2025-04-26,8,39,29,68,488Mac_T,"-37.79432415, 144.92973378"
171020231030,17,2023-10-30,10,382,257,639,Col15_T,"-37.81362543, 144.97323591"
18320250419,18,2025-04-19,3,2,1,3,Col12_T,"-37.81344862, 144.97305353"
632220231201,63,2023-12-01,22,362,569,931,Bou231_T,"-37.81333081, 144.96675571"
63320241030,63,2024-10-30,3,3,9,12,Bou231_T,"-37.81333081, 144.96675571"
62720241114,62,2024-11-14,7,43,73,116,Lat224_T,"-37.80996494, 144.96216521"
66120241019,66,2024-10-19,1,114,114,228,QVN_T,"-37.81057846, 144.96444294"
6520250212,6,2025-02-12,5,74,98,172,FliS_T,"-37.81911705, 144.96558255"
391020241012,39,2024-10-12,10,72,56,128,AlfPl_T,"-37.81379749, 144.96995745"
39520250507,39,2025-05-07,5,7,4,11,AlfPl_T,"-37.81379749, 144.96995745"
781020250211,78,2025-02-11,10,28,49,77,HarEsB_T,"-37.81471642, 144.9446508"
781720231203,78,2023-12-03,17,43,77,120,HarEsB_T,"-37.81471642, 144.9446508"
65720231027,65,2023-10-27,7,189,104,293,SwaCs_T,"-37.81569416, 144.9668064"
77120250406,77,2025-04-06,1,18,8,26,HarEsP_T,"-37.81441438, 144.94433026"
77620250712,77,2025-07-12,6,10,13,23,HarEsP_T,"-37.81441438, 144.94433026"
291520250116,29,2025-01-16,15,489,540,1029,AG_T,"-37.8199817, 144.96872865"
711820250302,71,2025-03-02,18,9,3,12,WestWP_T,"-37.81235775, 144.97136962"
281520240119,28,2024-01-19,15,738,1023,1761,VAC_T,"-37.82129925, 144.96879309"
282020240803,28,2024-08-03,20,190,262,452,VAC_T,"-37.82129925, 144.96879309"
291120250419,29,2025-04-19,11,511,436,947,AG_T,"-37.8199817, 144.96872865"
402120250311,40,2025-03-11,21,83,36,119,Spr201_T,"-37.80999341, 144.97227587"
37220240619,37,2024-06-19,2,3,6,9,Lyg260_T,"-37.80107122, 144.96704554"
37020250226,37,2025-02-26,0,17,6,23,Lyg260_T,"-37.80107122, 144.96704554"
37620251001,37,2025-10-01,6,8,5,13,Lyg260_T,"-37.80107122, 144.96704554"
611420240303,61,2024-03-03,14,376,447,823,RMIT14_T,"-37.80767455, 144.96309114"
502320241021,50,2024-10-21,23,34,12,46,Lyg309_T,"-37.79808192, 144.96721013"
432120240326,43,2024-03-26,21,50,53,103,UM2_T,"-37.79844526, 144.96411782"
51920240119,5,2024-01-19,19,1616,1779,3395,PriNW_T,"-37.81874249, 144.96787656"
21520231108,21,2023-11-08,5,19,16,35,Bourke155_T,"-37.81267313, 144.96788288"
212220231215,21,2023-12-15,22,574,629,1203,Bourke155_T,"-37.81267313, 144.96788288"
361520240216,36,2024-02-16,15,201,237,438,Que85_T,"-37.81652527, 144.96121062"
1401420250103,140,2025-01-03,14,103,62,165,Boyd2837_T,"-37.82590962, 144.96185972"
132920240521,132,2024-05-21,9,79,45,124,King335_T,"-37.81267639, 144.95386444"
1341920240608,134,2024-06-08,19,291,287,578,Spen201_T,"-37.81694221, 144.95303935"
134120241010,134,2024-10-10,1,34,39,73,Spen201_T,"-37.81694221, 144.95303935"
1311620241116,131,2024-11-16,16,184,66,250,King2_T,"-37.82009057, 144.95758725"
1351920240201,135,2024-02-01,19,277,264,541,Spen161_T,"-37.8172861, 144.95319102"
135420240615,135,2024-06-15,4,9,18,27,Spen161_T,"-37.8172861, 144.95319102"
135820240802,135,2024-08-02,8,220,251,471,Spen161_T,"-37.8172861, 144.95319102"
107820250823,107,2025-08-23,8,32,58,90,280Will_T,"-37.81246271, 144.95690188"
1181220250307,118,2025-03-07,12,16,14,30,Fli114C_T,"-37.81632783, 144.97090512"
87720250628,87,2025-06-28,7,15,13,28,Errol23_T,"-37.80454949, 144.94921863"
31620250325,31,2025-03-25,6,10,11,21,Lyg161_T,"-37.80169681, 144.96658911"
372220240521,37,2024-05-21,22,28,69,97,Lyg260_T,"-37.80107122, 144.96704554"
5320240317,5,2024-03-17,3,49,82,131,PriNW_T,"-37.81874249, 144.96787656"
362120250830,36,2025-08-30,21,131,161,292,Que85_T,"-37.81652527, 144.96121062"
362020251004,36,2025-10-04,20,235,179,414,Que85_T,"-37.81652527, 144.96121062"
362120250305,36,2025-03-05,21,69,118,187,Que85_T,"-37.81652527, 144.96121062"
87920240123,87,2024-01-23,9,52,48,100,Errol23_T,"-37.80454949, 144.94921863"
87220240417,87,2024-04-17,2,1,1,2,Errol23_T,"-37.80454949, 144.94921863"
501320240401,50,2024-04-01,13,280,281,561,Lyg309_T,"-37.79808192, 144.96721013"
50120231101,50,2023-11-01,1,2,1,3,Lyg309_T,"-37.79808192, 144.96721013"
431920250218,43,2025-02-18,19,74,115,189,UM2_T,"-37.79844526, 144.96411782"
451420250815,45,2025-08-15,14,373,710,1083,Swa148_T,"-37.81414075, 144.96609379"
1401720250928,140,2025-09-28,17,117,97,214,Boyd2837_T,"-37.82590962, 144.96185972"
1841320250909,184,2025-09-09,13,1040,1165,2205,Eli124_T,"-37.81512416, 144.96371988"
1341220250214,134,2025-02-14,12,458,448,906,Spen201_T,"-37.81694221, 144.95303935"
1352020250824,135,2025-08-24,20,114,150,264,Spen161_T,"-37.8172861, 144.95319102"
1181820250723,118,2025-07-23,18,11,13,24,Fli114C_T,"-37.81632783, 144.97090512"
1081520250902,108,2025-09-02,15,241,105,346,261Will_T,"-37.81295822, 144.95678789"
1661920250427,166,2025-04-27,19,44,40,84,Spen484_T,"-37.80896733, 144.94931703"
841220231214,84,2023-12-14,12,1117,1279,2396,ElFi_T,"-37.81798049, 144.96503383"
841420231217,84,2023-12-17,14,1106,1710,2816,ElFi_T,"-37.81798049, 144.96503383"
3720231023,3,2023-10-23,7,58,134,192,Swa295_T,"-37.81101524, 144.96429485"
78920240924,78,2024-09-24,9,28,34,62,HarEsB_T,"-37.81471642, 144.9446508"
421420241118,42,2024-11-18,14,91,121,212,UM1_T,"-37.80008566, 144.96386412"
421220241227,42,2024-12-27,12,49,41,90,UM1_T,"-37.80008566, 144.96386412"
59020241109,59,2024-11-09,0,74,88,162,RMIT_T,"-37.80825648, 144.96304859"
59120250816,59,2025-08-16,1,71,55,126,RMIT_T,"-37.80825648, 144.96304859"
59320240102,59,2024-01-02,3,19,3,22,RMIT_T,"-37.80825648, 144.96304859"
29520240126,29,2024-01-26,5,6,33,39,AG_T,"-37.8199817, 144.96872865"
281720241007,28,2024-10-07,17,413,833,1246,VAC_T,"-37.82129925, 144.96879309"
471620231208,47,2023-12-08,16,1024,846,1870,Eli250_T,"-37.81258467, 144.9625775"
47220250319,47,2025-03-19,2,14,18,32,Eli250_T,"-37.81258467, 144.9625775"
47020240118,47,2024-01-18,0,168,78,246,Eli250_T,"-37.81258467, 144.9625775"
31520231222,31,2023-12-22,5,6,3,9,Lyg161_T,"-37.80169681, 144.96658911"
21720240101,21,2024-01-01,7,24,34,58,Bourke155_T,"-37.81267313, 144.96788288"
36020240403,36,2024-04-03,0,7,6,13,Que85_T,"-37.81652527, 144.96121062"
361420231031,36,2023-10-31,14,167,195,362,Que85_T,"-37.81652527, 144.96121062"
37820250713,37,2025-07-13,8,30,13,43,Lyg260_T,"-37.80107122, 144.96704554"
452220251005,45,2025-10-05,22,101,269,370,Swa148_T,"-37.81414075, 144.96609379"
431020231129,43,2023-11-29,10,81,88,169,UM2_T,"-37.79844526, 144.96411782"
118820241022,118,2024-10-22,8,38,13,51,Fli114C_T,"-37.81632783, 144.97090512"
118520231119,118,2023-11-19,5,0,2,2,Fli114C_T,"-37.81632783, 144.97090512"
1182120240129,118,2024-01-29,21,3,5,8,Fli114C_T,"-37.81632783, 144.97090512"
87420240229,87,2024-02-29,4,4,5,9,Errol23_T,"-37.80454949, 144.94921863"
502220240104,50,2024-01-04,22,114,54,168,Lyg309_T,"-37.79808192, 144.96721013"
165720250922,165,2025-09-22,7,7,30,37,Spen475_T,"-37.80953359, 144.94939004"
167920241226,167,2024-12-26,9,25,84,109,Lat526_T,"-37.81304149, 144.95155955"
165720250819,165,2025-08-19,7,13,33,46,Spen475_T,"-37.80953359, 144.94939004"
852320250225,85,2025-02-25,23,4,14,18,488Mac_T,"-37.79432415, 144.92973378"
1671820250908,167,2025-09-08,18,39,70,109,Lat526_T,"-37.81304149, 144.95155955"
1720241101,1,2024-11-01,7,68,67,135,Bou292_T,"-37.81349441, 144.96515323"
11520250503,1,2025-05-03,15,1718,1535,3253,Bou292_T,"-37.81349441, 144.96515323"
681520250915,68,2025-09-15,15,236,228,464,FLDegN_T,"-37.8168479, 144.96559789"
561820241123,56,2024-11-23,18,395,420,815,Lon364_T,"-37.81234775, 144.96153311"
101220240423,10,2024-04-23,12,219,175,394,BouHbr_T,"-37.81876474, 144.94710545"
12020240921,12,2024-09-21,0,25,18,43,NewQ_T,"-37.81457988, 144.94292398"
122320250220,12,2025-02-20,23,29,41,70,NewQ_T,"-37.81457988, 144.94292398"
72720241028,72,2024-10-28,7,163,43,206,ACMI_T,"-37.81726338, 144.96872809"
721920240501,72,2024-05-01,19,214,290,504,ACMI_T,"-37.81726338, 144.96872809"
22220240531,2,2024-05-31,22,77,162,239,Bou283_T,"-37.81380668, 144.96516718"
581520250828,58,2025-08-28,15,562,543,1105,Bou688_T,"-37.81686075, 144.95358075"
91220240829,9,2024-08-29,12,687,674,1361,Col700_T,"-37.81982992, 144.95102555"
511420240613,51,2024-06-13,14,104,101,205,Fra118_T,"-37.80841815, 144.95906316"
511720250403,51,2025-04-03,17,137,115,252,Fra118_T,"-37.80841815, 144.95906316"
51620231112,51,2023-11-12,6,3,17,20,Fra118_T,"-37.80841815, 144.95906316"
512020231210,51,2023-12-10,20,53,75,128,Fra118_T,"-37.80841815, 144.95906316"
521720241126,52,2024-11-26,17,429,359,788,Eli263_T,"-37.81252157, 144.9619401"
1412020250802,141,2025-08-02,20,131,167,298,474Fl_T,"-37.81997273, 144.95834911"
137920241102,137,2024-11-02,9,7,4,11,BouHbr2353_T,"-37.81894815, 144.94612292"
1411920240205,141,2024-02-05,19,78,82,160,474Fl_T,"-37.81997273, 144.95834911"
139720241029,139,2024-10-29,7,15,161,176,Signal1647_T,"-37.81959923, 144.9632832"
1421920231215,142,2023-12-15,19,1278,870,2148,Hammer1584_T,"-37.81970749, 144.96795734"
1422020250327,142,2025-03-27,20,60,41,101,Hammer1584_T,"-37.81970749, 144.96795734"
1381120240222,138,2024-02-22,11,4,4,8,EntPark1671_T,"-37.81996544, 144.95981454"
1612320240608,161,2024-06-08,23,1,1,2,BirArt1109_T,"-37.81851276, 144.97131336"
1612220250208,161,2025-02-08,22,0,4,4,BirArt1109_T,"-37.81851276, 144.97131336"
49620240725,49,2024-07-25,6,45,45,90,Eli501_T,"-37.80730068, 144.95956055"
661620241130,66,2024-11-30,16,1270,1322,2592,QVN_T,"-37.81057846, 144.96444294"
692020240323,69,2024-03-23,20,41,60,101,FLDegC_T,"-37.81687226, 144.96559144"
6020250121,6,2025-01-21,0,134,40,174,FliS_T,"-37.81911705, 144.96558255"
841920240930,84,2024-09-30,19,665,909,1574,ElFi_T,"-37.81798049, 144.96503383"
42220240520,4,2024-05-20,22,188,131,319,Swa123_T,"-37.81487988, 144.9660878"
701920250112,70,2025-01-12,19,131,120,251,Errol20_T,"-37.80456984, 144.94946228"
39820250115,39,2025-01-15,8,131,120,251,AlfPl_T,"-37.81379749, 144.96995745"
31920250621,3,2025-06-21,19,1121,1515,2636,Swa295_T,"-37.81101524, 144.96429485"
8620240705,8,2024-07-05,6,11,5,16,WebBN_T,"-37.82293543, 144.9471751"
411320250305,41,2025-03-05,13,1522,1686,3208,Swa31,"-37.81668634, 144.96689733"
41620231025,41,2023-10-25,6,311,191,502,Swa31,"-37.81668634, 144.96689733"
81520250307,8,2025-03-07,15,174,259,433,WebBN_T,"-37.82293543, 144.9471751"
422120240525,42,2024-05-25,21,35,150,185,UM1_T,"-37.80008566, 144.96386412"
711020241219,71,2024-12-19,10,18,27,45,WestWP_T,"-37.81235775, 144.97136962"
711120240327,71,2024-03-27,11,25,21,46,WestWP_T,"-37.81235775, 144.97136962"
712020250804,71,2025-08-04,20,0,1,1,WestWP_T,"-37.81235775, 144.97136962"
312220240302,31,2024-03-02,22,316,341,657,Lyg161_T,"-37.80169681, 144.96658911"
54420241213,54,2024-12-13,4,4,0,4,Swa607_T,"-37.804024, 144.96308399"
472020240729,47,2024-07-29,20,420,303,723,Eli250_T,"-37.81258467, 144.9625775"
471720240629,47,2024-06-29,17,994,790,1784,Eli250_T,"-37.81258467, 144.9625775"
611420241018,61,2024-10-18,14,457,551,1008,RMIT14_T,"-37.80767455, 144.96309114"
14320231225,14,2023-12-25,3,35,8,43,SanBri_T,"-37.82011242, 144.96291897"
71820250428,71,2025-04-28,8,13,14,27,WestWP_T,"-37.81235775, 144.97136962"
711320240807,71,2024-08-07,13,13,26,39,WestWP_T,"-37.81235775, 144.97136962"
281720240817,28,2024-08-17,17,406,1329,1735,VAC_T,"-37.82129925, 144.96879309"
14720250315,14,2025-03-15,7,113,48,161,SanBri_T,"-37.82011242, 144.96291897"
541020240422,54,2024-04-22,10,196,79,275,Swa607_T,"-37.804024, 144.96308399"
28220250626,28,2025-06-26,2,6,6,12,VAC_T,"-37.82129925, 144.96879309"
471820250329,47,2025-03-29,18,930,914,1844,Eli250_T,"-37.81258467, 144.9625775"
5520240421,5,2024-04-21,5,28,18,46,PriNW_T,"-37.81874249, 144.96787656"
361420250130,36,2025-01-30,14,183,235,418,Que85_T,"-37.81652527, 144.96121062"
452220241230,45,2024-12-30,22,196,371,567,Swa148_T,"-37.81414075, 144.96609379"
108320250901,108,2025-09-01,3,10,11,21,261Will_T,"-37.81295822, 144.95678789"
165820241020,165,2024-10-20,8,5,15,20,Spen475_T,"-37.80953359, 144.94939004"
1651720241116,165,2024-11-16,17,71,95,166,Spen475_T,"-37.80953359, 144.94939004"
1311220250908,131,2025-09-08,12,141,162,303,King2_T,"-37.82009057, 144.95758725"
143020240605,143,2024-06-05,0,41,24,65,Spencer_T,"-37.821728, 144.95557015"
621920240127,62,2024-01-27,19,166,82,248,Lat224_T,"-37.80996494, 144.96216521"
62620241128,62,2024-11-28,6,82,29,111,Lat224_T,"-37.80996494, 144.96216521"
56520241106,56,2024-11-06,5,15,2,17,Lon364_T,"-37.81234775, 144.96153311"
121820250305,12,2025-03-05,18,195,315,510,NewQ_T,"-37.81457988, 144.94292398"
12420240408,12,2024-04-08,4,3,2,5,NewQ_T,"-37.81457988, 144.94292398"
582320241118,58,2024-11-18,23,1701,178,1879,Bou688_T,"-37.81686075, 144.95358075"
351720240709,35,2024-07-09,17,1463,887,2350,SouthB_T,"-37.82018685, 144.96508508"
271220241230,27,2024-12-30,12,101,146,247,Vic_T,"-37.80606888, 144.95644692"
232020250402,23,2025-04-02,20,109,172,281,Col623_T,"-37.81909256, 144.95452748"
231020250902,23,2025-09-02,10,228,213,441,Col623_T,"-37.81909256, 144.95452748"
202020240929,20,2024-09-29,20,206,436,642,LtB170_T,"-37.81172914, 144.9682466"
46920231130,46,2023-11-30,9,42,139,181,Pel147_T,"-37.80240719, 144.9615673"
191620250908,19,2025-09-08,16,366,310,676,LtB210_T,"-37.81237202, 144.96550671"
109120241114,109,2024-11-14,1,9,22,31,LatWill_T,"-37.81193681, 144.95621105"
180720250816,180,2025-08-16,7,19,8,27,Mac330_T,"-37.79497059, 144.93530329"
142520241213,142,2024-12-13,5,22,6,28,Hammer1584_T,"-37.81970749, 144.96795734"
1301920250117,130,2025-01-17,19,33,29,62,Bou892T,"-37.8204637, 144.94126826"
130220250315,130,2025-03-15,2,0,1,1,Bou892T,"-37.8204637, 144.94126826"
1220240112,1,2024-01-12,2,3,25,28,Bou292_T,"-37.81349441, 144.96515323"
85220250201,85,2025-02-01,2,0,1,1,488Mac_T,"-37.79432415, 144.92973378"
68820241025,68,2024-10-25,8,113,89,202,FLDegN_T,"-37.8168479, 144.96559789"
661120250719,66,2025-07-19,11,616,791,1407,QVN_T,"-37.81057846, 144.96444294"
69620240123,69,2024-01-23,6,21,11,32,FLDegC_T,"-37.81687226, 144.96559144"
43020240923,43,2024-09-23,0,4,4,8,UM2_T,"-37.79844526, 144.96411782"
45020250203,45,2025-02-03,0,3,40,43,Swa148_T,"-37.81414075, 144.96609379"
45520241202,45,2024-12-02,5,8,38,46,Swa148_T,"-37.81414075, 144.96609379"
51820231112,5,2023-11-12,18,881,1026,1907,PriNW_T,"-37.81874249, 144.96787656"
211620250207,21,2025-02-07,16,302,323,625,Bourke155_T,"-37.81267313, 144.96788288"
211120250305,21,2025-03-05,11,206,179,385,Bourke155_T,"-37.81267313, 144.96788288"
135020240326,135,2024-03-26,0,15,30,45,Spen161_T,"-37.8172861, 144.95319102"
1082020240319,108,2024-03-19,20,239,121,360,261Will_T,"-37.81295822, 144.95678789"
871720250729,87,2025-07-29,17,106,94,200,Errol23_T,"-37.80454949, 144.94921863"
162320250523,162,2025-05-23,3,20,14,34,Eli489_T,"-37.80740397, 144.95987909"
1621520240706,162,2024-07-06,15,592,1015,1607,Eli489_T,"-37.80740397, 144.95987909"
17520250403,17,2025-04-03,5,51,13,64,Col15_T,"-37.81362543, 144.97323591"
17320251015,17,2025-10-15,3,5,7,12,Col15_T,"-37.81362543, 144.97323591"
1420250313,1,2025-03-13,4,4,8,12,Bou292_T,"-37.81349441, 144.96515323"
671520240115,67,2024-01-15,15,309,322,631,FLDegS_T,"-37.81688755, 144.96562569"
66620250227,66,2025-02-27,6,26,86,112,QVN_T,"-37.81057846, 144.96444294"
751820231231,75,2023-12-31,18,74,88,162,SprFli_T,"-37.81515276, 144.97467661"
782120250124,78,2025-01-24,21,5,15,20,HarEsB_T,"-37.81471642, 144.9446508"
71820240609,71,2024-06-09,8,3,1,4,WestWP_T,"-37.81235775, 144.97136962"
59920250619,59,2025-06-19,9,508,232,740,RMIT_T,"-37.80825648, 144.96304859"
591220240127,59,2024-01-27,12,424,458,882,RMIT_T,"-37.80825648, 144.96304859"
311520241212,31,2024-12-12,15,132,127,259,Lyg161_T,"-37.80169681, 144.96658911"
371620250326,37,2025-03-26,16,154,128,282,Lyg260_T,"-37.80107122, 144.96704554"
432120241006,43,2024-10-06,21,36,34,70,UM2_T,"-37.79844526, 144.96411782"
1071920240715,107,2024-07-15,19,22,21,43,280Will_T,"-37.81246271, 144.95690188"
1332020240204,133,2024-02-04,20,448,318,766,Spen229_T,"-37.81531435, 144.95227769"
1331420240610,133,2024-06-10,14,447,496,943,Spen229_T,"-37.81531435, 144.95227769"
1331320240914,133,2024-09-14,13,375,389,764,Spen229_T,"-37.81531435, 144.95227769"
1331520240917,133,2024-09-17,15,509,583,1092,Spen229_T,"-37.81531435, 144.95227769"
133020241129,133,2024-11-29,0,48,30,78,Spen229_T,"-37.81531435, 144.95227769"
1182020250828,118,2025-08-28,20,2,11,13,Fli114C_T,"-37.81632783, 144.97090512"
1181020250924,118,2025-09-24,10,7,10,17,Fli114C_T,"-37.81632783, 144.97090512"
107420240430,107,2024-04-30,4,0,2,2,280Will_T,"-37.81246271, 144.95690188"
871120240721,87,2024-07-21,11,92,83,175,Errol23_T,"-37.80454949, 144.94921863"
61320231128,61,2023-11-28,3,5,3,8,RMIT14_T,"-37.80767455, 144.96309114"
61920241006,61,2024-10-06,9,117,179,296,RMIT14_T,"-37.80767455, 144.96309114"
1661820241014,166,2024-10-14,18,90,69,159,Spen484_T,"-37.80896733, 144.94931703"
1811420250822,181,2025-08-22,14,821,1052,1873,Eli368_T,"-37.81009465, 144.96143149"
1321020240604,132,2024-06-04,10,158,72,230,King335_T,"-37.81267639, 144.95386444"
852020240621,85,2024-06-21,20,24,26,50,488Mac_T,"-37.79432415, 144.92973378"
852120240827,85,2024-08-27,21,16,12,28,488Mac_T,"-37.79432415, 144.92973378"
851120240928,85,2024-09-28,11,144,101,245,488Mac_T,"-37.79432415, 144.92973378"
1331120240331,133,2024-03-31,11,393,513,906,Spen229_T,"-37.81531435, 144.95227769"
1181120250706,118,2025-07-06,11,10,24,34,Fli114C_T,"-37.81632783, 144.97090512"
1181220250918,118,2025-09-18,12,20,22,42,Fli114C_T,"-37.81632783, 144.97090512"
124820250707,124,2025-07-07,8,2,5,7,BirBridge_T,"-37.81757416, 144.97329934"
872120240809,87,2024-08-09,21,47,73,120,Errol23_T,"-37.80454949, 144.94921863"
1661220241011,166,2024-10-11,12,48,53,101,Spen484_T,"-37.80896733, 144.94931703"
1621020241124,162,2024-11-24,10,187,232,419,Eli489_T,"-37.80740397, 144.95987909"
66820250526,66,2025-05-26,8,242,496,738,QVN_T,"-37.81057846, 144.96444294"
69920241216,69,2024-12-16,9,236,107,343,FLDegC_T,"-37.81687226, 144.96559144"
84320240109,84,2024-01-09,3,14,12,26,ElFi_T,"-37.81798049, 144.96503383"
751320250407,75,2025-04-07,13,57,55,112,SprFli_T,"-37.81515276, 144.97467661"
421620240830,42,2024-08-30,16,234,639,873,UM1_T,"-37.80008566, 144.96386412"
591120241128,59,2024-11-28,11,244,183,427,RMIT_T,"-37.80825648, 144.96304859"
59420240519,59,2024-05-19,4,32,13,45,RMIT_T,"-37.80825648, 144.96304859"
292120240112,29,2024-01-12,21,323,354,677,AG_T,"-37.8199817, 144.96872865"
141120240128,14,2024-01-28,11,350,143,493,SanBri_T,"-37.82011242, 144.96291897"
40420250309,40,2025-03-09,4,10,3,13,Spr201_T,"-37.80999341, 144.97227587"
21820240216,21,2024-02-16,8,69,111,180,Bourke155_T,"-37.81267313, 144.96788288"
50120250426,50,2025-04-26,1,4,4,8,Lyg309_T,"-37.79808192, 144.96721013"
441320240320,44,2024-03-20,13,100,101,201,UM3_T,"-37.79698741, 144.96441306"
12220240902,1,2024-09-02,22,6,4,10,Bou292_T,"-37.81349441, 144.96515323"
18620250421,18,2025-04-21,6,2,7,9,Col12_T,"-37.81344862, 144.97305353"
63920241005,63,2024-10-05,9,137,190,327,Bou231_T,"-37.81333081, 144.96675571"
11420250218,1,2025-02-18,14,1046,1092,2138,Bou292_T,"-37.81349441, 144.96515323"
622320240607,62,2024-06-07,23,98,50,148,Lat224_T,"-37.80996494, 144.96216521"
561620241009,56,2024-10-09,16,384,375,759,Lon364_T,"-37.81234775, 144.96153311"
561920241106,56,2024-11-06,19,297,306,603,Lon364_T,"-37.81234775, 144.96153311"
861320240718,86,2024-07-18,13,79,96,175,574Qub_T,"-37.80309992, 144.94908064"
241620231217,24,2023-12-17,16,421,538,959,Col620_T,"-37.81887963, 144.95449198"
12520240122,12,2024-01-22,5,7,3,10,NewQ_T,"-37.81457988, 144.94292398"
562220250514,56,2025-05-14,22,99,162,261,Lon364_T,"-37.81234775, 144.96153311"
241920250702,24,2025-07-02,19,282,577,859,Col620_T,"-37.81887963, 144.95449198"
35020250902,35,2025-09-02,0,14,10,24,SouthB_T,"-37.82018685, 144.96508508"
58220240414,58,2024-04-14,2,78,84,162,Bou688_T,"-37.81686075, 144.95358075"
27220240628,27,2024-06-28,2,6,3,9,Vic_T,"-37.80606888, 144.95644692"
53720250818,53,2025-08-18,7,146,63,209,Col254_T,"-37.81564191, 144.965499"
531220240123,53,2024-01-23,12,1084,851,1935,Col254_T,"-37.81564191, 144.965499"
53420240411,53,2024-04-11,4,5,4,9,Col254_T,"-37.81564191, 144.965499"
27520250905,27,2025-09-05,5,6,5,11,Vic_T,"-37.80606888, 144.95644692"
231120231203,23,2023-12-03,11,117,204,321,Col623_T,"-37.81909256, 144.95452748"
231520240321,23,2024-03-21,15,221,545,766,Col623_T,"-37.81909256, 144.95452748"
522020231114,52,2023-11-14,20,275,256,531,Eli263_T,"-37.81252157, 144.9619401"
23620250105,23,2025-01-05,6,10,38,48,Col623_T,"-37.81909256, 144.95452748"
482020240331,48,2024-03-31,20,95,121,216,QVMQ_T,"-37.80631581, 144.95866697"
201920250218,20,2025-02-18,19,279,297,576,LtB170_T,"-37.81172914, 144.9682466"
20220240727,20,2024-07-27,2,44,41,85,LtB170_T,"-37.81172914, 144.9682466"
25120241119,25,2024-11-19,1,7,11,18,MCEC_T,"-37.82401776, 144.95604426"
25720250530,25,2025-05-30,7,149,168,317,MCEC_T,"-37.82401776, 144.95604426"
1641220241107,164,2024-11-07,12,112,75,187,Lat526_T,"-37.813005, 144.95160411"
1802320250809,180,2025-08-09,23,2,1,3,Mac330_T,"-37.79497059, 144.93530329"
1362120231211,136,2023-12-11,21,2,10,12,BirFed1120_T,"-37.8184141, 144.97357915"
1382120250104,138,2025-01-04,21,1,1,2,EntPark1671_T,"-37.81996544, 144.95981454"
1232220250403,123,2025-04-03,22,3,2,5,BirBridge_T,"-37.81753741, 144.97329734"
123820251009,123,2025-10-09,8,58,11,69,BirBridge_T,"-37.81753741, 144.97329734"
6120241004,6,2024-10-04,1,53,60,113,FliS_T,"-37.81911705, 144.96558255"
391920240819,39,2024-08-19,19,28,26,54,AlfPl_T,"-37.81379749, 144.96995745"
39820240918,39,2024-09-18,8,86,99,185,AlfPl_T,"-37.81379749, 144.96995745"
75020250207,75,2025-02-07,0,1,1,2,SprFli_T,"-37.81515276, 144.97467661"
591220241008,59,2024-10-08,12,976,1177,2153,RMIT_T,"-37.80825648, 144.96304859"
29320240523,29,2024-05-23,3,0,6,6,AG_T,"-37.8199817, 144.96872865"
14720250410,14,2025-04-10,7,203,261,464,SanBri_T,"-37.82011242, 144.96291897"
311020250921,31,2025-09-21,10,111,60,171,Lyg161_T,"-37.80169681, 144.96658911"
311420240118,31,2024-01-18,14,130,136,266,Lyg161_T,"-37.80169681, 144.96658911"
211120240815,21,2024-08-15,11,289,246,535,Bourke155_T,"-37.81267313, 144.96788288"
361420241123,36,2024-11-23,14,128,173,301,Que85_T,"-37.81652527, 144.96121062"
431620250503,43,2025-05-03,16,98,89,187,UM2_T,"-37.79844526, 144.96411782"
442220250627,44,2025-06-27,22,8,4,12,UM3_T,"-37.79698741, 144.96441306"
61520250912,61,2025-09-12,5,7,20,27,RMIT14_T,"-37.80767455, 144.96309114"
611520240120,61,2024-01-20,15,215,379,594,RMIT14_T,"-37.80767455, 144.96309114"
167020250501,167,2025-05-01,0,4,7,11,Lat526_T,"-37.81304149, 144.95155955"
1651020250604,165,2025-06-04,10,17,24,41,Spen475_T,"-37.80953359, 144.94939004"
162820250514,162,2025-05-14,8,322,159,481,Eli489_T,"-37.80740397, 144.95987909"
1621220250721,162,2025-07-21,12,398,565,963,Eli489_T,"-37.80740397, 144.95987909"
182620250803,182,2025-08-03,6,26,46,72,King163_T,"-37.81627451, 144.95550503"
132420241125,132,2024-11-25,4,5,9,14,King335_T,"-37.81267639, 144.95386444"
1341620250320,134,2025-03-20,16,415,428,843,Spen201_T,"-37.81694221, 144.95303935"
68820240801,68,2024-08-01,8,105,90,195,FLDegN_T,"-37.8168479, 144.96559789"
67520240425,67,2024-04-25,5,9,16,25,FLDegS_T,"-37.81688755, 144.96562569"
18420250125,18,2025-01-25,4,5,1,6,Col12_T,"-37.81344862, 144.97305353"
181120250228,18,2025-02-28,11,171,210,381,Col12_T,"-37.81344862, 144.97305353"
181020250726,18,2025-07-26,10,78,104,182,Col12_T,"-37.81344862, 144.97305353"
63920240116,63,2024-01-16,9,181,210,391,Bou231_T,"-37.81333081, 144.96675571"
561820231107,56,2023-11-07,18,228,189,417,Lon364_T,"-37.81234775, 144.96153311"
561320240422,56,2024-04-22,13,324,308,632,Lon364_T,"-37.81234775, 144.96153311"
56020240516,56,2024-05-16,0,28,25,53,Lon364_T,"-37.81234775, 144.96153311"
122220250419,12,2025-04-19,22,155,401,556,NewQ_T,"-37.81457988, 144.94292398"
241820240312,24,2024-03-12,18,490,1313,1803,Col620_T,"-37.81887963, 144.95449198"
761820240825,76,2024-08-25,18,16,21,37,KenMac_T,"-37.79453803, 144.93036194"
35920240717,35,2024-07-17,9,484,942,1426,SouthB_T,"-37.82018685, 144.96508508"
2320241224,2,2024-12-24,3,4,15,19,Bou283_T,"-37.81380668, 144.96516718"
58220250611,58,2025-06-11,2,11,25,36,Bou688_T,"-37.81686075, 144.95358075"
231420231127,23,2023-11-27,14,178,298,476,Col623_T,"-37.81909256, 144.95452748"
79720240429,79,2024-04-29,7,186,121,307,FliSS_T,"-37.81794046, 144.96616678"
301220250224,30,2025-02-24,12,201,368,569,Lon189_T,"-37.8112185, 144.96656806"
30220250323,30,2025-03-23,2,121,220,341,Lon189_T,"-37.8112185, 144.96656806"
521520240309,52,2024-03-09,15,329,282,611,Eli263_T,"-37.81252157, 144.9619401"
461820250614,46,2025-06-14,18,2,3,5,Pel147_T,"-37.80240719, 144.9615673"
52520231206,52,2023-12-06,5,16,12,28,Eli263_T,"-37.81252157, 144.9619401"
511120240221,51,2024-02-21,11,89,74,163,Fra118_T,"-37.80841815, 144.95906316"
201420241215,20,2024-12-15,14,151,241,392,LtB170_T,"-37.81172914, 144.9682466"
11620231105,1,2023-11-05,16,1733,1430,3163,Bou292_T,"-37.81349441, 144.96515323"
631320240908,63,2024-09-08,13,332,402,734,Bou231_T,"-37.81333081, 144.96675571"
68820241111,68,2024-11-11,8,132,91,223,FLDegN_T,"-37.8168479, 144.96559789"
11820240518,11,2024-05-18,8,39,40,79,WatCit_T,"-37.81564989, 144.93970694"
861620240720,86,2024-07-20,16,31,40,71,574Qub_T,"-37.80309992, 144.94908064"
861720250401,86,2025-04-01,17,36,69,105,574Qub_T,"-37.80309992, 144.94908064"
122220250506,12,2025-05-06,22,92,88,180,NewQ_T,"-37.81457988, 144.94292398"
561220250914,56,2025-09-14,12,378,366,744,Lon364_T,"-37.81234775, 144.96153311"
24220231217,24,2023-12-17,2,62,62,124,Col620_T,"-37.81887963, 144.95449198"
581220250101,58,2025-01-01,12,494,205,699,Bou688_T,"-37.81686075, 144.95358075"
351420240107,35,2024-01-07,14,396,463,859,SouthB_T,"-37.82018685, 144.96508508"
721520250310,72,2025-03-10,15,298,578,876,ACMI_T,"-37.81726338, 144.96872809"
721520250327,72,2025-03-27,15,164,361,525,ACMI_T,"-37.81726338, 144.96872809"
581920250622,58,2025-06-22,19,351,334,685,Bou688_T,"-37.81686075, 144.95358075"
91120250209,9,2025-02-09,11,63,89,152,Col700_T,"-37.81982992, 144.95102555"
271620250825,27,2025-08-25,16,141,91,232,Vic_T,"-37.80606888, 144.95644692"
301020240923,30,2024-09-23,10,91,204,295,Lon189_T,"-37.8112185, 144.96656806"
531520250427,53,2025-04-27,15,610,408,1018,Col254_T,"-37.81564191, 144.965499"
79520250614,79,2025-06-14,5,16,12,28,FliSS_T,"-37.81794046, 144.96616678"
791520250813,79,2025-08-13,15,478,418,896,FliSS_T,"-37.81794046, 144.96616678"
511520231120,51,2023-11-20,15,88,119,207,Fra118_T,"-37.80841815, 144.95906316"
20620241015,20,2024-10-15,6,9,14,23,LtB170_T,"-37.81172914, 144.9682466"
46720240325,46,2024-03-25,7,29,29,58,Pel147_T,"-37.80240719, 144.9615673"
1641520241023,164,2024-10-23,15,122,90,212,Lat526_T,"-37.813005, 144.95160411"
141320250227,141,2025-02-27,3,16,11,27,474Fl_T,"-37.81997273, 144.95834911"
136720240307,136,2024-03-07,7,95,132,227,BirFed1120_T,"-37.8184141, 144.97357915"
1361620240430,136,2024-04-30,16,177,72,249,BirFed1120_T,"-37.8184141, 144.97357915"
1361620250509,136,2025-05-09,16,263,70,333,BirFed1120_T,"-37.8184141, 144.97357915"
1422120250706,142,2025-07-06,21,1,1,2,Hammer1584_T,"-37.81970749, 144.96795734"
69420231115,69,2023-11-15,4,1,2,3,FLDegC_T,"-37.81687226, 144.96559144"
6920250201,6,2025-02-01,9,411,324,735,FliS_T,"-37.81911705, 144.96558255"
751920241101,75,2024-11-01,19,28,45,73,SprFli_T,"-37.81515276, 144.97467661"
421720240909,42,2024-09-09,17,214,597,811,UM1_T,"-37.80008566, 144.96386412"
311920240411,31,2024-04-11,19,280,255,535,Lyg161_T,"-37.80169681, 144.96658911"
54920240529,54,2024-05-29,9,164,53,217,Swa607_T,"-37.804024, 144.96308399"
471520250502,47,2025-05-02,15,1043,1091,2134,Eli250_T,"-37.81258467, 144.9625775"
361720240303,36,2024-03-03,17,105,55,160,Que85_T,"-37.81652527, 144.96121062"
361520231028,36,2023-10-28,15,100,119,219,Que85_T,"-37.81652527, 144.96121062"
501920250724,50,2025-07-24,19,191,142,333,Lyg309_T,"-37.79808192, 144.96721013"
50020240417,50,2024-04-17,0,7,5,12,Lyg309_T,"-37.79808192, 144.96721013"
431220231106,43,2023-11-06,12,116,140,256,UM2_T,"-37.79844526, 144.96411782"
431120240210,43,2024-02-10,11,30,57,87,UM2_T,"-37.79844526, 144.96411782"
1181320250114,118,2025-01-14,13,23,42,65,Fli114C_T,"-37.81632783, 144.97090512"
1181020231021,118,2023-10-21,10,4,18,22,Fli114C_T,"-37.81632783, 144.97090512"
871020250302,87,2025-03-02,10,100,87,187,Errol23_T,"-37.80454949, 144.94921863"
872220250818,87,2025-08-18,22,10,9,19,Errol23_T,"-37.80454949, 144.94921863"
201620240606,20,2024-06-06,16,199,195,394,LtB170_T,"-37.81172914, 144.9682466"
25520240708,25,2024-07-08,5,11,15,26,MCEC_T,"-37.82401776, 144.95604426"
461720231227,46,2023-12-27,17,31,40,71,Pel147_T,"-37.80240719, 144.9615673"
142620240723,142,2024-07-23,6,55,8,63,Hammer1584_T,"-37.81970749, 144.96795734"
1232120240107,123,2024-01-07,21,0,1,1,BirBridge_T,"-37.81753741, 144.97329734"
1381520240717,138,2024-07-17,15,5,1,6,EntPark1671_T,"-37.81996544, 144.95981454"
117120240418,117,2024-04-18,1,7,2,9,Fli114F_T,"-37.81629332, 144.97090877"
1171520240628,117,2024-06-28,15,132,170,302,Fli114F_T,"-37.81629332, 144.97090877"
1091720240409,109,2024-04-09,17,472,200,672,LatWill_T,"-37.81193681, 144.95621105"
109720231105,109,2023-11-05,7,20,14,34,LatWill_T,"-37.81193681, 144.95621105"
841020241115,84,2024-11-15,10,824,646,1470,ElFi_T,"-37.81798049, 144.96503383"
701320250825,70,2025-08-25,13,148,142,290,Errol20_T,"-37.80456984, 144.94946228"
751120251005,75,2025-10-05,11,52,44,96,SprFli_T,"-37.81515276, 144.97467661"
41520231205,41,2023-12-05,5,124,105,229,Swa31,"-37.81668634, 144.96689733"
781020250325,78,2025-03-25,10,29,34,63,HarEsB_T,"-37.81471642, 144.9446508"
29920240409,29,2024-04-09,9,63,55,118,AG_T,"-37.8199817, 144.96872865"
14920240706,14,2024-07-06,9,248,84,332,SanBri_T,"-37.82011242, 144.96291897"
142220240806,14,2024-08-06,22,137,43,180,SanBri_T,"-37.82011242, 144.96291897"
54120240613,54,2024-06-13,1,14,6,20,Swa607_T,"-37.804024, 144.96308399"
281920240818,28,2024-08-18,19,508,141,649,VAC_T,"-37.82129925, 144.96879309"
471420240123,47,2024-01-23,14,811,922,1733,Eli250_T,"-37.81258467, 144.9625775"
211820250331,21,2025-03-31,18,395,367,762,Bourke155_T,"-37.81267313, 144.96788288"
50520240929,50,2024-09-29,5,6,1,7,Lyg309_T,"-37.79808192, 144.96721013"
50320250125,50,2025-01-25,3,7,0,7,Lyg309_T,"-37.79808192, 144.96721013"
50120250419,50,2025-04-19,1,1,10,11,Lyg309_T,"-37.79808192, 144.96721013"
441720240908,44,2024-09-08,17,21,32,53,UM3_T,"-37.79698741, 144.96441306"
431620240424,43,2024-04-24,16,272,442,714,UM2_T,"-37.79844526, 144.96411782"
131420240204,131,2024-02-04,4,52,77,129,King2_T,"-37.82009057, 144.95758725"
1351520231029,135,2023-10-29,15,455,353,808,Spen161_T,"-37.8172861, 144.95319102"
107720240718,107,2024-07-18,7,21,56,77,280Will_T,"-37.81246271, 144.95690188"
1071420250629,107,2025-06-29,14,100,102,202,280Will_T,"-37.81246271, 144.95690188"
1181020240121,118,2024-01-21,10,6,56,62,Fli114C_T,"-37.81632783, 144.97090512"
118320250227,118,2025-02-27,3,0,1,1,Fli114C_T,"-37.81632783, 144.97090512"
871220250813,87,2025-08-13,12,172,157,329,Errol23_T,"-37.80454949, 144.94921863"
61620240215,61,2024-02-15,6,96,98,194,RMIT14_T,"-37.80767455, 144.96309114"
181520250915,181,2025-09-15,5,30,60,90,Eli368_T,"-37.81009465, 144.96143149"
1811720250502,181,2025-05-02,17,1105,1506,2611,Eli368_T,"-37.81009465, 144.96143149"
1432020250929,143,2025-09-29,20,97,151,248,Spencer_T,"-37.821728, 144.95557015"
1322220250117,132,2025-01-17,22,97,109,206,King335_T,"-37.81267639, 144.95386444"
682020250307,68,2025-03-07,20,138,72,210,FLDegN_T,"-37.8168479, 144.96559789"
852020240328,85,2024-03-28,20,41,31,72,488Mac_T,"-37.79432415, 144.92973378"
171520250126,17,2025-01-26,15,193,147,340,Col15_T,"-37.81362543, 144.97323591"
671720240114,67,2024-01-14,17,347,429,776,FLDegS_T,"-37.81688755, 144.96562569"
56020241223,56,2024-12-23,0,15,43,58,Lon364_T,"-37.81234775, 144.96153311"
12720240324,12,2024-03-24,7,78,27,105,NewQ_T,"-37.81457988, 144.94292398"
562320250706,56,2025-07-06,23,35,133,168,Lon364_T,"-37.81234775, 144.96153311"
241920240623,24,2024-06-23,19,268,399,667,Col620_T,"-37.81887963, 144.95449198"
761120241124,76,2024-11-24,11,35,27,62,KenMac_T,"-37.79453803, 144.93036194"
351820250216,35,2025-02-16,18,1165,1421,2586,SouthB_T,"-37.82018685, 144.96508508"
582020250114,58,2025-01-14,20,232,215,447,Bou688_T,"-37.81686075, 144.95358075"
272120250303,27,2025-03-03,21,58,31,89,Vic_T,"-37.80606888, 144.95644692"
271620240516,27,2024-05-16,16,123,110,233,Vic_T,"-37.80606888, 144.95644692"
611220231127,61,2023-11-27,12,258,382,640,RMIT14_T,"-37.80767455, 144.96309114"
1431920250704,143,2025-07-04,19,146,173,319,Spencer_T,"-37.821728, 144.95557015"
143420250722,143,2025-07-22,4,20,2,22,Spencer_T,"-37.821728, 144.95557015"
1341420241006,134,2024-10-06,14,375,356,731,Spen201_T,"-37.81694221, 144.95303935"
134420241107,134,2024-11-07,4,28,17,45,Spen201_T,"-37.81694221, 144.95303935"
622320250217,62,2025-02-17,23,62,66,128,Lat224_T,"-37.80996494, 144.96216521"
11720250519,1,2025-05-19,17,1082,770,1852,Bou292_T,"-37.81349441, 144.96515323"
17220241126,17,2024-11-26,2,2,0,2,Col15_T,"-37.81362543, 144.97323591"
241320240731,24,2024-07-31,13,767,829,1596,Col620_T,"-37.81887963, 144.95449198"
11720250627,11,2025-06-27,7,36,22,58,WatCit_T,"-37.81564989, 144.93970694"
11720250714,11,2025-07-14,7,36,19,55,WatCit_T,"-37.81564989, 144.93970694"
24320250501,24,2025-05-01,3,13,12,25,Col620_T,"-37.81887963, 144.95449198"
271220241213,27,2024-12-13,12,176,138,314,Vic_T,"-37.80606888, 144.95644692"
581120250604,58,2025-06-04,11,584,181,765,Bou688_T,"-37.81686075, 144.95358075"
30020250415,30,2025-04-15,0,39,63,102,Lon189_T,"-37.8112185, 144.96656806"
531920250219,53,2025-02-19,19,216,261,477,Col254_T,"-37.81564191, 144.965499"
23520250511,23,2025-05-11,5,9,25,34,Col623_T,"-37.81909256, 144.95452748"
23120240707,23,2024-07-07,1,7,35,42,Col623_T,"-37.81909256, 144.95452748"
201020240905,20,2024-09-05,10,76,83,159,LtB170_T,"-37.81172914, 144.9682466"
202220250204,20,2025-02-04,22,73,176,249,LtB170_T,"-37.81172914, 144.9682466"
522320241210,52,2024-12-10,23,54,69,123,Eli263_T,"-37.81252157, 144.9619401"
512020250621,51,2025-06-21,20,53,44,97,Fra118_T,"-37.80841815, 144.95906316"
1092120250126,109,2025-01-26,21,52,98,150,LatWill_T,"-37.81193681, 144.95621105"
109120251003,109,2025-10-03,1,7,8,15,LatWill_T,"-37.81193681, 144.95621105"
192220250827,19,2025-08-27,22,217,166,383,LtB210_T,"-37.81237202, 144.96550671"
19620240507,19,2024-05-07,6,14,15,29,LtB210_T,"-37.81237202, 144.96550671"
48620241122,48,2024-11-22,6,31,46,77,QVMQ_T,"-37.80631581, 144.95866697"
141520250610,141,2025-06-10,5,16,1,17,474Fl_T,"-37.81997273, 144.95834911"
1411820240731,141,2024-07-31,18,119,96,215,474Fl_T,"-37.81997273, 144.95834911"
1392220240105,139,2024-01-05,22,26,41,67,Signal1647_T,"-37.81959923, 144.9632832"
136720250124,136,2025-01-24,7,97,105,202,BirFed1120_T,"-37.8184141, 144.97357915"
142320240616,142,2024-06-16,3,4,1,5,Hammer1584_T,"-37.81970749, 144.96795734"
130920240315,130,2024-03-15,9,3,18,21,Bou892T,"-37.8204637, 144.94126826"
1171720250420,117,2025-04-20,17,216,237,453,Fli114F_T,"-37.81629332, 144.97090877"
1231020231207,123,2023-12-07,10,17,3,20,BirBridge_T,"-37.81753741, 144.97329734"
1232120240219,123,2024-02-19,21,2,0,2,BirBridge_T,"-37.81753741, 144.97329734"
751820231102,75,2023-11-02,18,61,48,109,SprFli_T,"-37.81515276, 144.97467661"
751920250601,75,2025-06-01,19,5,5,10,SprFli_T,"-37.81515276, 144.97467661"
411120240308,41,2024-03-08,11,1542,1024,2566,Swa31,"-37.81668634, 144.96689733"
651720231125,65,2023-11-25,17,565,1014,1579,SwaCs_T,"-37.81569416, 144.9668064"
28020241228,28,2024-12-28,0,49,27,76,VAC_T,"-37.82129925, 144.96879309"
28620240128,28,2024-01-28,6,37,18,55,VAC_T,"-37.82129925, 144.96879309"
29520240326,29,2024-03-26,5,19,14,33,AG_T,"-37.8199817, 144.96872865"
23920240303,23,2024-03-03,9,75,87,162,Col623_T,"-37.81909256, 144.95452748"
481420250915,48,2025-09-15,14,138,127,265,QVMQ_T,"-37.80631581, 144.95866697"
20420250308,20,2025-03-08,4,43,73,116,LtB170_T,"-37.81172914, 144.9682466"
180520250606,180,2025-06-06,5,2,1,3,Mac330_T,"-37.79497059, 144.93530329"
141720240924,141,2024-09-24,7,67,62,129,474Fl_T,"-37.81997273, 144.95834911"
1301520241213,130,2024-12-13,15,48,31,79,Bou892T,"-37.8204637, 144.94126826"
491520240707,49,2024-07-07,15,284,603,887,Eli501_T,"-37.80730068, 144.95956055"
69920250802,69,2025-08-02,9,208,123,331,FLDegC_T,"-37.81687226, 144.96559144"
84320241214,84,2024-12-14,3,59,101,160,ElFi_T,"-37.81798049, 144.96503383"
32320241214,3,2024-12-14,23,684,511,1195,Swa295_T,"-37.81101524, 144.96429485"
3620231227,3,2023-12-27,6,28,68,96,Swa295_T,"-37.81101524, 144.96429485"
75820231229,75,2023-12-29,8,13,25,38,SprFli_T,"-37.81515276, 144.97467661"
751120240315,75,2024-03-15,11,39,42,81,SprFli_T,"-37.81515276, 144.97467661"
391720240515,39,2024-05-15,17,137,122,259,AlfPl_T,"-37.81379749, 144.96995745"
412120241007,41,2024-10-07,21,72,63,135,Swa31,"-37.81668634, 144.96689733"
14720241220,14,2024-12-20,7,146,113,259,SanBri_T,"-37.82011242, 144.96291897"
71920241119,71,2024-11-19,9,27,35,62,WestWP_T,"-37.81235775, 144.97136962"
311420250628,31,2025-06-28,14,180,197,377,Lyg161_T,"-37.80169681, 144.96658911"
312220240629,31,2024-06-29,22,165,245,410,Lyg161_T,"-37.80169681, 144.96658911"
541620240208,54,2024-02-08,16,172,322,494,Swa607_T,"-37.804024, 144.96308399"
541320250820,54,2025-08-20,13,298,295,593,Swa607_T,"-37.804024, 144.96308399"
282120241026,28,2024-10-26,21,321,349,670,VAC_T,"-37.82129925, 144.96879309"
471520250206,47,2025-02-06,15,648,662,1310,Eli250_T,"-37.81258467, 144.9625775"
47120250212,47,2025-02-12,1,38,38,76,Eli250_T,"-37.81258467, 144.9625775"
36020250427,36,2025-04-27,0,146,210,356,Que85_T,"-37.81652527, 144.96121062"
361820231106,36,2023-11-06,18,181,154,335,Que85_T,"-37.81652527, 144.96121062"
45120240613,45,2024-06-13,1,15,11,26,Swa148_T,"-37.81414075, 144.96609379"
51320250122,5,2025-01-22,13,1198,1751,2949,PriNW_T,"-37.81874249, 144.96787656"
1071420240724,107,2024-07-24,14,136,127,263,280Will_T,"-37.81246271, 144.95690188"
107320241101,107,2024-11-01,3,6,7,13,280Will_T,"-37.81246271, 144.95690188"
1341520240728,134,2024-07-28,15,375,277,652,Spen201_T,"-37.81694221, 144.95303935"
134720241023,134,2024-10-23,7,522,355,877,Spen201_T,"-37.81694221, 144.95303935"
1181020250129,118,2025-01-29,10,12,20,32,Fli114C_T,"-37.81632783, 144.97090512"
1181920250619,118,2025-06-19,19,4,5,9,Fli114C_T,"-37.81632783, 144.97090512"
108220241030,108,2024-10-30,2,4,2,6,261Will_T,"-37.81295822, 144.95678789"
872020250526,87,2025-05-26,20,38,40,78,Errol23_T,"-37.80454949, 144.94921863"
1432220240818,143,2024-08-18,22,110,83,193,Spencer_T,"-37.821728, 144.95557015"
852020250120,85,2025-01-20,20,37,31,68,488Mac_T,"-37.79432415, 144.92973378"
631420250328,63,2025-03-28,14,315,419,734,Bou231_T,"-37.81333081, 144.96675571"
62620240318,62,2024-03-18,6,93,48,141,Lat224_T,"-37.80996494, 144.96216521"
562320241223,56,2024-12-23,23,74,91,165,Lon364_T,"-37.81234775, 144.96153311"
861420250319,86,2025-03-19,14,38,56,94,574Qub_T,"-37.80309992, 144.94908064"
121520250512,12,2025-05-12,15,80,120,200,NewQ_T,"-37.81457988, 144.94292398"
721720240524,72,2024-05-24,17,340,667,1007,ACMI_T,"-37.81726338, 144.96872809"
22220241107,2,2024-11-07,22,36,104,140,Bou283_T,"-37.81380668, 144.96516718"
581820240915,58,2024-09-15,18,369,259,628,Bou688_T,"-37.81686075, 144.95358075"
581820231114,58,2023-11-14,18,634,1194,1828,Bou688_T,"-37.81686075, 144.95358075"
79320251010,79,2025-10-10,3,11,11,22,FliSS_T,"-37.81794046, 144.96616678"
30020250320,30,2025-03-20,0,117,92,209,Lon189_T,"-37.8112185, 144.96656806"
30320240624,30,2024-06-24,3,17,30,47,Lon189_T,"-37.8112185, 144.96656806"
192120231121,19,2023-11-21,21,329,439,768,LtB210_T,"-37.81237202, 144.96550671"
461420240530,46,2024-05-30,14,89,141,230,Pel147_T,"-37.80240719, 144.9615673"
251620240327,25,2024-03-27,16,674,389,1063,MCEC_T,"-37.82401776, 144.95604426"
141120240926,141,2024-09-26,1,8,11,19,474Fl_T,"-37.81997273, 144.95834911"
141320240315,141,2024-03-15,3,4,12,16,474Fl_T,"-37.81997273, 144.95834911"
139020240704,139,2024-07-04,0,3,2,5,Signal1647_T,"-37.81959923, 144.9632832"
1391720250507,139,2025-05-07,17,272,37,309,Signal1647_T,"-37.81959923, 144.9632832"
130820241012,130,2024-10-12,8,77,17,94,Bou892T,"-37.8204637, 144.94126826"
1231120231108,123,2023-11-08,11,19,9,28,BirBridge_T,"-37.81753741, 144.97329734"
49920241230,49,2024-12-30,9,98,95,193,Eli501_T,"-37.80730068, 144.95956055"
117320250420,117,2025-04-20,3,8,5,13,Fli114F_T,"-37.81629332, 144.97090877"
1171820240525,117,2024-05-25,18,491,235,726,Fli114F_T,"-37.81629332, 144.97090877"
1171020240528,117,2024-05-28,10,103,112,215,Fli114F_T,"-37.81629332, 144.97090877"
1172320240910,117,2024-09-10,23,22,29,51,Fli114F_T,"-37.81629332, 144.97090877"
66620250308,66,2025-03-08,6,8,33,41,QVN_T,"-37.81057846, 144.96444294"
661720250323,66,2025-03-23,17,1440,1543,2983,QVN_T,"-37.81057846, 144.96444294"
4520240119,4,2024-01-19,5,24,24,48,Swa123_T,"-37.81487988, 144.9660878"
70720250814,70,2025-08-14,7,43,27,70,Errol20_T,"-37.80456984, 144.94946228"
701120250923,70,2025-09-23,11,129,114,243,Errol20_T,"-37.80456984, 144.94946228"
75720231113,75,2023-11-13,7,34,17,51,SprFli_T,"-37.81515276, 144.97467661"
81820241125,8,2024-11-25,18,178,220,398,WebBN_T,"-37.82293543, 144.9471751"
411420240310,41,2024-03-10,14,1466,1386,2852,Swa31,"-37.81668634, 144.96689733"
42920240813,42,2024-08-13,9,430,133,563,UM1_T,"-37.80008566, 144.96386412"
77020240630,77,2024-06-30,0,4,8,12,HarEsP_T,"-37.81441438, 144.94433026"
652020240327,65,2024-03-27,20,191,453,644,SwaCs_T,"-37.81569416, 144.9668064"
29320241030,29,2024-10-30,3,3,4,7,AG_T,"-37.8199817, 144.96872865"
71920231215,71,2023-12-15,9,50,49,99,WestWP_T,"-37.81235775, 144.97136962"
54020250119,54,2025-01-19,0,21,34,55,Swa607_T,"-37.804024, 144.96308399"
542020240611,54,2024-06-11,20,124,174,298,Swa607_T,"-37.804024, 144.96308399"
401120240618,40,2024-06-18,11,270,295,565,Spr201_T,"-37.80999341, 144.97227587"
1351220241225,135,2024-12-25,12,218,289,507,Spen161_T,"-37.8172861, 144.95319102"
1352220250713,135,2025-07-13,22,70,109,179,Spen161_T,"-37.8172861, 144.95319102"
1311720240703,131,2024-07-03,17,91,152,243,King2_T,"-37.82009057, 144.95758725"
1331520251005,133,2025-10-05,15,423,396,819,Spen229_T,"-37.81531435, 144.95227769"
134920240710,134,2024-07-10,9,198,315,513,Spen201_T,"-37.81694221, 144.95303935"
1181620240609,118,2024-06-09,16,75,26,101,Fli114C_T,"-37.81632783, 144.97090512"
87620251007,87,2025-10-07,6,18,5,23,Errol23_T,"-37.80454949, 144.94921863"
47420240727,47,2024-07-27,4,37,45,82,Eli250_T,"-37.81258467, 144.9625775"
401120240714,40,2024-07-14,11,149,129,278,Spr201_T,"-37.80999341, 144.97227587"
5920240919,5,2024-09-19,9,386,781,1167,PriNW_T,"-37.81874249, 144.96787656"
45020240119,45,2024-01-19,0,63,94,157,Swa148_T,"-37.81414075, 144.96609379"
21220250821,21,2025-08-21,2,2,7,9,Bourke155_T,"-37.81267313, 144.96788288"
212020240507,21,2024-05-07,20,272,294,566,Bourke155_T,"-37.81267313, 144.96788288"
37320250929,37,2025-09-29,3,2,1,3,Lyg260_T,"-37.80107122, 144.96704554"
1071720250316,107,2025-03-16,17,59,68,127,280Will_T,"-37.81246271, 144.95690188"
1341220231019,134,2023-10-19,12,360,458,818,Spen201_T,"-37.81694221, 144.95303935"
107420240611,107,2024-06-11,4,0,1,1,280Will_T,"-37.81246271, 144.95690188"
1081520251015,108,2025-10-15,15,632,286,918,261Will_T,"-37.81295822, 144.95678789"
871520241108,87,2024-11-08,15,97,137,234,Errol23_T,"-37.80454949, 144.94921863"
61920231231,61,2023-12-31,9,54,148,202,RMIT14_T,"-37.80767455, 144.96309114"
1621420250223,162,2025-02-23,14,590,873,1463,Eli489_T,"-37.80740397, 144.95987909"
1841720250714,184,2025-07-14,17,965,1130,2095,Eli124_T,"-37.81512416, 144.96371988"
1842320250918,184,2025-09-18,23,65,139,204,Eli124_T,"-37.81512416, 144.96371988"
1661920241108,166,2024-11-08,19,75,76,151,Spen484_T,"-37.80896733, 144.94931703"
1671420250626,167,2025-06-26,14,39,58,97,Lat526_T,"-37.81304149, 144.95155955"
143520240927,143,2024-09-27,5,24,29,53,Spencer_T,"-37.821728, 144.95557015"
1321420240929,132,2024-09-29,14,131,152,283,King335_T,"-37.81267639, 144.95386444"
1322120241214,132,2024-12-14,21,104,154,258,King335_T,"-37.81267639, 144.95386444"
1341220250510,134,2025-05-10,12,435,441,876,Spen201_T,"-37.81694221, 144.95303935"
135720250515,135,2025-05-15,7,182,183,365,Spen161_T,"-37.8172861, 144.95319102"
67020240128,67,2024-01-28,0,72,66,138,FLDegS_T,"-37.81688755, 144.96562569"
171520231215,17,2023-12-15,15,320,365,685,Col15_T,"-37.81362543, 144.97323591"
17920240211,17,2024-02-11,9,86,58,144,Col15_T,"-37.81362543, 144.97323591"
171620240402,17,2024-04-02,16,197,372,569,Col15_T,"-37.81362543, 144.97323591"
17720250709,17,2025-07-09,7,308,89,397,Col15_T,"-37.81362543, 144.97323591"
681020240515,68,2024-05-15,10,149,128,277,FLDegN_T,"-37.8168479, 144.96559789"
62320250824,62,2025-08-24,3,43,43,86,Lat224_T,"-37.80996494, 144.96216521"
861220240719,86,2024-07-19,12,57,50,107,574Qub_T,"-37.80309992, 144.94908064"
122220241221,12,2024-12-21,22,169,232,401,NewQ_T,"-37.81457988, 144.94292398"
86520251006,86,2025-10-06,5,1,1,2,574Qub_T,"-37.80309992, 144.94908064"
12420250331,12,2025-03-31,4,2,0,2,NewQ_T,"-37.81457988, 144.94292398"
582220240926,58,2024-09-26,22,258,234,492,Bou688_T,"-37.81686075, 144.95358075"
582020241124,58,2024-11-24,20,209,191,400,Bou688_T,"-37.81686075, 144.95358075"
27220240516,27,2024-05-16,2,1,0,1,Vic_T,"-37.80606888, 144.95644692"
27220240602,27,2024-06-02,2,15,9,24,Vic_T,"-37.80606888, 144.95644692"
272020231107,27,2023-11-07,20,43,36,79,Vic_T,"-37.80606888, 144.95644692"
2120240723,2,2024-07-23,1,2,6,8,Bou283_T,"-37.81380668, 144.96516718"
21220250404,2,2025-04-04,12,636,655,1291,Bou283_T,"-37.81380668, 144.96516718"
531720231023,53,2023-10-23,17,598,446,1044,Col254_T,"-37.81564191, 144.965499"
27920250919,27,2025-09-19,9,95,130,225,Vic_T,"-37.80606888, 144.95644692"
301620240806,30,2024-08-06,16,257,304,561,Lon189_T,"-37.8112185, 144.96656806"
30920240831,30,2024-08-31,9,50,108,158,Lon189_T,"-37.8112185, 144.96656806"
231520250718,23,2025-07-18,15,237,417,654,Col623_T,"-37.81909256, 144.95452748"
232320240310,23,2024-03-10,23,36,51,87,Col623_T,"-37.81909256, 144.95452748"
521520250902,52,2025-09-02,15,439,186,625,Eli263_T,"-37.81252157, 144.9619401"
462220240824,46,2024-08-24,22,3,1,4,Pel147_T,"-37.80240719, 144.9615673"
461820250701,46,2025-07-01,18,7,7,14,Pel147_T,"-37.80240719, 144.9615673"
51220250531,51,2025-05-31,2,23,14,37,Fra118_T,"-37.80841815, 144.95906316"
49620250303,49,2025-03-03,6,42,47,89,Eli501_T,"-37.80730068, 144.95956055"
191120240730,19,2024-07-30,11,272,165,437,LtB210_T,"-37.81237202, 144.96550671"
202120250618,20,2025-06-18,21,118,323,441,LtB170_T,"-37.81172914, 144.9682466"
1371920250709,137,2025-07-09,19,2,5,7,BouHbr2353_T,"-37.81894815, 144.94612292"
137620240330,137,2024-03-30,6,1,0,1,BouHbr2353_T,"-37.81894815, 144.94612292"
1392320240124,139,2024-01-24,23,18,19,37,Signal1647_T,"-37.81959923, 144.9632832"
139720240822,139,2024-08-22,7,15,110,125,Signal1647_T,"-37.81959923, 144.9632832"
1432020250818,143,2025-08-18,20,88,91,179,Spencer_T,"-37.821728, 144.95557015"
143220241020,143,2024-10-20,2,88,25,113,Spencer_T,"-37.821728, 144.95557015"
132020250128,132,2025-01-28,0,32,28,60,King335_T,"-37.81267639, 144.95386444"
231920250614,23,2025-06-14,19,110,248,358,Col623_T,"-37.81909256, 144.95452748"
512020240828,51,2024-08-28,20,63,80,143,Fra118_T,"-37.80841815, 144.95906316"
512120241025,51,2024-10-25,21,52,68,120,Fra118_T,"-37.80841815, 144.95906316"
51720231124,51,2023-11-24,7,32,31,63,Fra118_T,"-37.80841815, 144.95906316"
231620240423,23,2024-04-23,16,230,751,981,Col623_T,"-37.81909256, 144.95452748"
482020250916,48,2025-09-16,20,56,85,141,QVMQ_T,"-37.80631581, 144.95866697"
251920240321,25,2024-03-21,19,461,303,764,MCEC_T,"-37.82401776, 144.95604426"
252120240702,25,2024-07-02,21,195,142,337,MCEC_T,"-37.82401776, 144.95604426"
251320250108,25,2025-01-08,13,551,590,1141,MCEC_T,"-37.82401776, 144.95604426"
521620250926,52,2025-09-26,16,352,423,775,Eli263_T,"-37.81252157, 144.9619401"
521820250506,52,2025-05-06,18,327,363,690,Eli263_T,"-37.81252157, 144.9619401"
141920240125,141,2024-01-25,9,111,72,183,474Fl_T,"-37.81997273, 144.95834911"
1412220240304,141,2024-03-04,22,38,59,97,474Fl_T,"-37.81997273, 144.95834911"
1391420240320,139,2024-03-20,14,92,50,142,Signal1647_T,"-37.81959923, 144.9632832"
1391520240414,139,2024-04-14,15,74,62,136,Signal1647_T,"-37.81959923, 144.9632832"
1362220240513,136,2024-05-13,22,0,2,2,BirFed1120_T,"-37.8184141, 144.97357915"
1361020250722,136,2025-07-22,10,102,36,138,BirFed1120_T,"-37.8184141, 144.97357915"
1362120250917,136,2025-09-17,21,3,4,7,BirFed1120_T,"-37.8184141, 144.97357915"
1381120250707,138,2025-07-07,11,4,0,4,EntPark1671_T,"-37.81996544, 144.95981454"
1381220240723,138,2024-07-23,12,3,11,14,EntPark1671_T,"-37.81996544, 144.95981454"
491920240906,49,2024-09-06,19,224,231,455,Eli501_T,"-37.80730068, 144.95956055"
441720240123,44,2024-01-23,17,86,46,132,UM3_T,"-37.79698741, 144.96441306"
51420231106,5,2023-11-06,14,1034,1217,2251,PriNW_T,"-37.81874249, 144.96787656"
52320240402,5,2024-04-02,23,68,127,195,PriNW_T,"-37.81874249, 144.96787656"
1311320240502,131,2024-05-02,13,178,166,344,King2_T,"-37.82009057, 144.95758725"
118520250507,118,2025-05-07,5,1,1,2,Fli114C_T,"-37.81632783, 144.97090512"
108620250817,108,2025-08-17,6,25,36,61,261Will_T,"-37.81295822, 144.95678789"
1181920240205,118,2024-02-05,19,10,25,35,Fli114C_T,"-37.81632783, 144.97090512"
87820241020,87,2024-10-20,8,20,39,59,Errol23_T,"-37.80454949, 144.94921863"
611420250206,61,2025-02-06,14,404,578,982,RMIT14_T,"-37.80767455, 144.96309114"
611520231104,61,2023-11-04,15,279,403,682,RMIT14_T,"-37.80767455, 144.96309114"
1671520250505,167,2025-05-05,15,69,81,150,Lat526_T,"-37.81304149, 144.95155955"
1401520250203,140,2025-02-03,15,66,78,144,Boyd2837_T,"-37.82590962, 144.96185972"
67020231216,67,2023-12-16,0,127,126,253,FLDegS_T,"-37.81688755, 144.96562569"
171620240428,17,2024-04-28,16,121,100,221,Col15_T,"-37.81362543, 144.97323591"
17220250808,17,2025-08-08,2,6,5,11,Col15_T,"-37.81362543, 144.97323591"
67920240923,67,2024-09-23,9,328,369,697,FLDegS_T,"-37.81688755, 144.96562569"
621420250414,62,2025-04-14,14,253,216,469,Lat224_T,"-37.80996494, 144.96216521"
56020250310,56,2025-03-10,0,60,94,154,Lon364_T,"-37.81234775, 144.96153311"
122020250410,12,2025-04-10,20,209,234,443,NewQ_T,"-37.81457988, 144.94292398"
242120241107,24,2024-11-07,21,265,506,771,Col620_T,"-37.81887963, 144.95449198"
76420250202,76,2025-02-02,4,0,1,1,KenMac_T,"-37.79453803, 144.93036194"
351620240310,35,2024-03-10,16,969,1151,2120,SouthB_T,"-37.82018685, 144.96508508"
272120231020,27,2023-10-20,21,113,80,193,Vic_T,"-37.80606888, 144.95644692"
271620231222,27,2023-12-22,16,106,86,192,Vic_T,"-37.80606888, 144.95644692"
53220240805,53,2024-08-05,2,7,2,9,Col254_T,"-37.81564191, 144.965499"
1362320250211,136,2025-02-11,23,3,52,55,BirFed1120_T,"-37.8184141, 144.97357915"
139420240112,139,2024-01-12,4,4,0,4,Signal1647_T,"-37.81959923, 144.9632832"
1381920250303,138,2025-03-03,19,3,4,7,EntPark1671_T,"-37.81996544, 144.95981454"
117020250417,117,2025-04-17,0,15,14,29,Fli114F_T,"-37.81629332, 144.97090877"
661620250206,66,2025-02-06,16,1040,1033,2073,QVN_T,"-37.81057846, 144.96444294"
662120240927,66,2024-09-27,21,824,622,1446,QVN_T,"-37.81057846, 144.96444294"
691420240521,69,2024-05-21,14,154,173,327,FLDegC_T,"-37.81687226, 144.96559144"
84220250609,84,2025-06-09,2,42,43,85,ElFi_T,"-37.81798049, 144.96503383"
41220240722,4,2024-07-22,12,1258,1130,2388,Swa123_T,"-37.81487988, 144.9660878"
31220241127,3,2024-11-27,12,774,931,1705,Swa295_T,"-37.81101524, 144.96429485"
75720240725,75,2024-07-25,7,34,19,53,SprFli_T,"-37.81515276, 144.97467661"
411820240601,41,2024-06-01,18,1634,1113,2747,Swa31,"-37.81668634, 144.96689733"
77720231112,77,2023-11-12,7,23,36,59,HarEsP_T,"-37.81441438, 144.94433026"
711120240905,71,2024-09-05,11,33,27,60,WestWP_T,"-37.81235775, 144.97136962"
14220250430,14,2025-04-30,2,9,1,10,SanBri_T,"-37.82011242, 144.96291897"
31920240425,31,2024-04-25,9,52,34,86,Lyg161_T,"-37.80169681, 144.96658911"
542220241008,54,2024-10-08,22,93,100,193,Swa607_T,"-37.804024, 144.96308399"
37320231112,37,2023-11-12,3,2,5,7,Lyg260_T,"-37.80107122, 144.96704554"
45320240113,45,2024-01-13,3,39,46,85,Swa148_T,"-37.81414075, 144.96609379"
37420240605,37,2024-06-05,4,2,17,19,Lyg260_T,"-37.80107122, 144.96704554"
502020250206,50,2025-02-06,20,223,178,401,Lyg309_T,"-37.79808192, 144.96721013"
452320240801,45,2024-08-01,23,76,156,232,Swa148_T,"-37.81414075, 144.96609379"
451420250729,45,2025-07-29,14,482,690,1172,Swa148_T,"-37.81414075, 144.96609379"
107720241209,107,2024-12-09,7,26,103,129,280Will_T,"-37.81246271, 144.95690188"
107420241215,107,2024-12-15,4,21,8,29,280Will_T,"-37.81246271, 144.95690188"
133820240630,133,2024-06-30,8,198,221,419,Spen229_T,"-37.81531435, 144.95227769"
1182120231105,118,2023-11-05,21,2,11,13,Fli114C_T,"-37.81632783, 144.97090512"
118820241030,118,2024-10-30,8,30,13,43,Fli114C_T,"-37.81632783, 144.97090512"
108720240906,108,2024-09-06,7,46,488,534,261Will_T,"-37.81295822, 144.95678789"
871520240427,87,2024-04-27,15,73,87,160,Errol23_T,"-37.80454949, 144.94921863"
70220250430,70,2025-04-30,2,1,0,1,Errol20_T,"-37.80456984, 144.94946228"
871620240226,87,2024-02-26,16,107,90,197,Errol23_T,"-37.80454949, 144.94921863"
87220240521,87,2024-05-21,2,1,0,1,Errol23_T,"-37.80454949, 144.94921863"
1672220250211,167,2025-02-11,22,12,15,27,Lat526_T,"-37.81304149, 144.95155955"
1672320240819,167,2024-08-19,23,1,7,8,Lat526_T,"-37.81304149, 144.95155955"
1401620231214,140,2023-12-14,16,74,88,162,Boyd2837_T,"-37.82590962, 144.96185972"
135420250711,135,2025-07-11,4,14,9,23,Spen161_T,"-37.8172861, 144.95319102"
66120241114,66,2024-11-14,1,67,36,103,QVN_T,"-37.81057846, 144.96444294"
391920250920,39,2025-09-20,19,15,4,19,AlfPl_T,"-37.81379749, 144.96995745"
391220240426,39,2024-04-26,12,181,129,310,AlfPl_T,"-37.81379749, 144.96995745"
8020240621,8,2024-06-21,0,5,4,9,WebBN_T,"-37.82293543, 144.9471751"
782020250706,78,2025-07-06,20,602,1438,2040,HarEsB_T,"-37.81471642, 144.9446508"
781320250929,78,2025-09-29,13,60,63,123,HarEsB_T,"-37.81471642, 144.9446508"
712220250304,71,2025-03-04,22,12,14,26,WestWP_T,"-37.81235775, 144.97136962"
402120250406,40,2025-04-06,21,83,18,101,Spr201_T,"-37.80999341, 144.97227587"
40820250608,40,2025-06-08,8,36,35,71,Spr201_T,"-37.80999341, 144.97227587"
47020231224,47,2023-12-24,0,182,202,384,Eli250_T,"-37.81258467, 144.9625775"
312220250328,31,2025-03-28,22,231,279,510,Lyg161_T,"-37.80169681, 144.96658911"
31520240428,31,2024-04-28,5,7,6,13,Lyg161_T,"-37.80169681, 144.96658911"
371120240628,37,2024-06-28,11,75,60,135,Lyg260_T,"-37.80107122, 144.96704554"
361420240208,36,2024-02-08,14,227,293,520,Que85_T,"-37.81652527, 144.96121062"
6420240508,6,2024-05-08,4,31,7,38,FliS_T,"-37.81911705, 144.96558255"
691220250516,69,2025-05-16,12,368,393,761,FLDegC_T,"-37.81687226, 144.96559144"
6420240301,6,2024-03-01,4,33,17,50,FliS_T,"-37.81911705, 144.96558255"
4220240525,4,2024-05-25,2,45,52,97,Swa123_T,"-37.81487988, 144.9660878"
701320250403,70,2025-04-03,13,125,139,264,Errol20_T,"-37.80456984, 144.94946228"
3620240207,3,2024-02-07,6,64,129,193,Swa295_T,"-37.81101524, 144.96429485"
32120250112,3,2025-01-12,21,508,483,991,Swa295_T,"-37.81101524, 144.96429485"
75120250207,75,2025-02-07,1,0,1,1,SprFli_T,"-37.81515276, 144.97467661"
751620250917,75,2025-09-17,16,76,73,149,SprFli_T,"-37.81515276, 144.97467661"
8920240703,8,2024-07-03,9,241,136,377,WebBN_T,"-37.82293543, 144.9471751"
392320250418,39,2025-04-18,23,26,27,53,AlfPl_T,"-37.81379749, 144.96995745"
75520231101,75,2023-11-01,5,5,2,7,SprFli_T,"-37.81515276, 144.97467661"
41720250819,41,2025-08-19,7,845,315,1160,Swa31,"-37.81668634, 144.96689733"
82220250222,8,2025-02-22,22,30,13,43,WebBN_T,"-37.82293543, 144.9471751"
8520250901,8,2025-09-01,5,7,5,12,WebBN_T,"-37.82293543, 144.9471751"
81920250910,8,2025-09-10,19,25,30,55,WebBN_T,"-37.82293543, 144.9471751"
78920250407,78,2025-04-07,9,39,25,64,HarEsB_T,"-37.81471642, 144.9446508"
781120250822,78,2025-08-22,11,23,38,61,HarEsB_T,"-37.81471642, 144.9446508"
77920250813,77,2025-08-13,9,76,124,200,HarEsP_T,"-37.81441438, 144.94433026"
142220240314,14,2024-03-14,22,255,310,565,SanBri_T,"-37.82011242, 144.96291897"
711620250411,71,2025-04-11,16,20,12,32,WestWP_T,"-37.81235775, 144.97136962"
28020231203,28,2023-12-03,0,72,74,146,VAC_T,"-37.82129925, 144.96879309"
47120241024,47,2024-10-24,1,48,47,95,Eli250_T,"-37.81258467, 144.9625775"
501920241119,50,2024-11-19,19,163,142,305,Lyg309_T,"-37.79808192, 144.96721013"
44720240731,44,2024-07-31,7,20,23,43,UM3_T,"-37.79698741, 144.96441306"
1432020241016,143,2024-10-16,20,97,114,211,Spencer_T,"-37.821728, 144.95557015"
1341620250811,134,2025-08-11,16,536,502,1038,Spen201_T,"-37.81694221, 144.95303935"
134920250128,134,2025-01-28,9,247,290,537,Spen201_T,"-37.81694221, 144.95303935"
1352320240319,135,2024-03-19,23,41,79,120,Spen161_T,"-37.8172861, 144.95319102"
1071820250911,107,2025-09-11,18,145,118,263,280Will_T,"-37.81246271, 144.95690188"
1332320241130,133,2024-11-30,23,233,208,441,Spen229_T,"-37.81531435, 144.95227769"
108320250720,108,2025-07-20,3,20,20,40,261Will_T,"-37.81295822, 144.95678789"
1181420240717,118,2024-07-17,14,9,21,30,Fli114C_T,"-37.81632783, 144.97090512"
1182220250725,118,2025-07-25,22,7,18,25,Fli114C_T,"-37.81632783, 144.97090512"
87520240712,87,2024-07-12,5,4,4,8,Errol23_T,"-37.80454949, 144.94921863"
1401120250826,140,2025-08-26,11,79,55,134,Boyd2837_T,"-37.82590962, 144.96185972"
1621220241022,162,2024-10-22,12,672,952,1624,Eli489_T,"-37.80740397, 144.95987909"
67620250624,67,2025-06-24,6,70,52,122,FLDegS_T,"-37.81688755, 144.96562569"
171320240909,17,2024-09-09,13,526,572,1098,Col15_T,"-37.81362543, 144.97323591"
181120240317,18,2024-03-17,11,86,53,139,Col12_T,"-37.81344862, 144.97305353"
18520241230,18,2024-12-30,5,0,2,2,Col12_T,"-37.81344862, 144.97305353"
62720250121,62,2025-01-21,7,53,49,102,Lat224_T,"-37.80996494, 144.96216521"
62520250722,62,2025-07-22,5,9,8,17,Lat224_T,"-37.80996494, 144.96216521"
112020240403,11,2024-04-03,20,84,83,167,WatCit_T,"-37.81564989, 144.93970694"
112120250106,11,2025-01-06,21,110,88,198,WatCit_T,"-37.81564989, 144.93970694"
12720240211,12,2024-02-11,7,44,48,92,NewQ_T,"-37.81457988, 144.94292398"
12420240217,12,2024-02-17,4,3,2,5,NewQ_T,"-37.81457988, 144.94292398"
12520240407,12,2024-04-07,5,1,2,3,NewQ_T,"-37.81457988, 144.94292398"
102220250808,10,2025-08-08,22,8,20,28,BouHbr_T,"-37.81876474, 144.94710545"
24620240907,24,2024-09-07,6,78,103,181,Col620_T,"-37.81887963, 144.95449198"
241120241209,24,2024-12-09,11,635,382,1017,Col620_T,"-37.81887963, 144.95449198"
721020231108,72,2023-11-08,10,213,142,355,ACMI_T,"-37.81726338, 144.96872809"
242220250306,24,2025-03-06,22,174,413,587,Col620_T,"-37.81887963, 144.95449198"
21820240312,2,2024-03-12,18,377,348,725,Bou283_T,"-37.81380668, 144.96516718"
761220250915,76,2025-09-15,12,63,78,141,KenMac_T,"-37.79453803, 144.93036194"
58420240321,58,2024-03-21,4,11,15,26,Bou688_T,"-37.81686075, 144.95358075"
21320250217,21,2025-02-17,3,11,3,14,Bourke155_T,"-37.81267313, 144.96788288"
87420250309,87,2025-03-09,4,3,2,5,Errol23_T,"-37.80454949, 144.94921863"
87720241208,87,2024-12-08,7,12,7,19,Errol23_T,"-37.80454949, 144.94921863"
431120241212,43,2024-12-12,11,85,68,153,UM2_T,"-37.79844526, 144.96411782"
1661220250320,166,2025-03-20,12,83,69,152,Spen484_T,"-37.80896733, 144.94931703"
1651320250408,165,2025-04-08,13,30,30,60,Spen475_T,"-37.80953359, 144.94939004"
1311520241110,131,2024-11-10,15,99,64,163,King2_T,"-37.82009057, 144.95758725"
1621620250522,162,2025-05-22,16,275,401,676,Eli489_T,"-37.80740397, 144.95987909"
1622020250621,162,2025-06-21,20,188,193,381,Eli489_T,"-37.80740397, 144.95987909"
132320240729,132,2024-07-29,3,5,2,7,King335_T,"-37.81267639, 144.95386444"
1311020250413,131,2025-04-13,10,67,127,194,King2_T,"-37.82009057, 144.95758725"
171720231222,17,2023-12-22,17,182,209,391,Col15_T,"-37.81362543, 144.97323591"
11520240331,1,2024-03-31,15,1619,1409,3028,Bou292_T,"-37.81349441, 144.96515323"
11420250719,1,2025-07-19,14,1869,1834,3703,Bou292_T,"-37.81349441, 144.96515323"
681520240624,68,2024-06-24,15,182,117,299,FLDegN_T,"-37.8168479, 144.96559789"
18020240115,18,2024-01-15,0,3,1,4,Col12_T,"-37.81344862, 144.97305353"
631820231216,63,2023-12-16,18,360,506,866,Bou231_T,"-37.81333081, 144.96675571"
122220240210,12,2024-02-10,22,254,234,488,NewQ_T,"-37.81457988, 144.94292398"
111720231020,11,2023-10-20,17,143,117,260,WatCit_T,"-37.81564989, 144.93970694"
102020241025,10,2024-10-25,20,32,41,73,BouHbr_T,"-37.81876474, 144.94710545"
121720250922,12,2025-09-22,17,170,257,427,NewQ_T,"-37.81457988, 144.94292398"
2420240504,2,2024-05-04,4,7,11,18,Bou283_T,"-37.81380668, 144.96516718"
35220250519,35,2025-05-19,2,5,4,9,SouthB_T,"-37.82018685, 144.96508508"
21120250319,2,2025-03-19,11,376,436,812,Bou283_T,"-37.81380668, 144.96516718"
21620250501,2,2025-05-01,16,530,462,992,Bou283_T,"-37.81380668, 144.96516718"
9520240314,9,2024-03-14,5,25,46,71,Col700_T,"-37.81982992, 144.95102555"
531420240422,53,2024-04-22,14,716,696,1412,Col254_T,"-37.81564191, 144.965499"
53120240513,53,2024-05-13,1,8,8,16,Col254_T,"-37.81564191, 144.965499"
23520250223,23,2025-02-23,5,4,11,15,Col623_T,"-37.81909256, 144.95452748"
30720250221,30,2025-02-21,7,42,39,81,Lon189_T,"-37.8112185, 144.96656806"
301520240326,30,2024-03-26,15,199,321,520,Lon189_T,"-37.8112185, 144.96656806"
25720241012,25,2024-10-12,7,80,248,328,MCEC_T,"-37.82401776, 144.95604426"
201320240206,20,2024-02-06,13,271,320,591,LtB170_T,"-37.81172914, 144.9682466"
20820240702,20,2024-07-02,8,67,39,106,LtB170_T,"-37.81172914, 144.9682466"
1421820231120,142,2023-11-20,18,578,453,1031,Hammer1584_T,"-37.81970749, 144.96795734"
1642020250801,164,2025-08-01,20,46,83,129,Lat526_T,"-37.813005, 144.95160411"
1641620240908,164,2024-09-08,16,48,62,110,Lat526_T,"-37.813005, 144.95160411"
1381820250502,138,2025-05-02,18,1,1,2,EntPark1671_T,"-37.81996544, 144.95981454"
1411720240516,141,2024-05-16,17,166,143,309,474Fl_T,"-37.81997273, 144.95834911"
191620241020,19,2024-10-20,16,545,492,1037,LtB210_T,"-37.81237202, 144.96550671"
1801420251012,180,2025-10-12,14,50,56,106,Mac330_T,"-37.79497059, 144.93530329"
84020240315,84,2024-03-15,0,108,96,204,ElFi_T,"-37.81798049, 144.96503383"
6520250713,6,2025-07-13,5,42,96,138,FliS_T,"-37.81911705, 144.96558255"
70820231110,70,2023-11-10,8,93,88,181,Errol20_T,"-37.80456984, 144.94946228"
591520241209,59,2024-12-09,15,207,205,412,RMIT_T,"-37.80825648, 144.96304859"
421120240919,42,2024-09-19,11,316,271,587,UM1_T,"-37.80008566, 144.96386412"
141220250430,14,2025-04-30,12,344,125,469,SanBri_T,"-37.82011242, 144.96291897"
401820240930,40,2024-09-30,18,94,109,203,Spr201_T,"-37.80999341, 144.97227587"
532120240212,53,2024-02-12,21,103,240,343,Col254_T,"-37.81564191, 144.965499"
531620240615,53,2024-06-15,16,610,570,1180,Col254_T,"-37.81564191, 144.965499"
91220241218,9,2024-12-18,12,652,516,1168,Col700_T,"-37.81982992, 144.95102555"
792220241015,79,2024-10-15,22,38,36,74,FliSS_T,"-37.81794046, 144.96616678"
522320240416,52,2024-04-16,23,37,45,82,Eli263_T,"-37.81252157, 144.9619401"
511320250322,51,2025-03-22,13,160,215,375,Fra118_T,"-37.80841815, 144.95906316"
6620250826,6,2025-08-26,6,195,333,528,FliS_T,"-37.81911705, 144.96558255"
31120250818,3,2025-08-18,11,691,674,1365,Swa295_T,"-37.81101524, 144.96429485"
31720250518,3,2025-05-18,17,883,1118,2001,Swa295_T,"-37.81101524, 144.96429485"
391720240611,39,2024-06-11,17,104,83,187,AlfPl_T,"-37.81379749, 144.96995745"
8620241213,8,2024-12-13,6,48,43,91,WebBN_T,"-37.82293543, 144.9471751"
411220251011,41,2025-10-11,12,2719,1638,4357,Swa31,"-37.81668634, 144.96689733"
411420240913,41,2024-09-13,14,279,249,528,Swa31,"-37.81668634, 144.96689733"
78120250923,78,2025-09-23,1,2,1,3,HarEsB_T,"-37.81471642, 144.9446508"
142020240728,14,2024-07-28,20,177,56,233,SanBri_T,"-37.82011242, 144.96291897"
71120250403,71,2025-04-03,1,24,18,42,WestWP_T,"-37.81235775, 144.97136962"
311120241013,31,2024-10-13,11,109,138,247,Lyg161_T,"-37.80169681, 144.96658911"
541320240303,54,2024-03-03,13,181,141,322,Swa607_T,"-37.804024, 144.96308399"
401220241220,40,2024-12-20,12,156,429,585,Spr201_T,"-37.80999341, 144.97227587"
211520241202,21,2024-12-02,15,209,220,429,Bourke155_T,"-37.81267313, 144.96788288"
851620250624,85,2025-06-24,16,74,78,152,488Mac_T,"-37.79432415, 144.92973378"
85020251011,85,2025-10-11,0,3,7,10,488Mac_T,"-37.79432415, 144.92973378"
172020240224,17,2024-02-24,20,172,168,340,Col15_T,"-37.81362543, 144.97323591"
1920241113,1,2024-11-13,9,321,385,706,Bou292_T,"-37.81349441, 144.96515323"
56120240725,56,2024-07-25,1,14,13,27,Lon364_T,"-37.81234775, 144.96153311"
861220231124,86,2023-11-24,12,50,60,110,574Qub_T,"-37.80309992, 144.94908064"
72820240324,72,2024-03-24,8,172,285,457,ACMI_T,"-37.81726338, 144.96872809"
242320250818,24,2025-08-18,23,73,127,200,Col620_T,"-37.81887963, 144.95449198"
10420240816,10,2024-08-16,4,1,1,2,BouHbr_T,"-37.81876474, 144.94710545"
102220250202,10,2025-02-02,22,0,2,2,BouHbr_T,"-37.81876474, 144.94710545"
22320240619,2,2024-06-19,23,17,32,49,Bou283_T,"-37.81380668, 144.96516718"
58920241223,58,2024-12-23,9,508,113,621,Bou688_T,"-37.81686075, 144.95358075"
27720241201,27,2024-12-01,7,15,36,51,Vic_T,"-37.80606888, 144.95644692"
531720250314,53,2025-03-14,17,793,559,1352,Col254_T,"-37.81564191, 144.965499"
531020250430,53,2025-04-30,10,419,341,760,Col254_T,"-37.81564191, 144.965499"
791620240930,79,2024-09-30,16,490,550,1040,FliSS_T,"-37.81794046, 144.96616678"
23520250321,23,2025-03-21,5,15,18,33,Col623_T,"-37.81909256, 144.95452748"
20620231223,20,2023-12-23,6,8,12,20,LtB170_T,"-37.81172914, 144.9682466"
1412220241122,141,2024-11-22,22,137,152,289,474Fl_T,"-37.81997273, 144.95834911"
1411920250610,141,2025-06-10,19,58,66,124,474Fl_T,"-37.81997273, 144.95834911"
1371120231114,137,2023-11-14,11,16,81,97,BouHbr2353_T,"-37.81894815, 144.94612292"
137720250704,137,2025-07-04,7,38,12,50,BouHbr2353_T,"-37.81894815, 144.94612292"
1392320250107,139,2025-01-07,23,10,5,15,Signal1647_T,"-37.81959923, 144.9632832"
1421020240130,142,2024-01-30,10,185,179,364,Hammer1584_T,"-37.81970749, 144.96795734"
1381320240202,138,2024-02-02,13,9,10,19,EntPark1671_T,"-37.81996544, 144.95981454"
1171720250211,117,2025-02-11,17,223,592,815,Fli114F_T,"-37.81629332, 144.97090877"
1172020240130,117,2024-01-30,20,108,165,273,Fli114F_T,"-37.81629332, 144.97090877"
402020251002,40,2025-10-02,20,80,30,110,Spr201_T,"-37.80999341, 144.97227587"
471320250927,47,2025-09-27,13,890,1019,1909,Eli250_T,"-37.81258467, 144.9625775"
211720250226,21,2025-02-26,17,360,339,699,Bourke155_T,"-37.81267313, 144.96788288"
1332020250904,133,2025-09-04,20,344,243,587,Spen229_T,"-37.81531435, 144.95227769"
133020240119,133,2024-01-19,0,80,11,91,Spen229_T,"-37.81531435, 144.95227769"
133420240513,133,2024-05-13,4,12,21,33,Spen229_T,"-37.81531435, 144.95227769"
1321120250721,132,2025-07-21,11,108,90,198,King335_T,"-37.81267639, 144.95386444"
118920250108,118,2025-01-08,9,20,22,42,Fli114C_T,"-37.81632783, 144.97090512"
118820250130,118,2025-01-30,8,41,13,54,Fli114C_T,"-37.81632783, 144.97090512"
871920240627,87,2024-06-27,19,87,89,176,Errol23_T,"-37.80454949, 144.94921863"
611620250401,61,2025-04-01,16,886,984,1870,RMIT14_T,"-37.80767455, 144.96309114"
44020250320,44,2025-03-20,0,10,1,11,UM3_T,"-37.79698741, 144.96441306"
43220250129,43,2025-01-29,2,0,1,1,UM2_T,"-37.79844526, 144.96411782"
1431320250328,143,2025-03-28,13,165,191,356,Spencer_T,"-37.821728, 144.95557015"
1431120250506,143,2025-05-06,11,78,173,251,Spencer_T,"-37.821728, 144.95557015"
1341820240114,134,2024-01-14,18,339,333,672,Spen201_T,"-37.81694221, 144.95303935"
1341920241020,134,2024-10-20,19,373,366,739,Spen201_T,"-37.81694221, 144.95303935"
131520240608,131,2024-06-08,5,9,30,39,King2_T,"-37.82009057, 144.95758725"
1311220240907,131,2024-09-07,12,104,110,214,King2_T,"-37.82009057, 144.95758725"
1351220250820,135,2025-08-20,12,420,464,884,Spen161_T,"-37.8172861, 144.95319102"
852120250725,85,2025-07-25,21,22,23,45,488Mac_T,"-37.79432415, 144.92973378"
852220250915,85,2025-09-15,22,1,6,7,488Mac_T,"-37.79432415, 144.92973378"
632320250605,63,2025-06-05,23,18,93,111,Bou231_T,"-37.81333081, 144.96675571"
181320250323,18,2025-03-23,13,120,74,194,Col12_T,"-37.81344862, 144.97305353"
62320240219,62,2024-02-19,3,15,13,28,Lat224_T,"-37.80996494, 144.96216521"
62520241025,62,2024-10-25,5,18,10,28,Lat224_T,"-37.80996494, 144.96216521"
56220250716,56,2025-07-16,2,1,7,8,Lon364_T,"-37.81234775, 144.96153311"
121320250422,12,2025-04-22,13,149,175,324,NewQ_T,"-37.81457988, 144.94292398"
721320250210,72,2025-02-10,13,176,239,415,ACMI_T,"-37.81726338, 144.96872809"
72920240619,72,2024-06-19,9,427,224,651,ACMI_T,"-37.81726338, 144.96872809"
721620240723,72,2024-07-23,16,127,556,683,ACMI_T,"-37.81726338, 144.96872809"
76320241218,76,2024-12-18,3,0,1,1,KenMac_T,"-37.79453803, 144.93036194"
92220250507,9,2025-05-07,22,86,18,104,Col700_T,"-37.81982992, 144.95102555"
91920250722,9,2025-07-22,19,182,523,705,Col700_T,"-37.81982992, 144.95102555"
53820240312,53,2024-03-12,8,532,383,915,Col254_T,"-37.81564191, 144.965499"
53520241013,53,2024-10-13,5,36,11,47,Col254_T,"-37.81564191, 144.965499"
792020240909,79,2024-09-09,20,246,353,599,FliSS_T,"-37.81794046, 144.96616678"
79320231130,79,2023-11-30,3,16,14,30,FliSS_T,"-37.81794046, 144.96616678"
511320240503,51,2024-05-03,13,138,155,293,Fra118_T,"-37.80841815, 144.95906316"
20520250624,20,2025-06-24,5,8,16,24,LtB170_T,"-37.81172914, 144.9682466"
164220250521,164,2025-05-21,2,1,2,3,Lat526_T,"-37.813005, 144.95160411"
1381020250130,138,2025-01-30,10,1,10,11,EntPark1671_T,"-37.81996544, 144.95981454"
1611820250525,161,2025-05-25,18,0,46,46,BirArt1109_T,"-37.81851276, 144.97131336"
1611020250907,161,2025-09-07,10,91,67,158,BirArt1109_T,"-37.81851276, 144.97131336"
491320250114,49,2025-01-14,13,348,449,797,Eli501_T,"-37.80730068, 144.95956055"
109120250813,109,2025-08-13,1,12,13,25,LatWill_T,"-37.81193681, 144.95621105"
49420231020,49,2023-10-20,4,27,31,58,Eli501_T,"-37.80730068, 144.95956055"
66620250523,66,2025-05-23,6,31,45,76,QVN_T,"-37.81057846, 144.96444294"
61020240718,6,2024-07-18,10,504,448,952,FliS_T,"-37.81911705, 144.96558255"
841820250920,84,2025-09-20,18,873,1113,1986,ElFi_T,"-37.81798049, 144.96503383"
752320250207,75,2025-02-07,23,4,15,19,SprFli_T,"-37.81515276, 144.97467661"
39720250923,39,2025-09-23,7,44,36,80,AlfPl_T,"-37.81379749, 144.96995745"
81020231105,8,2023-11-05,10,124,182,306,WebBN_T,"-37.82293543, 144.9471751"
82220240708,8,2024-07-08,22,3,5,8,WebBN_T,"-37.82293543, 144.9471751"
781620250205,78,2025-02-05,16,35,172,207,HarEsB_T,"-37.81471642, 144.9446508"
411420240128,41,2024-01-28,14,1723,1529,3252,Swa31,"-37.81668634, 144.96689733"
42720240904,42,2024-09-04,7,67,62,129,UM1_T,"-37.80008566, 144.96386412"
71720250520,71,2025-05-20,7,5,11,16,WestWP_T,"-37.81235775, 144.97136962"
541320241018,54,2024-10-18,13,206,172,378,Swa607_T,"-37.804024, 144.96308399"
361720250527,36,2025-05-27,17,271,265,536,Que85_T,"-37.81652527, 144.96121062"
43820250527,43,2025-05-27,8,205,71,276,UM2_T,"-37.79844526, 144.96411782"
441820240201,44,2024-02-01,18,10,39,49,UM3_T,"-37.79698741, 144.96441306"
442220241110,44,2024-11-10,22,16,6,22,UM3_T,"-37.79698741, 144.96441306"
432220231208,43,2023-12-08,22,9,11,20,UM2_T,"-37.79844526, 144.96411782"
43820240511,43,2024-05-11,8,34,23,57,UM2_T,"-37.79844526, 144.96411782"
1342020231223,134,2023-12-23,20,269,315,584,Spen201_T,"-37.81694221, 144.95303935"
133420250306,133,2025-03-06,4,14,33,47,Spen229_T,"-37.81531435, 144.95227769"
107520240628,107,2024-06-28,5,6,10,16,280Will_T,"-37.81246271, 144.95690188"
1082220250707,108,2025-07-07,22,65,34,99,261Will_T,"-37.81295822, 144.95678789"
108720251002,108,2025-10-02,7,77,743,820,261Will_T,"-37.81295822, 144.95678789"
1082120250413,108,2025-04-13,21,75,101,176,261Will_T,"-37.81295822, 144.95678789"
871320241201,87,2024-12-01,13,98,85,183,Errol23_T,"-37.80454949, 144.94921863"
872220241206,87,2024-12-06,22,29,32,61,Errol23_T,"-37.80454949, 144.94921863"
1672320250509,167,2025-05-09,23,11,15,26,Lat526_T,"-37.81304149, 144.95155955"
182720250815,182,2025-08-15,7,38,62,100,King163_T,"-37.81627451, 144.95550503"
182920251016,182,2025-10-16,9,99,156,255,King163_T,"-37.81627451, 144.95550503"
143320250916,143,2025-09-16,3,12,5,17,Spencer_T,"-37.821728, 144.95557015"
1431920240927,143,2024-09-27,19,187,219,406,Spencer_T,"-37.821728, 144.95557015"
84720240407,84,2024-04-07,7,151,164,315,ElFi_T,"-37.81798049, 144.96503383"
841920240611,84,2024-06-11,19,526,885,1411,ElFi_T,"-37.81798049, 144.96503383"
4820250704,4,2025-07-04,8,401,281,682,Swa123_T,"-37.81487988, 144.9660878"
701720240613,70,2024-06-13,17,134,138,272,Errol20_T,"-37.80456984, 144.94946228"
75120250215,75,2025-02-15,1,5,0,5,SprFli_T,"-37.81515276, 144.97467661"
78120240128,78,2024-01-28,1,1,4,5,HarEsB_T,"-37.81471642, 144.9446508"
411020240811,41,2024-08-11,10,120,135,255,Swa31,"-37.81668634, 144.96689733"
412320240908,41,2024-09-08,23,34,26,60,Swa31,"-37.81668634, 144.96689733"
421320240916,42,2024-09-16,13,375,398,773,UM1_T,"-37.80008566, 144.96386412"
42820250322,42,2025-03-22,8,33,20,53,UM1_T,"-37.80008566, 144.96386412"
27020240729,27,2024-07-29,0,30,0,30,Vic_T,"-37.80606888, 144.95644692"
532120250212,53,2025-02-12,21,115,211,326,Col254_T,"-37.81564191, 144.965499"
271120250516,27,2025-05-16,11,141,131,272,Vic_T,"-37.80606888, 144.95644692"
791720250701,79,2025-07-01,17,627,579,1206,FliSS_T,"-37.81794046, 144.96616678"
79420240218,79,2024-02-18,4,55,49,104,FliSS_T,"-37.81794046, 144.96616678"
23820250819,23,2025-08-19,8,931,417,1348,Col623_T,"-37.81909256, 144.95452748"
20920231212,20,2023-12-12,9,118,68,186,LtB170_T,"-37.81172914, 144.9682466"
136220251017,136,2025-10-17,2,1,0,1,BirFed1120_T,"-37.8184141, 144.97357915"
1421120241213,142,2024-12-13,11,321,390,711,Hammer1584_T,"-37.81970749, 144.96795734"
1302020250510,130,2025-05-10,20,15,2,17,Bou892T,"-37.8204637, 144.94126826"
164220241204,164,2024-12-04,2,0,1,1,Lat526_T,"-37.813005, 144.95160411"
130220241220,130,2024-12-20,2,0,1,1,Bou892T,"-37.8204637, 144.94126826"
492020240822,49,2024-08-22,20,199,167,366,Eli501_T,"-37.80730068, 144.95956055"
109920240926,109,2024-09-26,9,87,247,334,LatWill_T,"-37.81193681, 144.95621105"
1421820250211,142,2025-02-11,18,420,231,651,Hammer1584_T,"-37.81970749, 144.96795734"
1381720241223,138,2024-12-23,17,11,6,17,EntPark1671_T,"-37.81996544, 144.95981454"
1382020250417,138,2025-04-17,20,0,1,1,EntPark1671_T,"-37.81996544, 144.95981454"
123720241016,123,2024-10-16,7,17,4,21,BirBridge_T,"-37.81753741, 144.97329734"
6720240104,6,2024-01-04,7,172,264,436,FliS_T,"-37.81911705, 144.96558255"
31120250128,3,2025-01-28,11,483,561,1044,Swa295_T,"-37.81101524, 144.96429485"
3420250527,3,2025-05-27,4,12,9,21,Swa295_T,"-37.81101524, 144.96429485"
751220241124,75,2024-11-24,12,9,11,20,SprFli_T,"-37.81515276, 144.97467661"
752020250922,75,2025-09-22,20,7,6,13,SprFli_T,"-37.81515276, 144.97467661"
81220240623,8,2024-06-23,12,330,273,603,WebBN_T,"-37.82293543, 144.9471751"
75520231205,75,2023-12-05,5,12,11,23,SprFli_T,"-37.81515276, 144.97467661"
391920240422,39,2024-04-22,19,31,22,53,AlfPl_T,"-37.81379749, 144.96995745"
411320250812,41,2025-08-12,13,1457,1603,3060,Swa31,"-37.81668634, 144.96689733"
41920231126,41,2023-11-26,9,749,310,1059,Swa31,"-37.81668634, 144.96689733"
77020240303,77,2024-03-03,0,33,31,64,HarEsP_T,"-37.81441438, 144.94433026"
652220240128,65,2024-01-28,22,174,150,324,SwaCs_T,"-37.81569416, 144.9668064"
421220250702,42,2025-07-02,12,24,26,50,UM1_T,"-37.80008566, 144.96386412"
141920250407,14,2025-04-07,19,255,109,364,SanBri_T,"-37.82011242, 144.96291897"
401320250417,40,2025-04-17,13,367,270,637,Spr201_T,"-37.80999341, 144.97227587"
31420240610,31,2024-06-10,4,18,2,20,Lyg161_T,"-37.80169681, 144.96658911"
5420231018,5,2023-10-18,4,21,7,28,PriNW_T,"-37.81874249, 144.96787656"
51220241023,5,2024-10-23,12,712,710,1422,PriNW_T,"-37.81874249, 144.96787656"
211620250924,21,2025-09-24,16,247,283,530,Bourke155_T,"-37.81267313, 144.96788288"
211320250629,21,2025-06-29,13,345,435,780,Bourke155_T,"-37.81267313, 144.96788288"
1431220240512,143,2024-05-12,12,796,441,1237,Spencer_T,"-37.821728, 144.95557015"
132120241002,132,2024-10-02,1,18,14,32,King335_T,"-37.81267639, 144.95386444"
1341720250322,134,2025-03-22,17,562,491,1053,Spen201_T,"-37.81694221, 144.95303935"
1311320250520,131,2025-05-20,13,184,183,367,King2_T,"-37.82009057, 144.95758725"
135320231122,135,2023-11-22,3,13,11,24,Spen161_T,"-37.8172861, 144.95319102"
1351320231225,135,2023-12-25,13,185,144,329,Spen161_T,"-37.8172861, 144.95319102"
133020251001,133,2025-10-01,0,56,37,93,Spen229_T,"-37.81531435, 144.95227769"
107620250109,107,2025-01-09,6,14,16,30,280Will_T,"-37.81246271, 144.95690188"
871520241117,87,2024-11-17,15,76,87,163,Errol23_T,"-37.80454949, 144.94921863"
612220250623,61,2025-06-23,22,83,25,108,RMIT14_T,"-37.80767455, 144.96309114"
1651320250121,165,2025-01-21,13,28,26,54,Spen475_T,"-37.80953359, 144.94939004"
162920240713,162,2024-07-13,9,345,267,612,Eli489_T,"-37.80740397, 144.95987909"
17220231205,17,2023-12-05,2,2,4,6,Col15_T,"-37.81362543, 144.97323591"
17820240918,17,2024-09-18,8,1263,215,1478,Col15_T,"-37.81362543, 144.97323591"
1411020231226,141,2023-12-26,10,152,107,259,474Fl_T,"-37.81997273, 144.95834911"
1411220240123,141,2024-01-23,12,239,167,406,474Fl_T,"-37.81997273, 144.95834911"
141820250907,141,2025-09-07,8,30,26,56,474Fl_T,"-37.81997273, 144.95834911"
1171220240229,117,2024-02-29,12,214,217,431,Fli114F_T,"-37.81629332, 144.97090877"
109920250401,109,2025-04-01,9,122,429,551,LatWill_T,"-37.81193681, 144.95621105"
19920250307,19,2025-03-07,9,110,79,189,LtB210_T,"-37.81237202, 144.96550671"
1371420240909,137,2024-09-09,14,11,29,40,BouHbr2353_T,"-37.81894815, 144.94612292"
69320250206,69,2025-02-06,3,1,0,1,FLDegC_T,"-37.81687226, 144.96559144"
61220250122,6,2025-01-22,12,954,862,1816,FliS_T,"-37.81911705, 144.96558255"
84220240221,84,2024-02-21,2,14,33,47,ElFi_T,"-37.81798049, 144.96503383"
662220240724,66,2024-07-24,22,318,273,591,QVN_T,"-37.81057846, 144.96444294"
3920240610,3,2024-06-10,9,195,229,424,Swa295_T,"-37.81101524, 144.96429485"
39020240520,39,2024-05-20,0,2,3,5,AlfPl_T,"-37.81379749, 144.96995745"
81820240307,8,2024-03-07,18,156,268,424,WebBN_T,"-37.82293543, 144.9471751"
75620250506,75,2025-05-06,6,23,25,48,SprFli_T,"-37.81515276, 144.97467661"
36220231207,36,2023-12-07,2,2,1,3,Que85_T,"-37.81652527, 144.96121062"
372120231218,37,2023-12-18,21,28,24,52,Lyg260_T,"-37.80107122, 144.96704554"
44820240113,44,2024-01-13,8,5,0,5,UM3_T,"-37.79698741, 144.96441306"
452320250920,45,2025-09-20,23,217,370,587,Swa148_T,"-37.81414075, 144.96609379"
1071220250419,107,2025-04-19,12,76,152,228,280Will_T,"-37.81246271, 144.95690188"
1811220250819,181,2025-08-19,12,832,1055,1887,Eli368_T,"-37.81009465, 144.96143149"
70320240602,70,2024-06-02,3,0,2,2,Errol20_T,"-37.80456984, 144.94946228"
1672020240904,167,2024-09-04,20,11,31,42,Lat526_T,"-37.81304149, 144.95155955"
1312120250722,131,2025-07-22,21,25,32,57,King2_T,"-37.82009057, 144.95758725"
1341020240325,134,2024-03-25,10,359,300,659,Spen201_T,"-37.81694221, 144.95303935"
851320231029,85,2023-10-29,13,82,96,178,488Mac_T,"-37.79432415, 144.92973378"
172320240916,17,2024-09-16,23,14,15,29,Col15_T,"-37.81362543, 144.97323591"
68120240303,68,2024-03-03,1,0,1,1,FLDegN_T,"-37.8168479, 144.96559789"
681220250406,68,2025-04-06,12,407,347,754,FLDegN_T,"-37.8168479, 144.96559789"
862120250302,86,2025-03-02,21,9,28,37,574Qub_T,"-37.80309992, 144.94908064"
121220250423,12,2025-04-23,12,179,208,387,NewQ_T,"-37.81457988, 144.94292398"
35420231031,35,2023-10-31,4,17,6,23,SouthB_T,"-37.82018685, 144.96508508"
11220241001,11,2024-10-01,2,3,0,3,WatCit_T,"-37.81564989, 144.93970694"
722320240314,72,2024-03-14,23,82,354,436,ACMI_T,"-37.81726338, 144.96872809"
22120250106,2,2025-01-06,21,92,133,225,Bou283_T,"-37.81380668, 144.96516718"
581720250517,58,2025-05-17,17,1156,638,1794,Bou688_T,"-37.81686075, 144.95358075"
351520250322,35,2025-03-22,15,1518,2041,3559,SouthB_T,"-37.82018685, 144.96508508"
2120250930,2,2025-09-30,1,6,16,22,Bou283_T,"-37.81380668, 144.96516718"
231720240322,23,2024-03-22,17,279,499,778,Col623_T,"-37.81909256, 144.95452748"
79620231211,79,2023-12-11,6,94,68,162,FliSS_T,"-37.81794046, 144.96616678"
79020240509,79,2024-05-09,0,26,33,59,FliSS_T,"-37.81794046, 144.96616678"
671420240515,67,2024-05-15,14,342,510,852,FLDegS_T,"-37.81688755, 144.96562569"
632220241010,63,2024-10-10,22,50,172,222,Bou231_T,"-37.81333081, 144.96675571"
631920250428,63,2025-04-28,19,33,128,161,Bou231_T,"-37.81333081, 144.96675571"
1620250917,1,2025-09-17,6,39,47,86,Bou292_T,"-37.81349441, 144.96515323"
621420231130,62,2023-11-30,14,276,156,432,Lat224_T,"-37.80996494, 144.96216521"
62720240606,62,2024-06-06,7,47,52,99,Lat224_T,"-37.80996494, 144.96216521"
622220250215,62,2025-02-15,22,143,122,265,Lat224_T,"-37.80996494, 144.96216521"
101020240602,10,2024-06-02,10,21,28,49,BouHbr_T,"-37.81876474, 144.94710545"
351420250504,35,2025-05-04,14,1472,1270,2742,SouthB_T,"-37.82018685, 144.96508508"
271520240526,27,2024-05-26,15,257,178,435,Vic_T,"-37.80606888, 144.95644692"
91220240216,9,2024-02-16,12,456,425,881,Col700_T,"-37.81982992, 144.95102555"
53820240424,53,2024-04-24,8,384,245,629,Col254_T,"-37.81564191, 144.965499"
27920250730,27,2025-07-30,9,46,88,134,Vic_T,"-37.80606888, 144.95644692"
30820231022,30,2023-10-22,8,44,75,119,Lon189_T,"-37.8112185, 144.96656806"
46720250618,46,2025-06-18,7,32,32,64,Pel147_T,"-37.80240719, 144.9615673"
48620240923,48,2024-09-23,6,28,21,49,QVMQ_T,"-37.80631581, 144.95866697"
482020250710,48,2025-07-10,20,72,85,157,QVMQ_T,"-37.80631581, 144.95866697"
46120240715,46,2024-07-15,1,1,0,1,Pel147_T,"-37.80240719, 144.9615673"
461720240424,46,2024-04-24,17,188,117,305,Pel147_T,"-37.80240719, 144.9615673"
46520240830,46,2024-08-30,5,1,0,1,Pel147_T,"-37.80240719, 144.9615673"
137920240826,137,2024-08-26,9,45,19,64,BouHbr2353_T,"-37.81894815, 144.94612292"
141920240402,141,2024-04-02,9,83,95,178,474Fl_T,"-37.81997273, 144.95834911"
1421420240422,142,2024-04-22,14,362,260,622,Hammer1584_T,"-37.81970749, 144.96795734"
66420250123,66,2025-01-23,4,18,7,25,QVN_T,"-37.81057846, 144.96444294"
841620250626,84,2025-06-26,16,953,1487,2440,ElFi_T,"-37.81798049, 144.96503383"
42120240105,4,2024-01-05,21,1155,785,1940,Swa123_T,"-37.81487988, 144.9660878"
3220240319,3,2024-03-19,2,52,37,89,Swa295_T,"-37.81101524, 144.96429485"
412020240811,41,2024-08-11,20,58,50,108,Swa31,"-37.81668634, 144.96689733"
411420250110,41,2025-01-10,14,1642,1518,3160,Swa31,"-37.81668634, 144.96689733"
411520240626,41,2024-06-26,15,378,370,748,Swa31,"-37.81668634, 144.96689733"
8520250729,8,2025-07-29,5,2,0,2,WebBN_T,"-37.82293543, 144.9471751"
14520240312,14,2024-03-12,5,46,30,76,SanBri_T,"-37.82011242, 144.96291897"
54820240906,54,2024-09-06,8,328,68,396,Swa607_T,"-37.804024, 144.96308399"
282120250828,28,2025-08-28,21,216,227,443,VAC_T,"-37.82129925, 144.96879309"
29420250904,29,2025-09-04,4,1,1,2,AG_T,"-37.8199817, 144.96872865"
311720250624,31,2025-06-24,17,123,104,227,Lyg161_T,"-37.80169681, 144.96658911"
541520241211,54,2024-12-11,15,87,129,216,Swa607_T,"-37.804024, 144.96308399"
361320240816,36,2024-08-16,13,368,324,692,Que85_T,"-37.81652527, 144.96121062"
36320250628,36,2025-06-28,3,190,108,298,Que85_T,"-37.81652527, 144.96121062"
372320240427,37,2024-04-27,23,113,169,282,Lyg260_T,"-37.80107122, 144.96704554"
37520241121,37,2024-11-21,5,5,5,10,Lyg260_T,"-37.80107122, 144.96704554"
471120250923,47,2025-09-23,11,567,661,1228,Eli250_T,"-37.81258467, 144.9625775"
45720240325,45,2024-03-25,7,124,139,263,Swa148_T,"-37.81414075, 144.96609379"
21320250105,21,2025-01-05,3,39,32,71,Bourke155_T,"-37.81267313, 144.96788288"
1321820241005,132,2024-10-05,18,81,98,179,King335_T,"-37.81267639, 144.95386444"
251520231217,25,2023-12-17,15,1086,849,1935,MCEC_T,"-37.82401776, 144.95604426"
1361720250724,136,2025-07-24,17,695,101,796,BirFed1120_T,"-37.8184141, 144.97357915"
130520241206,130,2024-12-06,5,0,1,1,Bou892T,"-37.8204637, 144.94126826"
1802120250531,180,2025-05-31,21,15,1,16,Mac330_T,"-37.79497059, 144.93530329"
49820250426,49,2025-04-26,8,169,118,287,Eli501_T,"-37.80730068, 144.95956055"
48820250901,48,2025-09-01,8,141,69,210,QVMQ_T,"-37.80631581, 144.95866697"
1411120250307,141,2025-03-07,11,188,231,419,474Fl_T,"-37.81997273, 144.95834911"
138820240602,138,2024-06-02,8,0,1,1,EntPark1671_T,"-37.81996544, 144.95981454"
1091320231203,109,2023-12-03,13,110,80,190,LatWill_T,"-37.81193681, 144.95621105"
48020240524,48,2024-05-24,0,7,12,19,QVMQ_T,"-37.80631581, 144.95866697"
1801420250925,180,2025-09-25,14,33,39,72,Mac330_T,"-37.79497059, 144.93530329"
1371220250428,137,2025-04-28,12,42,102,144,BouHbr2353_T,"-37.81894815, 144.94612292"
139020240908,139,2024-09-08,0,11,10,21,Signal1647_T,"-37.81959923, 144.9632832"
661020251015,66,2025-10-15,10,476,540,1016,QVN_T,"-37.81057846, 144.96444294"
61420240707,6,2024-07-07,14,1112,1112,2224,FliS_T,"-37.81911705, 144.96558255"
61520250310,6,2025-03-10,15,933,837,1770,FliS_T,"-37.81911705, 144.96558255"
84920240204,84,2024-02-04,9,507,371,878,ElFi_T,"-37.81798049, 144.96503383"
84820240226,84,2024-02-26,8,1291,392,1683,ElFi_T,"-37.81798049, 144.96503383"
661620240129,66,2024-01-29,16,1042,980,2022,QVN_T,"-37.81057846, 144.96444294"
701520231219,70,2023-12-19,15,128,118,246,Errol20_T,"-37.80456984, 144.94946228"
82220250912,8,2025-09-12,22,20,12,32,WebBN_T,"-37.82293543, 144.9471751"
751320240820,75,2024-08-20,13,50,49,99,SprFli_T,"-37.81515276, 144.97467661"
77620241030,77,2024-10-30,6,35,54,89,HarEsP_T,"-37.81441438, 144.94433026"
77520250617,77,2025-06-17,5,3,19,22,HarEsP_T,"-37.81441438, 144.94433026"
781520240313,78,2024-03-13,15,41,86,127,HarEsB_T,"-37.81471642, 144.9446508"
78520240907,78,2024-09-07,5,1,0,1,HarEsB_T,"-37.81471642, 144.9446508"
78920250416,78,2025-04-16,9,52,50,102,HarEsB_T,"-37.81471642, 144.9446508"
142020231230,14,2023-12-30,20,563,170,733,SanBri_T,"-37.82011242, 144.96291897"
711720240414,71,2024-04-14,17,7,8,15,WestWP_T,"-37.81235775, 144.97136962"
591320240809,59,2024-08-09,13,1296,1335,2631,RMIT_T,"-37.80825648, 144.96304859"
59720240211,59,2024-02-11,7,41,57,98,RMIT_T,"-37.80825648, 144.96304859"
652320240225,65,2024-02-25,23,28,66,94,SwaCs_T,"-37.81569416, 144.9668064"
421720250512,42,2025-05-12,17,221,470,691,UM1_T,"-37.80008566, 144.96386412"
281420250129,28,2025-01-29,14,897,979,1876,VAC_T,"-37.82129925, 144.96879309"
291520240525,29,2024-05-25,15,356,579,935,AG_T,"-37.8199817, 144.96872865"
31820240209,31,2024-02-09,8,51,110,161,Lyg161_T,"-37.80169681, 144.96658911"
36020250220,36,2025-02-20,0,6,8,14,Que85_T,"-37.81652527, 144.96121062"
21320241019,21,2024-10-19,3,30,27,57,Bourke155_T,"-37.81267313, 144.96788288"
1071120231222,107,2023-12-22,11,90,115,205,280Will_T,"-37.81246271, 144.95690188"
1241620250525,124,2025-05-25,16,4,2,6,BirBridge_T,"-37.81757416, 144.97329934"
1081220240131,108,2024-01-31,12,433,405,838,261Will_T,"-37.81295822, 144.95678789"
871020240205,87,2024-02-05,10,74,69,143,Errol23_T,"-37.80454949, 144.94921863"
1791320250826,179,2025-08-26,13,47,61,108,Pow61_T,"-37.82392385, 144.96299677"
1671320250206,167,2025-02-06,13,6,13,19,Lat526_T,"-37.81304149, 144.95155955"
1321520240201,132,2024-02-01,15,124,114,238,King335_T,"-37.81267639, 144.95386444"
1341320250809,134,2025-08-09,13,295,361,656,Spen201_T,"-37.81694221, 144.95303935"
135820250414,135,2025-04-14,8,282,352,634,Spen161_T,"-37.8172861, 144.95319102"
671020250626,67,2025-06-26,10,332,352,684,FLDegS_T,"-37.81688755, 144.96562569"
67220241106,67,2024-11-06,2,1,12,13,FLDegS_T,"-37.81688755, 144.96562569"
682320240103,68,2024-01-03,23,9,1,10,FLDegN_T,"-37.8168479, 144.96559789"
851320240105,85,2024-01-05,13,87,82,169,488Mac_T,"-37.79432415, 144.92973378"
172220250207,17,2025-02-07,22,90,107,197,Col15_T,"-37.81362543, 144.97323591"
1321720250208,132,2025-02-08,17,147,100,247,King335_T,"-37.81267639, 144.95386444"
132220250306,132,2025-03-06,2,10,5,15,King335_T,"-37.81267639, 144.95386444"
1342020250210,134,2025-02-10,20,321,268,589,Spen201_T,"-37.81694221, 144.95303935"
1351420250306,135,2025-03-06,14,399,457,856,Spen161_T,"-37.8172861, 144.95319102"
131220231125,131,2023-11-25,2,39,43,82,King2_T,"-37.82009057, 144.95758725"
1351720240121,135,2024-01-21,17,397,305,702,Spen161_T,"-37.8172861, 144.95319102"
1352020241005,135,2024-10-05,20,213,200,413,Spen161_T,"-37.8172861, 144.95319102"
107120250624,107,2025-06-24,1,1,8,9,280Will_T,"-37.81246271, 144.95690188"
1331220250804,133,2025-08-04,12,491,473,964,Spen229_T,"-37.81531435, 144.95227769"
108320241013,108,2024-10-13,3,15,6,21,261Will_T,"-37.81295822, 144.95678789"
1661720250616,166,2025-06-16,17,37,54,91,Spen484_T,"-37.80896733, 144.94931703"
1652020240905,165,2024-09-05,20,22,19,41,Spen475_T,"-37.80953359, 144.94939004"
1662320241104,166,2024-11-04,23,6,7,13,Spen484_T,"-37.80896733, 144.94931703"
68620240703,68,2024-07-03,6,3,2,5,FLDegN_T,"-37.8168479, 144.96559789"
17620240921,17,2024-09-21,6,25,20,45,Col15_T,"-37.81362543, 144.97323591"
11720240527,1,2024-05-27,17,915,760,1675,Bou292_T,"-37.81349441, 144.96515323"
621920250731,62,2025-07-31,19,292,333,625,Lat224_T,"-37.80996494, 144.96216521"
111320250611,11,2025-06-11,13,137,84,221,WatCit_T,"-37.81564989, 144.93970694"
21620240802,2,2024-08-02,16,624,599,1223,Bou283_T,"-37.81380668, 144.96516718"
351920231030,35,2023-10-30,19,831,707,1538,SouthB_T,"-37.82018685, 144.96508508"
35520250121,35,2025-01-21,5,79,65,144,SouthB_T,"-37.82018685, 144.96508508"
35420240330,35,2024-03-30,4,17,25,42,SouthB_T,"-37.82018685, 144.96508508"
271920240222,27,2024-02-22,19,120,91,211,Vic_T,"-37.80606888, 144.95644692"
53020250320,53,2025-03-20,0,10,19,29,Col254_T,"-37.81564191, 144.965499"
92120250203,9,2025-02-03,21,75,42,117,Col700_T,"-37.81982992, 144.95102555"
46920240302,46,2024-03-02,9,13,30,43,Pel147_T,"-37.80240719, 144.9615673"
521120231119,52,2023-11-19,11,281,290,571,Eli263_T,"-37.81252157, 144.9619401"
51920240625,51,2024-06-25,9,40,43,83,Fra118_T,"-37.80841815, 144.95906316"
231720240820,23,2024-08-20,17,466,990,1456,Col623_T,"-37.81909256, 144.95452748"
521820250117,52,2025-01-17,18,347,373,720,Eli263_T,"-37.81252157, 144.9619401"
522120250620,52,2025-06-20,21,280,274,554,Eli263_T,"-37.81252157, 144.9619401"
461220240501,46,2024-05-01,12,183,217,400,Pel147_T,"-37.80240719, 144.9615673"
1371420240623,137,2024-06-23,14,12,16,28,BouHbr2353_T,"-37.81894815, 144.94612292"
1231120250925,123,2025-09-25,11,27,30,57,BirBridge_T,"-37.81753741, 144.97329734"
1172320240307,117,2024-03-07,23,138,33,171,Fli114F_T,"-37.81629332, 144.97090877"
1091520250523,109,2025-05-23,15,151,81,232,LatWill_T,"-37.81193681, 144.95621105"
691020250608,69,2025-06-08,10,223,126,349,FLDegC_T,"-37.81687226, 144.96559144"
6720241218,6,2024-12-18,7,469,786,1255,FliS_T,"-37.81911705, 144.96558255"
84420250213,84,2025-02-13,4,6,23,29,ElFi_T,"-37.81798049, 144.96503383"
84020250425,84,2025-04-25,0,153,120,273,ElFi_T,"-37.81798049, 144.96503383"
32320250704,3,2025-07-04,23,517,513,1030,Swa295_T,"-37.81101524, 144.96429485"
751020240311,75,2024-03-11,10,8,22,30,SprFli_T,"-37.81515276, 144.97467661"
751320240322,75,2024-03-22,13,74,59,133,SprFli_T,"-37.81515276, 144.97467661"
392320250315,39,2025-03-15,23,21,7,28,AlfPl_T,"-37.81379749, 144.96995745"
29720241105,29,2024-11-05,7,67,55,122,AG_T,"-37.8199817, 144.96872865"
14520240519,14,2024-05-19,5,26,28,54,SanBri_T,"-37.82011242, 144.96291897"
592320250419,59,2025-04-19,23,79,99,178,RMIT_T,"-37.80825648, 144.96304859"
591220250428,59,2025-04-28,12,1269,1240,2509,RMIT_T,"-37.80825648, 144.96304859"
54520240307,54,2024-03-07,5,3,5,8,Swa607_T,"-37.804024, 144.96308399"
281220240910,28,2024-09-10,12,803,1624,2427,VAC_T,"-37.82129925, 144.96879309"
401320241021,40,2024-10-21,13,332,252,584,Spr201_T,"-37.80999341, 144.97227587"
40520231207,40,2023-12-07,5,11,13,24,Spr201_T,"-37.80999341, 144.97227587"
311420231215,31,2023-12-15,14,185,198,383,Lyg161_T,"-37.80169681, 144.96658911"
312320250511,31,2025-05-11,23,11,63,74,Lyg161_T,"-37.80169681, 144.96658911"
37620240804,37,2024-08-04,6,1,6,7,Lyg260_T,"-37.80107122, 144.96704554"
181320250129,18,2025-01-29,13,268,234,502,Col12_T,"-37.81344862, 144.97305353"
10720240109,10,2024-01-09,7,26,147,173,BouHbr_T,"-37.81876474, 144.94710545"
101620240510,10,2024-05-10,16,169,54,223,BouHbr_T,"-37.81876474, 144.94710545"
72420240605,72,2024-06-05,4,6,3,9,ACMI_T,"-37.81726338, 144.96872809"
21620250205,2,2025-02-05,16,518,525,1043,Bou283_T,"-37.81380668, 144.96516718"
352220240306,35,2024-03-06,22,370,886,1256,SouthB_T,"-37.82018685, 144.96508508"
581820250501,58,2025-05-01,18,732,1207,1939,Bou688_T,"-37.81686075, 144.95358075"
761720250113,76,2025-01-13,17,52,57,109,KenMac_T,"-37.79453803, 144.93036194"
9220250823,9,2025-08-23,2,2,11,13,Col700_T,"-37.81982992, 144.95102555"
53520241030,53,2024-10-30,5,18,27,45,Col254_T,"-37.81564191, 144.965499"
521320240218,52,2024-02-18,13,442,481,923,Eli263_T,"-37.81252157, 144.9619401"
202320240725,20,2024-07-25,23,76,142,218,LtB170_T,"-37.81172914, 144.9682466"
521720241222,52,2024-12-22,17,271,393,664,Eli263_T,"-37.81252157, 144.9619401"
142920250427,142,2025-04-27,9,378,263,641,Hammer1584_T,"-37.81970749, 144.96795734"
142920240807,142,2024-08-07,9,160,122,282,Hammer1584_T,"-37.81970749, 144.96795734"
123720250824,123,2025-08-24,7,9,15,24,BirBridge_T,"-37.81753741, 144.97329734"
491320250308,49,2025-03-08,13,354,629,983,Eli501_T,"-37.80730068, 144.95956055"
1232020231101,123,2023-11-01,20,6,5,11,BirBridge_T,"-37.81753741, 144.97329734"
123220240114,123,2024-01-14,2,3,1,4,BirBridge_T,"-37.81753741, 144.97329734"
1231820250104,123,2025-01-04,18,79,6,85,BirBridge_T,"-37.81753741, 144.97329734"
141820250924,141,2025-09-24,8,131,91,222,474Fl_T,"-37.81997273, 144.95834911"
491120250102,49,2025-01-02,11,338,572,910,Eli501_T,"-37.80730068, 144.95956055"
1092320250615,109,2025-06-15,23,10,35,45,LatWill_T,"-37.81193681, 144.95621105"
117720240502,117,2024-05-02,7,121,60,181,Fli114F_T,"-37.81629332, 144.97090877"
180120250326,180,2025-03-26,1,0,1,1,Mac330_T,"-37.79497059, 144.93530329"
139920250826,139,2025-08-26,9,19,143,162,Signal1647_T,"-37.81959923, 144.9632832"
139620240827,139,2024-08-27,6,5,17,22,Signal1647_T,"-37.81959923, 144.9632832"
66720240509,66,2024-05-09,7,76,195,271,QVN_T,"-37.81057846, 144.96444294"
4620250614,4,2025-06-14,6,42,30,72,Swa123_T,"-37.81487988, 144.9660878"
32320240602,3,2024-06-02,23,172,157,329,Swa295_T,"-37.81101524, 144.96429485"
391120231102,39,2023-11-02,11,134,110,244,AlfPl_T,"-37.81379749, 144.96995745"
391520240507,39,2024-05-07,15,99,89,188,AlfPl_T,"-37.81379749, 144.96995745"
411020231115,41,2023-11-15,10,1598,737,2335,Swa31,"-37.81668634, 144.96689733"
771820250107,77,2025-01-07,18,209,121,330,HarEsP_T,"-37.81441438, 144.94433026"
781020240722,78,2024-07-22,10,23,33,56,HarEsB_T,"-37.81471642, 144.9446508"
59320251009,59,2025-10-09,3,16,10,26,RMIT_T,"-37.80825648, 144.96304859"
652320240716,65,2024-07-16,23,73,69,142,SwaCs_T,"-37.81569416, 144.9668064"
291420240801,29,2024-08-01,14,213,340,553,AG_T,"-37.8199817, 144.96872865"
312220251009,31,2025-10-09,22,75,132,207,Lyg161_T,"-37.80169681, 144.96658911"
36320250128,36,2025-01-28,3,4,1,5,Que85_T,"-37.81652527, 144.96121062"
37820240704,37,2024-07-04,8,24,51,75,Lyg260_T,"-37.80107122, 144.96704554"
171020250208,17,2025-02-08,10,130,88,218,Col15_T,"-37.81362543, 144.97323591"
631920250419,63,2025-04-19,19,471,630,1101,Bou231_T,"-37.81333081, 144.96675571"
63720250528,63,2025-05-28,7,58,63,121,Bou231_T,"-37.81333081, 144.96675571"
181320241019,18,2024-10-19,13,104,90,194,Col12_T,"-37.81344862, 144.97305353"
121020231207,12,2023-12-07,10,120,124,244,NewQ_T,"-37.81457988, 144.94292398"
68620250608,68,2025-06-08,6,2,0,2,FLDegN_T,"-37.8168479, 144.96559789"
62320240920,62,2024-09-20,3,23,6,29,Lat224_T,"-37.80996494, 144.96216521"
62920250616,62,2025-06-16,9,64,91,155,Lat224_T,"-37.80996494, 144.96216521"
562320241016,56,2024-10-16,23,64,94,158,Lon364_T,"-37.81234775, 144.96153311"
86720250204,86,2025-02-04,7,15,13,28,574Qub_T,"-37.80309992, 144.94908064"
451120240130,45,2024-01-30,11,364,463,827,Swa148_T,"-37.81414075, 144.96609379"
1322320240718,132,2024-07-18,23,36,33,69,King335_T,"-37.81267639, 144.95386444"
1071720251014,107,2025-10-14,17,217,124,341,280Will_T,"-37.81246271, 144.95690188"
1181820240221,118,2024-02-21,18,24,48,72,Fli114C_T,"-37.81632783, 144.97090512"
1081320240804,108,2024-08-04,13,38,80,118,261Will_T,"-37.81295822, 144.95678789"
871020231105,87,2023-11-05,10,85,96,181,Errol23_T,"-37.80454949, 144.94921863"
1791220250717,179,2025-07-17,12,52,41,93,Pow61_T,"-37.82392385, 144.96299677"
167820250819,167,2025-08-19,8,26,125,151,Lat526_T,"-37.81304149, 144.95155955"
1811120250621,181,2025-06-21,11,461,761,1222,Eli368_T,"-37.81009465, 144.96143149"
1311520250721,131,2025-07-21,15,132,90,222,King2_T,"-37.82009057, 144.95758725"
1621420250923,162,2025-09-23,14,512,768,1280,Eli489_T,"-37.80740397, 144.95987909"
162520240707,162,2024-07-07,5,22,12,34,Eli489_T,"-37.80740397, 144.95987909"
671820240909,67,2024-09-09,18,244,446,690,FLDegS_T,"-37.81688755, 144.96562569"
851620241212,85,2024-12-12,16,70,90,160,488Mac_T,"-37.79432415, 144.92973378"
17920250219,17,2025-02-19,9,709,239,948,Col15_T,"-37.81362543, 144.97323591"
17920250712,17,2025-07-12,9,100,60,160,Col15_T,"-37.81362543, 144.97323591"
11720250726,1,2025-07-26,17,1390,945,2335,Bou292_T,"-37.81349441, 144.96515323"
681620240612,68,2024-06-12,16,125,57,182,FLDegN_T,"-37.8168479, 144.96559789"
671920250616,67,2025-06-16,19,135,158,293,FLDegS_T,"-37.81688755, 144.96562569"
621020231211,62,2023-12-11,10,147,130,277,Lat224_T,"-37.80996494, 144.96216521"
12520250130,12,2025-01-30,5,15,6,21,NewQ_T,"-37.81457988, 144.94292398"
10720250714,10,2025-07-14,7,16,82,98,BouHbr_T,"-37.81876474, 144.94710545"
21520240406,2,2024-04-06,15,1031,1060,2091,Bou283_T,"-37.81380668, 144.96516718"
9120231020,9,2023-10-20,1,3,8,11,Col700_T,"-37.81982992, 144.95102555"
791420231031,79,2023-10-31,14,445,352,797,FliSS_T,"-37.81794046, 144.96616678"
46920250708,46,2025-07-08,9,91,39,130,Pel147_T,"-37.80240719, 144.9615673"
521720240411,52,2024-04-11,17,579,487,1066,Eli263_T,"-37.81252157, 144.9619401"
512020240621,51,2024-06-21,20,66,51,117,Fra118_T,"-37.80841815, 144.95906316"
231120240726,23,2024-07-26,11,255,227,482,Col623_T,"-37.81909256, 144.95452748"
19920241029,19,2024-10-29,9,95,96,191,LtB210_T,"-37.81237202, 144.96550671"
191120250401,19,2025-04-01,11,313,211,524,LtB210_T,"-37.81237202, 144.96550671"
251220250929,25,2025-09-29,12,767,1073,1840,MCEC_T,"-37.82401776, 144.95604426"
48920250204,48,2025-02-04,9,173,118,291,QVMQ_T,"-37.80631581, 144.95866697"
202020250309,20,2025-03-09,20,235,502,737,LtB170_T,"-37.81172914, 144.9682466"
1372320231214,137,2023-12-14,23,1,1,2,BouHbr2353_T,"-37.81894815, 144.94612292"
139920241214,139,2024-12-14,9,24,40,64,Signal1647_T,"-37.81959923, 144.9632832"
1171120250118,117,2025-01-18,11,255,202,457,Fli114F_T,"-37.81629332, 144.97090877"
70420240330,70,2024-03-30,4,1,0,1,Errol20_T,"-37.80456984, 144.94946228"
391420240725,39,2024-07-25,14,97,109,206,AlfPl_T,"-37.81379749, 144.96995745"
751320231228,75,2023-12-28,13,46,39,85,SprFli_T,"-37.81515276, 144.97467661"
82120240204,8,2024-02-04,21,34,53,87,WebBN_T,"-37.82293543, 144.9471751"
39720250305,39,2025-03-05,7,61,48,109,AlfPl_T,"-37.81379749, 144.96995745"
42720250413,42,2025-04-13,7,13,18,31,UM1_T,"-37.80008566, 144.96386412"
101920250122,10,2025-01-22,19,47,40,87,BouHbr_T,"-37.81876474, 144.94710545"
76220240606,76,2024-06-06,2,1,1,2,KenMac_T,"-37.79453803, 144.93036194"
21420250313,2,2025-03-13,14,607,659,1266,Bou283_T,"-37.81380668, 144.96516718"
352220231229,35,2023-12-29,22,1203,1583,2786,SouthB_T,"-37.82018685, 144.96508508"
582120241116,58,2024-11-16,21,291,262,553,Bou688_T,"-37.81686075, 144.95358075"
22020250324,2,2025-03-24,20,70,200,270,Bou283_T,"-37.81380668, 144.96516718"
271020240208,27,2024-02-08,10,98,105,203,Vic_T,"-37.80606888, 144.95644692"
91620250519,9,2025-05-19,16,1984,137,2121,Col700_T,"-37.81982992, 144.95102555"
23320240606,23,2024-06-06,3,4,12,16,Col623_T,"-37.81909256, 144.95452748"
30120240823,30,2024-08-23,1,74,85,159,Lon189_T,"-37.8112185, 144.96656806"
20020250213,20,2025-02-13,0,29,31,60,LtB170_T,"-37.81172914, 144.9682466"
20320250625,20,2025-06-25,3,2,8,10,LtB170_T,"-37.81172914, 144.9682466"
1361220241127,136,2024-11-27,12,86,53,139,BirFed1120_T,"-37.8184141, 144.97357915"
1231020251008,123,2025-10-08,10,21,30,51,BirBridge_T,"-37.81753741, 144.97329734"
1301220240217,130,2024-02-17,12,30,60,90,Bou892T,"-37.8204637, 144.94126826"
130920250925,130,2025-09-25,9,45,31,76,Bou892T,"-37.8204637, 144.94126826"
1641620250322,164,2025-03-22,16,140,113,253,Lat526_T,"-37.813005, 144.95160411"
1381320240903,138,2024-09-03,13,4,8,12,EntPark1671_T,"-37.81996544, 144.95981454"
1611220241022,161,2024-10-22,12,187,202,389,BirArt1109_T,"-37.81851276, 144.97131336"
117420240923,117,2024-09-23,4,4,1,5,Fli114F_T,"-37.81629332, 144.97090877"
1231520241203,123,2024-12-03,15,9,3,12,BirBridge_T,"-37.81753741, 144.97329734"
141720241028,141,2024-10-28,7,55,48,103,474Fl_T,"-37.81997273, 144.95834911"
1091720240226,109,2024-02-26,17,467,215,682,LatWill_T,"-37.81193681, 144.95621105"
212220231119,21,2023-11-19,22,170,261,431,Bourke155_T,"-37.81267313, 144.96788288"
1241720231209,124,2023-12-09,17,0,1,1,BirBridge_T,"-37.81757416, 144.97329934"
108520240704,108,2024-07-04,5,1,70,71,261Will_T,"-37.81295822, 144.95678789"
871820240107,87,2024-01-07,18,48,42,90,Errol23_T,"-37.80454949, 144.94921863"
612120231029,61,2023-10-29,21,155,130,285,RMIT14_T,"-37.80767455, 144.96309114"
1661720250918,166,2025-09-18,17,93,73,166,Spen484_T,"-37.80896733, 144.94931703"
1651620250315,165,2025-03-15,16,50,40,90,Spen475_T,"-37.80953359, 144.94939004"
1671220250819,167,2025-08-19,12,29,70,99,Lat526_T,"-37.81304149, 144.95155955"
181420250320,18,2025-03-20,14,286,183,469,Col12_T,"-37.81344862, 144.97305353"
621620250624,62,2025-06-24,16,219,229,448,Lat224_T,"-37.80996494, 144.96216521"
562220240412,56,2024-04-12,22,215,301,516,Lon364_T,"-37.81234775, 144.96153311"
24320240620,24,2024-06-20,3,9,22,31,Col620_T,"-37.81887963, 144.95449198"
21620240725,2,2024-07-25,16,555,548,1103,Bou283_T,"-37.81380668, 144.96516718"
531820250106,53,2025-01-06,18,263,220,483,Col254_T,"-37.81564191, 144.965499"
9520240902,9,2024-09-02,5,10,23,33,Col700_T,"-37.81982992, 144.95102555"
9720250203,9,2025-02-03,7,56,1042,1098,Col700_T,"-37.81982992, 144.95102555"
27620250904,27,2025-09-04,6,17,16,33,Vic_T,"-37.80606888, 144.95644692"
301020250112,30,2025-01-12,10,99,184,283,Lon189_T,"-37.8112185, 144.96656806"
461720240922,46,2024-09-22,17,45,41,86,Pel147_T,"-37.80240719, 144.9615673"
521420241104,52,2024-11-04,14,467,328,795,Eli263_T,"-37.81252157, 144.9619401"
712320241213,71,2024-12-13,23,6,1,7,WestWP_T,"-37.81235775, 144.97136962"
401620240211,40,2024-02-11,16,96,142,238,Spr201_T,"-37.80999341, 144.97227587"
37420240112,37,2024-01-12,4,0,9,9,Lyg260_T,"-37.80107122, 144.96704554"
432120250713,43,2025-07-13,21,7,4,11,UM2_T,"-37.79844526, 144.96411782"
44820250405,44,2025-04-05,8,28,15,43,UM3_T,"-37.79698741, 144.96441306"
52320240306,5,2024-03-06,23,1112,379,1491,PriNW_T,"-37.81874249, 144.96787656"
1321120240201,132,2024-02-01,11,152,95,247,King335_T,"-37.81267639, 144.95386444"
1322120241016,132,2024-10-16,21,128,128,256,King335_T,"-37.81267639, 144.95386444"
1321520241220,132,2024-12-20,15,117,134,251,King335_T,"-37.81267639, 144.95386444"
132420241222,132,2024-12-22,4,23,4,27,King335_T,"-37.81267639, 144.95386444"
1341720250130,134,2025-01-30,17,577,423,1000,Spen201_T,"-37.81694221, 144.95303935"
1352320241119,135,2024-11-19,23,77,74,151,Spen161_T,"-37.8172861, 144.95319102"
1351320240810,135,2024-08-10,13,407,480,887,Spen161_T,"-37.8172861, 144.95319102"
1791620250501,179,2025-05-01,16,60,59,119,Pow61_T,"-37.82392385, 144.96299677"
179720250816,179,2025-08-16,7,13,7,20,Pow61_T,"-37.82392385, 144.96299677"
166020241113,166,2024-11-13,0,4,1,5,Spen484_T,"-37.80896733, 144.94931703"
1671420240927,167,2024-09-27,14,16,41,57,Lat526_T,"-37.81304149, 144.95155955"
671220240224,67,2024-02-24,12,394,432,826,FLDegS_T,"-37.81688755, 144.96562569"
67520231021,67,2023-10-21,5,6,10,16,FLDegS_T,"-37.81688755, 144.96562569"
672320240222,67,2024-02-22,23,30,18,48,FLDegS_T,"-37.81688755, 144.96562569"
67320250527,67,2025-05-27,3,5,11,16,FLDegS_T,"-37.81688755, 144.96562569"
67420231229,67,2023-12-29,4,1,4,5,FLDegS_T,"-37.81688755, 144.96562569"
181020250613,18,2025-06-13,10,141,218,359,Col12_T,"-37.81344862, 144.97305353"
67220231219,67,2023-12-19,2,4,0,4,FLDegS_T,"-37.81688755, 144.96562569"
721320240427,72,2024-04-27,13,258,358,616,ACMI_T,"-37.81726338, 144.96872809"
582320250219,58,2025-02-19,23,128,94,222,Bou688_T,"-37.81686075, 144.95358075"
58520250915,58,2025-09-15,5,63,21,84,Bou688_T,"-37.81686075, 144.95358075"
511720250507,51,2025-05-07,17,117,143,260,Fra118_T,"-37.80841815, 144.95906316"
461720240304,46,2024-03-04,17,184,132,316,Pel147_T,"-37.80240719, 144.9615673"
23220240215,23,2024-02-15,2,5,3,8,Col623_T,"-37.81909256, 144.95452748"
25520240811,25,2024-08-11,5,8,12,20,MCEC_T,"-37.82401776, 144.95604426"
201120241228,20,2024-12-28,11,267,142,409,LtB170_T,"-37.81172914, 144.9682466"
25320240213,25,2024-02-13,3,8,8,16,MCEC_T,"-37.82401776, 144.95604426"
180920250517,180,2025-05-17,9,9,12,21,Mac330_T,"-37.79497059, 144.93530329"
161120250117,161,2025-01-17,1,0,10,10,BirArt1109_T,"-37.81851276, 144.97131336"
161720250804,161,2025-08-04,7,73,144,217,BirArt1109_T,"-37.81851276, 144.97131336"
1232220250516,123,2025-05-16,22,11,0,11,BirBridge_T,"-37.81753741, 144.97329734"
1091320250725,109,2025-07-25,13,173,135,308,LatWill_T,"-37.81193681, 144.95621105"
481320250714,48,2025-07-14,13,167,149,316,QVMQ_T,"-37.80631581, 144.95866697"
139720250917,139,2025-09-17,7,23,151,174,Signal1647_T,"-37.81959923, 144.9632832"
672320240527,67,2024-05-27,23,13,32,45,FLDegS_T,"-37.81688755, 144.96562569"
851720240326,85,2024-03-26,17,72,136,208,488Mac_T,"-37.79432415, 144.92973378"
85520250227,85,2025-02-27,5,6,3,9,488Mac_T,"-37.79432415, 144.92973378"
69520250503,69,2025-05-03,5,3,0,3,FLDegC_T,"-37.81687226, 144.96559144"
692020250910,69,2025-09-10,20,26,22,48,FLDegC_T,"-37.81687226, 144.96559144"
70620240805,70,2024-08-05,6,14,0,14,Errol20_T,"-37.80456984, 144.94946228"
701920250119,70,2025-01-19,19,86,102,188,Errol20_T,"-37.80456984, 144.94946228"
392020250102,39,2025-01-02,20,30,25,55,AlfPl_T,"-37.81379749, 144.96995745"
75920231228,75,2023-12-28,9,20,73,93,SprFli_T,"-37.81515276, 144.97467661"
41920240425,41,2024-04-25,9,867,1039,1906,Swa31,"-37.81668634, 144.96689733"
78020241121,78,2024-11-21,0,2,10,12,HarEsB_T,"-37.81471642, 144.9446508"
14520250112,14,2025-01-12,5,27,21,48,SanBri_T,"-37.82011242, 144.96291897"
422120250413,42,2025-04-13,21,35,49,84,UM1_T,"-37.80008566, 144.96386412"
471720240222,47,2024-02-22,17,1222,794,2016,Eli250_T,"-37.81258467, 144.9625775"
471020240703,47,2024-07-03,10,365,517,882,Eli250_T,"-37.81258467, 144.9625775"
312220250119,31,2025-01-19,22,158,272,430,Lyg161_T,"-37.80169681, 144.96658911"
311520240515,31,2024-05-15,15,100,137,237,Lyg161_T,"-37.80169681, 144.96658911"
37220240403,37,2024-04-03,2,3,0,3,Lyg260_T,"-37.80107122, 144.96704554"
442120240714,44,2024-07-14,21,4,3,7,UM3_T,"-37.79698741, 144.96441306"
5320250301,5,2025-03-01,3,20,35,55,PriNW_T,"-37.81874249, 144.96787656"
211720241028,21,2024-10-28,17,307,244,551,Bourke155_T,"-37.81267313, 144.96788288"
61720250312,61,2025-03-12,7,293,229,522,RMIT14_T,"-37.80767455, 144.96309114"
179720250210,179,2025-02-10,7,39,18,57,Pow61_T,"-37.82392385, 144.96299677"
1791120250519,179,2025-05-19,11,45,40,85,Pow61_T,"-37.82392385, 144.96299677"
143620250326,143,2025-03-26,6,19,50,69,Spencer_T,"-37.821728, 144.95557015"
1342220250301,134,2025-03-01,22,442,268,710,Spen201_T,"-37.81694221, 144.95303935"
1351020240421,135,2024-04-21,10,372,396,768,Spen161_T,"-37.8172861, 144.95319102"
67220240408,67,2024-04-08,2,1,6,7,FLDegS_T,"-37.81688755, 144.96562569"
67920240621,67,2024-06-21,9,430,350,780,FLDegS_T,"-37.81688755, 144.96562569"
181120241214,18,2024-12-14,11,100,98,198,Col12_T,"-37.81344862, 144.97305353"
86820250829,86,2025-08-29,8,50,29,79,574Qub_T,"-37.80309992, 144.94908064"
112220240704,11,2024-07-04,22,14,12,26,WatCit_T,"-37.81564989, 144.93970694"
11220240914,11,2024-09-14,2,6,1,7,WatCit_T,"-37.81564989, 144.93970694"
101920240417,10,2024-04-17,19,34,31,65,BouHbr_T,"-37.81876474, 144.94710545"
2920241016,2,2024-10-16,9,185,258,443,Bou283_T,"-37.81380668, 144.96516718"
2720240201,2,2024-02-01,7,49,59,108,Bou283_T,"-37.81380668, 144.96516718"
76620241212,76,2024-12-12,6,18,12,30,KenMac_T,"-37.79453803, 144.93036194"
91920240823,9,2024-08-23,19,279,99,378,Col700_T,"-37.81982992, 144.95102555"
91320250907,9,2025-09-07,13,42,48,90,Col700_T,"-37.81982992, 144.95102555"
92020250302,9,2025-03-02,20,45,37,82,Col700_T,"-37.81982992, 144.95102555"
30520240920,30,2024-09-20,5,12,22,34,Lon189_T,"-37.8112185, 144.96656806"
30320250124,30,2025-01-24,3,30,63,93,Lon189_T,"-37.8112185, 144.96656806"
25220250414,25,2025-04-14,2,4,12,16,MCEC_T,"-37.82401776, 144.95604426"
20820240303,20,2024-03-03,8,39,31,70,LtB170_T,"-37.81172914, 144.9682466"
136820250213,136,2025-02-13,8,113,115,228,BirFed1120_T,"-37.8184141, 144.97357915"
1361320250517,136,2025-05-17,13,1192,66,1258,BirFed1120_T,"-37.8184141, 144.97357915"
1422020240715,142,2024-07-15,20,1,1,2,Hammer1584_T,"-37.81970749, 144.96795734"
1301020250710,130,2025-07-10,10,53,19,72,Bou892T,"-37.8204637, 144.94126826"
1641120250524,164,2025-05-24,11,130,138,268,Lat526_T,"-37.813005, 144.95160411"
1171620250507,117,2025-05-07,16,170,367,537,Fli114F_T,"-37.81629332, 144.97090877"
1392020250803,139,2025-08-03,20,20,10,30,Signal1647_T,"-37.81959923, 144.9632832"
1391020241114,139,2024-11-14,10,29,43,72,Signal1647_T,"-37.81959923, 144.9632832"
6820240702,6,2024-07-02,8,807,2161,2968,FliS_T,"-37.81911705, 144.96558255"
6620250328,6,2025-03-28,6,206,263,469,FliS_T,"-37.81911705, 144.96558255"
841720240316,84,2024-03-16,17,1281,1571,2852,ElFi_T,"-37.81798049, 144.96503383"
42220240530,4,2024-05-30,22,294,222,516,Swa123_T,"-37.81487988, 144.9660878"
3120250404,3,2025-04-04,1,106,54,160,Swa295_T,"-37.81101524, 144.96429485"
3720231222,3,2023-12-22,7,51,125,176,Swa295_T,"-37.81101524, 144.96429485"
8220251003,8,2025-10-03,2,1,0,1,WebBN_T,"-37.82293543, 144.9471751"
751820241127,75,2024-11-27,18,49,34,83,SprFli_T,"-37.81515276, 144.97467661"
82020250309,8,2025-03-09,20,47,27,74,WebBN_T,"-37.82293543, 144.9471751"
75120250304,75,2025-03-04,1,1,0,1,SprFli_T,"-37.81515276, 144.97467661"
411020240907,41,2024-09-07,10,174,218,392,Swa31,"-37.81668634, 144.96689733"
41220250208,41,2025-02-08,2,128,197,325,Swa31,"-37.81668634, 144.96689733"
41720241207,41,2024-12-07,7,162,190,352,Swa31,"-37.81668634, 144.96689733"
412020241113,41,2024-11-13,20,729,1236,1965,Swa31,"-37.81668634, 144.96689733"
291420231026,29,2023-10-26,14,253,197,450,AG_T,"-37.8199817, 144.96872865"
42620250704,42,2025-07-04,6,5,25,30,UM1_T,"-37.80008566, 144.96386412"
281120240117,28,2024-01-17,11,500,317,817,VAC_T,"-37.82129925, 144.96879309"
291520250404,29,2025-04-04,15,204,286,490,AG_T,"-37.8199817, 144.96872865"
40620240311,40,2024-03-11,6,11,8,19,Spr201_T,"-37.80999341, 144.97227587"
312020250125,31,2025-01-25,20,446,407,853,Lyg161_T,"-37.80169681, 144.96658911"
361720250421,36,2025-04-21,17,79,58,137,Que85_T,"-37.81652527, 144.96121062"
361220240825,36,2024-08-25,12,84,90,174,Que85_T,"-37.81652527, 144.96121062"
471120250829,47,2025-08-29,11,598,606,1204,Eli250_T,"-37.81258467, 144.9625775"
471920240830,47,2024-08-30,19,855,720,1575,Eli250_T,"-37.81258467, 144.9625775"
442020231026,44,2023-10-26,20,28,8,36,UM3_T,"-37.79698741, 144.96441306"
44420240220,44,2024-02-20,4,2,2,4,UM3_T,"-37.79698741, 144.96441306"
451820250426,45,2025-04-26,18,466,748,1214,Swa148_T,"-37.81414075, 144.96609379"
1241820240130,124,2024-01-30,18,0,1,1,BirBridge_T,"-37.81757416, 144.97329934"
108020231218,108,2023-12-18,0,28,29,57,261Will_T,"-37.81295822, 144.95678789"
871920240124,87,2024-01-24,19,133,112,245,Errol23_T,"-37.80454949, 144.94921863"
50320250824,50,2025-08-24,3,11,1,12,Lyg309_T,"-37.79808192, 144.96721013"
1792120241230,179,2024-12-30,21,72,72,144,Pow61_T,"-37.82392385, 144.96299677"
167620241228,167,2024-12-28,6,3,17,20,Lat526_T,"-37.81304149, 144.95155955"
1341020240214,134,2024-02-14,10,268,377,645,Spen201_T,"-37.81694221, 144.95303935"
134520240608,134,2024-06-08,5,38,47,85,Spen201_T,"-37.81694221, 144.95303935"
311020250310,31,2025-03-10,10,97,102,199,Lyg161_T,"-37.80169681, 144.96658911"
542320250112,54,2025-01-12,23,25,15,40,Swa607_T,"-37.804024, 144.96308399"
541620240425,54,2024-04-25,16,135,145,280,Swa607_T,"-37.804024, 144.96308399"
472220240712,47,2024-07-12,22,419,356,775,Eli250_T,"-37.81258467, 144.9625775"
401320250530,40,2025-05-30,13,267,214,481,Spr201_T,"-37.80999341, 144.97227587"
212020250117,21,2025-01-17,20,363,490,853,Bourke155_T,"-37.81267313, 144.96788288"
21220240321,21,2024-03-21,2,34,37,71,Bourke155_T,"-37.81267313, 144.96788288"
5820250226,5,2025-02-26,8,374,919,1293,PriNW_T,"-37.81874249, 144.96787656"
1352120231109,135,2023-11-09,21,148,170,318,Spen161_T,"-37.8172861, 144.95319102"
1331620240313,133,2024-03-13,16,752,933,1685,Spen229_T,"-37.81531435, 144.95227769"
1332120240722,133,2024-07-22,21,285,210,495,Spen229_T,"-37.81531435, 144.95227769"
1241420250514,124,2025-05-14,14,1,2,3,BirBridge_T,"-37.81757416, 144.97329934"
872120250219,87,2025-02-19,21,26,38,64,Errol23_T,"-37.80454949, 144.94921863"
181920250421,181,2025-04-21,9,216,444,660,Eli368_T,"-37.81009465, 144.96143149"
1312120250404,131,2025-04-04,21,204,139,343,King2_T,"-37.82009057, 144.95758725"
1431320250510,143,2025-05-10,13,179,206,385,Spencer_T,"-37.821728, 144.95557015"
132520240308,132,2024-03-08,5,4,5,9,King335_T,"-37.81267639, 144.95386444"
1342120250116,134,2025-01-16,21,579,458,1037,Spen201_T,"-37.81694221, 144.95303935"
671720250702,67,2025-07-02,17,248,422,670,FLDegS_T,"-37.81688755, 144.96562569"
181620240910,18,2024-09-10,16,562,117,679,Col12_T,"-37.81344862, 144.97305353"
562320240501,56,2024-05-01,23,52,66,118,Lon364_T,"-37.81234775, 144.96153311"
862020231225,86,2023-12-25,20,11,16,27,574Qub_T,"-37.80309992, 144.94908064"
24220231121,24,2023-11-21,2,18,19,37,Col620_T,"-37.81887963, 144.95449198"
12220240612,12,2024-06-12,2,0,1,1,NewQ_T,"-37.81457988, 144.94292398"
562320250809,56,2025-08-09,23,112,179,291,Lon364_T,"-37.81234775, 144.96153311"
2520250622,2,2025-06-22,5,2,10,12,Bou283_T,"-37.81380668, 144.96516718"
35220240423,35,2024-04-23,2,17,19,36,SouthB_T,"-37.82018685, 144.96508508"
27520241008,27,2024-10-08,5,9,11,20,Vic_T,"-37.80606888, 144.95644692"
53620240101,53,2024-01-01,6,17,9,26,Col254_T,"-37.81564191, 144.965499"
91420250404,9,2025-04-04,14,464,288,752,Col700_T,"-37.81982992, 144.95102555"
79320250223,79,2025-02-23,3,50,51,101,FliSS_T,"-37.81794046, 144.96616678"
232020240506,23,2024-05-06,20,110,196,306,Col623_T,"-37.81909256, 144.95452748"
192120240707,19,2024-07-07,21,320,551,871,LtB210_T,"-37.81237202, 144.96550671"
1422020250508,142,2025-05-08,20,25,31,56,Hammer1584_T,"-37.81970749, 144.96795734"
1422320240123,142,2024-01-23,23,45,38,83,Hammer1584_T,"-37.81970749, 144.96795734"
117620240724,117,2024-07-24,6,34,31,65,Fli114F_T,"-37.81629332, 144.97090877"
492220231030,49,2023-10-30,22,73,55,128,Eli501_T,"-37.80730068, 144.95956055"
691320240610,69,2024-06-10,13,160,153,313,FLDegC_T,"-37.81687226, 144.96559144"
6620250109,6,2025-01-09,6,167,227,394,FliS_T,"-37.81911705, 144.96558255"
841720240110,84,2024-01-10,17,1109,2155,3264,ElFi_T,"-37.81798049, 144.96503383"
41720250930,4,2025-09-30,17,1784,1556,3340,Swa123_T,"-37.81487988, 144.9660878"
671220250112,67,2025-01-12,12,231,235,466,FLDegS_T,"-37.81688755, 144.96562569"
1220250413,1,2025-04-13,2,41,94,135,Bou292_T,"-37.81349441, 144.96515323"
1920250430,1,2025-04-30,9,345,315,660,Bou292_T,"-37.81349441, 144.96515323"
631620250130,63,2025-01-30,16,349,369,718,Bou231_T,"-37.81333081, 144.96675571"
632220250622,63,2025-06-22,22,3,22,25,Bou231_T,"-37.81333081, 144.96675571"
18720231202,18,2023-12-02,7,5,8,13,Col12_T,"-37.81344862, 144.97305353"
18520240316,18,2024-03-16,5,2,1,3,Col12_T,"-37.81344862, 144.97305353"
622220250802,62,2025-08-02,22,204,221,425,Lat224_T,"-37.80996494, 144.96216521"
111320240723,11,2024-07-23,13,98,79,177,WatCit_T,"-37.81564989, 144.93970694"
11920240922,11,2024-09-22,9,55,62,117,WatCit_T,"-37.81564989, 144.93970694"
122320240627,12,2024-06-27,23,27,39,66,NewQ_T,"-37.81457988, 144.94292398"
721620250602,72,2025-06-02,16,106,518,624,ACMI_T,"-37.81726338, 144.96872809"
35820240714,35,2024-07-14,8,251,198,449,SouthB_T,"-37.82018685, 144.96508508"
58320250214,58,2025-02-14,3,17,13,30,Bou688_T,"-37.81686075, 144.95358075"
58020250516,58,2025-05-16,0,51,51,102,Bou688_T,"-37.81686075, 144.95358075"
35620250323,35,2025-03-23,6,86,74,160,SouthB_T,"-37.82018685, 144.96508508"
9920251004,9,2025-10-04,9,45,65,110,Col700_T,"-37.81982992, 144.95102555"
92320241009,9,2024-10-09,23,18,14,32,Col700_T,"-37.81982992, 144.95102555"
91020241102,9,2024-11-02,10,73,118,191,Col700_T,"-37.81982992, 144.95102555"
301020240913,30,2024-09-13,10,138,185,323,Lon189_T,"-37.8112185, 144.96656806"
461020250117,46,2025-01-17,10,49,29,78,Pel147_T,"-37.80240719, 144.9615673"
511420250312,51,2025-03-12,14,94,89,183,Fra118_T,"-37.80841815, 144.95906316"
1362320231208,136,2023-12-08,23,4,193,197,BirFed1120_T,"-37.8184141, 144.97357915"
136920240421,136,2024-04-21,9,174,136,310,BirFed1120_T,"-37.8184141, 144.97357915"
136020250227,136,2025-02-27,0,1,2,3,BirFed1120_T,"-37.8184141, 144.97357915"
180820250429,180,2025-04-29,8,127,42,169,Mac330_T,"-37.79497059, 144.93530329"
49820250720,49,2025-07-20,8,88,79,167,Eli501_T,"-37.80730068, 144.95956055"
492120240828,49,2024-08-28,21,255,466,721,Eli501_T,"-37.80730068, 144.95956055"
1091820231128,109,2023-11-28,18,199,144,343,LatWill_T,"-37.81193681, 144.95621105"
109720250423,109,2025-04-23,7,32,194,226,LatWill_T,"-37.81193681, 144.95621105"
19820250312,19,2025-03-12,8,63,52,115,LtB210_T,"-37.81237202, 144.96550671"
1392220250122,139,2025-01-22,22,34,21,55,Signal1647_T,"-37.81959923, 144.9632832"
1372020240410,137,2024-04-10,20,4,5,9,BouHbr2353_T,"-37.81894815, 144.94612292"
691820240527,69,2024-05-27,18,39,42,81,FLDegC_T,"-37.81687226, 144.96559144"
691020250720,69,2025-07-20,10,248,171,419,FLDegC_T,"-37.81687226, 144.96559144"
61020250303,6,2025-03-03,10,446,459,905,FliS_T,"-37.81911705, 144.96558255"
661620240112,66,2024-01-12,16,863,839,1702,QVN_T,"-37.81057846, 144.96444294"
84520240928,84,2024-09-28,5,43,34,77,ElFi_T,"-37.81798049, 144.96503383"
662220240517,66,2024-05-17,22,502,340,842,QVN_T,"-37.81057846, 144.96444294"
662220240603,66,2024-06-03,22,238,169,407,QVN_T,"-37.81057846, 144.96444294"
70620231116,70,2023-11-16,6,11,11,22,Errol20_T,"-37.80456984, 144.94946228"
701520240214,70,2024-02-14,15,170,141,311,Errol20_T,"-37.80456984, 144.94946228"
701220240220,70,2024-02-20,12,178,182,360,Errol20_T,"-37.80456984, 144.94946228"
3720240228,3,2024-02-28,7,87,169,256,Swa295_T,"-37.81101524, 144.96429485"
751920240301,75,2024-03-01,19,57,60,117,SprFli_T,"-37.81515276, 144.97467661"
752020240423,75,2024-04-23,20,23,31,54,SprFli_T,"-37.81515276, 144.97467661"
39520240629,39,2024-06-29,5,1,3,4,AlfPl_T,"-37.81379749, 144.96995745"
8420250910,8,2025-09-10,4,1,0,1,WebBN_T,"-37.82293543, 144.9471751"
75320250425,75,2025-04-25,3,1,1,2,SprFli_T,"-37.81515276, 144.97467661"
82320250214,8,2025-02-14,23,5,3,8,WebBN_T,"-37.82293543, 144.9471751"
411920240228,41,2024-02-28,19,760,1101,1861,Swa31,"-37.81668634, 144.96689733"
41420240325,41,2024-03-25,4,43,48,91,Swa31,"-37.81668634, 144.96689733"
77720241224,77,2024-12-24,7,38,39,77,HarEsP_T,"-37.81441438, 144.94433026"
781120250917,78,2025-09-17,11,32,34,66,HarEsB_T,"-37.81471642, 144.9446508"
14220231122,14,2023-11-22,2,5,4,9,SanBri_T,"-37.82011242, 144.96291897"
141720240508,14,2024-05-08,17,1150,243,1393,SanBri_T,"-37.82011242, 144.96291897"
59220240328,59,2024-03-28,2,42,22,64,RMIT_T,"-37.80825648, 144.96304859"
651620240519,65,2024-05-19,16,604,667,1271,SwaCs_T,"-37.81569416, 144.9668064"
651820231206,65,2023-12-06,18,746,1106,1852,SwaCs_T,"-37.81569416, 144.9668064"
421920240625,42,2024-06-25,19,50,83,133,UM1_T,"-37.80008566, 144.96386412"
29820241108,29,2024-11-08,8,137,124,261,AG_T,"-37.8199817, 144.96872865"
14420250503,14,2025-05-03,4,27,5,32,SanBri_T,"-37.82011242, 144.96291897"
47520250207,47,2025-02-07,5,18,64,82,Eli250_T,"-37.81258467, 144.9625775"
471520231107,47,2023-11-07,15,627,648,1275,Eli250_T,"-37.81258467, 144.9625775"
312020250928,31,2025-09-28,20,207,228,435,Lyg161_T,"-37.80169681, 144.96658911"
31920250718,31,2025-07-18,9,62,68,130,Lyg161_T,"-37.80169681, 144.96658911"
54420250125,54,2025-01-25,4,12,4,16,Swa607_T,"-37.804024, 144.96308399"
37020250722,37,2025-07-22,0,4,12,16,Lyg260_T,"-37.80107122, 144.96704554"
37820231101,37,2023-11-01,8,27,72,99,Lyg260_T,"-37.80107122, 144.96704554"
1411020250906,141,2025-09-06,10,48,97,145,474Fl_T,"-37.81997273, 144.95834911"
1371520250501,137,2025-05-01,15,19,112,131,BouHbr2353_T,"-37.81894815, 144.94612292"
1361720240519,136,2024-05-19,17,10,12,22,BirFed1120_T,"-37.8184141, 144.97357915"
1361120250811,136,2025-08-11,11,55,45,100,BirFed1120_T,"-37.8184141, 144.97357915"
1421820250928,142,2025-09-28,18,258,319,577,Hammer1584_T,"-37.81970749, 144.96795734"
1381020231212,138,2023-12-12,10,5,7,12,EntPark1671_T,"-37.81996544, 144.95981454"
1092320250416,109,2025-04-16,23,52,49,101,LatWill_T,"-37.81193681, 144.95621105"
1092220231130,109,2023-11-30,22,30,31,61,LatWill_T,"-37.81193681, 144.95621105"
661720250331,66,2025-03-31,17,1699,1753,3452,QVN_T,"-37.81057846, 144.96444294"
842220240701,84,2024-07-01,22,248,360,608,ElFi_T,"-37.81798049, 144.96503383"
702120240908,70,2024-09-08,21,79,61,140,Errol20_T,"-37.80456984, 144.94946228"
31920241001,3,2024-10-01,19,802,983,1785,Swa295_T,"-37.81101524, 144.96429485"
3420240630,3,2024-06-30,4,108,101,209,Swa295_T,"-37.81101524, 144.96429485"
75220250504,75,2025-05-04,2,4,4,8,SprFli_T,"-37.81515276, 144.97467661"
41320250427,41,2025-04-27,3,96,179,275,Swa31,"-37.81668634, 144.96689733"
41120241124,41,2024-11-24,1,242,419,661,Swa31,"-37.81668634, 144.96689733"
81020250213,8,2025-02-13,10,101,144,245,WebBN_T,"-37.82293543, 144.9471751"
771220240313,77,2024-03-13,12,122,88,210,HarEsP_T,"-37.81441438, 144.94433026"
29420250118,29,2025-01-18,4,3,6,9,AG_T,"-37.8199817, 144.96872865"
71520240810,71,2024-08-10,5,14,7,21,WestWP_T,"-37.81235775, 144.97136962"
28320241205,28,2024-12-05,3,10,20,30,VAC_T,"-37.82129925, 144.96879309"
40020240313,40,2024-03-13,0,13,13,26,Spr201_T,"-37.80999341, 144.97227587"
472020240918,47,2024-09-18,20,444,373,817,Eli250_T,"-37.81258467, 144.9625775"
37120250730,37,2025-07-30,1,3,1,4,Lyg260_T,"-37.80107122, 144.96704554"
43220251011,43,2025-10-11,2,3,2,5,UM2_T,"-37.79844526, 144.96411782"
44920251011,44,2025-10-11,9,27,40,67,UM3_T,"-37.79698741, 144.96441306"
45220231202,45,2023-12-02,2,50,134,184,Swa148_T,"-37.81414075, 144.96609379"
52320241021,5,2024-10-21,23,79,100,179,PriNW_T,"-37.81874249, 144.96787656"
5820241203,5,2024-12-03,8,329,852,1181,PriNW_T,"-37.81874249, 144.96787656"
1322020231103,132,2023-11-03,20,106,122,228,King335_T,"-37.81267639, 144.95386444"
1352220250324,135,2025-03-24,22,81,118,199,Spen161_T,"-37.8172861, 144.95319102"
1351320241120,135,2024-11-20,13,586,537,1123,Spen161_T,"-37.8172861, 144.95319102"
1082320250208,108,2025-02-08,23,207,140,347,261Will_T,"-37.81295822, 144.95678789"
871120250704,87,2025-07-04,11,130,100,230,Errol23_T,"-37.80454949, 144.94921863"
1621820240905,162,2024-09-05,18,277,286,563,Eli489_T,"-37.80740397, 144.95987909"
1622120250120,162,2025-01-20,21,151,82,233,Eli489_T,"-37.80740397, 144.95987909"
671620250519,67,2025-05-19,16,340,555,895,FLDegS_T,"-37.81688755, 144.96562569"
682120250522,68,2025-05-22,21,71,44,115,FLDegN_T,"-37.8168479, 144.96559789"
851120240609,85,2024-06-09,11,94,73,167,488Mac_T,"-37.79432415, 144.92973378"
67320241218,67,2024-12-18,3,2,2,4,FLDegS_T,"-37.81688755, 144.96562569"
18620240619,18,2024-06-19,6,0,2,2,Col12_T,"-37.81344862, 144.97305353"
671620231209,67,2023-12-09,16,143,249,392,FLDegS_T,"-37.81688755, 144.96562569"
67720250412,67,2025-04-12,7,86,81,167,FLDegS_T,"-37.81688755, 144.96562569"
56920240528,56,2024-05-28,9,166,119,285,Lon364_T,"-37.81234775, 144.96153311"
861320240511,86,2024-05-11,13,83,86,169,574Qub_T,"-37.80309992, 144.94908064"
862020241129,86,2024-11-29,20,34,60,94,574Qub_T,"-37.80309992, 144.94908064"
21320240317,2,2024-03-17,13,518,656,1174,Bou283_T,"-37.81380668, 144.96516718"
581020240410,58,2024-04-10,10,793,209,1002,Bou688_T,"-37.81686075, 144.95358075"
351020240704,35,2024-07-04,10,645,472,1117,SouthB_T,"-37.82018685, 144.96508508"
91020241008,9,2024-10-08,10,199,591,790,Col700_T,"-37.81982992, 144.95102555"
27020250315,27,2025-03-15,0,36,19,55,Vic_T,"-37.80606888, 144.95644692"
791620241027,79,2024-10-27,16,528,416,944,FliSS_T,"-37.81794046, 144.96616678"
302320240130,30,2024-01-30,23,161,100,261,Lon189_T,"-37.8112185, 144.96656806"
512220250502,51,2025-05-02,22,31,41,72,Fra118_T,"-37.80841815, 144.95906316"
521020240320,52,2024-03-20,10,204,175,379,Eli263_T,"-37.81252157, 144.9619401"
23020250117,23,2025-01-17,0,18,27,45,Col623_T,"-37.81909256, 144.95452748"
48120231102,48,2023-11-02,1,5,10,15,QVMQ_T,"-37.80631581, 144.95866697"
521120240531,52,2024-05-31,11,256,174,430,Eli263_T,"-37.81252157, 144.9619401"
1091420250101,109,2025-01-01,14,63,76,139,LatWill_T,"-37.81193681, 144.95621105"
662220240403,66,2024-04-03,22,468,258,726,QVN_T,"-37.81057846, 144.96444294"
692220240107,69,2024-01-07,22,0,1,1,FLDegC_T,"-37.81687226, 144.96559144"
4420240103,4,2024-01-03,4,13,17,30,Swa123_T,"-37.81487988, 144.9660878"
8220250209,8,2025-02-09,2,1,0,1,WebBN_T,"-37.82293543, 144.9471751"
771120250409,77,2025-04-09,11,113,86,199,HarEsP_T,"-37.81441438, 144.94433026"
681320240309,68,2024-03-09,13,275,200,475,FLDegN_T,"-37.8168479, 144.96559789"
681220240725,68,2024-07-25,12,283,206,489,FLDegN_T,"-37.8168479, 144.96559789"
851120231214,85,2023-12-14,11,115,86,201,488Mac_T,"-37.79432415, 144.92973378"
851220250624,85,2025-06-24,12,115,90,205,488Mac_T,"-37.79432415, 144.92973378"
851520251007,85,2025-10-07,15,104,110,214,488Mac_T,"-37.79432415, 144.92973378"
17320240316,17,2024-03-16,3,7,5,12,Col15_T,"-37.81362543, 144.97323591"
1120240611,1,2024-06-11,1,2,5,7,Bou292_T,"-37.81349441, 144.96515323"
67620241108,67,2024-11-08,6,112,71,183,FLDegS_T,"-37.81688755, 144.96562569"
68820240904,68,2024-09-04,8,117,85,202,FLDegN_T,"-37.8168479, 144.96559789"
672120250123,67,2025-01-23,21,169,246,415,FLDegS_T,"-37.81688755, 144.96562569"
68020240818,68,2024-08-18,0,2,0,2,FLDegN_T,"-37.8168479, 144.96559789"
861720250106,86,2025-01-06,17,32,57,89,574Qub_T,"-37.80309992, 144.94908064"
10120250709,10,2025-07-09,1,2,2,4,BouHbr_T,"-37.81876474, 144.94710545"
242120240616,24,2024-06-16,21,255,290,545,Col620_T,"-37.81887963, 144.95449198"
58620250130,58,2025-01-30,6,188,43,231,Bou688_T,"-37.81686075, 144.95358075"
58020250420,58,2025-04-20,0,129,140,269,Bou688_T,"-37.81686075, 144.95358075"
2420250726,2,2025-07-26,4,8,11,19,Bou283_T,"-37.81380668, 144.96516718"
9020250906,9,2025-09-06,0,15,25,40,Col700_T,"-37.81982992, 144.95102555"
9020251010,9,2025-10-10,0,14,18,32,Col700_T,"-37.81982992, 144.95102555"
91620241202,9,2024-12-02,16,2055,113,2168,Col700_T,"-37.81982992, 144.95102555"
9420240928,9,2024-09-28,4,1,11,12,Col700_T,"-37.81982992, 144.95102555"
301320250129,30,2025-01-29,13,274,450,724,Lon189_T,"-37.8112185, 144.96656806"
30020250502,30,2025-05-02,0,118,105,223,Lon189_T,"-37.8112185, 144.96656806"
511120240326,51,2024-03-26,11,99,151,250,Fra118_T,"-37.80841815, 144.95906316"
251620240620,25,2024-06-20,16,737,540,1277,MCEC_T,"-37.82401776, 144.95604426"
137320250525,137,2025-05-25,3,1,1,2,BouHbr2353_T,"-37.81894815, 144.94612292"
1372220250909,137,2025-09-09,22,0,1,1,BouHbr2353_T,"-37.81894815, 144.94612292"
1411320231228,141,2023-12-28,13,162,150,312,474Fl_T,"-37.81997273, 144.95834911"
3820250429,3,2025-04-29,8,212,273,485,Swa295_T,"-37.81101524, 144.96429485"
421320241201,42,2024-12-01,13,49,44,93,UM1_T,"-37.80008566, 144.96386412"
771620240416,77,2024-04-16,16,198,159,357,HarEsP_T,"-37.81441438, 144.94433026"
59520240311,59,2024-03-11,5,9,10,19,RMIT_T,"-37.80825648, 144.96304859"
291020250330,29,2025-03-30,10,497,447,944,AG_T,"-37.8199817, 144.96872865"
311720250917,31,2025-09-17,17,204,133,337,Lyg161_T,"-37.80169681, 144.96658911"
212020250903,21,2025-09-03,20,173,179,352,Bourke155_T,"-37.81267313, 144.96788288"
36820250116,36,2025-01-16,8,230,190,420,Que85_T,"-37.81652527, 144.96121062"
371720240319,37,2024-03-19,17,127,118,245,Lyg260_T,"-37.80107122, 144.96704554"
44120250501,44,2025-05-01,1,10,0,10,UM3_T,"-37.79698741, 144.96441306"
45220250415,45,2025-04-15,2,2,5,7,Swa148_T,"-37.81414075, 144.96609379"
51320240607,5,2024-06-07,13,705,841,1546,PriNW_T,"-37.81874249, 144.96787656"
51720250525,5,2025-05-25,17,867,990,1857,PriNW_T,"-37.81874249, 144.96787656"
1351420241228,135,2024-12-28,14,374,402,776,Spen161_T,"-37.8172861, 144.95319102"
1341420240125,134,2024-01-25,14,455,374,829,Spen201_T,"-37.81694221, 144.95303935"
1341520240305,134,2024-03-05,15,385,342,727,Spen201_T,"-37.81694221, 144.95303935"
1331120240504,133,2024-05-04,11,485,465,950,Spen229_T,"-37.81531435, 144.95227769"
1081520250506,108,2025-05-06,15,625,237,862,261Will_T,"-37.81295822, 144.95678789"
1852120250904,185,2025-09-04,21,298,352,650,Eli197_T,"-37.81374643, 144.96276183"
167420250226,167,2025-02-26,4,0,3,3,Lat526_T,"-37.81304149, 144.95155955"
1311520250324,131,2025-03-24,15,126,95,221,King2_T,"-37.82009057, 144.95758725"
182920250904,182,2025-09-04,9,116,157,273,King163_T,"-37.81627451, 144.95550503"
143820251010,143,2025-10-10,8,122,553,675,Spencer_T,"-37.821728, 144.95557015"
851620240315,85,2024-03-15,16,63,95,158,488Mac_T,"-37.79432415, 144.92973378"
181820250403,18,2025-04-03,18,428,94,522,Col12_T,"-37.81344862, 144.97305353"
631720240712,63,2024-07-12,17,577,519,1096,Bou231_T,"-37.81333081, 144.96675571"
63920250807,63,2025-08-07,9,169,220,389,Bou231_T,"-37.81333081, 144.96675571"
72120250720,72,2025-07-20,1,7,28,35,ACMI_T,"-37.81726338, 144.96872809"
351320241015,35,2024-10-15,13,1230,1360,2590,SouthB_T,"-37.82018685, 144.96508508"
22120241030,2,2024-10-30,21,97,140,237,Bou283_T,"-37.81380668, 144.96516718"
21720250205,2,2025-02-05,17,596,457,1053,Bou283_T,"-37.81380668, 144.96516718"
581020250927,58,2025-09-27,10,841,241,1082,Bou688_T,"-37.81686075, 144.95358075"
79720250523,79,2025-05-23,7,225,116,341,FliSS_T,"-37.81794046, 144.96616678"
232020241221,23,2024-12-21,20,98,128,226,Col623_T,"-37.81909256, 144.95452748"
20820250717,20,2025-07-17,8,47,60,107,LtB170_T,"-37.81172914, 144.9682466"
251820240330,25,2024-03-30,18,1405,438,1843,MCEC_T,"-37.82401776, 144.95604426"
1641920250428,164,2025-04-28,19,55,86,141,Lat526_T,"-37.813005, 144.95160411"
1641520250722,164,2025-07-22,15,101,102,203,Lat526_T,"-37.813005, 144.95160411"
139120240712,139,2024-07-12,1,0,1,1,Signal1647_T,"-37.81959923, 144.9632832"
136820240731,136,2024-07-31,8,93,128,221,BirFed1120_T,"-37.8184141, 144.97357915"
1362320240601,136,2024-06-01,23,3,0,3,BirFed1120_T,"-37.8184141, 144.97357915"
442020240508,44,2024-05-08,20,44,51,95,UM3_T,"-37.79698741, 144.96441306"
441720240829,44,2024-08-29,17,140,129,269,UM3_T,"-37.79698741, 144.96441306"
51020250709,5,2025-07-09,10,460,853,1313,PriNW_T,"-37.81874249, 144.96787656"
1181620240218,118,2024-02-18,16,49,81,130,Fli114C_T,"-37.81632783, 144.97090512"
1181120250210,118,2025-02-10,11,8,14,22,Fli114C_T,"-37.81632783, 144.97090512"
1081720231221,108,2023-12-21,17,1027,220,1247,261Will_T,"-37.81295822, 144.95678789"
871720240209,87,2024-02-09,17,123,125,248,Errol23_T,"-37.80454949, 144.94921863"
501320250529,50,2025-05-29,13,161,171,332,Lyg309_T,"-37.79808192, 144.96721013"
165920250104,165,2025-01-04,9,18,46,64,Spen475_T,"-37.80953359, 144.94939004"
165820250122,165,2025-01-22,8,26,59,85,Spen475_T,"-37.80953359, 144.94939004"
1401420250915,140,2025-09-15,14,77,64,141,Boyd2837_T,"-37.82590962, 144.96185972"
1851920250802,185,2025-08-02,19,597,706,1303,Eli197_T,"-37.81374643, 144.96276183"
135020250913,135,2025-09-13,0,56,56,112,Spen161_T,"-37.8172861, 144.95319102"
171020250225,17,2025-02-25,10,385,284,669,Col15_T,"-37.81362543, 144.97323591"
172220250414,17,2025-04-14,22,28,60,88,Col15_T,"-37.81362543, 144.97323591"
632220240724,63,2024-07-24,22,62,211,273,Bou231_T,"-37.81333081, 144.96675571"
631920241008,63,2024-10-08,19,129,222,351,Bou231_T,"-37.81333081, 144.96675571"
631520240318,63,2024-03-18,15,268,330,598,Bou231_T,"-37.81333081, 144.96675571"
622220240819,62,2024-08-19,22,120,42,162,Lat224_T,"-37.80996494, 144.96216521"
561620250304,56,2025-03-04,16,318,281,599,Lon364_T,"-37.81234775, 144.96153311"
112020250326,11,2025-03-26,20,155,154,309,WatCit_T,"-37.81564989, 144.93970694"
111320250621,11,2025-06-21,13,88,96,184,WatCit_T,"-37.81564989, 144.93970694"
22020241014,2,2024-10-14,20,98,141,239,Bou283_T,"-37.81380668, 144.96516718"
2220250510,2,2025-05-10,2,3,35,38,Bou283_T,"-37.81380668, 144.96516718"
27720240130,27,2024-01-30,7,37,35,72,Vic_T,"-37.80606888, 144.95644692"
30320240419,30,2024-04-19,3,28,99,127,Lon189_T,"-37.8112185, 144.96656806"
302020231026,30,2023-10-26,20,266,420,686,Lon189_T,"-37.8112185, 144.96656806"
251720240205,25,2024-02-05,17,771,372,1143,MCEC_T,"-37.82401776, 144.95604426"
201420241023,20,2024-10-23,14,138,227,365,LtB170_T,"-37.81172914, 144.9682466"
142920240512,142,2024-05-12,9,641,384,1025,Hammer1584_T,"-37.81970749, 144.96795734"
130620250125,130,2025-01-25,6,4,1,5,Bou892T,"-37.8204637, 144.94126826"
130520250912,130,2025-09-12,5,4,0,4,Bou892T,"-37.8204637, 144.94126826"
49120250608,49,2025-06-08,1,36,26,62,Eli501_T,"-37.80730068, 144.95956055"
1231720240415,123,2024-04-15,17,47,10,57,BirBridge_T,"-37.81753741, 144.97329734"
1412220250112,141,2025-01-12,22,48,144,192,474Fl_T,"-37.81997273, 144.95834911"
1411120250218,141,2025-02-18,11,141,89,230,474Fl_T,"-37.81997273, 144.95834911"
49420231227,49,2023-12-27,4,14,13,27,Eli501_T,"-37.80730068, 144.95956055"
48420240503,48,2024-05-03,4,9,1,10,QVMQ_T,"-37.80631581, 144.95866697"
1392120250905,139,2025-09-05,21,3,10,13,Signal1647_T,"-37.81959923, 144.9632832"
1342320241223,134,2024-12-23,23,137,108,245,Spen201_T,"-37.81694221, 144.95303935"
1341120250131,134,2025-01-31,11,291,365,656,Spen201_T,"-37.81694221, 144.95303935"
662020240102,66,2024-01-02,20,614,496,1110,QVN_T,"-37.81057846, 144.96444294"
662320240709,66,2024-07-09,23,101,62,163,QVN_T,"-37.81057846, 144.96444294"
66420240808,66,2024-08-08,4,17,11,28,QVN_T,"-37.81057846, 144.96444294"
661420241214,66,2024-12-14,14,1371,1328,2699,QVN_T,"-37.81057846, 144.96444294"
661220241216,66,2024-12-16,12,727,840,1567,QVN_T,"-37.81057846, 144.96444294"
841320240305,84,2024-03-05,13,1099,1336,2435,ElFi_T,"-37.81798049, 144.96503383"
661120240418,66,2024-04-18,11,641,721,1362,QVN_T,"-37.81057846, 144.96444294"
3820250124,3,2025-01-24,8,120,191,311,Swa295_T,"-37.81101524, 144.96429485"
1301920250929,130,2025-09-29,19,18,14,32,Bou892T,"-37.8204637, 144.94126826"
1301920240309,130,2024-03-09,19,6,7,13,Bou892T,"-37.8204637, 144.94126826"
1381220250316,138,2025-03-16,12,2,3,5,EntPark1671_T,"-37.81996544, 144.95981454"
1231720241115,123,2024-11-15,17,10,0,10,BirBridge_T,"-37.81753741, 144.97329734"
117620240104,117,2024-01-04,6,13,6,19,Fli114F_T,"-37.81629332, 144.97090877"
492220240407,49,2024-04-07,22,78,93,171,Eli501_T,"-37.80730068, 144.95956055"
691720240526,69,2024-05-26,17,82,65,147,FLDegC_T,"-37.81687226, 144.96559144"
61020250408,6,2025-04-08,10,632,540,1172,FliS_T,"-37.81911705, 144.96558255"
841520240111,84,2024-01-11,15,926,1450,2376,ElFi_T,"-37.81798049, 144.96503383"
842220240709,84,2024-07-09,22,218,310,528,ElFi_T,"-37.81798049, 144.96503383"
4420240424,4,2024-04-24,4,6,8,14,Swa123_T,"-37.81487988, 144.9660878"
391520250421,39,2025-04-21,15,35,47,82,AlfPl_T,"-37.81379749, 144.96995745"
77820231029,77,2023-10-29,8,82,63,145,HarEsP_T,"-37.81441438, 144.94433026"
78320240217,78,2024-02-17,3,0,1,1,HarEsB_T,"-37.81471642, 144.9446508"
591220240904,59,2024-09-04,12,737,542,1279,RMIT_T,"-37.80825648, 144.96304859"
29220241212,29,2024-12-12,2,2,19,21,AG_T,"-37.8199817, 144.96872865"
281220231109,28,2023-11-09,12,395,424,819,VAC_T,"-37.82129925, 144.96879309"
29020240425,29,2024-04-25,0,10,36,46,AG_T,"-37.8199817, 144.96872865"
711820240716,71,2024-07-16,18,25,21,46,WestWP_T,"-37.81235775, 144.97136962"
311920250729,31,2025-07-29,19,152,131,283,Lyg161_T,"-37.80169681, 144.96658911"
541120250522,54,2025-05-22,11,155,134,289,Swa607_T,"-37.804024, 144.96308399"
361720240120,36,2024-01-20,17,164,147,311,Que85_T,"-37.81652527, 144.96121062"
37620231219,37,2023-12-19,6,13,13,26,Lyg260_T,"-37.80107122, 144.96704554"
501920240501,50,2024-05-01,19,182,174,356,Lyg309_T,"-37.79808192, 144.96721013"
452220250219,45,2025-02-19,22,90,269,359,Swa148_T,"-37.81414075, 144.96609379"
1351320240913,135,2024-09-13,13,452,459,911,Spen161_T,"-37.8172861, 144.95319102"
1311820240704,131,2024-07-04,18,84,112,196,King2_T,"-37.82009057, 144.95758725"
1071820241118,107,2024-11-18,18,135,156,291,280Will_T,"-37.81246271, 144.95690188"
134520241003,134,2024-10-03,5,47,57,104,Spen201_T,"-37.81694221, 144.95303935"
179320250701,179,2025-07-01,3,1,1,2,Pow61_T,"-37.82392385, 144.96299677"
1671220240924,167,2024-09-24,12,18,42,60,Lat526_T,"-37.81304149, 144.95155955"
1621520250818,162,2025-08-18,15,262,337,599,Eli489_T,"-37.80740397, 144.95987909"
143320251013,143,2025-10-13,3,30,7,37,Spencer_T,"-37.821728, 144.95557015"
67620231230,67,2023-12-30,6,18,21,39,FLDegS_T,"-37.81688755, 144.96562569"
172220241201,17,2024-12-01,22,29,37,66,Col15_T,"-37.81362543, 144.97323591"
182220250205,18,2025-02-05,22,37,26,63,Col12_T,"-37.81344862, 144.97305353"
62620250930,62,2025-09-30,6,44,27,71,Lat224_T,"-37.80996494, 144.96216521"
56620240426,56,2024-04-26,6,29,36,65,Lon364_T,"-37.81234775, 144.96153311"
561120240908,56,2024-09-08,11,276,185,461,Lon364_T,"-37.81234775, 144.96153311"
862020250404,86,2025-04-04,20,38,72,110,574Qub_T,"-37.80309992, 144.94908064"
63620250525,63,2025-05-25,6,0,12,12,Bou231_T,"-37.81333081, 144.96675571"
24920250518,24,2025-05-18,9,407,304,711,Col620_T,"-37.81887963, 144.95449198"
76520240523,76,2024-05-23,5,1,4,5,KenMac_T,"-37.79453803, 144.93036194"
138820240125,138,2024-01-25,8,4,2,6,EntPark1671_T,"-37.81996544, 144.95981454"
1381620240317,138,2024-03-17,16,8,1,9,EntPark1671_T,"-37.81996544, 144.95981454"
1381020250418,138,2025-04-18,10,4,19,23,EntPark1671_T,"-37.81996544, 144.95981454"
138020231127,138,2023-11-27,0,1,0,1,EntPark1671_T,"-37.81996544, 144.95981454"
1091120250210,109,2025-02-10,11,90,90,180,LatWill_T,"-37.81193681, 144.95621105"
59320241207,59,2024-12-07,3,44,13,57,RMIT_T,"-37.80825648, 144.96304859"
28020240323,28,2024-03-23,0,56,69,125,VAC_T,"-37.82129925, 144.96879309"
281320251012,28,2025-10-12,13,727,879,1606,VAC_T,"-37.82129925, 144.96879309"
291920250826,29,2025-08-26,19,43,49,92,AG_T,"-37.8199817, 144.96872865"
542220241128,54,2024-11-28,22,63,102,165,Swa607_T,"-37.804024, 144.96308399"
362220250505,36,2025-05-05,22,24,19,43,Que85_T,"-37.81652527, 144.96121062"
372120231106,37,2023-11-06,21,71,87,158,Lyg260_T,"-37.80107122, 144.96704554"
471620250929,47,2025-09-29,16,1156,847,2003,Eli250_T,"-37.81258467, 144.9625775"
471020231110,47,2023-11-10,10,486,556,1042,Eli250_T,"-37.81258467, 144.9625775"
45320240718,45,2024-07-18,3,12,11,23,Swa148_T,"-37.81414075, 144.96609379"
452020250705,45,2025-07-05,20,430,958,1388,Swa148_T,"-37.81414075, 144.96609379"
452320231129,45,2023-11-29,23,85,202,287,Swa148_T,"-37.81414075, 144.96609379"
51620250705,5,2025-07-05,16,1605,1451,3056,PriNW_T,"-37.81874249, 144.96787656"
451320241102,45,2024-11-02,13,617,753,1370,Swa148_T,"-37.81414075, 144.96609379"
5020240401,5,2024-04-01,0,112,120,232,PriNW_T,"-37.81874249, 144.96787656"
212120250705,21,2025-07-05,21,365,572,937,Bourke155_T,"-37.81267313, 144.96788288"
1401020240805,140,2024-08-05,10,93,40,133,Boyd2837_T,"-37.82590962, 144.96185972"
132820250924,132,2025-09-24,8,106,109,215,King335_T,"-37.81267639, 144.95386444"
1321320250829,132,2025-08-29,13,155,137,292,King335_T,"-37.81267639, 144.95386444"
1351920250330,135,2025-03-30,19,235,258,493,Spen161_T,"-37.8172861, 144.95319102"
131520250201,131,2025-02-01,5,9,32,41,King2_T,"-37.82009057, 144.95758725"
1241820250804,124,2025-08-04,18,0,1,1,BirBridge_T,"-37.81757416, 144.97329934"
107520241119,107,2024-11-19,5,9,7,16,280Will_T,"-37.81246271, 144.95690188"
108220240107,108,2024-01-07,2,31,30,61,261Will_T,"-37.81295822, 144.95678789"
1081320250529,108,2025-05-29,13,663,586,1249,261Will_T,"-37.81295822, 144.95678789"
87720241111,87,2024-11-11,7,29,32,61,Errol23_T,"-37.80454949, 144.94921863"
111620241001,11,2024-10-01,16,86,110,196,WatCit_T,"-37.81564989, 144.93970694"
112220250506,11,2025-05-06,22,59,59,118,WatCit_T,"-37.81564989, 144.93970694"
10120241122,10,2024-11-22,1,0,2,2,BouHbr_T,"-37.81876474, 144.94710545"
122320240602,12,2024-06-02,23,22,31,53,NewQ_T,"-37.81457988, 144.94292398"
12720241031,12,2024-10-31,7,103,72,175,NewQ_T,"-37.81457988, 144.94292398"
122220241229,12,2024-12-29,22,163,154,317,NewQ_T,"-37.81457988, 144.94292398"
10520241012,10,2024-10-12,5,1,0,1,BouHbr_T,"-37.81876474, 144.94710545"
351920250215,35,2025-02-15,19,1351,1519,2870,SouthB_T,"-37.82018685, 144.96508508"
35120241103,35,2024-11-03,1,178,244,422,SouthB_T,"-37.82018685, 144.96508508"
351820241210,35,2024-12-10,18,1595,1425,3020,SouthB_T,"-37.82018685, 144.96508508"
761320231115,76,2023-11-15,13,69,69,138,KenMac_T,"-37.79453803, 144.93036194"
76520240316,76,2024-03-16,5,1,0,1,KenMac_T,"-37.79453803, 144.93036194"
9820240804,9,2024-08-04,8,24,34,58,Col700_T,"-37.81982992, 144.95102555"
271220250116,27,2025-01-16,12,192,194,386,Vic_T,"-37.80606888, 144.95644692"
23620241029,23,2024-10-29,6,102,70,172,Col623_T,"-37.81909256, 144.95452748"
23420241107,23,2024-11-07,4,1,4,5,Col623_T,"-37.81909256, 144.95452748"
19620240317,19,2024-03-17,6,16,10,26,LtB210_T,"-37.81237202, 144.96550671"
20320240106,20,2024-01-06,3,28,31,59,LtB170_T,"-37.81172914, 144.9682466"
180720250531,180,2025-05-31,7,16,12,28,Mac330_T,"-37.79497059, 144.93530329"
1421620250322,142,2025-03-22,16,752,1302,2054,Hammer1584_T,"-37.81970749, 144.96795734"
392120250812,39,2025-08-12,21,23,8,31,AlfPl_T,"-37.81379749, 144.96995745"
751320231201,75,2023-12-01,13,79,53,132,SprFli_T,"-37.81515276, 144.97467661"
8720250921,8,2025-09-21,7,34,67,101,WebBN_T,"-37.82293543, 144.9471751"
75620241023,75,2024-10-23,6,28,27,55,SprFli_T,"-37.81515276, 144.97467661"
81420250601,8,2025-06-01,14,189,400,589,WebBN_T,"-37.82293543, 144.9471751"
411420250610,41,2025-06-10,14,879,904,1783,Swa31,"-37.81668634, 144.96689733"
41920250324,41,2025-03-24,9,1325,573,1898,Swa31,"-37.81668634, 144.96689733"
77120240708,77,2024-07-08,1,4,3,7,HarEsP_T,"-37.81441438, 144.94433026"
77420250713,77,2025-07-13,4,5,4,9,HarEsP_T,"-37.81441438, 144.94433026"
592120240711,59,2024-07-11,21,134,108,242,RMIT_T,"-37.80825648, 144.96304859"
291120240531,29,2024-05-31,11,421,251,672,AG_T,"-37.8199817, 144.96872865"
29220240808,29,2024-08-08,2,0,6,6,AG_T,"-37.8199817, 144.96872865"
311620250812,31,2025-08-12,16,107,106,213,Lyg161_T,"-37.80169681, 144.96658911"
31220250821,31,2025-08-21,2,5,0,5,Lyg161_T,"-37.80169681, 144.96658911"
441420240522,44,2024-05-22,14,163,136,299,UM3_T,"-37.79698741, 144.96441306"
5620250803,5,2025-08-03,6,31,30,61,PriNW_T,"-37.81874249, 144.96787656"
45620241227,45,2024-12-27,6,22,51,73,Swa148_T,"-37.81414075, 144.96609379"
211820250721,21,2025-07-21,18,240,272,512,Bourke155_T,"-37.81267313, 144.96788288"
1332220240825,133,2024-08-25,22,165,144,309,Spen229_T,"-37.81531435, 144.95227769"
1322120250316,132,2025-03-16,21,72,85,157,King335_T,"-37.81267639, 144.95386444"
1242020250131,124,2025-01-31,20,4,2,6,BirBridge_T,"-37.81757416, 144.97329934"
50620250320,50,2025-03-20,6,4,10,14,Lyg309_T,"-37.79808192, 144.96721013"
70320231105,70,2023-11-05,3,0,4,4,Errol20_T,"-37.80456984, 144.94946228"
1651120250202,165,2025-02-02,11,18,33,51,Spen475_T,"-37.80953359, 144.94939004"
1401020250120,140,2025-01-20,10,94,29,123,Boyd2837_T,"-37.82590962, 144.96185972"
171320250729,17,2025-07-29,13,641,674,1315,Col15_T,"-37.81362543, 144.97323591"
631820240818,63,2024-08-18,18,275,304,579,Bou231_T,"-37.81333081, 144.96675571"
632120240920,63,2024-09-20,21,110,271,381,Bou231_T,"-37.81333081, 144.96675571"
632320241124,63,2024-11-24,23,8,57,65,Bou231_T,"-37.81333081, 144.96675571"
681820250605,68,2025-06-05,18,191,110,301,FLDegN_T,"-37.8168479, 144.96559789"
56420240114,56,2024-01-14,4,60,10,70,Lon364_T,"-37.81234775, 144.96153311"
11620250512,11,2025-05-12,6,18,16,34,WatCit_T,"-37.81564989, 144.93970694"
721920241119,72,2024-11-19,19,176,273,449,ACMI_T,"-37.81726338, 144.96872809"
721820240110,72,2024-01-10,18,162,421,583,ACMI_T,"-37.81726338, 144.96872809"
561420251004,56,2025-10-04,14,508,408,916,Lon364_T,"-37.81234775, 144.96153311"
351820250527,35,2025-05-27,18,528,338,866,SouthB_T,"-37.82018685, 144.96508508"
9520240816,9,2024-08-16,5,15,36,51,Col700_T,"-37.81982992, 144.95102555"
231120240314,23,2024-03-14,11,283,372,655,Col623_T,"-37.81909256, 144.95452748"
79720240412,79,2024-04-12,7,194,137,331,FliSS_T,"-37.81794046, 144.96616678"
52820231204,52,2023-12-04,8,138,284,422,Eli263_T,"-37.81252157, 144.9619401"
521720240926,52,2024-09-26,17,406,393,799,Eli263_T,"-37.81252157, 144.9619401"
521320240306,52,2024-03-06,13,438,379,817,Eli263_T,"-37.81252157, 144.9619401"
20920241030,20,2024-10-30,9,67,92,159,LtB170_T,"-37.81172914, 144.9682466"
161020250114,161,2025-01-14,0,1,102,103,BirArt1109_T,"-37.81851276, 144.97131336"
1171220240712,117,2024-07-12,12,183,162,345,Fli114F_T,"-37.81629332, 144.97090877"
17320240108,17,2024-01-08,3,5,1,6,Col15_T,"-37.81362543, 144.97323591"
17720240114,17,2024-01-14,7,24,18,42,Col15_T,"-37.81362543, 144.97323591"
172220250510,17,2025-05-10,22,61,90,151,Col15_T,"-37.81362543, 144.97323591"
681620250406,68,2025-04-06,16,282,234,516,FLDegN_T,"-37.8168479, 144.96559789"
63920231031,63,2023-10-31,9,153,165,318,Bou231_T,"-37.81333081, 144.96675571"
672220240713,67,2024-07-13,22,173,295,468,FLDegS_T,"-37.81688755, 144.96562569"
66220250215,66,2025-02-15,2,67,53,120,QVN_T,"-37.81057846, 144.96444294"
692320240126,69,2024-01-26,23,18,14,32,FLDegC_T,"-37.81687226, 144.96559144"
69620240331,69,2024-03-31,6,7,4,11,FLDegC_T,"-37.81687226, 144.96559144"
61320250113,6,2025-01-13,13,877,845,1722,FliS_T,"-37.81911705, 144.96558255"
41520240708,4,2024-07-08,15,1400,1445,2845,Swa123_T,"-37.81487988, 144.9660878"
42220241218,4,2024-12-18,22,976,979,1955,Swa123_T,"-37.81487988, 144.9660878"
3420240225,3,2024-02-25,4,129,86,215,Swa295_T,"-37.81101524, 144.96429485"
782320240828,78,2024-08-28,23,2,6,8,HarEsB_T,"-37.81471642, 144.9446508"
42520250506,42,2025-05-06,5,2,1,3,UM1_T,"-37.80008566, 144.96386412"
422120240628,42,2024-06-28,21,34,37,71,UM1_T,"-37.80008566, 144.96386412"
422320241010,42,2024-10-10,23,25,30,55,UM1_T,"-37.80008566, 144.96386412"
141120241120,14,2024-11-20,11,272,165,437,SanBri_T,"-37.82011242, 144.96291897"
402320250623,40,2025-06-23,23,6,5,11,Spr201_T,"-37.80999341, 144.97227587"
40020250719,40,2025-07-19,0,36,18,54,Spr201_T,"-37.80999341, 144.97227587"
312120250706,31,2025-07-06,21,151,187,338,Lyg161_T,"-37.80169681, 144.96658911"
47120240309,47,2024-03-09,1,135,138,273,Eli250_T,"-37.81258467, 144.9625775"
611420240406,61,2024-04-06,14,286,420,706,RMIT14_T,"-37.80767455, 144.96309114"
43520241229,43,2024-12-29,5,0,1,1,UM2_T,"-37.79844526, 144.96411782"
451420240227,45,2024-02-27,14,404,779,1183,Swa148_T,"-37.81414075, 144.96609379"
51520250706,5,2025-07-06,15,1342,1213,2555,PriNW_T,"-37.81874249, 144.96787656"
1321920250901,132,2025-09-01,19,112,135,247,King335_T,"-37.81267639, 144.95386444"
1072320250616,107,2025-06-16,23,17,14,31,280Will_T,"-37.81246271, 144.95690188"
133420250226,133,2025-02-26,4,9,18,27,Spen229_T,"-37.81531435, 144.95227769"
1071420241120,107,2024-11-20,14,152,158,310,280Will_T,"-37.81246271, 144.95690188"
1071320231117,107,2023-11-17,13,223,205,428,280Will_T,"-37.81246271, 144.95690188"
1842220250813,184,2025-08-13,22,119,205,324,Eli124_T,"-37.81512416, 144.96371988"
1791920250305,179,2025-03-05,19,78,98,176,Pow61_T,"-37.82392385, 144.96299677"
1671220240821,167,2024-08-21,12,26,146,172,Lat526_T,"-37.81304149, 144.95155955"
162020240908,162,2024-09-08,0,83,71,154,Eli489_T,"-37.80740397, 144.95987909"
851620240427,85,2024-04-27,16,101,76,177,488Mac_T,"-37.79432415, 144.92973378"
17520231112,17,2023-11-12,5,12,10,22,Col15_T,"-37.81362543, 144.97323591"
1720250115,1,2025-01-15,7,73,101,174,Bou292_T,"-37.81349441, 144.96515323"
631420240205,63,2024-02-05,14,290,309,599,Bou231_T,"-37.81333081, 144.96675571"
62720240330,62,2024-03-30,7,17,13,30,Lat224_T,"-37.80996494, 144.96216521"
862120240603,86,2024-06-03,21,10,29,39,574Qub_T,"-37.80309992, 144.94908064"
861620241013,86,2024-10-13,16,38,48,86,574Qub_T,"-37.80309992, 144.94908064"
111520240114,11,2024-01-14,15,167,141,308,WatCit_T,"-37.81564989, 144.93970694"
63420250403,63,2025-04-03,4,0,1,1,Bou231_T,"-37.81333081, 144.96675571"
1422020250126,142,2025-01-26,20,462,591,1053,Hammer1584_T,"-37.81970749, 144.96795734"
1611020241114,161,2024-11-14,10,98,79,177,BirArt1109_T,"-37.81851276, 144.97131336"
671920240615,67,2024-06-15,19,330,378,708,FLDegS_T,"-37.81688755, 144.96562569"
681220250101,68,2025-01-01,12,335,273,608,FLDegN_T,"-37.8168479, 144.96559789"
561920241210,56,2024-12-10,19,377,320,697,Lon364_T,"-37.81234775, 144.96153311"
111320240311,11,2024-03-11,13,61,44,105,WatCit_T,"-37.81564989, 144.93970694"
111720241227,11,2024-12-27,17,159,107,266,WatCit_T,"-37.81564989, 144.93970694"
122120240728,12,2024-07-28,21,42,38,80,NewQ_T,"-37.81457988, 144.94292398"
121920250330,12,2025-03-30,19,279,269,548,NewQ_T,"-37.81457988, 144.94292398"
92120240619,9,2024-06-19,21,72,42,114,Col700_T,"-37.81982992, 144.95102555"
46820250413,46,2025-04-13,8,11,7,18,Pel147_T,"-37.80240719, 144.9615673"
49320231215,49,2023-12-15,3,22,29,51,Eli501_T,"-37.80730068, 144.95956055"
481320241118,48,2024-11-18,13,218,152,370,QVMQ_T,"-37.80631581, 144.95866697"
1641720250713,164,2025-07-13,17,73,90,163,Lat526_T,"-37.813005, 144.95160411"
1371420250207,137,2025-02-07,14,26,72,98,BouHbr2353_T,"-37.81894815, 144.94612292"
136720250402,136,2025-04-02,7,89,100,189,BirFed1120_T,"-37.8184141, 144.97357915"
1421420250619,142,2025-06-19,14,314,242,556,Hammer1584_T,"-37.81970749, 144.96795734"
1301020240718,130,2024-07-18,10,28,12,40,Bou892T,"-37.8204637, 144.94126826"
1301220241219,130,2024-12-19,12,83,80,163,Bou892T,"-37.8204637, 144.94126826"
164020241002,164,2024-10-02,0,5,11,16,Lat526_T,"-37.813005, 144.95160411"
1381720251016,138,2025-10-16,17,9,10,19,EntPark1671_T,"-37.81996544, 144.95981454"
123620240219,123,2024-02-19,6,5,3,8,BirBridge_T,"-37.81753741, 144.97329734"
1231220240802,123,2024-08-02,12,9,5,14,BirBridge_T,"-37.81753741, 144.97329734"
1171320240426,117,2024-04-26,13,184,186,370,Fli114F_T,"-37.81629332, 144.97090877"
661220250914,66,2025-09-14,12,1073,1092,2165,QVN_T,"-37.81057846, 144.96444294"
69520231029,69,2023-10-29,5,2,0,2,FLDegC_T,"-37.81687226, 144.96559144"
69020250902,69,2025-09-02,0,1,2,3,FLDegC_T,"-37.81687226, 144.96559144"
841420240120,84,2024-01-20,14,1000,1494,2494,ElFi_T,"-37.81798049, 144.96503383"
66120240424,66,2024-04-24,1,25,10,35,QVN_T,"-37.81057846, 144.96444294"
392120241027,39,2024-10-27,21,5,1,6,AlfPl_T,"-37.81379749, 144.96995745"
752020250819,75,2025-08-19,20,2,10,12,SprFli_T,"-37.81515276, 144.97467661"
39620231122,39,2023-11-22,6,48,31,79,AlfPl_T,"-37.81379749, 144.96995745"
41220250831,41,2025-08-31,2,106,349,455,Swa31,"-37.81668634, 144.96689733"
42320250909,42,2025-09-09,3,1,0,1,UM1_T,"-37.80008566, 144.96386412"
651220240113,65,2024-01-13,12,662,687,1349,SwaCs_T,"-37.81569416, 144.9668064"
42920250623,42,2025-06-23,9,121,150,271,UM1_T,"-37.80008566, 144.96386412"
771720240916,77,2024-09-16,17,260,113,373,HarEsP_T,"-37.81441438, 144.94433026"
59920250326,59,2025-03-26,9,588,336,924,RMIT_T,"-37.80825648, 144.96304859"
281920250517,28,2025-05-17,19,451,518,969,VAC_T,"-37.82129925, 144.96879309"
61020240511,6,2024-05-11,10,655,398,1053,FliS_T,"-37.81911705, 144.96558255"
6920240617,6,2024-06-17,9,510,839,1349,FliS_T,"-37.81911705, 144.96558255"
841020241020,84,2024-10-20,10,627,509,1136,ElFi_T,"-37.81798049, 144.96503383"
84020250305,84,2025-03-05,0,50,57,107,ElFi_T,"-37.81798049, 144.96503383"
841720250411,84,2025-04-11,17,1317,1909,3226,ElFi_T,"-37.81798049, 144.96503383"
84620250413,84,2025-04-13,6,61,71,132,ElFi_T,"-37.81798049, 144.96503383"
6820250831,6,2025-08-31,8,175,137,312,FliS_T,"-37.81911705, 144.96558255"
3420231219,3,2023-12-19,4,20,26,46,Swa295_T,"-37.81101524, 144.96429485"
70620250415,70,2025-04-15,6,15,4,19,Errol20_T,"-37.80456984, 144.94946228"
75720250828,75,2025-08-28,7,35,32,67,SprFli_T,"-37.81515276, 144.97467661"
752120250109,75,2025-01-09,21,20,18,38,SprFli_T,"-37.81515276, 144.97467661"
421520240927,42,2024-09-27,15,85,83,168,UM1_T,"-37.80008566, 144.96386412"
42420240902,42,2024-09-02,4,0,3,3,UM1_T,"-37.80008566, 144.96386412"
14720240323,14,2024-03-23,7,103,49,152,SanBri_T,"-37.82011242, 144.96291897"
142220240607,14,2024-06-07,22,260,108,368,SanBri_T,"-37.82011242, 144.96291897"
14720240729,14,2024-07-29,7,142,128,270,SanBri_T,"-37.82011242, 144.96291897"
141020231221,14,2023-12-21,10,319,119,438,SanBri_T,"-37.82011242, 144.96291897"
591420250207,59,2025-02-07,14,203,210,413,RMIT_T,"-37.80825648, 144.96304859"
59220250301,59,2025-03-01,2,60,27,87,RMIT_T,"-37.80825648, 144.96304859"
59620240907,59,2024-09-07,6,43,37,80,RMIT_T,"-37.80825648, 144.96304859"
29120250504,29,2025-05-04,1,10,21,31,AG_T,"-37.8199817, 144.96872865"
291820250808,29,2025-08-08,18,182,270,452,AG_T,"-37.8199817, 144.96872865"
47320250430,47,2025-04-30,3,15,17,32,Eli250_T,"-37.81258467, 144.9625775"
5120240523,5,2024-05-23,1,9,22,31,PriNW_T,"-37.81874249, 144.96787656"
212220240929,21,2024-09-29,22,69,97,166,Bourke155_T,"-37.81267313, 144.96788288"
432220250309,43,2025-03-09,22,36,12,48,UM2_T,"-37.79844526, 144.96411782"
107420240413,107,2024-04-13,4,6,1,7,280Will_T,"-37.81246271, 144.95690188"
67920250717,67,2025-07-17,9,388,350,738,FLDegS_T,"-37.81688755, 144.96562569"
112220250626,11,2025-06-26,22,27,17,44,WatCit_T,"-37.81564989, 144.93970694"
621720250116,62,2025-01-16,17,295,260,555,Lat224_T,"-37.80996494, 144.96216521"
62920250227,62,2025-02-27,9,143,143,286,Lat224_T,"-37.80996494, 144.96216521"
1320250527,1,2025-05-27,3,8,5,13,Bou292_T,"-37.81349441, 144.96515323"
72620240802,72,2024-08-02,6,48,25,73,ACMI_T,"-37.81726338, 144.96872809"
72320250125,72,2025-01-25,3,6,22,28,ACMI_T,"-37.81726338, 144.96872809"
241220250603,24,2025-06-03,12,740,806,1546,Col620_T,"-37.81887963, 144.95449198"
10720250903,10,2025-09-03,7,30,108,138,BouHbr_T,"-37.81876474, 144.94710545"
761120250625,76,2025-06-25,11,40,44,84,KenMac_T,"-37.79453803, 144.93036194"
27520231216,27,2023-12-16,5,17,3,20,Vic_T,"-37.80606888, 144.95644692"
9320250122,9,2025-01-22,3,2,1,3,Col700_T,"-37.81982992, 144.95102555"
9520231118,9,2023-11-18,5,3,3,6,Col700_T,"-37.81982992, 144.95102555"
53220250323,53,2025-03-23,2,21,33,54,Col254_T,"-37.81564191, 144.965499"
23020250309,23,2025-03-09,0,34,43,77,Col623_T,"-37.81909256, 144.95452748"
49720231108,49,2023-11-08,7,59,60,119,Eli501_T,"-37.80730068, 144.95956055"
1091720240703,109,2024-07-03,17,496,233,729,LatWill_T,"-37.81193681, 144.95621105"
1091420241025,109,2024-10-25,14,188,128,316,LatWill_T,"-37.81193681, 144.95621105"
48920240119,48,2024-01-19,9,187,132,319,QVMQ_T,"-37.80631581, 144.95866697"
48020240514,48,2024-05-14,0,11,14,25,QVMQ_T,"-37.80631581, 144.95866697"
1391920231208,139,2023-12-08,19,84,75,159,Signal1647_T,"-37.81959923, 144.9632832"
136720250210,136,2025-02-10,7,65,108,173,BirFed1120_T,"-37.8184141, 144.97357915"
142820241029,142,2024-10-29,8,216,396,612,Hammer1584_T,"-37.81970749, 144.96795734"
37220241110,37,2024-11-10,2,2,15,17,Lyg260_T,"-37.80107122, 144.96704554"
471120250223,47,2025-02-23,11,605,616,1221,Eli250_T,"-37.81258467, 144.9625775"
471520240406,47,2024-04-06,15,1143,1303,2446,Eli250_T,"-37.81258467, 144.9625775"
43920250215,43,2025-02-15,9,22,9,31,UM2_T,"-37.79844526, 144.96411782"
44020241129,44,2024-11-29,0,1,0,1,UM3_T,"-37.79698741, 144.96441306"
451320240318,45,2024-03-18,13,533,846,1379,Swa148_T,"-37.81414075, 144.96609379"
361220250714,36,2025-07-14,12,321,291,612,Que85_T,"-37.81652527, 144.96121062"
1321020231105,132,2023-11-05,10,188,70,258,King335_T,"-37.81267639, 144.95386444"
132220240615,132,2024-06-15,2,30,15,45,King335_T,"-37.81267639, 144.95386444"
135320250829,135,2025-08-29,3,9,10,19,Spen161_T,"-37.8172861, 144.95319102"
1331220231201,133,2023-12-01,12,600,734,1334,Spen229_T,"-37.81531435, 144.95227769"
1331020240826,133,2024-08-26,10,396,370,766,Spen229_T,"-37.81531435, 144.95227769"
108520240903,108,2024-09-03,5,3,60,63,261Will_T,"-37.81295822, 144.95678789"
108320240402,108,2024-04-02,3,2,0,2,261Will_T,"-37.81295822, 144.95678789"
871220240225,87,2024-02-25,12,119,127,246,Errol23_T,"-37.80454949, 144.94921863"
171120240723,17,2024-07-23,11,382,289,671,Col15_T,"-37.81362543, 144.97323591"
632220240224,63,2024-02-24,22,268,486,754,Bou231_T,"-37.81333081, 144.96675571"
63320240909,63,2024-09-09,3,1,4,5,Bou231_T,"-37.81333081, 144.96675571"
681020250403,68,2025-04-03,10,291,252,543,FLDegN_T,"-37.8168479, 144.96559789"
62720240503,62,2024-05-03,7,43,44,87,Lat224_T,"-37.80996494, 144.96216521"
622220240701,62,2024-07-01,22,112,44,156,Lat224_T,"-37.80996494, 144.96216521"
86720250930,86,2025-09-30,7,23,13,36,574Qub_T,"-37.80309992, 144.94908064"
102120240928,10,2024-09-28,21,23,13,36,BouHbr_T,"-37.81876474, 144.94710545"
12520240304,12,2024-03-04,5,10,3,13,NewQ_T,"-37.81457988, 144.94292398"
581720250214,58,2025-02-14,17,788,770,1558,Bou688_T,"-37.81686075, 144.95358075"
761620240330,76,2024-03-30,16,45,47,92,KenMac_T,"-37.79453803, 144.93036194"
58720250927,58,2025-09-27,7,133,58,191,Bou688_T,"-37.81686075, 144.95358075"
91820231231,9,2023-12-31,18,266,549,815,Col700_T,"-37.81982992, 144.95102555"
531320241217,53,2024-12-17,13,1170,936,2106,Col254_T,"-37.81564191, 144.965499"
271420250214,27,2025-02-14,14,166,126,292,Vic_T,"-37.80606888, 144.95644692"
301520250531,30,2025-05-31,15,301,480,781,Lon189_T,"-37.8112185, 144.96656806"
791120240727,79,2024-07-27,11,553,453,1006,FliSS_T,"-37.81794046, 144.96616678"
19120231107,19,2023-11-07,1,85,88,173,LtB210_T,"-37.81237202, 144.96550671"
48920240310,48,2024-03-10,9,163,208,371,QVMQ_T,"-37.80631581, 144.95866697"
20920231108,20,2023-11-08,9,80,79,159,LtB170_T,"-37.81172914, 144.9682466"
137020241222,137,2024-12-22,0,0,2,2,BouHbr2353_T,"-37.81894815, 144.94612292"
136820241007,136,2024-10-07,8,99,134,233,BirFed1120_T,"-37.8184141, 144.97357915"
1392220241227,139,2024-12-27,22,29,30,59,Signal1647_T,"-37.81959923, 144.9632832"
1421720250210,142,2025-02-10,17,559,416,975,Hammer1584_T,"-37.81970749, 144.96795734"
1381320240307,138,2024-03-07,13,10,11,21,EntPark1671_T,"-37.81996544, 144.95981454"
1232020250108,123,2025-01-08,20,26,20,46,BirBridge_T,"-37.81753741, 144.97329734"
85420241111,85,2024-11-11,4,1,0,1,488Mac_T,"-37.79432415, 144.92973378"
63120240425,63,2024-04-25,1,42,104,146,Bou231_T,"-37.81333081, 144.96675571"
62520240127,62,2024-01-27,5,10,7,17,Lat224_T,"-37.80996494, 144.96216521"
56320250120,56,2025-01-20,3,6,6,12,Lon364_T,"-37.81234775, 144.96153311"
111120240728,11,2024-07-28,11,39,30,69,WatCit_T,"-37.81564989, 144.93970694"
76620240531,76,2024-05-31,6,17,13,30,KenMac_T,"-37.79453803, 144.93036194"
2220240414,2,2024-04-14,2,26,48,74,Bou283_T,"-37.81380668, 144.96516718"
22320231103,2,2023-11-03,23,41,117,158,Bou283_T,"-37.81380668, 144.96516718"
58020240411,58,2024-04-11,0,56,71,127,Bou688_T,"-37.81686075, 144.95358075"
58520231201,58,2023-12-01,5,59,20,79,Bou688_T,"-37.81686075, 144.95358075"
581820240130,58,2024-01-30,18,479,558,1037,Bou688_T,"-37.81686075, 144.95358075"
92020241111,9,2024-11-11,20,74,53,127,Col700_T,"-37.81982992, 144.95102555"
51320250722,51,2025-07-22,3,3,2,5,Fra118_T,"-37.80841815, 144.95906316"
46020240525,46,2024-05-25,0,14,7,21,Pel147_T,"-37.80240719, 144.9615673"
251020240513,25,2024-05-13,10,157,509,666,MCEC_T,"-37.82401776, 144.95604426"
252020240513,25,2024-05-13,20,166,203,369,MCEC_T,"-37.82401776, 144.95604426"
141220250124,141,2025-01-24,2,12,26,38,474Fl_T,"-37.81997273, 144.95834911"
1412320250907,141,2025-09-07,23,15,55,70,474Fl_T,"-37.81997273, 144.95834911"
139620241120,139,2024-11-20,6,12,24,36,Signal1647_T,"-37.81959923, 144.9632832"
1392020250113,139,2025-01-13,20,34,51,85,Signal1647_T,"-37.81959923, 144.9632832"
1301120241006,130,2024-10-06,11,25,9,34,Bou892T,"-37.8204637, 144.94126826"
117220231223,117,2023-12-23,2,6,13,19,Fli114F_T,"-37.81629332, 144.97090877"
1171220231223,117,2023-12-23,12,124,131,255,Fli114F_T,"-37.81629332, 144.97090877"
109620250228,109,2025-02-28,6,18,74,92,LatWill_T,"-37.81193681, 144.95621105"
1091620250313,109,2025-03-13,16,394,128,522,LatWill_T,"-37.81193681, 144.95621105"
69720241126,69,2024-11-26,7,110,39,149,FLDegC_T,"-37.81687226, 144.96559144"
701120231225,70,2023-12-25,11,84,78,162,Errol20_T,"-37.80456984, 144.94946228"
70720240401,70,2024-04-01,7,6,6,12,Errol20_T,"-37.80456984, 144.94946228"
751520240411,75,2024-04-11,15,50,70,120,SprFli_T,"-37.81515276, 144.97467661"
751220241028,75,2024-10-28,12,65,65,130,SprFli_T,"-37.81515276, 144.97467661"
751020250214,75,2025-02-14,10,39,25,64,SprFli_T,"-37.81515276, 144.97467661"
8620240428,8,2024-04-28,6,4,5,9,WebBN_T,"-37.82293543, 144.9471751"
411020250214,41,2025-02-14,10,1504,1019,2523,Swa31,"-37.81668634, 144.96689733"
421020241009,42,2024-10-09,10,276,211,487,UM1_T,"-37.80008566, 144.96386412"
781520250314,78,2025-03-14,15,54,101,155,HarEsB_T,"-37.81471642, 144.9446508"
65420240514,65,2024-05-14,4,1,8,9,SwaCs_T,"-37.81569416, 144.9668064"
711020250624,71,2025-06-24,10,14,27,41,WestWP_T,"-37.81235775, 144.97136962"
54120250511,54,2025-05-11,1,27,14,41,Swa607_T,"-37.804024, 144.96308399"
542320250905,54,2025-09-05,23,70,92,162,Swa607_T,"-37.804024, 144.96308399"
281120250928,28,2025-09-28,11,660,500,1160,VAC_T,"-37.82129925, 144.96879309"
282220250329,28,2025-03-29,22,301,366,667,VAC_T,"-37.82129925, 144.96879309"
471920241003,47,2024-10-03,19,833,626,1459,Eli250_T,"-37.81258467, 144.9625775"
47420251002,47,2025-10-02,4,9,20,29,Eli250_T,"-37.81258467, 144.9625775"
47120240412,47,2024-04-12,1,69,56,125,Eli250_T,"-37.81258467, 144.9625775"
47820240101,47,2024-01-01,8,77,144,221,Eli250_T,"-37.81258467, 144.9625775"
21220241105,21,2024-11-05,2,37,18,55,Bourke155_T,"-37.81267313, 144.96788288"
212320251001,21,2025-10-01,23,53,78,131,Bourke155_T,"-37.81267313, 144.96788288"
50420240913,50,2024-09-13,4,6,1,7,Lyg309_T,"-37.79808192, 144.96721013"
43820250708,43,2025-07-08,8,115,47,162,UM2_T,"-37.79844526, 144.96411782"
441020240127,44,2024-01-27,10,12,11,23,UM3_T,"-37.79698741, 144.96441306"
44220240305,44,2024-03-05,2,0,1,1,UM3_T,"-37.79698741, 144.96441306"
451320231113,45,2023-11-13,13,321,747,1068,Swa148_T,"-37.81414075, 144.96609379"
1352020240515,135,2024-05-15,20,113,124,237,Spen161_T,"-37.8172861, 144.95319102"
1331220240717,133,2024-07-17,12,520,471,991,Spen229_T,"-37.81531435, 144.95227769"
1332020250126,133,2025-01-26,20,444,323,767,Spen229_T,"-37.81531435, 144.95227769"
1081920231223,108,2023-12-23,19,123,148,271,261Will_T,"-37.81295822, 144.95678789"
1661220241003,166,2024-10-03,12,62,41,103,Spen484_T,"-37.80896733, 144.94931703"
66520240123,66,2024-01-23,5,10,18,28,QVN_T,"-37.81057846, 144.96444294"
66120241209,66,2024-12-09,1,50,64,114,QVN_T,"-37.81057846, 144.96444294"
61520240611,6,2024-06-11,15,758,442,1200,FliS_T,"-37.81911705, 144.96558255"
4420241112,4,2024-11-12,4,10,12,22,Swa123_T,"-37.81487988, 144.9660878"
751020250923,75,2025-09-23,10,32,35,67,SprFli_T,"-37.81515276, 144.97467661"
81820240507,8,2024-05-07,18,61,84,145,WebBN_T,"-37.82293543, 144.9471751"
391220231110,39,2023-11-10,12,264,178,442,AlfPl_T,"-37.81379749, 144.96995745"
75220240514,75,2024-05-14,2,2,0,2,SprFli_T,"-37.81515276, 144.97467661"
411620241202,41,2024-12-02,16,1320,1994,3314,Swa31,"-37.81668634, 144.96689733"
781920250908,78,2025-09-08,19,6,17,23,HarEsB_T,"-37.81471642, 144.9446508"
65420240721,65,2024-07-21,4,16,28,44,SwaCs_T,"-37.81569416, 144.9668064"
292220250820,29,2025-08-20,22,24,58,82,AG_T,"-37.8199817, 144.96872865"
401220241004,40,2024-10-04,12,222,273,495,Spr201_T,"-37.80999341, 144.97227587"
402020241217,40,2024-12-17,20,125,60,185,Spr201_T,"-37.80999341, 144.97227587"
40220240219,40,2024-02-19,2,2,0,2,Spr201_T,"-37.80999341, 144.97227587"
36320241009,36,2024-10-09,3,1,3,4,Que85_T,"-37.81652527, 144.96121062"
361520250604,36,2025-06-04,15,153,134,287,Que85_T,"-37.81652527, 144.96121062"
36320240501,36,2024-05-01,3,8,2,10,Que85_T,"-37.81652527, 144.96121062"
451120240915,45,2024-09-15,11,644,410,1054,Swa148_T,"-37.81414075, 144.96609379"
134320250520,134,2025-05-20,3,15,15,30,Spen201_T,"-37.81694221, 144.95303935"
85720250621,85,2025-06-21,7,21,22,43,488Mac_T,"-37.79432415, 144.92973378"
181020231115,18,2023-11-15,10,260,286,546,Col12_T,"-37.81344862, 144.97305353"
67120250319,67,2025-03-19,1,3,17,20,FLDegS_T,"-37.81688755, 144.96562569"
56620250226,56,2025-02-26,6,28,26,54,Lon364_T,"-37.81234775, 144.96153311"
12120250904,12,2025-09-04,1,0,2,2,NewQ_T,"-37.81457988, 144.94292398"
24220240526,24,2024-05-26,2,56,96,152,Col620_T,"-37.81887963, 144.95449198"
721720240420,72,2024-04-20,17,433,835,1268,ACMI_T,"-37.81726338, 144.96872809"
58320240302,58,2024-03-02,3,10,48,58,Bou688_T,"-37.81686075, 144.95358075"
761320241208,76,2024-12-08,13,41,40,81,KenMac_T,"-37.79453803, 144.93036194"
9520231222,9,2023-12-22,5,14,16,30,Col700_T,"-37.81982992, 144.95102555"
91820250226,9,2025-02-26,18,793,126,919,Col700_T,"-37.81982992, 144.95102555"
27720250719,27,2025-07-19,7,27,38,65,Vic_T,"-37.80606888, 144.95644692"
23220241001,23,2024-10-01,2,7,5,12,Col623_T,"-37.81909256, 144.95452748"
25820231119,25,2023-11-19,8,157,271,428,MCEC_T,"-37.82401776, 144.95604426"
481720250905,48,2025-09-05,17,161,163,324,QVMQ_T,"-37.80631581, 144.95866697"
1342220231025,134,2023-10-25,22,77,107,184,Spen201_T,"-37.81694221, 144.95303935"
1342120240211,134,2024-02-11,21,296,265,561,Spen201_T,"-37.81694221, 144.95303935"
1332320250620,133,2025-06-20,23,155,77,232,Spen229_T,"-37.81531435, 144.95227769"
1331620250113,133,2025-01-13,16,615,772,1387,Spen229_T,"-37.81531435, 144.95227769"
1182120240914,118,2024-09-14,21,8,4,12,Fli114C_T,"-37.81632783, 144.97090512"
1241620250406,124,2025-04-06,16,1,2,3,BirBridge_T,"-37.81757416, 144.97329934"
1071820240430,107,2024-04-30,18,102,110,212,280Will_T,"-37.81246271, 144.95690188"
118520240920,118,2024-09-20,5,0,1,1,Fli114C_T,"-37.81632783, 144.97090512"
108020240702,108,2024-07-02,0,2,23,25,261Will_T,"-37.81295822, 144.95678789"
1661720250909,166,2025-09-09,17,95,71,166,Spen484_T,"-37.80896733, 144.94931703"
1311320250304,131,2025-03-04,13,182,178,360,King2_T,"-37.82009057, 144.95758725"
1821320250730,182,2025-07-30,13,323,400,723,King163_T,"-37.81627451, 144.95550503"
1431420241008,143,2024-10-08,14,123,193,316,Spencer_T,"-37.821728, 144.95557015"
132920250217,132,2025-02-17,9,90,76,166,King335_T,"-37.81267639, 144.95386444"
132120231210,132,2023-12-10,1,39,31,70,King335_T,"-37.81267639, 144.95386444"
68820250707,68,2025-07-07,8,178,154,332,FLDegN_T,"-37.8168479, 144.96559789"
621220250918,62,2025-09-18,12,334,278,612,Lat224_T,"-37.80996494, 144.96216521"
671120250215,67,2025-02-15,11,464,537,1001,FLDegS_T,"-37.81688755, 144.96562569"
68820240912,68,2024-09-12,8,132,79,211,FLDegN_T,"-37.8168479, 144.96559789"
62520241128,62,2024-11-28,5,10,9,19,Lat224_T,"-37.80996494, 144.96216521"
561420231213,56,2023-12-13,14,227,273,500,Lon364_T,"-37.81234775, 144.96153311"
56420240124,56,2024-01-24,4,1,2,3,Lon364_T,"-37.81234775, 144.96153311"
862320231115,86,2023-11-15,23,2,13,15,574Qub_T,"-37.80309992, 144.94908064"
24820240221,24,2024-02-21,8,2112,299,2411,Col620_T,"-37.81887963, 144.95449198"
24620250313,24,2025-03-13,6,447,183,630,Col620_T,"-37.81887963, 144.95449198"
10820250526,10,2025-05-26,8,64,156,220,BouHbr_T,"-37.81876474, 144.94710545"
79620251004,79,2025-10-04,6,52,40,92,FliSS_T,"-37.81794046, 144.96616678"
51320241205,51,2024-12-05,3,6,5,11,Fra118_T,"-37.80841815, 144.95906316"
46920240905,46,2024-09-05,9,138,50,188,Pel147_T,"-37.80240719, 144.9615673"
521320250916,52,2025-09-16,13,399,349,748,Eli263_T,"-37.81252157, 144.9619401"
511720231024,51,2023-10-24,17,72,110,182,Fra118_T,"-37.80841815, 144.95906316"
23820240628,23,2024-06-28,8,811,320,1131,Col623_T,"-37.81909256, 144.95452748"
19420240127,19,2024-01-27,4,8,28,36,LtB210_T,"-37.81237202, 144.96550671"
251320251007,25,2025-10-07,13,711,855,1566,MCEC_T,"-37.82401776, 144.95604426"
25020240514,25,2024-05-14,0,14,21,35,MCEC_T,"-37.82401776, 144.95604426"
25520250613,25,2025-06-13,5,12,18,30,MCEC_T,"-37.82401776, 144.95604426"
1391920250708,139,2025-07-08,19,15,13,28,Signal1647_T,"-37.81959923, 144.9632832"
1361820240424,136,2024-04-24,18,1721,2,1723,BirFed1120_T,"-37.8184141, 144.97357915"
142420240325,142,2024-03-25,4,4,2,6,Hammer1584_T,"-37.81970749, 144.96795734"
1422120241110,142,2024-11-10,21,15,3,18,Hammer1584_T,"-37.81970749, 144.96795734"
1421420250213,142,2025-02-13,14,161,163,324,Hammer1584_T,"-37.81970749, 144.96795734"
1301620240426,130,2024-04-26,16,13,24,37,Bou892T,"-37.8204637, 144.94126826"
1381420240113,138,2024-01-13,14,4,2,6,EntPark1671_T,"-37.81996544, 144.95981454"
117220240627,117,2024-06-27,2,10,2,12,Fli114F_T,"-37.81629332, 144.97090877"
661120241003,66,2024-10-03,11,882,1058,1940,QVN_T,"-37.81057846, 144.96444294"
691620250819,69,2025-08-19,16,118,193,311,FLDegC_T,"-37.81687226, 144.96559144"
842120241026,84,2024-10-26,21,897,976,1873,ElFi_T,"-37.81798049, 144.96503383"
661420240204,66,2024-02-04,14,792,899,1691,QVN_T,"-37.81057846, 144.96444294"
3420240906,3,2024-09-06,4,41,34,75,Swa295_T,"-37.81101524, 144.96429485"
701320241205,70,2024-12-05,13,141,147,288,Errol20_T,"-37.80456984, 144.94946228"
751920241006,75,2024-10-06,19,17,25,42,SprFli_T,"-37.81515276, 144.97467661"
78120240414,78,2024-04-14,1,2,4,6,HarEsB_T,"-37.81471642, 144.9446508"
772120250524,77,2025-05-24,21,109,70,179,HarEsP_T,"-37.81441438, 144.94433026"
1421920231111,142,2023-11-11,19,765,609,1374,Hammer1584_T,"-37.81970749, 144.96795734"
117620250422,117,2025-04-22,6,22,20,42,Fli114F_T,"-37.81629332, 144.97090877"
1231120241227,123,2024-12-27,11,69,26,95,BirBridge_T,"-37.81753741, 144.97329734"
118120240124,118,2024-01-24,1,16,0,16,Fli114C_T,"-37.81632783, 144.97090512"
1081120250308,108,2025-03-08,11,136,146,282,261Will_T,"-37.81295822, 144.95678789"
872020240430,87,2024-04-30,20,46,36,82,Errol23_T,"-37.80454949, 144.94921863"
611720231224,61,2023-12-24,17,216,274,490,RMIT14_T,"-37.80767455, 144.96309114"
1621020241029,162,2024-10-29,10,446,374,820,Eli489_T,"-37.80740397, 144.95987909"
1672220241214,167,2024-12-14,22,10,24,34,Lat526_T,"-37.81304149, 144.95155955"
140820250712,140,2025-07-12,8,67,17,84,Boyd2837_T,"-37.82590962, 144.96185972"
1432020250723,143,2025-07-23,20,95,110,205,Spencer_T,"-37.821728, 144.95557015"
143620240507,143,2024-05-07,6,57,162,219,Spencer_T,"-37.821728, 144.95557015"
143020250103,143,2025-01-03,0,69,30,99,Spencer_T,"-37.821728, 144.95557015"
672320240913,67,2024-09-13,23,84,194,278,FLDegS_T,"-37.81688755, 144.96562569"
18120240417,18,2024-04-17,1,0,1,1,Col12_T,"-37.81344862, 144.97305353"
631720250410,63,2025-04-10,17,585,603,1188,Bou231_T,"-37.81333081, 144.96675571"
11720240911,11,2024-09-11,7,54,53,107,WatCit_T,"-37.81564989, 144.93970694"
67020240111,67,2024-01-11,0,4,17,21,FLDegS_T,"-37.81688755, 144.96562569"
62220241230,62,2024-12-30,2,9,10,19,Lat224_T,"-37.80996494, 144.96216521"
12820240128,12,2024-01-28,8,73,91,164,NewQ_T,"-37.81457988, 144.94292398"
24020250420,24,2025-04-20,0,115,156,271,Col620_T,"-37.81887963, 144.95449198"
22120231030,2,2023-10-30,21,53,104,157,Bou283_T,"-37.81380668, 144.96516718"
23220241104,23,2024-11-04,2,3,5,8,Col623_T,"-37.81909256, 144.95452748"
512020241001,51,2024-10-01,20,45,56,101,Fra118_T,"-37.80841815, 144.95906316"
521620241013,52,2024-10-13,16,304,266,570,Eli263_T,"-37.81252157, 144.9619401"
521120250609,52,2025-06-09,11,197,167,364,Eli263_T,"-37.81252157, 144.9619401"
461620231217,46,2023-12-17,16,44,30,74,Pel147_T,"-37.80240719, 144.9615673"
1171620231223,117,2023-12-23,16,198,243,441,Fli114F_T,"-37.81629332, 144.97090877"
117320240911,117,2024-09-11,3,3,2,5,Fli114F_T,"-37.81629332, 144.97090877"
492220250104,49,2025-01-04,22,106,102,208,Eli501_T,"-37.80730068, 144.95956055"
191220240314,19,2024-03-14,12,503,524,1027,LtB210_T,"-37.81237202, 144.96550671"
251220241206,25,2024-12-06,12,403,798,1201,MCEC_T,"-37.82401776, 144.95604426"
1411520240920,141,2024-09-20,15,138,112,250,474Fl_T,"-37.81997273, 144.95834911"
130120250504,130,2025-05-04,1,1,0,1,Bou892T,"-37.8204637, 144.94126826"
1231620231028,123,2023-10-28,16,49,27,76,BirBridge_T,"-37.81753741, 144.97329734"
691120250519,69,2025-05-19,11,277,219,496,FLDegC_T,"-37.81687226, 144.96559144"
661720240226,66,2024-02-26,17,1551,1518,3069,QVN_T,"-37.81057846, 144.96444294"
4520240913,4,2024-09-13,5,25,19,44,Swa123_T,"-37.81487988, 144.9660878"
751520250807,75,2025-08-07,15,50,66,116,SprFli_T,"-37.81515276, 144.97467661"
8820250623,8,2025-06-23,8,247,165,412,WebBN_T,"-37.82293543, 144.9471751"
651720240728,65,2024-07-28,17,963,612,1575,SwaCs_T,"-37.81569416, 144.9668064"
141920250511,14,2025-05-11,19,292,134,426,SanBri_T,"-37.82011242, 144.96291897"
31320240322,31,2024-03-22,3,5,3,8,Lyg161_T,"-37.80169681, 144.96658911"
471920250520,47,2025-05-20,19,612,588,1200,Eli250_T,"-37.81258467, 144.9625775"
21520250529,21,2025-05-29,5,6,6,12,Bourke155_T,"-37.81267313, 144.96788288"
361620250810,36,2025-08-10,16,75,70,145,Que85_T,"-37.81652527, 144.96121062"
1331520240106,133,2024-01-06,15,438,450,888,Spen229_T,"-37.81531435, 144.95227769"
118820241125,118,2024-11-25,8,25,10,35,Fli114C_T,"-37.81632783, 144.97090512"
87520250721,87,2025-07-21,5,3,3,6,Errol23_T,"-37.80454949, 144.94921863"
108620240229,108,2024-02-29,6,42,303,345,261Will_T,"-37.81295822, 144.95678789"
872320241225,87,2024-12-25,23,14,12,26,Errol23_T,"-37.80454949, 144.94921863"
1661120250208,166,2025-02-08,11,65,69,134,Spen484_T,"-37.80896733, 144.94931703"
1621120250220,162,2025-02-20,11,428,580,1008,Eli489_T,"-37.80740397, 144.95987909"
1431320250621,143,2025-06-21,13,163,350,513,Spencer_T,"-37.821728, 144.95557015"
851720240317,85,2024-03-17,17,49,53,102,488Mac_T,"-37.79432415, 144.92973378"
852120240620,85,2024-06-20,21,15,18,33,488Mac_T,"-37.79432415, 144.92973378"
85020241105,85,2024-11-05,0,0,6,6,488Mac_T,"-37.79432415, 144.92973378"
17520231119,17,2023-11-19,5,6,3,9,Col15_T,"-37.81362543, 144.97323591"
171920240422,17,2024-04-22,19,95,111,206,Col15_T,"-37.81362543, 144.97323591"
56420241229,56,2024-12-29,4,48,18,66,Lon364_T,"-37.81234775, 144.96153311"
121120240503,12,2024-05-03,11,122,151,273,NewQ_T,"-37.81457988, 144.94292398"
111920241003,11,2024-10-03,19,172,122,294,WatCit_T,"-37.81564989, 144.93970694"
761420250524,76,2025-05-24,14,63,80,143,KenMac_T,"-37.79453803, 144.93036194"
352320241205,35,2024-12-05,23,518,641,1159,SouthB_T,"-37.82018685, 144.96508508"
581420240124,58,2024-01-24,14,512,418,930,Bou688_T,"-37.81686075, 144.95358075"
91420250516,9,2025-05-16,14,541,216,757,Col700_T,"-37.81982992, 144.95102555"
512220240311,51,2024-03-11,22,39,23,62,Fra118_T,"-37.80841815, 144.95906316"
192220241103,19,2024-11-03,22,197,342,539,LtB210_T,"-37.81237202, 144.96550671"
492020250519,49,2025-05-19,20,206,134,340,Eli501_T,"-37.80730068, 144.95956055"
49420250905,49,2025-09-05,4,9,12,21,Eli501_T,"-37.80730068, 144.95956055"
137920240818,137,2024-08-18,9,8,7,15,BouHbr2353_T,"-37.81894815, 144.94612292"
136720240531,136,2024-05-31,7,82,53,135,BirFed1120_T,"-37.8184141, 144.97357915"
1381120240801,138,2024-08-01,11,2,2,4,EntPark1671_T,"-37.81996544, 144.95981454"
138820250713,138,2025-07-13,8,2,4,6,EntPark1671_T,"-37.81996544, 144.95981454"
1172320231221,117,2023-12-21,23,236,93,329,Fli114F_T,"-37.81629332, 144.97090877"
117520240716,117,2024-07-16,5,4,5,9,Fli114F_T,"-37.81629332, 144.97090877"
702020231108,70,2023-11-08,20,102,130,232,Errol20_T,"-37.80456984, 144.94946228"
701920240605,70,2024-06-05,19,118,206,324,Errol20_T,"-37.80456984, 144.94946228"
391720241118,39,2024-11-18,17,163,75,238,AlfPl_T,"-37.81379749, 144.96995745"
751020240129,75,2024-01-29,10,32,39,71,SprFli_T,"-37.81515276, 144.97467661"
751220241021,75,2024-10-21,12,75,63,138,SprFli_T,"-37.81515276, 144.97467661"
130720240215,130,2024-02-15,7,3,3,6,Bou892T,"-37.8204637, 144.94126826"
1611120240826,161,2024-08-26,11,107,78,185,BirArt1109_T,"-37.81851276, 144.97131336"
1232120250107,123,2025-01-07,21,5,8,13,BirBridge_T,"-37.81753741, 144.97329734"
117720250112,117,2025-01-12,7,34,35,69,Fli114F_T,"-37.81629332, 144.97090877"
691520240630,69,2024-06-30,15,204,181,385,FLDegC_T,"-37.81687226, 144.96559144"
66620240609,66,2024-06-09,6,14,30,44,QVN_T,"-37.81057846, 144.96444294"
701620250118,70,2025-01-18,16,103,110,213,Errol20_T,"-37.80456984, 144.94946228"
751320240605,75,2024-06-05,13,65,67,132,SprFli_T,"-37.81515276, 144.97467661"
751920240730,75,2024-07-30,19,9,28,37,SprFli_T,"-37.81515276, 144.97467661"
82120241025,8,2024-10-25,21,76,49,125,WebBN_T,"-37.82293543, 144.9471751"
39520240413,39,2024-04-13,5,9,9,18,AlfPl_T,"-37.81379749, 144.96995745"
8220250418,8,2025-04-18,2,1,0,1,WebBN_T,"-37.82293543, 144.9471751"
14720250201,14,2025-02-01,7,62,40,102,SanBri_T,"-37.82011242, 144.96291897"
142320231024,14,2023-10-24,23,95,25,120,SanBri_T,"-37.82011242, 144.96291897"
71520231209,71,2023-12-09,5,6,3,9,WestWP_T,"-37.81235775, 144.97136962"
71120231024,71,2023-10-24,1,4,0,4,WestWP_T,"-37.81235775, 144.97136962"
591120240406,59,2024-04-06,11,282,425,707,RMIT_T,"-37.80825648, 144.96304859"
281320240625,28,2024-06-25,13,571,563,1134,VAC_T,"-37.82129925, 144.96879309"
28920231119,28,2023-11-19,9,194,220,414,VAC_T,"-37.82129925, 144.96879309"
40420250412,40,2025-04-12,4,2,1,3,Spr201_T,"-37.80999341, 144.97227587"
311420250525,31,2025-05-25,14,241,222,463,Lyg161_T,"-37.80169681, 144.96658911"
471620240612,47,2024-06-12,16,913,670,1583,Eli250_T,"-37.81258467, 144.9625775"
43220240814,43,2024-08-14,2,0,1,1,UM2_T,"-37.79844526, 144.96411782"
44220240408,44,2024-04-08,2,0,2,2,UM3_T,"-37.79698741, 144.96441306"
5120240626,5,2024-06-26,1,10,12,22,PriNW_T,"-37.81874249, 144.96787656"
1322020240620,132,2024-06-20,20,97,72,169,King335_T,"-37.81267639, 144.95386444"
135520250322,135,2025-03-22,5,41,19,60,Spen161_T,"-37.8172861, 144.95319102"
131920240926,131,2024-09-26,9,70,117,187,King2_T,"-37.82009057, 144.95758725"
131520250410,131,2025-04-10,5,3,8,11,King2_T,"-37.82009057, 144.95758725"
1311420250430,131,2025-04-30,14,139,90,229,King2_T,"-37.82009057, 144.95758725"
1071120250920,107,2025-09-20,11,132,154,286,280Will_T,"-37.81246271, 144.95690188"
1332020240213,133,2024-02-13,20,451,374,825,Spen229_T,"-37.81531435, 144.95227769"
1331620250329,133,2025-03-29,16,614,549,1163,Spen229_T,"-37.81531435, 144.95227769"
1081020250621,108,2025-06-21,10,131,125,256,261Will_T,"-37.81295822, 144.95678789"
1181220240306,118,2024-03-06,12,15,12,27,Fli114C_T,"-37.81632783, 144.97090512"
87420250531,87,2025-05-31,4,0,1,1,Errol23_T,"-37.80454949, 144.94921863"
165820241106,165,2024-11-06,8,24,58,82,Spen475_T,"-37.80953359, 144.94939004"
141820240909,141,2024-09-09,8,117,158,275,474Fl_T,"-37.81997273, 144.95834911"
1362020240211,136,2024-02-11,20,12,18,30,BirFed1120_T,"-37.8184141, 144.97357915"
1362020240616,136,2024-06-16,20,1,0,1,BirFed1120_T,"-37.8184141, 144.97357915"
1391020240530,139,2024-05-30,10,19,38,57,Signal1647_T,"-37.81959923, 144.9632832"
1301120241014,130,2024-10-14,11,51,43,94,Bou892T,"-37.8204637, 144.94126826"
1232020240125,123,2024-01-25,20,16,14,30,BirBridge_T,"-37.81753741, 144.97329734"
109120240907,109,2024-09-07,1,14,33,47,LatWill_T,"-37.81193681, 144.95621105"
671420231110,67,2023-11-10,14,333,486,819,FLDegS_T,"-37.81688755, 144.96562569"
85420250731,85,2025-07-31,4,2,0,2,488Mac_T,"-37.79432415, 144.92973378"
85020250804,85,2025-08-04,0,1,0,1,488Mac_T,"-37.79432415, 144.92973378"
592120250830,59,2025-08-30,21,350,290,640,RMIT_T,"-37.80825648, 144.96304859"
282220240605,28,2024-06-05,22,71,66,137,VAC_T,"-37.82129925, 144.96879309"
142220231022,14,2023-10-22,22,132,46,178,SanBri_T,"-37.82011242, 144.96291897"
311720241124,31,2024-11-24,17,211,155,366,Lyg161_T,"-37.80169681, 144.96658911"
401820240903,40,2024-09-03,18,117,131,248,Spr201_T,"-37.80999341, 144.97227587"
502220250821,50,2025-08-21,22,123,28,151,Lyg309_T,"-37.79808192, 144.96721013"
431620250407,43,2025-04-07,16,268,368,636,UM2_T,"-37.79844526, 144.96411782"
1072220250312,107,2025-03-12,22,76,46,122,280Will_T,"-37.81246271, 144.95690188"
107820250720,107,2025-07-20,8,27,38,65,280Will_T,"-37.81246271, 144.95690188"
133720250412,133,2025-04-12,7,143,240,383,Spen229_T,"-37.81531435, 144.95227769"
1081120240419,108,2024-04-19,11,110,261,371,261Will_T,"-37.81295822, 144.95678789"
871120240116,87,2024-01-16,11,78,65,143,Errol23_T,"-37.80454949, 144.94921863"
87220240323,87,2024-03-23,2,1,2,3,Errol23_T,"-37.80454949, 144.94921863"
1661920250712,166,2025-07-12,19,18,35,53,Spen484_T,"-37.80896733, 144.94931703"
1401520250318,140,2025-03-18,15,90,122,212,Boyd2837_T,"-37.82590962, 144.96185972"
131920241030,131,2024-10-30,9,104,89,193,King2_T,"-37.82009057, 144.95758725"
1621920240930,162,2024-09-30,19,138,118,256,Eli489_T,"-37.80740397, 144.95987909"
1431620250606,143,2025-06-06,16,186,237,423,Spencer_T,"-37.821728, 144.95557015"
143920250822,143,2025-08-22,9,105,223,328,Spencer_T,"-37.821728, 144.95557015"
1432020241223,143,2024-12-23,20,136,292,428,Spencer_T,"-37.821728, 144.95557015"
181220250217,18,2025-02-17,12,300,255,555,Col12_T,"-37.81344862, 144.97305353"
631020250803,63,2025-08-03,10,151,273,424,Bou231_T,"-37.81333081, 144.96675571"
11420241220,1,2024-12-20,14,1454,1423,2877,Bou292_T,"-37.81349441, 144.96515323"
622320240314,62,2024-03-14,23,114,72,186,Lat224_T,"-37.80996494, 144.96216521"
621920241215,62,2024-12-15,19,155,163,318,Lat224_T,"-37.80996494, 144.96216521"
561220240206,56,2024-02-06,12,400,313,713,Lon364_T,"-37.81234775, 144.96153311"
12720250219,12,2025-02-19,7,115,75,190,NewQ_T,"-37.81457988, 144.94292398"
12720250325,12,2025-03-25,7,118,90,208,NewQ_T,"-37.81457988, 144.94292398"
861020250604,86,2025-06-04,10,48,31,79,574Qub_T,"-37.80309992, 144.94908064"
681620250414,68,2025-04-14,16,235,224,459,FLDegN_T,"-37.8168479, 144.96559789"
56520250908,56,2025-09-08,5,10,5,15,Lon364_T,"-37.81234775, 144.96153311"
72820240116,72,2024-01-16,8,702,142,844,ACMI_T,"-37.81726338, 144.96872809"
56920251001,56,2025-10-01,9,151,122,273,Lon364_T,"-37.81234775, 144.96153311"
91120240323,9,2024-03-23,11,147,141,288,Col700_T,"-37.81982992, 144.95102555"
30520231206,30,2023-12-06,5,10,12,22,Lon189_T,"-37.8112185, 144.96656806"
791920240106,79,2024-01-06,19,486,400,886,FliSS_T,"-37.81794046, 144.96616678"
231020251006,23,2025-10-06,10,193,215,408,Col623_T,"-37.81909256, 144.95452748"
521620250114,52,2025-01-14,16,262,204,466,Eli263_T,"-37.81252157, 144.9619401"
522220250725,52,2025-07-25,22,214,211,425,Eli263_T,"-37.81252157, 144.9619401"
52520231127,52,2023-11-27,5,5,12,17,Eli263_T,"-37.81252157, 144.9619401"
1091520240807,109,2024-08-07,15,295,177,472,LatWill_T,"-37.81193681, 144.95621105"
192220250802,19,2025-08-02,22,414,587,1001,LtB210_T,"-37.81237202, 144.96550671"
25320250204,25,2025-02-04,3,5,4,9,MCEC_T,"-37.82401776, 144.95604426"
481420231107,48,2023-11-07,14,149,120,269,QVMQ_T,"-37.80631581, 144.95866697"
164020250821,164,2025-08-21,0,7,15,22,Lat526_T,"-37.813005, 144.95160411"
137220250810,137,2025-08-10,2,0,1,1,BouHbr2353_T,"-37.81894815, 144.94612292"
141220240316,141,2024-03-16,2,52,46,98,474Fl_T,"-37.81997273, 144.95834911"
1411520240317,141,2024-03-17,15,271,106,377,474Fl_T,"-37.81997273, 144.95834911"
1391920240223,139,2024-02-23,19,72,45,117,Signal1647_T,"-37.81959923, 144.9632832"
1361220240827,136,2024-08-27,12,107,73,180,BirFed1120_T,"-37.8184141, 144.97357915"
661720250225,66,2025-02-25,17,1518,1750,3268,QVN_T,"-37.81057846, 144.96444294"
84920240609,84,2024-06-09,9,387,316,703,ElFi_T,"-37.81798049, 144.96503383"
842220250407,84,2025-04-07,22,240,345,585,ElFi_T,"-37.81798049, 144.96503383"
61120250817,6,2025-08-17,11,709,539,1248,FliS_T,"-37.81911705, 144.96558255"
75620250911,75,2025-09-11,6,26,17,43,SprFli_T,"-37.81515276, 144.97467661"
771920241125,77,2024-11-25,19,134,113,247,HarEsP_T,"-37.81441438, 144.94433026"
782120250219,78,2025-02-19,21,4,11,15,HarEsB_T,"-37.81471642, 144.9446508"
711920250612,71,2025-06-12,19,8,4,12,WestWP_T,"-37.81235775, 144.97136962"
712020250122,71,2025-01-22,20,2,3,5,WestWP_T,"-37.81235775, 144.97136962"
71420250526,71,2025-05-26,4,1,0,1,WestWP_T,"-37.81235775, 144.97136962"
282120250716,28,2025-07-16,21,118,529,647,VAC_T,"-37.82129925, 144.96879309"
47620250623,47,2025-06-23,6,32,134,166,Eli250_T,"-37.81258467, 144.9625775"
501420240622,50,2024-06-22,14,325,255,580,Lyg309_T,"-37.79808192, 144.96721013"
1331820250401,133,2025-04-01,18,834,746,1580,Spen229_T,"-37.81531435, 144.95227769"
1081020240528,108,2024-05-28,10,109,449,558,261Will_T,"-37.81295822, 144.95678789"
108620241015,108,2024-10-15,6,26,257,283,261Will_T,"-37.81295822, 144.95678789"
872320240718,87,2024-07-18,23,4,6,10,Errol23_T,"-37.80454949, 144.94921863"
61320240118,61,2024-01-18,3,5,2,7,RMIT14_T,"-37.80767455, 144.96309114"
501220250816,50,2025-08-16,12,249,266,515,Lyg309_T,"-37.79808192, 144.96721013"
1661820250730,166,2025-07-30,18,33,37,70,Spen484_T,"-37.80896733, 144.94931703"
166620250825,166,2025-08-25,6,2,4,6,Spen484_T,"-37.80896733, 144.94931703"
1661120250925,166,2025-09-25,11,37,47,84,Spen484_T,"-37.80896733, 144.94931703"
1671020250508,167,2025-05-08,10,36,85,121,Lat526_T,"-37.81304149, 144.95155955"
167320240908,167,2024-09-08,3,1,2,3,Lat526_T,"-37.81304149, 144.95155955"
1621820250429,162,2025-04-29,18,221,136,357,Eli489_T,"-37.80740397, 144.95987909"
851520240318,85,2024-03-18,15,92,99,191,488Mac_T,"-37.79432415, 144.92973378"
1020240205,1,2024-02-05,0,13,26,39,Bou292_T,"-37.81349441, 144.96515323"
631720240704,63,2024-07-04,17,512,464,976,Bou231_T,"-37.81333081, 144.96675571"
1620250425,1,2025-04-25,6,19,24,43,Bou292_T,"-37.81349441, 144.96515323"
621720241109,62,2024-11-09,17,324,423,747,Lat224_T,"-37.80996494, 144.96216521"
62120250522,62,2025-05-22,1,26,37,63,Lat224_T,"-37.80996494, 144.96216521"
562120231222,56,2023-12-22,21,330,325,655,Lon364_T,"-37.81234775, 144.96153311"
561920240315,56,2024-03-15,19,379,370,749,Lon364_T,"-37.81234775, 144.96153311"
861020240304,86,2024-03-04,10,52,46,98,574Qub_T,"-37.80309992, 144.94908064"
861320250512,86,2025-05-12,13,69,80,149,574Qub_T,"-37.80309992, 144.94908064"
112120250401,11,2025-04-01,21,79,84,163,WatCit_T,"-37.81564989, 144.93970694"
10020240629,10,2024-06-29,0,6,3,9,BouHbr_T,"-37.81876474, 144.94710545"
722020240916,72,2024-09-16,20,30,59,89,ACMI_T,"-37.81726338, 144.96872809"
351820241028,35,2024-10-28,18,1170,1162,2332,SouthB_T,"-37.82018685, 144.96508508"
27520241111,27,2024-11-11,5,7,1,8,Vic_T,"-37.80606888, 144.95644692"
79920240129,79,2024-01-29,9,357,196,553,FliSS_T,"-37.81794046, 144.96616678"
512120250922,51,2025-09-22,21,44,71,115,Fra118_T,"-37.80841815, 144.95906316"
51620240128,51,2024-01-28,6,10,21,31,Fra118_T,"-37.80841815, 144.95906316"
191520241118,19,2024-11-18,15,432,477,909,LtB210_T,"-37.81237202, 144.96550671"
201820250806,20,2025-08-06,18,422,305,727,LtB170_T,"-37.81172914, 144.9682466"
201320240907,20,2024-09-07,13,401,426,827,LtB170_T,"-37.81172914, 144.9682466"
251820250527,25,2025-05-27,18,443,213,656,MCEC_T,"-37.82401776, 144.95604426"
251120250820,25,2025-08-20,11,297,480,777,MCEC_T,"-37.82401776, 144.95604426"
180620251004,180,2025-10-04,6,10,3,13,Mac330_T,"-37.79497059, 144.93530329"
1411720240824,141,2024-08-24,17,176,137,313,474Fl_T,"-37.81997273, 144.95834911"
1411020250803,141,2025-08-03,10,114,142,256,474Fl_T,"-37.81997273, 144.95834911"
1392020240424,139,2024-04-24,20,18,20,38,Signal1647_T,"-37.81959923, 144.9632832"
139920241222,139,2024-12-22,9,36,23,59,Signal1647_T,"-37.81959923, 144.9632832"
139720231124,139,2023-11-24,7,16,75,91,Signal1647_T,"-37.81959923, 144.9632832"
39820250712,39,2025-07-12,8,35,50,85,AlfPl_T,"-37.81379749, 144.96995745"
8820241201,8,2024-12-01,8,61,97,158,WebBN_T,"-37.82293543, 144.9471751"
651120240522,65,2024-05-22,11,421,352,773,SwaCs_T,"-37.81569416, 144.9668064"
422020250628,42,2025-06-28,20,17,15,32,UM1_T,"-37.80008566, 144.96386412"
77120250622,77,2025-06-22,1,6,2,8,HarEsP_T,"-37.81441438, 144.94433026"
29020240822,29,2024-08-22,0,4,20,24,AG_T,"-37.8199817, 144.96872865"
142020250409,14,2025-04-09,20,218,116,334,SanBri_T,"-37.82011242, 144.96291897"
31020231123,31,2023-11-23,0,7,16,23,Lyg161_T,"-37.80169681, 144.96658911"
471620240913,47,2024-09-13,16,926,932,1858,Eli250_T,"-37.81258467, 144.9625775"
36720241005,36,2024-10-05,7,48,26,74,Que85_T,"-37.81652527, 144.96121062"
37820240902,37,2024-09-02,8,41,53,94,Lyg260_T,"-37.80107122, 144.96704554"
37920250109,37,2025-01-09,9,46,60,106,Lyg260_T,"-37.80107122, 144.96704554"
50420241017,50,2024-10-17,4,7,0,7,Lyg309_T,"-37.79808192, 144.96721013"
431920250115,43,2025-01-15,19,43,39,82,UM2_T,"-37.79844526, 144.96411782"
501520240430,50,2024-04-30,15,173,121,294,Lyg309_T,"-37.79808192, 144.96721013"
452020240609,45,2024-06-09,20,441,777,1218,Swa148_T,"-37.81414075, 144.96609379"
1332120250824,133,2025-08-24,21,332,204,536,Spen229_T,"-37.81531435, 144.95227769"
118020250225,118,2025-02-25,0,0,2,2,Fli114C_T,"-37.81632783, 144.97090512"
1081120250219,108,2025-02-19,11,273,293,566,261Will_T,"-37.81295822, 144.95678789"
1081320250623,108,2025-06-23,13,575,501,1076,261Will_T,"-37.81295822, 144.95678789"
871820240824,87,2024-08-24,18,116,87,203,Errol23_T,"-37.80454949, 144.94921863"
87320241115,87,2024-11-15,3,1,1,2,Errol23_T,"-37.80454949, 144.94921863"
179520250830,179,2025-08-30,5,8,2,10,Pow61_T,"-37.82392385, 144.96299677"
131820250113,131,2025-01-13,8,127,84,211,King2_T,"-37.82009057, 144.95758725"
1311520250419,131,2025-04-19,15,185,144,329,King2_T,"-37.82009057, 144.95758725"
1432020250809,143,2025-08-09,20,223,230,453,Spencer_T,"-37.821728, 144.95557015"
143520240910,143,2024-09-10,5,13,24,37,Spencer_T,"-37.821728, 144.95557015"
143720240930,143,2024-09-30,7,81,126,207,Spencer_T,"-37.821728, 144.95557015"
135820240526,135,2024-05-26,8,115,114,229,Spen161_T,"-37.8172861, 144.95319102"
1421520240730,142,2024-07-30,15,288,262,550,Hammer1584_T,"-37.81970749, 144.96795734"
1421620250208,142,2025-02-08,16,524,789,1313,Hammer1584_T,"-37.81970749, 144.96795734"
1171120250301,117,2025-03-01,11,116,143,259,Fli114F_T,"-37.81629332, 144.97090877"
851620240219,85,2024-02-19,16,42,66,108,488Mac_T,"-37.79432415, 144.92973378"
851520250108,85,2025-01-08,15,87,77,164,488Mac_T,"-37.79432415, 144.92973378"
851220250831,85,2025-08-31,12,68,70,138,488Mac_T,"-37.79432415, 144.92973378"
17020251012,17,2025-10-12,0,22,35,57,Col15_T,"-37.81362543, 144.97323591"
111520250105,11,2025-01-05,15,81,39,120,WatCit_T,"-37.81564989, 144.93970694"
242020241212,24,2024-12-12,20,250,624,874,Col620_T,"-37.81887963, 144.95449198"
24520250206,24,2025-02-06,5,79,60,139,Col620_T,"-37.81887963, 144.95449198"
721320240315,72,2024-03-15,13,240,414,654,ACMI_T,"-37.81726338, 144.96872809"
12220251009,12,2025-10-09,2,0,1,1,NewQ_T,"-37.81457988, 144.94292398"
561020250928,56,2025-09-28,10,293,139,432,Lon364_T,"-37.81234775, 144.96153311"
58020240618,58,2024-06-18,0,46,41,87,Bou688_T,"-37.81686075, 144.95358075"
581420231212,58,2023-12-12,14,681,442,1123,Bou688_T,"-37.81686075, 144.95358075"
72720250916,72,2025-09-16,7,223,51,274,ACMI_T,"-37.81726338, 144.96872809"
271720241223,27,2024-12-23,17,112,90,202,Vic_T,"-37.80606888, 144.95644692"
272020231124,27,2023-11-24,20,58,50,108,Vic_T,"-37.80606888, 144.95644692"
22020231213,2,2023-12-13,20,327,333,660,Bou283_T,"-37.81380668, 144.96516718"
531520231127,53,2023-11-27,15,740,553,1293,Col254_T,"-37.81564191, 144.965499"
27920250816,27,2025-08-16,9,140,183,323,Vic_T,"-37.80606888, 144.95644692"
232120240918,23,2024-09-18,21,76,165,241,Col623_T,"-37.81909256, 144.95452748"
1361620231226,136,2023-12-26,16,85,652,737,BirFed1120_T,"-37.8184141, 144.97357915"
1362020240823,136,2024-08-23,20,9,0,9,BirFed1120_T,"-37.8184141, 144.97357915"
142920231204,142,2023-12-04,9,168,136,304,Hammer1584_T,"-37.81970749, 144.96795734"
1231320240430,123,2024-04-30,13,46,12,58,BirBridge_T,"-37.81753741, 144.97329734"
1231420250927,123,2025-09-27,14,38,12,50,BirBridge_T,"-37.81753741, 144.97329734"
49620241010,49,2024-10-10,6,56,48,104,Eli501_T,"-37.80730068, 144.95956055"
1091220240701,109,2024-07-01,12,72,123,195,LatWill_T,"-37.81193681, 144.95621105"
109620240825,109,2024-08-25,6,3,10,13,LatWill_T,"-37.81193681, 144.95621105"
1091520250316,109,2025-03-16,15,67,52,119,LatWill_T,"-37.81193681, 144.95621105"
109920250616,109,2025-06-16,9,63,275,338,LatWill_T,"-37.81193681, 144.95621105"
49420231123,49,2023-11-23,4,6,9,15,Eli501_T,"-37.80730068, 144.95956055"
69920240111,69,2024-01-11,9,141,70,211,FLDegC_T,"-37.81687226, 144.96559144"
61720240602,6,2024-06-02,17,962,718,1680,FliS_T,"-37.81911705, 144.96558255"
841220250209,84,2025-02-09,12,1010,1075,2085,ElFi_T,"-37.81798049, 144.96503383"
3120240507,3,2024-05-07,1,69,52,121,Swa295_T,"-37.81101524, 144.96429485"
781820250105,78,2025-01-05,18,26,44,70,HarEsB_T,"-37.81471642, 144.9446508"
711420240710,71,2024-07-10,14,11,9,20,WestWP_T,"-37.81235775, 144.97136962"
311720250909,31,2025-09-09,17,135,105,240,Lyg161_T,"-37.80169681, 144.96658911"
541520240218,54,2024-02-18,15,214,192,406,Swa607_T,"-37.804024, 144.96308399"
281220250323,28,2025-03-23,12,1287,1440,2727,VAC_T,"-37.82129925, 144.96879309"
282220240423,28,2024-04-23,22,559,171,730,VAC_T,"-37.82129925, 144.96879309"
471920250623,47,2025-06-23,19,501,447,948,Eli250_T,"-37.81258467, 144.9625775"
401620241204,40,2024-12-04,16,276,289,565,Spr201_T,"-37.80999341, 144.97227587"
212120231025,21,2023-10-25,21,278,289,567,Bourke155_T,"-37.81267313, 144.96788288"
361120250328,36,2025-03-28,11,168,173,341,Que85_T,"-37.81652527, 144.96121062"
361520231210,36,2023-12-10,15,86,95,181,Que85_T,"-37.81652527, 144.96121062"
501220241230,50,2024-12-30,12,239,319,558,Lyg309_T,"-37.79808192, 144.96721013"
44920231028,44,2023-10-28,9,8,10,18,UM3_T,"-37.79698741, 144.96441306"
45020240930,45,2024-09-30,0,16,44,60,Swa148_T,"-37.81414075, 144.96609379"
107720250304,107,2025-03-04,7,38,106,144,280Will_T,"-37.81246271, 144.95690188"
1332220250428,133,2025-04-28,22,188,149,337,Spen229_T,"-37.81531435, 144.95227769"
1322220250903,132,2025-09-03,22,50,52,102,King335_T,"-37.81267639, 144.95386444"
1081720250401,108,2025-04-01,17,1978,291,2269,261Will_T,"-37.81295822, 144.95678789"
1851420250923,185,2025-09-23,14,656,766,1422,Eli197_T,"-37.81374643, 144.96276183"
1671920250209,167,2025-02-09,19,69,58,127,Lat526_T,"-37.81304149, 144.95155955"
1651420250707,165,2025-07-07,14,32,28,60,Spen475_T,"-37.80953359, 144.94939004"
1401020240226,140,2024-02-26,10,104,40,144,Boyd2837_T,"-37.82590962, 144.96185972"
1311620241124,131,2024-11-24,16,143,46,189,King2_T,"-37.82009057, 144.95758725"
162620241008,162,2024-10-08,6,73,38,111,Eli489_T,"-37.80740397, 144.95987909"
143020250922,143,2025-09-22,0,50,23,73,Spencer_T,"-37.821728, 144.95557015"
171320231116,17,2023-11-16,13,707,717,1424,Col15_T,"-37.81362543, 144.97323591"
17720250415,17,2025-04-15,7,443,112,555,Col15_T,"-37.81362543, 144.97323591"
171920250731,17,2025-07-31,19,57,149,206,Col15_T,"-37.81362543, 144.97323591"
181520240920,18,2024-09-20,15,223,116,339,Col12_T,"-37.81344862, 144.97305353"
62520231224,62,2023-12-24,5,10,3,13,Lat224_T,"-37.80996494, 144.96216521"
24420231124,24,2023-11-24,4,21,23,44,Col620_T,"-37.81887963, 144.95449198"
242020240918,24,2024-09-18,20,240,451,691,Col620_T,"-37.81887963, 144.95449198"
10020240526,10,2024-05-26,0,7,4,11,BouHbr_T,"-37.81876474, 144.94710545"
242220250917,24,2025-09-17,22,122,326,448,Col620_T,"-37.81887963, 144.95449198"
121420250521,12,2025-05-21,14,98,119,217,NewQ_T,"-37.81457988, 144.94292398"
121420250624,12,2025-06-24,14,83,75,158,NewQ_T,"-37.81457988, 144.94292398"
172020240407,17,2024-04-07,20,60,88,148,Col15_T,"-37.81362543, 144.97323591"
67520250225,67,2025-02-25,5,33,33,66,FLDegS_T,"-37.81688755, 144.96562569"
681220250921,68,2025-09-21,12,314,343,657,FLDegN_T,"-37.8168479, 144.96559789"
621120240618,62,2024-06-18,11,141,125,266,Lat224_T,"-37.80996494, 144.96216521"
861820240523,86,2024-05-23,18,68,44,112,574Qub_T,"-37.80309992, 144.94908064"
24720231110,24,2023-11-10,7,659,234,893,Col620_T,"-37.81887963, 144.95449198"
721820241128,72,2024-11-28,18,357,553,910,ACMI_T,"-37.81726338, 144.96872809"
241820250223,24,2025-02-23,18,374,451,825,Col620_T,"-37.81887963, 144.95449198"
24820250904,24,2025-09-04,8,2671,416,3087,Col620_T,"-37.81887963, 144.95449198"
35420250908,35,2025-09-08,4,16,11,27,SouthB_T,"-37.82018685, 144.96508508"
761620250225,76,2025-02-25,16,49,75,124,KenMac_T,"-37.79453803, 144.93036194"
35320240803,35,2024-08-03,3,35,63,98,SouthB_T,"-37.82018685, 144.96508508"
91620250804,9,2025-08-04,16,1884,96,1980,Col700_T,"-37.81982992, 144.95102555"
9220240114,9,2024-01-14,2,13,18,31,Col700_T,"-37.81982992, 144.95102555"
531220250207,53,2025-02-07,12,835,720,1555,Col254_T,"-37.81564191, 144.965499"
51820250822,51,2025-08-22,8,55,69,124,Fra118_T,"-37.80841815, 144.95906316"
231120240622,23,2024-06-22,11,173,180,353,Col623_T,"-37.81909256, 144.95452748"
231820250701,23,2025-07-01,18,183,418,601,Col623_T,"-37.81909256, 144.95452748"
191120240919,19,2024-09-19,11,277,173,450,LtB210_T,"-37.81237202, 144.96550671"
48120240618,48,2024-06-18,1,3,7,10,QVMQ_T,"-37.80631581, 144.95866697"
481520241009,48,2024-10-09,15,181,182,363,QVMQ_T,"-37.80631581, 144.95866697"
164020250727,164,2025-07-27,0,6,23,29,Lat526_T,"-37.813005, 144.95160411"
1411720250618,141,2025-06-18,17,136,144,280,474Fl_T,"-37.81997273, 144.95834911"
841620240902,84,2024-09-02,16,771,1272,2043,ElFi_T,"-37.81798049, 144.96503383"
66120240304,66,2024-03-04,1,42,23,65,QVN_T,"-37.81057846, 144.96444294"
661520240625,66,2024-06-25,15,1100,1123,2223,QVN_T,"-37.81057846, 144.96444294"
661120240107,66,2024-01-07,11,755,749,1504,QVN_T,"-37.81057846, 144.96444294"
75320250521,75,2025-05-21,3,1,0,1,SprFli_T,"-37.81515276, 144.97467661"
412120240930,41,2024-09-30,21,51,43,94,Swa31,"-37.81668634, 144.96689733"
782120240419,78,2024-04-19,21,4,44,48,HarEsB_T,"-37.81471642, 144.9446508"
41420250722,41,2025-07-22,4,20,30,50,Swa31,"-37.81668634, 144.96689733"
65620240125,65,2024-01-25,6,73,44,117,SwaCs_T,"-37.81569416, 144.9668064"
292220241113,29,2024-11-13,22,287,72,359,AG_T,"-37.8199817, 144.96872865"
291920250318,29,2025-03-18,19,226,262,488,AG_T,"-37.8199817, 144.96872865"
282320250703,28,2025-07-03,23,65,17,82,VAC_T,"-37.82129925, 144.96879309"
402120250205,40,2025-02-05,21,83,51,134,Spr201_T,"-37.80999341, 144.97227587"
311420231025,31,2023-10-25,14,91,126,217,Lyg161_T,"-37.80169681, 144.96658911"
37320240913,37,2024-09-13,3,2,1,3,Lyg260_T,"-37.80107122, 144.96704554"
37220240326,37,2024-03-26,2,1,2,3,Lyg260_T,"-37.80107122, 144.96704554"
472120240217,47,2024-02-17,21,728,503,1231,Eli250_T,"-37.81258467, 144.9625775"
471520250214,47,2025-02-14,15,885,848,1733,Eli250_T,"-37.81258467, 144.9625775"
47120240204,47,2024-02-04,1,103,144,247,Eli250_T,"-37.81258467, 144.9625775"
501520240127,50,2024-01-27,15,261,235,496,Lyg309_T,"-37.79808192, 144.96721013"
5220250713,5,2025-07-13,2,41,51,92,PriNW_T,"-37.81874249, 144.96787656"
51220250505,5,2025-05-05,12,635,770,1405,PriNW_T,"-37.81874249, 144.96787656"
1321220241122,132,2024-11-22,12,172,182,354,King335_T,"-37.81267639, 144.95386444"
1311220250330,131,2025-03-30,12,114,105,219,King2_T,"-37.82009057, 144.95758725"
1331220241113,133,2024-11-13,12,338,333,671,Spen229_T,"-37.81531435, 144.95227769"
124720240317,124,2024-03-17,7,0,1,1,BirBridge_T,"-37.81757416, 144.97329934"
1071020231106,107,2023-11-06,10,91,98,189,280Will_T,"-37.81246271, 144.95690188"
165520241005,165,2024-10-05,5,0,1,1,Spen475_T,"-37.80953359, 144.94939004"
162720250529,162,2025-05-29,7,103,65,168,Eli489_T,"-37.80740397, 144.95987909"
1621320240831,162,2024-08-31,13,693,1030,1723,Eli489_T,"-37.80740397, 144.95987909"
521820240118,52,2024-01-18,18,320,342,662,Eli263_T,"-37.81252157, 144.9619401"
522020250302,52,2025-03-02,20,222,193,415,Eli263_T,"-37.81252157, 144.9619401"
461220250921,46,2025-09-21,12,27,35,62,Pel147_T,"-37.80240719, 144.9615673"
46720231222,46,2023-12-22,7,14,19,33,Pel147_T,"-37.80240719, 144.9615673"
1091220250313,109,2025-03-13,12,270,195,465,LatWill_T,"-37.81193681, 144.95621105"
109120250916,109,2025-09-16,1,6,2,8,LatWill_T,"-37.81193681, 144.95621105"
1172020240924,117,2024-09-24,20,68,57,125,Fli114F_T,"-37.81629332, 144.97090877"
492120250820,49,2025-08-20,21,312,523,835,Eli501_T,"-37.80730068, 144.95956055"
49920251015,49,2025-10-15,9,179,232,411,Eli501_T,"-37.80730068, 144.95956055"
19120231228,19,2023-12-28,1,43,61,104,LtB210_T,"-37.81237202, 144.96550671"
481820250613,48,2025-06-13,18,166,180,346,QVMQ_T,"-37.80631581, 144.95866697"
137720241022,137,2024-10-22,7,44,10,54,BouHbr2353_T,"-37.81894815, 144.94612292"
141120240530,141,2024-05-30,1,8,10,18,474Fl_T,"-37.81997273, 144.95834911"
1411820240903,141,2024-09-03,18,116,105,221,474Fl_T,"-37.81997273, 144.95834911"
1372220240218,137,2024-02-18,22,0,3,3,BouHbr2353_T,"-37.81894815, 144.94612292"
1361920240424,136,2024-04-24,19,226,7,233,BirFed1120_T,"-37.8184141, 144.97357915"
1362120250624,136,2025-06-24,21,2,1,3,BirFed1120_T,"-37.8184141, 144.97357915"
841120250220,84,2025-02-20,11,731,675,1406,ElFi_T,"-37.81798049, 144.96503383"
4620231114,4,2023-11-14,6,155,59,214,Swa123_T,"-37.81487988, 144.9660878"
661720240305,66,2024-03-05,17,1539,1546,3085,QVN_T,"-37.81057846, 144.96444294"
701320241126,70,2024-11-26,13,173,136,309,Errol20_T,"-37.80456984, 144.94946228"
31120240414,3,2024-04-14,11,706,759,1465,Swa295_T,"-37.81101524, 144.96429485"
3120240516,3,2024-05-16,1,73,88,161,Swa295_T,"-37.81101524, 144.96429485"
3120240602,3,2024-06-02,1,236,287,523,Swa295_T,"-37.81101524, 144.96429485"
75720240828,75,2024-08-28,7,48,36,84,SprFli_T,"-37.81515276, 144.97467661"
771720250908,77,2025-09-08,17,305,154,459,HarEsP_T,"-37.81441438, 144.94433026"
281320250208,28,2025-02-08,13,1776,1110,2886,VAC_T,"-37.82129925, 144.96879309"
292320240305,29,2024-03-05,23,1192,91,1283,AG_T,"-37.8199817, 144.96872865"
141120241009,14,2024-10-09,11,206,91,297,SanBri_T,"-37.82011242, 144.96291897"
31120240907,31,2024-09-07,1,10,26,36,Lyg161_T,"-37.80169681, 144.96658911"
281020231219,28,2023-12-19,10,449,149,598,VAC_T,"-37.82129925, 144.96879309"
472220250831,47,2025-08-31,22,148,110,258,Eli250_T,"-37.81258467, 144.9625775"
36820250928,36,2025-09-28,8,42,52,94,Que85_T,"-37.81652527, 144.96121062"
36620240916,36,2024-09-16,6,32,20,52,Que85_T,"-37.81652527, 144.96121062"
501520241215,50,2024-12-15,15,354,272,626,Lyg309_T,"-37.79808192, 144.96721013"
501620250626,50,2025-06-26,16,171,168,339,Lyg309_T,"-37.79808192, 144.96721013"
50320240428,50,2024-04-28,3,2,2,4,Lyg309_T,"-37.79808192, 144.96721013"
451920250504,45,2025-05-04,19,245,601,846,Swa148_T,"-37.81414075, 144.96609379"
1082020240414,108,2024-04-14,20,21,57,78,261Will_T,"-37.81295822, 144.95678789"
1081720231214,108,2023-12-14,17,1440,300,1740,261Will_T,"-37.81295822, 144.95678789"
611120241127,61,2024-11-27,11,301,525,826,RMIT14_T,"-37.80767455, 144.96309114"
184920250928,184,2025-09-28,9,355,294,649,Eli124_T,"-37.81512416, 144.96371988"
166720250707,166,2025-07-07,7,7,20,27,Spen484_T,"-37.80896733, 144.94931703"
179120250828,179,2025-08-28,1,0,7,7,Pow61_T,"-37.82392385, 144.96299677"
1662120241230,166,2024-12-30,21,20,11,31,Spen484_T,"-37.80896733, 144.94931703"
167520241107,167,2024-11-07,5,0,5,5,Lat526_T,"-37.81304149, 144.95155955"
1342220250308,134,2025-03-08,22,292,297,589,Spen201_T,"-37.81694221, 144.95303935"
172020240519,17,2024-05-19,20,53,35,88,Col15_T,"-37.81362543, 144.97323591"
17020250225,17,2025-02-25,0,11,11,22,Col15_T,"-37.81362543, 144.97323591"
721120250827,72,2025-08-27,11,190,194,384,ACMI_T,"-37.81726338, 144.96872809"
2820241102,2,2024-11-02,8,60,67,127,Bou283_T,"-37.81380668, 144.96516718"
352120250417,35,2025-04-17,21,723,1630,2353,SouthB_T,"-37.82018685, 144.96508508"
581320240326,58,2024-03-26,13,819,549,1368,Bou688_T,"-37.81686075, 144.95358075"
792320250627,79,2025-06-27,23,176,182,358,FliSS_T,"-37.81794046, 144.96616678"
51320250825,51,2025-08-25,3,2,2,4,Fra118_T,"-37.80841815, 144.95906316"
511920240128,51,2024-01-28,19,107,60,167,Fra118_T,"-37.80841815, 144.95906316"
231020240714,23,2024-07-14,10,184,199,383,Col623_T,"-37.81909256, 144.95452748"
19720240802,19,2024-08-02,7,31,19,50,LtB210_T,"-37.81237202, 144.96550671"
481720231026,48,2023-10-26,17,145,196,341,QVMQ_T,"-37.80631581, 144.95866697"
201520250306,20,2025-03-06,15,179,226,405,LtB170_T,"-37.81172914, 144.9682466"
201520250409,20,2025-04-09,15,213,444,657,LtB170_T,"-37.81172914, 144.9682466"
25520250621,25,2025-06-21,5,9,5,14,MCEC_T,"-37.82401776, 144.95604426"
1421320240719,142,2024-07-19,13,265,236,501,Hammer1584_T,"-37.81970749, 144.96795734"
1171020250614,117,2025-06-14,10,66,101,167,Fli114F_T,"-37.81629332, 144.97090877"
491920241010,49,2024-10-10,19,234,192,426,Eli501_T,"-37.80730068, 144.95956055"
117320240626,117,2024-06-26,3,3,0,3,Fli114F_T,"-37.81629332, 144.97090877"
671520240226,67,2024-02-26,15,284,471,755,FLDegS_T,"-37.81688755, 144.96562569"
671720241115,67,2024-11-15,17,372,651,1023,FLDegS_T,"-37.81688755, 144.96562569"
851620240210,85,2024-02-10,16,79,92,171,488Mac_T,"-37.79432415, 144.92973378"
852320250217,85,2025-02-17,23,1,1,2,488Mac_T,"-37.79432415, 144.92973378"
1620240805,1,2024-08-05,6,33,52,85,Bou292_T,"-37.81349441, 144.96515323"
181520250326,18,2025-03-26,15,330,163,493,Col12_T,"-37.81344862, 144.97305353"
63020250614,63,2025-06-14,0,10,77,87,Bou231_T,"-37.81333081, 144.96675571"
56120241009,56,2024-10-09,1,14,13,27,Lon364_T,"-37.81234775, 144.96153311"
561220250102,56,2025-01-02,12,309,236,545,Lon364_T,"-37.81234775, 144.96153311"
10420250901,10,2025-09-01,4,4,1,5,BouHbr_T,"-37.81876474, 144.94710545"
721220240531,72,2024-05-31,12,235,330,565,ACMI_T,"-37.81726338, 144.96872809"
351020240419,35,2024-04-19,10,741,651,1392,SouthB_T,"-37.82018685, 144.96508508"
351220240422,35,2024-04-22,12,1206,1391,2597,SouthB_T,"-37.82018685, 144.96508508"
271320250227,27,2025-02-27,13,196,172,368,Vic_T,"-37.80606888, 144.95644692"
53520250123,53,2025-01-23,5,3,6,9,Col254_T,"-37.81564191, 144.965499"
53220250426,53,2025-04-26,2,14,11,25,Col254_T,"-37.81564191, 144.965499"
91920241023,9,2024-10-23,19,291,355,646,Col700_T,"-37.81982992, 144.95102555"
301820250107,30,2025-01-07,18,396,381,777,Lon189_T,"-37.8112185, 144.96656806"
52520240117,52,2024-01-17,5,9,7,16,Eli263_T,"-37.81252157, 144.9619401"
521820240204,52,2024-02-04,18,190,182,372,Eli263_T,"-37.81252157, 144.9619401"
231020250910,23,2025-09-10,10,204,207,411,Col623_T,"-37.81909256, 144.95452748"
231820241211,23,2024-12-11,18,252,409,661,Col623_T,"-37.81909256, 144.95452748"
481620250808,48,2025-08-08,16,201,183,384,QVMQ_T,"-37.80631581, 144.95866697"
48720240107,48,2024-01-07,7,42,25,67,QVMQ_T,"-37.80631581, 144.95866697"
48220240222,48,2024-02-22,2,6,3,9,QVMQ_T,"-37.80631581, 144.95866697"
201520240824,20,2024-08-24,15,294,302,596,LtB170_T,"-37.81172914, 144.9682466"
462220240402,46,2024-04-02,22,27,20,47,Pel147_T,"-37.80240719, 144.9615673"
139620250922,139,2025-09-22,6,9,26,35,Signal1647_T,"-37.81959923, 144.9632832"
139320240301,139,2024-03-01,3,1,1,2,Signal1647_T,"-37.81959923, 144.9632832"
130720250802,130,2025-08-02,7,41,10,51,Bou892T,"-37.8204637, 144.94126826"
1302220250930,130,2025-09-30,22,9,7,16,Bou892T,"-37.8204637, 144.94126826"
1612120240906,161,2024-09-06,21,2,8,10,BirArt1109_T,"-37.81851276, 144.97131336"
1381220231207,138,2023-12-07,12,5,9,14,EntPark1671_T,"-37.81996544, 144.95981454"
109120240304,109,2024-03-04,1,6,11,17,LatWill_T,"-37.81193681, 144.95621105"
109620250515,109,2025-05-15,6,24,82,106,LatWill_T,"-37.81193681, 144.95621105"
662020250403,66,2025-04-03,20,1006,842,1848,QVN_T,"-37.81057846, 144.96444294"
69920240827,69,2024-08-27,9,174,67,241,FLDegC_T,"-37.81687226, 144.96559144"
84120250918,84,2025-09-18,1,27,30,57,ElFi_T,"-37.81798049, 144.96503383"
621320250917,62,2025-09-17,13,256,212,468,Lat224_T,"-37.80996494, 144.96216521"
631120250202,63,2025-02-02,11,189,226,415,Bou231_T,"-37.81333081, 144.96675571"
56220240329,56,2024-03-29,2,40,59,99,Lon364_T,"-37.81234775, 144.96153311"
121820250130,12,2025-01-30,18,178,250,428,NewQ_T,"-37.81457988, 144.94292398"
241320240619,24,2024-06-19,13,737,767,1504,Col620_T,"-37.81887963, 144.95449198"
58720250115,58,2025-01-15,7,708,104,812,Bou688_T,"-37.81686075, 144.95358075"
351720250206,35,2025-02-06,17,2344,1441,3785,SouthB_T,"-37.82018685, 144.96508508"
2320250302,2,2025-03-02,3,24,73,97,Bou283_T,"-37.81380668, 144.96516718"
2320250319,2,2025-03-19,3,8,14,22,Bou283_T,"-37.81380668, 144.96516718"
302020241103,30,2024-11-03,20,204,360,564,Lon189_T,"-37.8112185, 144.96656806"
301320250416,30,2025-04-16,13,363,544,907,Lon189_T,"-37.8112185, 144.96656806"
79120240905,79,2024-09-05,1,18,24,42,FliSS_T,"-37.81794046, 144.96616678"
531020241001,53,2024-10-01,10,524,370,894,Col254_T,"-37.81564191, 144.965499"
23220241225,23,2024-12-25,2,7,14,21,Col623_T,"-37.81909256, 144.95452748"
231620240223,23,2024-02-23,16,250,578,828,Col623_T,"-37.81909256, 144.95452748"
481820250708,48,2025-07-08,18,115,142,257,QVMQ_T,"-37.80631581, 144.95866697"
301320250503,30,2025-05-03,13,329,506,835,Lon189_T,"-37.8112185, 144.96656806"
25920240302,25,2024-03-02,9,201,448,649,MCEC_T,"-37.82401776, 144.95604426"
25220240327,25,2024-03-27,2,6,6,12,MCEC_T,"-37.82401776, 144.95604426"
1371520240329,137,2024-03-29,15,10,112,122,BouHbr2353_T,"-37.81894815, 144.94612292"
137720240901,137,2024-09-01,7,1,3,4,BouHbr2353_T,"-37.81894815, 144.94612292"
1301220250225,130,2025-02-25,12,133,75,208,Bou892T,"-37.8204637, 144.94126826"
1231120250224,123,2025-02-24,11,29,39,68,BirBridge_T,"-37.81753741, 144.97329734"
66120231218,66,2023-12-18,1,43,46,89,QVN_T,"-37.81057846, 144.96444294"
70720240608,70,2024-06-08,7,14,17,31,Errol20_T,"-37.80456984, 144.94946228"
31620250723,3,2025-07-23,16,1034,1142,2176,Swa295_T,"-37.81101524, 144.96429485"
75420250731,75,2025-07-31,4,6,0,6,SprFli_T,"-37.81515276, 144.97467661"
75720241026,75,2024-10-26,7,17,25,42,SprFli_T,"-37.81515276, 144.97467661"
81520250324,8,2025-03-24,15,111,203,314,WebBN_T,"-37.82293543, 144.9471751"
781120241012,78,2024-10-12,11,57,83,140,HarEsB_T,"-37.81471642, 144.9446508"
781820241202,78,2024-12-02,18,21,100,121,HarEsB_T,"-37.81471642, 144.9446508"
411820250202,41,2025-02-02,18,642,859,1501,Swa31,"-37.81668634, 144.96689733"
711120231018,71,2023-10-18,11,45,39,84,WestWP_T,"-37.81235775, 144.97136962"
29520241007,29,2024-10-07,5,6,11,17,AG_T,"-37.8199817, 144.96872865"
291020250304,29,2025-03-04,10,156,214,370,AG_T,"-37.8199817, 144.96872865"
291420250327,29,2025-03-27,14,264,261,525,AG_T,"-37.8199817, 144.96872865"
291420250716,29,2025-07-16,14,276,293,569,AG_T,"-37.8199817, 144.96872865"
291820240127,29,2024-01-27,18,434,534,968,AG_T,"-37.8199817, 144.96872865"
312320240528,31,2024-05-28,23,29,27,56,Lyg161_T,"-37.80169681, 144.96658911"
282020250717,28,2025-07-17,20,148,213,361,VAC_T,"-37.82129925, 144.96879309"
37520240120,37,2024-01-20,5,6,5,11,Lyg260_T,"-37.80107122, 144.96704554"
37520240206,37,2024-02-06,5,4,5,9,Lyg260_T,"-37.80107122, 144.96704554"
40820250323,40,2025-03-23,8,32,41,73,Spr201_T,"-37.80999341, 144.97227587"
401820250723,40,2025-07-23,18,112,241,353,Spr201_T,"-37.80999341, 144.97227587"
371120241017,37,2024-10-17,11,90,65,155,Lyg260_T,"-37.80107122, 144.96704554"
371320241204,37,2024-12-04,13,117,136,253,Lyg260_T,"-37.80107122, 144.96704554"
441620240224,44,2024-02-24,16,19,9,28,UM3_T,"-37.79698741, 144.96441306"
1071820250903,107,2025-09-03,18,133,100,233,280Will_T,"-37.81246271, 144.95690188"
133820231114,133,2023-11-14,8,449,416,865,Spen229_T,"-37.81531435, 144.95227769"
672120241203,67,2024-12-03,21,126,222,348,FLDegS_T,"-37.81688755, 144.96562569"
672120240608,67,2024-06-08,21,229,282,511,FLDegS_T,"-37.81688755, 144.96562569"
682120241021,68,2024-10-21,21,73,32,105,FLDegN_T,"-37.8168479, 144.96559789"
621820240327,62,2024-03-27,18,327,212,539,Lat224_T,"-37.80996494, 144.96216521"
11120240613,11,2024-06-13,1,3,1,4,WatCit_T,"-37.81564989, 144.93970694"
112020250704,11,2025-07-04,20,1406,783,2189,WatCit_T,"-37.81564989, 144.93970694"
101820241021,10,2024-10-21,18,60,54,114,BouHbr_T,"-37.81876474, 144.94710545"
121520240702,12,2024-07-02,15,112,150,262,NewQ_T,"-37.81457988, 144.94292398"
121220240708,12,2024-07-08,12,189,223,412,NewQ_T,"-37.81457988, 144.94292398"
72520250724,72,2025-07-24,5,19,11,30,ACMI_T,"-37.81726338, 144.96872809"
352220251014,35,2025-10-14,22,162,267,429,SouthB_T,"-37.82018685, 144.96508508"
35720240307,35,2024-03-07,7,595,964,1559,SouthB_T,"-37.82018685, 144.96508508"
56720250816,56,2025-08-16,7,41,16,57,Lon364_T,"-37.81234775, 144.96153311"
561620250922,56,2025-09-22,16,290,331,621,Lon364_T,"-37.81234775, 144.96153311"
581920240329,58,2024-03-29,19,2270,282,2552,Bou688_T,"-37.81686075, 144.95358075"
22220250917,2,2025-09-17,22,50,92,142,Bou283_T,"-37.81380668, 144.96516718"
91520250721,9,2025-07-21,15,778,160,938,Col700_T,"-37.81982992, 144.95102555"
531320240502,53,2024-05-02,13,976,798,1774,Col254_T,"-37.81564191, 144.965499"
46120231113,46,2023-11-13,1,3,7,10,Pel147_T,"-37.80240719, 144.9615673"
511020240726,51,2024-07-26,10,102,90,192,Fra118_T,"-37.80841815, 144.95906316"
252120241029,25,2024-10-29,21,247,216,463,MCEC_T,"-37.82401776, 144.95604426"
202120250601,20,2025-06-01,21,110,287,397,LtB170_T,"-37.81172914, 144.9682466"
139920250920,139,2025-09-20,9,23,15,38,Signal1647_T,"-37.81959923, 144.9632832"
137720241125,137,2024-11-25,7,35,3,38,BouHbr2353_T,"-37.81894815, 144.94612292"
141320240202,141,2024-02-02,3,16,6,22,474Fl_T,"-37.81997273, 144.95834911"
1411020240503,141,2024-05-03,10,144,95,239,474Fl_T,"-37.81997273, 144.95834911"
136520241114,136,2024-11-14,5,3,3,6,BirFed1120_T,"-37.8184141, 144.97357915"
1421020231227,142,2023-12-27,10,379,177,556,Hammer1584_T,"-37.81970749, 144.96795734"
1611820250724,161,2025-07-24,18,355,3,358,BirArt1109_T,"-37.81851276, 144.97131336"
164820250314,164,2025-03-14,8,165,104,269,Lat526_T,"-37.813005, 144.95160411"
164720250328,164,2025-03-28,7,39,39,78,Lat526_T,"-37.813005, 144.95160411"
1381020250522,138,2025-05-22,10,1,1,2,EntPark1671_T,"-37.81996544, 144.95981454"
138820250705,138,2025-07-05,8,2,3,5,EntPark1671_T,"-37.81996544, 144.95981454"
1231620231209,123,2023-12-09,16,3,2,5,BirBridge_T,"-37.81753741, 144.97329734"
1171320240323,117,2024-03-23,13,184,170,354,Fli114F_T,"-37.81629332, 144.97090877"
4220241205,4,2024-12-05,2,26,21,47,Swa123_T,"-37.81487988, 144.9660878"
70220240628,70,2024-06-28,2,4,0,4,Errol20_T,"-37.80456984, 144.94946228"
70520250905,70,2025-09-05,5,4,4,8,Errol20_T,"-37.80456984, 144.94946228"
751720240402,75,2024-04-02,17,77,50,127,SprFli_T,"-37.81515276, 144.97467661"
751520241118,75,2024-11-18,15,75,87,162,SprFli_T,"-37.81515276, 144.97467661"
75020241201,75,2024-12-01,0,0,1,1,SprFli_T,"-37.81515276, 144.97467661"
781920250305,78,2025-03-05,19,20,89,109,HarEsB_T,"-37.81471642, 144.9446508"
29920241116,29,2024-11-16,9,233,327,560,AG_T,"-37.8199817, 144.96872865"
141520231020,14,2023-10-20,15,321,143,464,SanBri_T,"-37.82011242, 144.96291897"
591120241120,59,2024-11-20,11,227,294,521,RMIT_T,"-37.80825648, 144.96304859"
54520240125,54,2024-01-25,5,6,7,13,Swa607_T,"-37.804024, 144.96308399"
87320240314,87,2024-03-14,3,0,3,3,Errol23_T,"-37.80454949, 144.94921863"
1622320241005,162,2024-10-05,23,223,126,349,Eli489_T,"-37.80740397, 144.95987909"
1652220250310,165,2025-03-10,22,29,8,37,Spen475_T,"-37.80953359, 144.94939004"
1401720250125,140,2025-01-25,17,105,81,186,Boyd2837_T,"-37.82590962, 144.96185972"
1311520250531,131,2025-05-31,15,185,67,252,King2_T,"-37.82009057, 144.95758725"
1352320241102,135,2024-11-02,23,206,2884,3090,Spen161_T,"-37.8172861, 144.95319102"
852320240607,85,2024-06-07,23,4,12,16,488Mac_T,"-37.79432415, 144.92973378"
17320240506,17,2024-05-06,3,10,5,15,Col15_T,"-37.81362543, 144.97323591"
671820241004,67,2024-10-04,18,361,565,926,FLDegS_T,"-37.81688755, 144.96562569"
63820250314,63,2025-03-14,8,140,189,329,Bou231_T,"-37.81333081, 144.96675571"
62720240225,62,2024-02-25,7,29,28,57,Lat224_T,"-37.80996494, 144.96216521"
621620240316,62,2024-03-16,16,295,165,460,Lat224_T,"-37.80996494, 144.96216521"
56120231113,56,2023-11-13,1,7,8,15,Lon364_T,"-37.81234775, 144.96153311"
56120240914,56,2024-09-14,1,83,90,173,Lon364_T,"-37.81234775, 144.96153311"
122220250201,12,2025-02-01,22,239,231,470,NewQ_T,"-37.81457988, 144.94292398"
12820250525,12,2025-05-25,8,99,74,173,NewQ_T,"-37.81457988, 144.94292398"
24120250101,24,2025-01-01,1,532,1090,1622,Col620_T,"-37.81887963, 144.95449198"
241520250206,24,2025-02-06,15,511,1180,1691,Col620_T,"-37.81887963, 144.95449198"
351720240320,35,2024-03-20,17,2408,1722,4130,SouthB_T,"-37.82018685, 144.96508508"
351720240406,35,2024-04-06,17,1473,1689,3162,SouthB_T,"-37.82018685, 144.96508508"
581420250512,58,2025-05-12,14,520,376,896,Bou688_T,"-37.81686075, 144.95358075"
91220241105,9,2024-11-05,12,349,456,805,Col700_T,"-37.81982992, 144.95102555"
271120250412,27,2025-04-12,11,223,217,440,Vic_T,"-37.80606888, 144.95644692"
27520250724,27,2025-07-24,5,4,3,7,Vic_T,"-37.80606888, 144.95644692"
791420240729,79,2024-07-29,14,329,318,647,FliSS_T,"-37.81794046, 144.96616678"
23220240423,23,2024-04-23,2,0,10,10,Col623_T,"-37.81909256, 144.95452748"
232320240508,23,2024-05-08,23,14,50,64,Col623_T,"-37.81909256, 144.95452748"
232120231204,23,2023-12-04,21,82,148,230,Col623_T,"-37.81909256, 144.95452748"
79720250419,79,2025-04-19,7,96,55,151,FliSS_T,"-37.81794046, 144.96616678"
20520240514,20,2024-05-14,5,3,13,16,LtB170_T,"-37.81172914, 144.9682466"
52520241015,52,2024-10-15,5,12,6,18,Eli263_T,"-37.81252157, 144.9619401"
461420250209,46,2025-02-09,14,28,13,41,Pel147_T,"-37.80240719, 144.9615673"
492320240211,49,2024-02-11,23,96,60,156,Eli501_T,"-37.80730068, 144.95956055"
19320250315,19,2025-03-15,3,28,42,70,LtB210_T,"-37.81237202, 144.96550671"
251520250103,25,2025-01-03,15,881,775,1656,MCEC_T,"-37.82401776, 144.95604426"
482020240607,48,2024-06-07,20,98,137,235,QVMQ_T,"-37.80631581, 144.95866697"
1801920250606,180,2025-06-06,19,9,2,11,Mac330_T,"-37.79497059, 144.93530329"
1371920241226,137,2024-12-26,19,12,17,29,BouHbr2353_T,"-37.81894815, 144.94612292"
1392220241106,139,2024-11-06,22,1,20,21,Signal1647_T,"-37.81959923, 144.9632832"
1361620250405,136,2025-04-05,16,532,62,594,BirFed1120_T,"-37.8184141, 144.97357915"
1362020250505,136,2025-05-05,20,9,0,9,BirFed1120_T,"-37.8184141, 144.97357915"
1362120250805,136,2025-08-05,21,1,1,2,BirFed1120_T,"-37.8184141, 144.97357915"
136420250313,136,2025-03-13,4,0,1,1,BirFed1120_T,"-37.8184141, 144.97357915"
1611120250707,161,2025-07-07,11,110,152,262,BirArt1109_T,"-37.81851276, 144.97131336"
1231320240724,123,2024-07-24,13,33,1,34,BirBridge_T,"-37.81753741, 144.97329734"
1382120241011,138,2024-10-11,21,0,4,4,EntPark1671_T,"-37.81996544, 144.95981454"
81720250106,8,2025-01-06,17,197,246,443,WebBN_T,"-37.82293543, 144.9471751"
751920240928,75,2024-09-28,19,114,31,145,SprFli_T,"-37.81515276, 144.97467661"
751920241015,75,2024-10-15,19,24,24,48,SprFli_T,"-37.81515276, 144.97467661"
81820250824,8,2025-08-24,18,131,227,358,WebBN_T,"-37.82293543, 144.9471751"
781720250503,78,2025-05-03,17,21,49,70,HarEsB_T,"-37.81471642, 144.9446508"
78620250505,78,2025-05-05,6,2,5,7,HarEsB_T,"-37.81471642, 144.9446508"
59720250315,59,2025-03-15,7,20,9,29,RMIT_T,"-37.80825648, 144.96304859"
141120240922,14,2024-09-22,11,316,106,422,SanBri_T,"-37.82011242, 144.96291897"
311020231105,31,2023-11-05,10,95,112,207,Lyg161_T,"-37.80169681, 144.96658911"
311420231111,31,2023-11-11,14,179,200,379,Lyg161_T,"-37.80169681, 144.96658911"
28420240801,28,2024-08-01,4,2,19,21,VAC_T,"-37.82129925, 144.96879309"
282320241012,28,2024-10-12,23,97,102,199,VAC_T,"-37.82129925, 144.96879309"
28020241107,28,2024-11-07,0,21,15,36,VAC_T,"-37.82129925, 144.96879309"
29720250829,29,2025-08-29,7,129,90,219,AG_T,"-37.8199817, 144.96872865"
401920241025,40,2024-10-25,19,113,219,332,Spr201_T,"-37.80999341, 144.97227587"
401620250616,40,2025-06-16,16,130,115,245,Spr201_T,"-37.80999341, 144.97227587"
36220241025,36,2024-10-25,2,15,7,22,Que85_T,"-37.81652527, 144.96121062"
36620250113,36,2025-01-13,6,42,17,59,Que85_T,"-37.81652527, 144.96121062"
371120240724,37,2024-07-24,11,69,87,156,Lyg260_T,"-37.80107122, 144.96704554"
37620241208,37,2024-12-08,6,5,11,16,Lyg260_T,"-37.80107122, 144.96704554"
472220240815,47,2024-08-15,22,275,251,526,Eli250_T,"-37.81258467, 144.9625775"
472320250412,47,2025-04-12,23,330,389,719,Eli250_T,"-37.81258467, 144.9625775"
47520250128,47,2025-01-28,5,18,35,53,Eli250_T,"-37.81258467, 144.9625775"
431320241129,43,2024-11-29,13,75,79,154,UM2_T,"-37.79844526, 144.96411782"
43020250406,43,2025-04-06,0,50,10,60,UM2_T,"-37.79844526, 144.96411782"
442220240212,44,2024-02-12,22,8,2,10,UM3_T,"-37.79698741, 144.96441306"
1401420240223,140,2024-02-23,14,101,65,166,Boyd2837_T,"-37.82590962, 144.96185972"
1311220240916,131,2024-09-16,12,151,167,318,King2_T,"-37.82009057, 144.95758725"
1241220250204,124,2025-02-04,12,9,6,15,BirBridge_T,"-37.81757416, 144.97329934"
871920250901,87,2025-09-01,19,65,81,146,Errol23_T,"-37.80454949, 144.94921863"
1841520250826,184,2025-08-26,15,647,870,1517,Eli124_T,"-37.81512416, 144.96371988"
1652320250923,165,2025-09-23,23,3,0,3,Spen475_T,"-37.80953359, 144.94939004"
67020250429,67,2025-04-29,0,9,4,13,FLDegS_T,"-37.81688755, 144.96562569"
851820240421,85,2024-04-21,18,51,36,87,488Mac_T,"-37.79432415, 144.92973378"
852120250319,85,2025-03-19,21,12,25,37,488Mac_T,"-37.79432415, 144.92973378"
17820250505,17,2025-05-05,8,1113,193,1306,Col15_T,"-37.81362543, 144.97323591"
672320250802,67,2025-08-02,23,124,269,393,FLDegS_T,"-37.81688755, 144.96562569"
682120231108,68,2023-11-08,21,36,4,40,FLDegN_T,"-37.8168479, 144.96559789"
63220241031,63,2024-10-31,2,7,52,59,Bou231_T,"-37.81333081, 144.96675571"
111320240922,11,2024-09-22,13,111,118,229,WatCit_T,"-37.81564989, 144.93970694"
111720241003,11,2024-10-03,17,190,176,366,WatCit_T,"-37.81564989, 144.93970694"
721420250725,72,2025-07-25,14,279,513,792,ACMI_T,"-37.81726338, 144.96872809"
21920241217,2,2024-12-17,19,514,475,989,Bou283_T,"-37.81380668, 144.96516718"
761420240229,76,2024-02-29,14,56,44,100,KenMac_T,"-37.79453803, 144.93036194"
531720231101,53,2023-11-01,17,669,416,1085,Col254_T,"-37.81564191, 144.965499"
91920250505,9,2025-05-05,19,170,66,236,Col700_T,"-37.81982992, 144.95102555"
79920241130,79,2024-11-30,9,222,157,379,FliSS_T,"-37.81794046, 144.96616678"
511720240714,51,2024-07-14,17,97,95,192,Fra118_T,"-37.80841815, 144.95906316"
49920231103,49,2023-11-03,9,53,98,151,Eli501_T,"-37.80730068, 144.95956055"
191420241017,19,2024-10-17,14,390,407,797,LtB210_T,"-37.81237202, 144.96550671"
252120240209,25,2024-02-09,21,527,313,840,MCEC_T,"-37.82401776, 144.95604426"
251220250318,25,2025-03-18,12,461,543,1004,MCEC_T,"-37.82401776, 144.95604426"
52320250823,52,2025-08-23,3,92,25,117,Eli263_T,"-37.81252157, 144.9619401"
180520250710,180,2025-07-10,5,3,1,4,Mac330_T,"-37.79497059, 144.93530329"
1801220250922,180,2025-09-22,12,49,29,78,Mac330_T,"-37.79497059, 144.93530329"
141920250530,141,2025-05-30,9,92,100,192,474Fl_T,"-37.81997273, 144.95834911"
19420250817,19,2025-08-17,4,18,26,44,LtB210_T,"-37.81237202, 144.96550671"
1391420240717,139,2024-07-17,14,55,42,97,Signal1647_T,"-37.81959923, 144.9632832"
1301320241201,130,2024-12-01,13,39,28,67,Bou892T,"-37.8204637, 144.94126826"
491520240603,49,2024-06-03,15,200,198,398,Eli501_T,"-37.80730068, 144.95956055"
41920240505,41,2024-05-05,9,694,421,1115,Swa31,"-37.81668634, 144.96689733"
411220250331,41,2025-03-31,12,1560,1504,3064,Swa31,"-37.81668634, 144.96689733"
41620240826,41,2024-08-26,6,40,50,90,Swa31,"-37.81668634, 144.96689733"
78220250424,78,2025-04-24,2,2,3,5,HarEsB_T,"-37.81471642, 144.9446508"
59420250206,59,2025-02-06,4,4,4,8,RMIT_T,"-37.80825648, 144.96304859"
141820250304,14,2025-03-04,18,543,160,703,SanBri_T,"-37.82011242, 144.96291897"
47720240514,47,2024-05-14,7,116,270,386,Eli250_T,"-37.81258467, 144.9625775"
40320240815,40,2024-08-15,3,0,2,2,Spr201_T,"-37.80999341, 144.97227587"
441220240312,44,2024-03-12,12,79,68,147,UM3_T,"-37.79698741, 144.96441306"
451520231203,45,2023-12-03,15,706,1563,2269,Swa148_T,"-37.81414075, 144.96609379"
1331220250907,133,2025-09-07,12,304,321,625,Spen229_T,"-37.81531435, 144.95227769"
1331420251014,133,2025-10-14,14,409,421,830,Spen229_T,"-37.81531435, 144.95227769"
133220241106,133,2024-11-06,2,10,8,18,Spen229_T,"-37.81531435, 144.95227769"
1082220241113,108,2024-11-13,22,84,74,158,261Will_T,"-37.81295822, 144.95678789"
612220250512,61,2025-05-12,22,180,55,235,RMIT14_T,"-37.80767455, 144.96309114"
1792220250910,179,2025-09-10,22,23,29,52,Pow61_T,"-37.82392385, 144.96299677"
131720250327,131,2025-03-27,7,88,27,115,King2_T,"-37.82009057, 144.95758725"
1621720250317,162,2025-03-17,17,402,461,863,Eli489_T,"-37.80740397, 144.95987909"
182320250809,182,2025-08-09,3,64,81,145,King163_T,"-37.81627451, 144.95550503"
1432120240601,143,2024-06-01,21,294,397,691,Spencer_T,"-37.821728, 144.95557015"
1431120240910,143,2024-09-10,11,130,170,300,Spencer_T,"-37.821728, 144.95557015"
132320250122,132,2025-01-22,3,8,12,20,King335_T,"-37.81267639, 144.95386444"
171320250823,17,2025-08-23,13,238,163,401,Col15_T,"-37.81362543, 144.97323591"
67920240208,67,2024-02-08,9,401,243,644,FLDegS_T,"-37.81688755, 144.96562569"
631520240816,63,2024-08-16,15,276,340,616,Bou231_T,"-37.81333081, 144.96675571"
681120240217,68,2024-02-17,11,275,178,453,FLDegN_T,"-37.8168479, 144.96559789"
621320250105,62,2025-01-05,13,182,97,279,Lat224_T,"-37.80996494, 144.96216521"
86820240503,86,2024-05-03,8,48,35,83,574Qub_T,"-37.80309992, 144.94908064"
122320250117,12,2025-01-17,23,67,97,164,NewQ_T,"-37.81457988, 144.94292398"
121820240425,12,2024-04-25,18,155,197,352,NewQ_T,"-37.81457988, 144.94292398"
35120250110,35,2025-01-10,1,44,73,117,SouthB_T,"-37.82018685, 144.96508508"
52320250316,52,2025-03-16,3,86,56,142,Eli263_T,"-37.81252157, 144.9619401"
1372220240106,137,2024-01-06,22,6,5,11,BouHbr2353_T,"-37.81894815, 144.94612292"
141620231224,141,2023-12-24,6,25,22,47,474Fl_T,"-37.81997273, 144.95834911"
139720250614,139,2025-06-14,7,3,8,11,Signal1647_T,"-37.81959923, 144.9632832"
37820250825,37,2025-08-25,8,22,31,53,Lyg260_T,"-37.80107122, 144.96704554"
431820250218,43,2025-02-18,18,133,78,211,UM2_T,"-37.79844526, 144.96411782"
452020250713,45,2025-07-13,20,173,575,748,Swa148_T,"-37.81414075, 144.96609379"
45320250527,45,2025-05-27,3,13,9,22,Swa148_T,"-37.81414075, 144.96609379"
1082220231113,108,2023-11-13,22,86,37,123,261Will_T,"-37.81295822, 144.95678789"
871220240313,87,2024-03-13,12,197,156,353,Errol23_T,"-37.80454949, 144.94921863"
871320240321,87,2024-03-21,13,134,170,304,Errol23_T,"-37.80454949, 144.94921863"
61820250218,61,2025-02-18,8,852,448,1300,RMIT14_T,"-37.80767455, 144.96309114"
1621120250318,162,2025-03-18,11,594,719,1313,Eli489_T,"-37.80740397, 144.95987909"
1431820250626,143,2025-06-26,18,121,175,296,Spencer_T,"-37.821728, 144.95557015"
691820250605,69,2025-06-05,18,57,60,117,FLDegC_T,"-37.81687226, 144.96559144"
621520250920,62,2025-09-20,15,329,257,586,Lat224_T,"-37.80996494, 144.96216521"
631420250319,63,2025-03-19,14,313,384,697,Bou231_T,"-37.81333081, 144.96675571"
631820250627,63,2025-06-27,18,214,414,628,Bou231_T,"-37.81333081, 144.96675571"
62420240214,62,2024-02-14,4,12,15,27,Lat224_T,"-37.80996494, 144.96216521"
561820250624,56,2025-06-24,18,312,349,661,Lon364_T,"-37.81234775, 144.96153311"
72420250127,72,2025-01-27,4,1,1,2,ACMI_T,"-37.81726338, 144.96872809"
58120231120,58,2023-11-20,1,39,38,77,Bou688_T,"-37.81686075, 144.95358075"
27920250202,27,2025-02-02,9,108,120,228,Vic_T,"-37.80606888, 144.95644692"
91320240812,9,2024-08-12,13,516,434,950,Col700_T,"-37.81982992, 144.95102555"
272220250830,27,2025-08-30,22,67,44,111,Vic_T,"-37.80606888, 144.95644692"
301420250327,30,2025-03-27,14,247,341,588,Lon189_T,"-37.8112185, 144.96656806"
30420231128,30,2023-11-28,4,6,10,16,Lon189_T,"-37.8112185, 144.96656806"
20120240208,20,2024-02-08,1,11,16,27,LtB170_T,"-37.81172914, 144.9682466"
1172020240208,117,2024-02-08,20,113,173,286,Fli114F_T,"-37.81629332, 144.97090877"
1171420240423,117,2024-04-23,14,128,166,294,Fli114F_T,"-37.81629332, 144.97090877"
251520250820,25,2025-08-20,15,653,527,1180,MCEC_T,"-37.82401776, 144.95604426"
1371920241105,137,2024-11-05,19,9,12,21,BouHbr2353_T,"-37.81894815, 144.94612292"
1371920240207,137,2024-02-07,19,13,22,35,BouHbr2353_T,"-37.81894815, 144.94612292"
1392220240408,139,2024-04-08,22,2,0,2,Signal1647_T,"-37.81959923, 144.9632832"
1421120241023,142,2024-10-23,11,229,256,485,Hammer1584_T,"-37.81970749, 144.96795734"
130920240401,130,2024-04-01,9,3,20,23,Bou892T,"-37.8204637, 144.94126826"
6120250530,6,2025-05-30,1,24,33,57,FliS_T,"-37.81911705, 144.96558255"
8120240916,8,2024-09-16,1,3,5,8,WebBN_T,"-37.82293543, 144.9471751"
78820241026,78,2024-10-26,8,29,35,64,HarEsB_T,"-37.81471642, 144.9446508"
651420240706,65,2024-07-06,14,1187,926,2113,SwaCs_T,"-37.81569416, 144.9668064"
1422020231226,142,2023-12-26,20,434,572,1006,Hammer1584_T,"-37.81970749, 144.96795734"
1421320240822,142,2024-08-22,13,560,368,928,Hammer1584_T,"-37.81970749, 144.96795734"
1381220250919,138,2025-09-19,12,5,9,14,EntPark1671_T,"-37.81996544, 144.95981454"
123020240120,123,2024-01-20,0,8,0,8,BirBridge_T,"-37.81753741, 144.97329734"
49120250219,49,2025-02-19,1,42,31,73,Eli501_T,"-37.80730068, 144.95956055"
49720240208,49,2024-02-08,7,49,87,136,Eli501_T,"-37.80730068, 144.95956055"
109120250710,109,2025-07-10,1,4,9,13,LatWill_T,"-37.81193681, 144.95621105"
84320240721,84,2024-07-21,3,90,120,210,ElFi_T,"-37.81798049, 144.96503383"
75820250121,75,2025-01-21,8,89,68,157,SprFli_T,"-37.81515276, 144.97467661"
82320250923,8,2025-09-23,23,5,2,7,WebBN_T,"-37.82293543, 144.9471751"
782220231128,78,2023-11-28,22,11,7,18,HarEsB_T,"-37.81471642, 144.9446508"
29320250428,29,2025-04-28,3,1,2,3,AG_T,"-37.8199817, 144.96872865"
541820240211,54,2024-02-11,18,139,86,225,Swa607_T,"-37.804024, 144.96308399"
54320240806,54,2024-08-06,3,11,6,17,Swa607_T,"-37.804024, 144.96308399"
21520240115,21,2024-01-15,5,15,11,26,Bourke155_T,"-37.81267313, 144.96788288"
50720250424,50,2025-04-24,7,18,28,46,Lyg309_T,"-37.79808192, 144.96721013"
50420250430,50,2025-04-30,4,8,0,8,Lyg309_T,"-37.79808192, 144.96721013"
451820240331,45,2024-03-31,18,831,1135,1966,Swa148_T,"-37.81414075, 144.96609379"
135220250811,135,2025-08-11,2,8,6,14,Spen161_T,"-37.8172861, 144.95319102"
1351420250814,135,2025-08-14,14,361,385,746,Spen161_T,"-37.8172861, 144.95319102"
1071220240721,107,2024-07-21,12,111,159,270,280Will_T,"-37.81246271, 144.95690188"
1071220231101,107,2023-11-01,12,166,171,337,280Will_T,"-37.81246271, 144.95690188"
118120241005,118,2024-10-05,1,0,3,3,Fli114C_T,"-37.81632783, 144.97090512"
108420240921,108,2024-09-21,4,3,7,10,261Will_T,"-37.81295822, 144.95678789"
872320250121,87,2025-01-21,23,9,15,24,Errol23_T,"-37.80454949, 144.94921863"
87720250421,87,2025-04-21,7,15,7,22,Errol23_T,"-37.80454949, 144.94921863"
611120250109,61,2025-01-09,11,156,256,412,RMIT14_T,"-37.80767455, 144.96309114"
179420251004,179,2025-10-04,4,6,2,8,Pow61_T,"-37.82392385, 144.96299677"
165720250930,165,2025-09-30,7,3,15,18,Spen475_T,"-37.80953359, 144.94939004"
1652220241215,165,2024-12-15,22,26,8,34,Spen475_T,"-37.80953359, 144.94939004"
181220250613,181,2025-06-13,2,37,66,103,Eli368_T,"-37.81009465, 144.96143149"
1811320250628,181,2025-06-28,13,682,1133,1815,Eli368_T,"-37.81009465, 144.96143149"
1401420231113,140,2023-11-13,14,56,51,107,Boyd2837_T,"-37.82590962, 144.96185972"
1311820250609,131,2025-06-09,18,134,34,168,King2_T,"-37.82009057, 144.95758725"
1432120250116,143,2025-01-16,21,168,139,307,Spencer_T,"-37.821728, 144.95557015"
134220250606,134,2025-06-06,2,12,14,26,Spen201_T,"-37.81694221, 144.95303935"
134920250224,134,2025-02-24,9,275,392,667,Spen201_T,"-37.81694221, 144.95303935"
851920240309,85,2024-03-09,19,35,29,64,488Mac_T,"-37.79432415, 144.92973378"
171120250706,17,2025-07-06,11,154,130,284,Col15_T,"-37.81362543, 144.97323591"
1120240213,1,2024-02-13,1,15,22,37,Bou292_T,"-37.81349441, 144.96515323"
631020240313,63,2024-03-13,10,205,251,456,Bou231_T,"-37.81333081, 144.96675571"
1620250814,1,2025-08-14,6,29,49,78,Bou292_T,"-37.81349441, 144.96515323"
861220231117,86,2023-11-17,12,67,53,120,574Qub_T,"-37.80309992, 144.94908064"
11220240407,11,2024-04-07,2,7,10,17,WatCit_T,"-37.81564989, 144.93970694"
11420251005,1,2025-10-05,14,1389,1451,2840,Bou292_T,"-37.81349441, 144.96515323"
56120250527,56,2025-05-27,1,3,8,11,Lon364_T,"-37.81234775, 144.96153311"
241520240527,24,2024-05-27,15,572,967,1539,Col620_T,"-37.81887963, 144.95449198"
111320250404,11,2025-04-04,13,78,66,144,WatCit_T,"-37.81564989, 144.93970694"
102220231026,10,2023-10-26,22,11,15,26,BouHbr_T,"-37.81876474, 144.94710545"
10420251013,10,2025-10-13,4,1,0,1,BouHbr_T,"-37.81876474, 144.94710545"
351220240603,35,2024-06-03,12,867,875,1742,SouthB_T,"-37.82018685, 144.96508508"
2920251016,2,2025-10-16,9,212,342,554,Bou283_T,"-37.81380668, 144.96516718"
27820241213,27,2024-12-13,8,85,83,168,Vic_T,"-37.80606888, 144.95644692"
271220250108,27,2025-01-08,12,106,103,209,Vic_T,"-37.80606888, 144.95644692"
27020250209,27,2025-02-09,0,36,19,55,Vic_T,"-37.80606888, 144.95644692"
53120250916,53,2025-09-16,1,10,5,15,Col254_T,"-37.81564191, 144.965499"
531220240804,53,2024-08-04,12,748,492,1240,Col254_T,"-37.81564191, 144.965499"
792220240308,79,2024-03-08,22,434,1135,1569,FliSS_T,"-37.81794046, 144.96616678"
521920240229,52,2024-02-29,19,365,341,706,Eli263_T,"-37.81252157, 144.9619401"
292020250128,29,2025-01-28,20,151,178,329,AG_T,"-37.8199817, 144.96872865"
292320250122,29,2025-01-22,23,48,77,125,AG_T,"-37.8199817, 144.96872865"
311420241119,31,2024-11-19,14,126,126,252,Lyg161_T,"-37.80169681, 144.96658911"
401620250720,40,2025-07-20,16,95,155,250,Spr201_T,"-37.80999341, 144.97227587"
401320240917,40,2024-09-17,13,370,320,690,Spr201_T,"-37.80999341, 144.97227587"
451620231019,45,2023-10-19,16,417,631,1048,Swa148_T,"-37.81414075, 144.96609379"
37620240528,37,2024-05-28,6,3,8,11,Lyg260_T,"-37.80107122, 144.96704554"
372320250308,37,2025-03-08,23,93,104,197,Lyg260_T,"-37.80107122, 144.96704554"
441420250402,44,2025-04-02,14,131,109,240,UM3_T,"-37.79698741, 144.96441306"
431820240522,43,2024-05-22,18,156,303,459,UM2_T,"-37.79844526, 144.96411782"
451220250127,45,2025-01-27,12,332,483,815,Swa148_T,"-37.81414075, 144.96609379"
107720240424,107,2024-04-24,7,33,82,115,280Will_T,"-37.81246271, 144.95690188"
1341420231101,134,2023-11-01,14,375,375,750,Spen201_T,"-37.81694221, 144.95303935"
1081920240326,108,2024-03-26,19,270,121,391,261Will_T,"-37.81295822, 144.95678789"
1182120240708,118,2024-07-08,21,2,4,6,Fli114C_T,"-37.81632783, 144.97090512"
1081920240309,108,2024-03-09,19,109,105,214,261Will_T,"-37.81295822, 144.95678789"
872320251010,87,2025-10-10,23,22,35,57,Errol23_T,"-37.80454949, 144.94921863"
166820250923,166,2025-09-23,8,35,45,80,Spen484_T,"-37.80896733, 144.94931703"
167220250915,167,2025-09-15,2,1,0,1,Lat526_T,"-37.81304149, 144.95155955"
143420240902,143,2024-09-02,4,14,5,19,Spencer_T,"-37.821728, 144.95557015"
1431820241109,143,2024-11-09,18,224,356,580,Spencer_T,"-37.821728, 144.95557015"
1321520240625,132,2024-06-25,15,144,121,265,King335_T,"-37.81267639, 144.95386444"
1341520240814,134,2024-08-14,15,486,466,952,Spen201_T,"-37.81694221, 144.95303935"
135020240404,135,2024-04-04,0,21,34,55,Spen161_T,"-37.8172861, 144.95319102"
1352220250730,135,2025-07-30,22,79,99,178,Spen161_T,"-37.8172861, 144.95319102"
17620250302,17,2025-03-02,6,13,14,27,Col15_T,"-37.81362543, 144.97323591"
631120240618,63,2024-06-18,11,212,280,492,Bou231_T,"-37.81333081, 144.96675571"
67320231123,67,2023-11-23,3,2,6,8,FLDegS_T,"-37.81688755, 144.96562569"
622320250114,62,2025-01-14,23,58,44,102,Lat224_T,"-37.80996494, 144.96216521"
241920231021,24,2023-10-21,19,346,711,1057,Col620_T,"-37.81887963, 144.95449198"
241020231127,24,2023-11-27,10,593,392,985,Col620_T,"-37.81887963, 144.95449198"
1520250915,1,2025-09-15,5,2,11,13,Bou292_T,"-37.81349441, 144.96515323"
24920240103,24,2024-01-03,9,528,350,878,Col620_T,"-37.81887963, 144.95449198"
72220240731,72,2024-07-31,2,8,4,12,ACMI_T,"-37.81726338, 144.96872809"
581020250419,58,2025-04-19,10,707,180,887,Bou688_T,"-37.81686075, 144.95358075"
21520240224,2,2024-02-24,15,1287,1339,2626,Bou283_T,"-37.81380668, 144.96516718"
302320241011,30,2024-10-11,23,333,406,739,Lon189_T,"-37.8112185, 144.96656806"
79120231018,79,2023-10-18,1,36,26,62,FliSS_T,"-37.81794046, 144.96616678"
20520250218,20,2025-02-18,5,8,6,14,LtB170_T,"-37.81172914, 144.9682466"
521620241124,52,2024-11-24,16,401,306,707,Eli263_T,"-37.81252157, 144.9619401"
521220250719,52,2025-07-19,12,329,317,646,Eli263_T,"-37.81252157, 144.9619401"
461420250306,46,2025-03-06,14,148,134,282,Pel147_T,"-37.80240719, 144.9615673"
1092220240716,109,2024-07-16,22,62,39,101,LatWill_T,"-37.81193681, 144.95621105"
109720240414,109,2024-04-14,7,11,16,27,LatWill_T,"-37.81193681, 144.95621105"
481520250828,48,2025-08-28,15,272,142,414,QVMQ_T,"-37.80631581, 144.95866697"
511820250808,51,2025-08-08,18,118,82,200,Fra118_T,"-37.80841815, 144.95906316"
522120231103,52,2023-11-03,21,339,380,719,Eli263_T,"-37.81252157, 144.9619401"
52220231125,52,2023-11-25,2,68,63,131,Eli263_T,"-37.81252157, 144.9619401"
192120240102,19,2024-01-02,21,349,468,817,LtB210_T,"-37.81237202, 144.96550671"
482220250106,48,2025-01-06,22,19,37,56,QVMQ_T,"-37.80631581, 144.95866697"
481920250725,48,2025-07-25,19,151,138,289,QVMQ_T,"-37.80631581, 144.95866697"
20220250130,20,2025-01-30,2,6,4,10,LtB170_T,"-37.81172914, 144.9682466"
20620240126,20,2024-01-26,6,12,13,25,LtB170_T,"-37.81172914, 144.9682466"
251320250617,25,2025-06-17,13,355,365,720,MCEC_T,"-37.82401776, 144.95604426"
52520250531,52,2025-05-31,5,61,15,76,Eli263_T,"-37.81252157, 144.9619401"
1802220250505,180,2025-05-05,22,2,0,2,Mac330_T,"-37.79497059, 144.93530329"
1371820231218,137,2023-12-18,18,14,43,57,BouHbr2353_T,"-37.81894815, 144.94612292"
1411620240316,141,2024-03-16,16,195,197,392,474Fl_T,"-37.81997273, 144.95834911"
136120240526,136,2024-05-26,1,0,1,1,BirFed1120_T,"-37.8184141, 144.97357915"
1361920250321,136,2025-03-21,19,3043,36,3079,BirFed1120_T,"-37.8184141, 144.97357915"
1421620231109,142,2023-11-09,16,258,280,538,Hammer1584_T,"-37.81970749, 144.96795734"
1381620250404,138,2025-04-04,16,5,5,10,EntPark1671_T,"-37.81996544, 144.95981454"
1091420250204,109,2025-02-04,14,149,91,240,LatWill_T,"-37.81193681, 144.95621105"
109220250315,109,2025-03-15,2,16,19,35,LatWill_T,"-37.81193681, 144.95621105"
84620231226,84,2023-12-26,6,67,44,111,ElFi_T,"-37.81798049, 144.96503383"
3920250326,3,2025-03-26,9,260,301,561,Swa295_T,"-37.81101524, 144.96429485"
781620231210,78,2023-12-10,16,61,75,136,HarEsB_T,"-37.81471642, 144.9446508"
652120240516,65,2024-05-16,21,98,299,397,SwaCs_T,"-37.81569416, 144.9668064"
291020250511,29,2025-05-11,10,2705,565,3270,AG_T,"-37.8199817, 144.96872865"
40420250524,40,2025-05-24,4,2,5,7,Spr201_T,"-37.80999341, 144.97227587"
211420240809,21,2024-08-09,14,359,438,797,Bourke155_T,"-37.81267313, 144.96788288"
43620250705,43,2025-07-05,6,5,4,9,UM2_T,"-37.79844526, 144.96411782"
43120250906,43,2025-09-06,1,6,3,9,UM2_T,"-37.79844526, 144.96411782"
50220240807,50,2024-08-07,2,3,1,4,Lyg309_T,"-37.79808192, 144.96721013"
442220241214,44,2024-12-14,22,3,5,8,UM3_T,"-37.79698741, 144.96441306"
45620241022,45,2024-10-22,6,71,68,139,Swa148_T,"-37.81414075, 144.96609379"
51420240511,5,2024-05-11,14,961,1282,2243,PriNW_T,"-37.81874249, 144.96787656"
135920241026,135,2024-10-26,9,258,333,591,Spen161_T,"-37.8172861, 144.95319102"
1311620231220,131,2023-12-20,16,139,107,246,King2_T,"-37.82009057, 144.95758725"
107620250508,107,2025-05-08,6,13,19,32,280Will_T,"-37.81246271, 144.95690188"
1071820250808,107,2025-08-08,18,133,147,280,280Will_T,"-37.81246271, 144.95690188"
1181320240306,118,2024-03-06,13,22,16,38,Fli114C_T,"-37.81632783, 144.97090512"
1081820231224,108,2023-12-24,18,112,122,234,261Will_T,"-37.81295822, 144.95678789"
611720250317,61,2025-03-17,17,992,1618,2610,RMIT14_T,"-37.80767455, 144.96309114"
611820250929,61,2025-09-29,18,379,481,860,RMIT14_T,"-37.80767455, 144.96309114"
61420251008,61,2025-10-08,4,13,12,25,RMIT14_T,"-37.80767455, 144.96309114"
1671920250926,167,2025-09-26,19,9,20,29,Lat526_T,"-37.81304149, 144.95155955"
1321720241115,132,2024-11-15,17,241,177,418,King335_T,"-37.81267639, 144.95386444"
85320240315,85,2024-03-15,3,1,0,1,488Mac_T,"-37.79432415, 144.92973378"
1920240120,1,2024-01-20,9,275,401,676,Bou292_T,"-37.81349441, 144.96515323"
561220240302,56,2024-03-02,12,343,267,610,Lon364_T,"-37.81234775, 144.96153311"
86620250412,86,2025-04-12,6,1,1,2,574Qub_T,"-37.80309992, 144.94908064"
561620250914,56,2025-09-14,16,374,398,772,Lon364_T,"-37.81234775, 144.96153311"
112320250525,11,2025-05-25,23,3,4,7,WatCit_T,"-37.81564989, 144.93970694"
72320240903,72,2024-09-03,3,1,2,3,ACMI_T,"-37.81726338, 144.96872809"
58820240825,58,2024-08-25,8,180,100,280,Bou688_T,"-37.81686075, 144.95358075"
27120241015,27,2024-10-15,1,8,2,10,Vic_T,"-37.80606888, 144.95644692"
271820231225,27,2023-12-25,18,65,36,101,Vic_T,"-37.80606888, 144.95644692"
302220231130,30,2023-11-30,22,243,368,611,Lon189_T,"-37.8112185, 144.96656806"
92120250602,9,2025-06-02,21,42,27,69,Col700_T,"-37.81982992, 144.95102555"
52820231022,52,2023-10-22,8,36,56,92,Eli263_T,"-37.81252157, 144.9619401"
23220250906,23,2025-09-06,2,11,17,28,Col623_T,"-37.81909256, 144.95452748"
511020240113,51,2024-01-13,10,118,100,218,Fra118_T,"-37.80841815, 144.95906316"
482020250924,48,2025-09-24,20,166,232,398,QVMQ_T,"-37.80631581, 144.95866697"
19620250117,19,2025-01-17,6,17,11,28,LtB210_T,"-37.81237202, 144.96550671"
251020241124,25,2024-11-24,10,55,252,307,MCEC_T,"-37.82401776, 144.95604426"
52820250305,52,2025-03-05,8,169,378,547,Eli263_T,"-37.81252157, 144.9619401"
521620240917,52,2024-09-17,16,292,222,514,Eli263_T,"-37.81252157, 144.9619401"
1371320240101,137,2024-01-01,13,12,33,45,BouHbr2353_T,"-37.81894815, 144.94612292"
1361520231115,136,2023-11-15,15,63,56,119,BirFed1120_T,"-37.8184141, 144.97357915"
1362120240505,136,2024-05-05,21,2,0,2,BirFed1120_T,"-37.8184141, 144.97357915"
161720250907,161,2025-09-07,7,30,57,87,BirArt1109_T,"-37.81851276, 144.97131336"
1381520231201,138,2023-12-01,15,18,6,24,EntPark1671_T,"-37.81996544, 144.95981454"
1091720250315,109,2025-03-15,17,84,127,211,LatWill_T,"-37.81193681, 144.95621105"
491420231227,49,2023-12-27,14,199,199,398,Eli501_T,"-37.80730068, 144.95956055"
751120250401,75,2025-04-01,11,44,37,81,SprFli_T,"-37.81515276, 144.97467661"
75820250407,75,2025-04-07,8,66,47,113,SprFli_T,"-37.81515276, 144.97467661"
75420250610,75,2025-06-10,4,2,0,2,SprFli_T,"-37.81515276, 144.97467661"
781620240726,78,2024-07-26,16,32,116,148,HarEsB_T,"-37.81471642, 144.9446508"
771520240925,77,2024-09-25,15,108,82,190,HarEsP_T,"-37.81441438, 144.94433026"
77420240927,77,2024-09-27,4,1,6,7,HarEsP_T,"-37.81441438, 144.94433026"
771420250507,77,2025-05-07,14,82,50,132,HarEsP_T,"-37.81441438, 144.94433026"
78620250625,78,2025-06-25,6,0,6,6,HarEsB_T,"-37.81471642, 144.9446508"
59620250510,59,2025-05-10,6,11,28,39,RMIT_T,"-37.80825648, 144.96304859"
29120240822,29,2024-08-22,1,1,9,10,AG_T,"-37.8199817, 144.96872865"
291120250626,29,2025-06-26,11,220,155,375,AG_T,"-37.8199817, 144.96872865"
541920240523,54,2024-05-23,19,152,252,404,Swa607_T,"-37.804024, 144.96308399"
282120240415,28,2024-04-15,21,108,196,304,VAC_T,"-37.82129925, 144.96879309"
282320250417,28,2025-04-17,23,138,457,595,VAC_T,"-37.82129925, 144.96879309"
281620240617,28,2024-06-17,16,255,845,1100,VAC_T,"-37.82129925, 144.96879309"
471420240908,47,2024-09-08,14,1017,946,1963,Eli250_T,"-37.81258467, 144.9625775"
471720240302,47,2024-03-02,17,1171,899,2070,Eli250_T,"-37.81258467, 144.9625775"
692320241119,69,2024-11-19,23,1,0,1,FLDegC_T,"-37.81687226, 144.96559144"
661820240306,66,2024-03-06,18,1456,1366,2822,QVN_T,"-37.81057846, 144.96444294"
32220240805,3,2024-08-05,22,330,320,650,Swa295_T,"-37.81101524, 144.96429485"
392320240608,39,2024-06-08,23,24,45,69,AlfPl_T,"-37.81379749, 144.96995745"
422320241113,42,2024-11-13,23,29,17,46,UM1_T,"-37.80008566, 144.96386412"
14120250808,14,2025-08-08,1,3,0,3,SanBri_T,"-37.82011242, 144.96291897"
711920250405,71,2025-04-05,19,15,4,19,WestWP_T,"-37.81235775, 144.97136962"
71520240620,71,2024-06-20,5,1,1,2,WestWP_T,"-37.81235775, 144.97136962"
40320241022,40,2024-10-22,3,2,3,5,Spr201_T,"-37.80999341, 144.97227587"
361620240723,36,2024-07-23,16,160,221,381,Que85_T,"-37.81652527, 144.96121062"
371520240423,37,2024-04-23,15,84,104,188,Lyg260_T,"-37.80107122, 144.96704554"
37920240516,37,2024-05-16,9,57,65,122,Lyg260_T,"-37.80107122, 144.96704554"
37620250214,37,2025-02-14,6,6,5,11,Lyg260_T,"-37.80107122, 144.96704554"
471120250820,47,2025-08-20,11,578,684,1262,Eli250_T,"-37.81258467, 144.9625775"
502220240131,50,2024-01-31,22,120,47,167,Lyg309_T,"-37.79808192, 144.96721013"
501120250403,50,2025-04-03,11,153,140,293,Lyg309_T,"-37.79808192, 144.96721013"
50320240220,50,2024-02-20,3,3,0,3,Lyg309_T,"-37.79808192, 144.96721013"
5720240701,5,2024-07-01,7,125,337,462,PriNW_T,"-37.81874249, 144.96787656"
36620231228,36,2023-12-28,6,22,20,42,Que85_T,"-37.81652527, 144.96121062"
1401020240123,140,2024-01-23,10,81,40,121,Boyd2837_T,"-37.82590962, 144.96185972"
132320240322,132,2024-03-22,3,7,7,14,King335_T,"-37.81267639, 144.95386444"
131120240313,131,2024-03-13,1,19,20,39,King2_T,"-37.82009057, 144.95758725"
1311220240710,131,2024-07-10,12,167,207,374,King2_T,"-37.82009057, 144.95758725"
1312020250716,131,2025-07-16,20,73,60,133,King2_T,"-37.82009057, 144.95758725"
1351920240710,135,2024-07-10,19,123,143,266,Spen161_T,"-37.8172861, 144.95319102"
1332320250612,133,2025-06-12,23,121,55,176,Spen229_T,"-37.81531435, 144.95227769"
1331020240214,133,2024-02-14,10,449,473,922,Spen229_T,"-37.81531435, 144.95227769"
1082320240416,108,2024-04-16,23,19,28,47,261Will_T,"-37.81295822, 144.95678789"
108120240425,108,2024-04-25,1,5,17,22,261Will_T,"-37.81295822, 144.95678789"
1662020241007,166,2024-10-07,20,5,13,18,Spen484_T,"-37.80896733, 144.94931703"
1671720250907,167,2025-09-07,17,60,99,159,Lat526_T,"-37.81304149, 144.95155955"
1811520250614,181,2025-06-14,15,839,1126,1965,Eli368_T,"-37.81009465, 144.96143149"
1621920241009,162,2024-10-09,19,537,653,1190,Eli489_T,"-37.80740397, 144.95987909"
4120241205,4,2024-12-05,1,71,54,125,Swa123_T,"-37.81487988, 144.9660878"
70220250319,70,2025-03-19,2,0,1,1,Errol20_T,"-37.80456984, 144.94946228"
3120250412,3,2025-04-12,1,171,148,319,Swa295_T,"-37.81101524, 144.96429485"
391920250302,39,2025-03-02,19,21,18,39,AlfPl_T,"-37.81379749, 144.96995745"
412020250118,41,2025-01-18,20,1252,1069,2321,Swa31,"-37.81668634, 144.96689733"
41620250525,41,2025-05-25,6,32,24,56,Swa31,"-37.81668634, 144.96689733"
78020250421,78,2025-04-21,0,6,7,13,HarEsB_T,"-37.81471642, 144.9446508"
771420240609,77,2024-06-09,14,220,174,394,HarEsP_T,"-37.81441438, 144.94433026"
422320240906,42,2024-09-06,23,35,38,73,UM1_T,"-37.80008566, 144.96386412"
71020240210,71,2024-02-10,0,3,4,7,WestWP_T,"-37.81235775, 144.97136962"
542020240326,54,2024-03-26,20,121,195,316,Swa607_T,"-37.804024, 144.96308399"
54320250727,54,2025-07-27,3,22,2,24,Swa607_T,"-37.804024, 144.96308399"
281620231213,28,2023-12-13,16,378,901,1279,VAC_T,"-37.82129925, 144.96879309"
40520240808,40,2024-08-08,5,3,7,10,Spr201_T,"-37.80999341, 144.97227587"
43420250227,43,2025-02-27,4,0,1,1,UM2_T,"-37.79844526, 144.96411782"
1352320240214,135,2024-02-14,23,69,92,161,Spen161_T,"-37.8172861, 144.95319102"
135820231113,135,2023-11-13,8,264,366,630,Spen161_T,"-37.8172861, 144.95319102"
118520250826,118,2025-08-26,5,1,0,1,Fli114C_T,"-37.81632783, 144.97090512"
1082320250829,108,2025-08-29,23,78,64,142,261Will_T,"-37.81295822, 144.95678789"
118120240901,118,2024-09-01,1,0,2,2,Fli114C_T,"-37.81632783, 144.97090512"
871520240219,87,2024-02-19,15,120,134,254,Errol23_T,"-37.80454949, 144.94921863"
501920231207,50,2023-12-07,19,219,225,444,Lyg309_T,"-37.79808192, 144.96721013"
1401620250411,140,2025-04-11,16,22,14,36,Boyd2837_T,"-37.82590962, 144.96185972"
162420250508,162,2025-05-08,4,8,6,14,Eli489_T,"-37.80740397, 144.95987909"
143220240513,143,2024-05-13,2,20,3,23,Spencer_T,"-37.821728, 144.95557015"
1341320250119,134,2025-01-19,13,252,208,460,Spen201_T,"-37.81694221, 144.95303935"
252120250607,25,2025-06-07,21,165,179,344,MCEC_T,"-37.82401776, 144.95604426"
52120240813,52,2024-08-13,1,2,10,12,Eli263_T,"-37.81252157, 144.9619401"
462020240107,46,2024-01-07,20,22,38,60,Pel147_T,"-37.80240719, 144.9615673"
164820250306,164,2025-03-06,8,131,68,199,Lat526_T,"-37.813005, 144.95160411"
164220250624,164,2025-06-24,2,2,2,4,Lat526_T,"-37.813005, 144.95160411"
1372220240926,137,2024-09-26,22,3,1,4,BouHbr2353_T,"-37.81894815, 144.94612292"
139420241104,139,2024-11-04,4,1,0,1,Signal1647_T,"-37.81959923, 144.9632832"
1301320231219,130,2023-12-19,13,32,29,61,Bou892T,"-37.8204637, 144.94126826"
17820250427,17,2025-04-27,8,70,34,104,Col15_T,"-37.81362543, 144.97323591"
171520251016,17,2025-10-16,15,293,415,708,Col15_T,"-37.81362543, 144.97323591"
68620240625,68,2024-06-25,6,4,0,4,FLDegN_T,"-37.8168479, 144.96559789"
631320250702,63,2025-07-02,13,159,164,323,Bou231_T,"-37.81333081, 144.96675571"
621420241009,62,2024-10-09,14,242,243,485,Lat224_T,"-37.80996494, 144.96216521"
562220240309,56,2024-03-09,22,324,266,590,Lon364_T,"-37.81234775, 144.96153311"
862220240820,86,2024-08-20,22,2,21,23,574Qub_T,"-37.80309992, 144.94908064"
11720231214,11,2023-12-14,7,52,44,96,WatCit_T,"-37.81564989, 144.93970694"
242020240202,24,2024-02-02,20,335,474,809,Col620_T,"-37.81887963, 144.95449198"
121120241010,12,2024-10-10,11,88,153,241,NewQ_T,"-37.81457988, 144.94292398"
12420231204,12,2023-12-04,4,8,4,12,NewQ_T,"-37.81457988, 144.94292398"
101020250611,10,2025-06-11,10,59,50,109,BouHbr_T,"-37.81876474, 144.94710545"
722220231021,72,2023-10-21,22,595,478,1073,ACMI_T,"-37.81726338, 144.96872809"
351720250321,35,2025-03-21,17,2484,1751,4235,SouthB_T,"-37.82018685, 144.96508508"
271920231216,27,2023-12-16,19,89,67,156,Vic_T,"-37.80606888, 144.95644692"
582020250831,58,2025-08-31,20,185,179,364,Bou688_T,"-37.81686075, 144.95358075"
531820250815,53,2025-08-15,18,392,195,587,Col254_T,"-37.81564191, 144.965499"
9820231106,9,2023-11-06,8,83,1035,1118,Col700_T,"-37.81982992, 144.95102555"
512020240216,51,2024-02-16,20,61,48,109,Fra118_T,"-37.80841815, 144.95906316"
19120241012,19,2024-10-12,1,104,145,249,LtB210_T,"-37.81237202, 144.96550671"
192120250228,19,2025-02-28,21,533,714,1247,LtB210_T,"-37.81237202, 144.96550671"
252320240507,25,2024-05-07,23,57,37,94,MCEC_T,"-37.82401776, 144.95604426"
452020240514,45,2024-05-14,20,174,442,616,Swa148_T,"-37.81414075, 144.96609379"
452220240808,45,2024-08-08,22,209,279,488,Swa148_T,"-37.81414075, 144.96609379"
451420240220,45,2024-02-20,14,460,904,1364,Swa148_T,"-37.81414075, 144.96609379"
51720250428,5,2025-04-28,17,1024,782,1806,PriNW_T,"-37.81874249, 144.96787656"
201920250427,20,2025-04-27,19,336,428,764,LtB170_T,"-37.81172914, 144.9682466"
164220241022,164,2024-10-22,2,1,0,1,Lat526_T,"-37.813005, 144.95160411"
32020250908,3,2025-09-08,20,797,754,1551,Swa295_T,"-37.81101524, 144.96429485"
59020240902,59,2024-09-02,0,48,17,65,RMIT_T,"-37.80825648, 144.96304859"
29420241119,29,2024-11-19,4,6,7,13,AG_T,"-37.8199817, 144.96872865"
291720250807,29,2025-08-07,17,356,287,643,AG_T,"-37.8199817, 144.96872865"
141320241213,14,2024-12-13,13,300,116,416,SanBri_T,"-37.82011242, 144.96291897"
54920240114,54,2024-01-14,9,16,31,47,Swa607_T,"-37.804024, 144.96308399"
47220231018,47,2023-10-18,2,35,26,61,Eli250_T,"-37.81258467, 144.9625775"
47620240907,47,2024-09-07,6,25,60,85,Eli250_T,"-37.81258467, 144.9625775"
212120240816,21,2024-08-16,21,311,378,689,Bourke155_T,"-37.81267313, 144.96788288"
501220241204,50,2024-12-04,12,224,221,445,Lyg309_T,"-37.79808192, 144.96721013"
501220240427,50,2024-04-27,12,227,320,547,Lyg309_T,"-37.79808192, 144.96721013"
45720240515,45,2024-05-15,7,109,138,247,Swa148_T,"-37.81414075, 144.96609379"
1071720250902,107,2025-09-02,17,233,140,373,280Will_T,"-37.81246271, 144.95690188"
179020250421,179,2025-04-21,0,4,12,16,Pow61_T,"-37.82392385, 144.96299677"
179020250508,179,2025-05-08,0,2,0,2,Pow61_T,"-37.82392385, 144.96299677"
1672120240824,167,2024-08-24,21,3,23,26,Lat526_T,"-37.81304149, 144.95155955"
1401620231110,140,2023-11-10,16,75,76,151,Boyd2837_T,"-37.82590962, 144.96185972"
1351520240208,135,2024-02-08,15,406,378,784,Spen161_T,"-37.8172861, 144.95319102"
135720240713,135,2024-07-13,7,48,74,122,Spen161_T,"-37.8172861, 144.95319102"
1352320250921,135,2025-09-21,23,12,29,41,Spen161_T,"-37.8172861, 144.95319102"
142120250208,142,2025-02-08,1,2,2,4,Hammer1584_T,"-37.81970749, 144.96795734"
136020231111,136,2023-11-11,0,7,8,15,BirFed1120_T,"-37.8184141, 144.97357915"
852320250122,85,2025-01-22,23,3,0,3,488Mac_T,"-37.79432415, 144.92973378"
171320240728,17,2024-07-28,13,152,112,264,Col15_T,"-37.81362543, 144.97323591"
171520250706,17,2025-07-06,15,156,165,321,Col15_T,"-37.81362543, 144.97323591"
63620240809,63,2024-08-09,6,19,36,55,Bou231_T,"-37.81333081, 144.96675571"
181620250513,18,2025-05-13,16,579,96,675,Col12_T,"-37.81344862, 144.97305353"
67720250714,67,2025-07-14,7,144,139,283,FLDegS_T,"-37.81688755, 144.96562569"
621620240419,62,2024-04-19,16,272,175,447,Lat224_T,"-37.80996494, 144.96216521"
561220250214,56,2025-02-14,12,426,299,725,Lon364_T,"-37.81234775, 144.96153311"
56120250501,56,2025-05-01,1,8,11,19,Lon364_T,"-37.81234775, 144.96153311"
861920240610,86,2024-06-10,19,25,34,59,574Qub_T,"-37.80309992, 144.94908064"
12420241123,12,2024-11-23,4,2,4,6,NewQ_T,"-37.81457988, 144.94292398"
241620240922,24,2024-09-22,16,459,767,1226,Col620_T,"-37.81887963, 144.95449198"
10020240922,10,2024-09-22,0,7,6,13,BouHbr_T,"-37.81876474, 144.94710545"
721820241120,72,2024-11-20,18,280,562,842,ACMI_T,"-37.81726338, 144.96872809"
762220250204,76,2025-02-04,22,4,7,11,KenMac_T,"-37.79453803, 144.93036194"
761220251002,76,2025-10-02,12,70,56,126,KenMac_T,"-37.79453803, 144.93036194"
311320250112,31,2025-01-12,13,104,106,210,Lyg161_T,"-37.80169681, 144.96658911"
362120241218,36,2024-12-18,21,118,161,279,Que85_T,"-37.81652527, 144.96121062"
361020250210,36,2025-02-10,10,171,153,324,Que85_T,"-37.81652527, 144.96121062"
361920240717,36,2024-07-17,19,117,112,229,Que85_T,"-37.81652527, 144.96121062"
501120231216,50,2023-12-16,11,327,345,672,Lyg309_T,"-37.79808192, 144.96721013"
43620240911,43,2024-09-11,6,29,9,38,UM2_T,"-37.79844526, 144.96411782"
432120241126,43,2024-11-26,21,153,40,193,UM2_T,"-37.79844526, 144.96411782"
441420240531,44,2024-05-31,14,78,92,170,UM3_T,"-37.79698741, 144.96441306"
51620250911,5,2025-09-11,16,1081,677,1758,PriNW_T,"-37.81874249, 144.96787656"
362020250926,36,2025-09-26,20,128,143,271,Que85_T,"-37.81652527, 144.96121062"
143620250910,143,2025-09-10,6,57,105,162,Spencer_T,"-37.821728, 144.95557015"
1312120240602,131,2024-06-02,21,28,18,46,King2_T,"-37.82009057, 144.95758725"
1311620250530,131,2025-05-30,16,118,134,252,King2_T,"-37.82009057, 144.95758725"
135320241105,135,2024-11-05,3,38,23,61,Spen161_T,"-37.8172861, 144.95319102"
1332020240318,133,2024-03-18,20,382,322,704,Spen229_T,"-37.81531435, 144.95227769"
1811520250511,181,2025-05-11,15,738,1117,1855,Eli368_T,"-37.81009465, 144.96143149"
1811420250719,181,2025-07-19,14,780,1189,1969,Eli368_T,"-37.81009465, 144.96143149"
1622020241028,162,2024-10-28,20,191,153,344,Eli489_T,"-37.80740397, 144.95987909"
172120240630,17,2024-06-30,21,53,54,107,Col15_T,"-37.81362543, 144.97323591"
171320250530,17,2025-05-30,13,448,448,896,Col15_T,"-37.81362543, 144.97323591"
1420240218,1,2024-02-18,4,23,18,41,Bou292_T,"-37.81349441, 144.96515323"
181720240704,18,2024-07-04,17,100,17,117,Col12_T,"-37.81344862, 144.97305353"
631520250507,63,2025-05-07,15,340,373,713,Bou231_T,"-37.81333081, 144.96675571"
111620240113,11,2024-01-13,16,103,132,235,WatCit_T,"-37.81564989, 144.93970694"
241520240519,24,2024-05-19,15,487,852,1339,Col620_T,"-37.81887963, 144.95449198"
72220240516,72,2024-05-16,2,3,5,8,ACMI_T,"-37.81726338, 144.96872809"
72220240706,72,2024-07-06,2,3,15,18,ACMI_T,"-37.81726338, 144.96872809"
76120250812,76,2025-08-12,1,1,0,1,KenMac_T,"-37.79453803, 144.93036194"
351620250118,35,2025-01-18,16,1738,2049,3787,SouthB_T,"-37.82018685, 144.96508508"
35220250302,35,2025-03-02,2,90,149,239,SouthB_T,"-37.82018685, 144.96508508"
2120250818,2,2025-08-18,1,19,8,27,Bou283_T,"-37.81380668, 144.96516718"
9020250803,9,2025-08-03,0,7,14,21,Col700_T,"-37.81982992, 144.95102555"
531820240722,53,2024-07-22,18,272,220,492,Col254_T,"-37.81564191, 144.965499"
531720231205,53,2023-12-05,17,814,560,1374,Col254_T,"-37.81564191, 144.965499"
27120250608,27,2025-06-08,1,24,5,29,Vic_T,"-37.80606888, 144.95644692"
301820231215,30,2023-12-15,18,497,518,1015,Lon189_T,"-37.8112185, 144.96656806"
461220240206,46,2024-02-06,12,128,132,260,Pel147_T,"-37.80240719, 144.9615673"
51920250315,51,2025-03-15,9,85,102,187,Fra118_T,"-37.80841815, 144.95906316"
251520240112,25,2024-01-12,15,643,440,1083,MCEC_T,"-37.82401776, 144.95604426"
522220240905,52,2024-09-05,22,103,110,213,Eli263_T,"-37.81252157, 144.9619401"
1611520251008,161,2025-10-08,15,91,91,182,BirArt1109_T,"-37.81851276, 144.97131336"
1171220250713,117,2025-07-13,12,327,245,572,Fli114F_T,"-37.81629332, 144.97090877"
1091720231205,109,2023-12-05,17,488,197,685,LatWill_T,"-37.81193681, 144.95621105"
661820251005,66,2025-10-05,18,901,951,1852,QVN_T,"-37.81057846, 144.96444294"
691820231228,69,2023-12-28,18,146,120,266,FLDegC_T,"-37.81687226, 144.96559144"
351620241120,35,2024-11-20,16,1333,1088,2421,SouthB_T,"-37.82018685, 144.96508508"
9020250128,9,2025-01-28,0,2,6,8,Col700_T,"-37.81982992, 144.95102555"
302320241003,30,2024-10-03,23,181,175,356,Lon189_T,"-37.8112185, 144.96656806"
792220240117,79,2024-01-17,22,269,571,840,FliSS_T,"-37.81794046, 144.96616678"
79720240403,79,2024-04-03,7,215,109,324,FliSS_T,"-37.81794046, 144.96616678"
231520241201,23,2024-12-01,15,98,144,242,Col623_T,"-37.81909256, 144.95452748"
231220241103,23,2024-11-03,12,188,191,379,Col623_T,"-37.81909256, 144.95452748"
511520240706,51,2024-07-06,15,153,140,293,Fra118_T,"-37.80841815, 144.95906316"
52420241110,52,2024-11-10,4,32,25,57,Eli263_T,"-37.81252157, 144.9619401"
521620241203,52,2024-12-03,16,357,284,641,Eli263_T,"-37.81252157, 144.9619401"
52020240606,52,2024-06-06,0,8,24,32,Eli263_T,"-37.81252157, 144.9619401"
1171320240616,117,2024-06-16,13,96,200,296,Fli114F_T,"-37.81629332, 144.97090877"
49620240717,49,2024-07-17,6,31,22,53,Eli501_T,"-37.80730068, 144.95956055"
202220250404,20,2025-04-04,22,244,667,911,LtB170_T,"-37.81172914, 144.9682466"
1411020251010,141,2025-10-10,10,121,109,230,474Fl_T,"-37.81997273, 144.95834911"
1371920241122,137,2024-11-22,19,11,24,35,BouHbr2353_T,"-37.81894815, 144.94612292"
141720240113,141,2024-01-13,7,31,16,47,474Fl_T,"-37.81997273, 144.95834911"
1411220240306,141,2024-03-06,12,215,180,395,474Fl_T,"-37.81997273, 144.95834911"
139620251001,139,2025-10-01,6,18,23,41,Signal1647_T,"-37.81959923, 144.9632832"
1392220240305,139,2024-03-05,22,20,31,51,Signal1647_T,"-37.81959923, 144.9632832"
1351820240714,135,2024-07-14,18,129,138,267,Spen161_T,"-37.8172861, 144.95319102"
107520250310,107,2025-03-10,5,2,6,8,280Will_T,"-37.81246271, 144.95690188"
108920251010,108,2025-10-10,9,244,743,987,261Will_T,"-37.81295822, 144.95678789"
87420231126,87,2023-11-26,4,3,2,5,Errol23_T,"-37.80454949, 144.94921863"
1672120250518,167,2025-05-18,21,7,21,28,Lat526_T,"-37.81304149, 144.95155955"
17020240126,17,2024-01-26,0,42,40,82,Col15_T,"-37.81362543, 144.97323591"
171220251014,17,2025-10-14,12,910,766,1676,Col15_T,"-37.81362543, 144.97323591"
681920250713,68,2025-07-13,19,69,46,115,FLDegN_T,"-37.8168479, 144.96559789"
181520240119,18,2024-01-19,15,283,147,430,Col12_T,"-37.81344862, 144.97305353"
62420250123,62,2025-01-23,4,6,2,8,Lat224_T,"-37.80996494, 144.96216521"
621020250508,62,2025-05-08,10,141,122,263,Lat224_T,"-37.80996494, 144.96216521"
12320251013,1,2025-10-13,23,29,37,66,Bou292_T,"-37.81349441, 144.96515323"
12220240323,12,2024-03-23,2,3,20,23,NewQ_T,"-37.81457988, 144.94292398"
121020250606,12,2025-06-06,10,76,68,144,NewQ_T,"-37.81457988, 144.94292398"
722220240228,72,2024-02-28,22,175,133,308,ACMI_T,"-37.81726338, 144.96872809"
761220231129,76,2023-11-29,12,55,59,114,KenMac_T,"-37.79453803, 144.93036194"
721420251007,72,2025-10-07,14,193,363,556,ACMI_T,"-37.81726338, 144.96872809"
22320250607,2,2025-06-07,23,50,97,147,Bou283_T,"-37.81380668, 144.96516718"
35520231222,35,2023-12-22,5,65,47,112,SouthB_T,"-37.82018685, 144.96508508"
27320231104,27,2023-11-04,3,4,9,13,Vic_T,"-37.80606888, 144.95644692"
30620240713,30,2024-07-13,6,25,58,83,Lon189_T,"-37.8112185, 144.96656806"
52720250430,52,2025-04-30,7,68,90,158,Eli263_T,"-37.81252157, 144.9619401"
522220251010,52,2025-10-10,22,234,303,537,Eli263_T,"-37.81252157, 144.9619401"
20720250903,20,2025-09-03,7,40,59,99,LtB170_T,"-37.81172914, 144.9682466"
201920240101,20,2024-01-01,19,258,250,508,LtB170_T,"-37.81172914, 144.9682466"
522120240520,52,2024-05-20,21,178,91,269,Eli263_T,"-37.81252157, 144.9619401"
51820241102,51,2024-11-02,8,41,45,86,Fra118_T,"-37.80841815, 144.95906316"
511320231027,51,2023-10-27,13,134,122,256,Fra118_T,"-37.80841815, 144.95906316"
491320240709,49,2024-07-09,13,154,349,503,Eli501_T,"-37.80730068, 144.95956055"
481920240407,48,2024-04-07,19,86,130,216,QVMQ_T,"-37.80631581, 144.95866697"
1361720250909,136,2025-09-09,17,277,70,347,BirFed1120_T,"-37.8184141, 144.97357915"
1421220251002,142,2025-10-02,12,523,510,1033,Hammer1584_T,"-37.81970749, 144.96795734"
130020250202,130,2025-02-02,0,3,1,4,Bou892T,"-37.8204637, 144.94126826"
164820250513,164,2025-05-13,8,127,82,209,Lat526_T,"-37.813005, 144.95160411"
138720250328,138,2025-03-28,7,6,2,8,EntPark1671_T,"-37.81996544, 144.95981454"
1172220240410,117,2024-04-10,22,86,77,163,Fli114F_T,"-37.81629332, 144.97090877"
42320240924,4,2024-09-24,23,132,179,311,Swa123_T,"-37.81487988, 144.9660878"
41520250908,4,2025-09-08,15,1336,1101,2437,Swa123_T,"-37.81487988, 144.9660878"
701220240909,70,2024-09-09,12,147,161,308,Errol20_T,"-37.80456984, 144.94946228"
1351920231115,135,2023-11-15,19,217,239,456,Spen161_T,"-37.8172861, 144.95319102"
1331920240711,133,2024-07-11,19,344,332,676,Spen229_T,"-37.81531435, 144.95227769"
671320240129,67,2024-01-29,13,327,379,706,FLDegS_T,"-37.81688755, 144.96562569"
681120240322,68,2024-03-22,11,198,162,360,FLDegN_T,"-37.8168479, 144.96559789"
852220250603,85,2025-06-03,22,0,4,4,488Mac_T,"-37.79432415, 144.92973378"
12020250129,1,2025-01-29,20,360,304,664,Bou292_T,"-37.81349441, 144.96515323"
86520240727,86,2024-07-27,5,1,1,2,574Qub_T,"-37.80309992, 144.94908064"
862220250126,86,2025-01-26,22,5,23,28,574Qub_T,"-37.80309992, 144.94908064"
24520240723,24,2024-07-23,5,97,63,160,Col620_T,"-37.81887963, 144.95449198"
12320250127,12,2025-01-27,3,6,6,12,NewQ_T,"-37.81457988, 144.94292398"
10620231206,10,2023-12-06,6,16,62,78,BouHbr_T,"-37.81876474, 144.94710545"
10620231223,10,2023-12-23,6,11,9,20,BouHbr_T,"-37.81876474, 144.94710545"
10520240531,10,2024-05-31,5,0,3,3,BouHbr_T,"-37.81876474, 144.94710545"
722220241130,72,2024-11-30,22,243,379,622,ACMI_T,"-37.81726338, 144.96872809"
72520240101,72,2024-01-01,5,16,30,46,ACMI_T,"-37.81726338, 144.96872809"
721020240107,72,2024-01-07,10,106,173,279,ACMI_T,"-37.81726338, 144.96872809"
581920240512,58,2024-05-12,19,246,226,472,Bou688_T,"-37.81686075, 144.95358075"
352320240827,35,2024-08-27,23,118,220,338,SouthB_T,"-37.82018685, 144.96508508"
72320250529,72,2025-05-29,3,0,3,3,ACMI_T,"-37.81726338, 144.96872809"
91320231023,9,2023-10-23,13,329,331,660,Col700_T,"-37.81982992, 144.95102555"
9620240429,9,2024-04-29,6,33,349,382,Col700_T,"-37.81982992, 144.95102555"
91420250906,9,2025-09-06,14,93,118,211,Col700_T,"-37.81982992, 144.95102555"
51620250629,51,2025-06-29,6,5,7,12,Fra118_T,"-37.80841815, 144.95906316"
511620240517,51,2024-05-17,16,90,88,178,Fra118_T,"-37.80841815, 144.95906316"
79820251007,79,2025-10-07,8,375,270,645,FliSS_T,"-37.81794046, 144.96616678"
202320240608,20,2024-06-08,23,489,553,1042,LtB170_T,"-37.81172914, 144.9682466"
109020240131,109,2024-01-31,0,9,18,27,LatWill_T,"-37.81193681, 144.95621105"
19120250707,19,2025-07-07,1,21,61,82,LtB210_T,"-37.81237202, 144.96550671"
1802320250401,180,2025-04-01,23,0,2,2,Mac330_T,"-37.79497059, 144.93530329"
1371120231206,137,2023-12-06,11,36,79,115,BouHbr2353_T,"-37.81894815, 144.94612292"
1371520240317,137,2024-03-17,15,12,19,31,BouHbr2353_T,"-37.81894815, 144.94612292"
1391120231130,139,2023-11-30,11,24,39,63,Signal1647_T,"-37.81959923, 144.9632832"
1392320250206,139,2025-02-06,23,11,32,43,Signal1647_T,"-37.81959923, 144.9632832"
1422020250301,142,2025-03-01,20,337,247,584,Hammer1584_T,"-37.81970749, 144.96795734"
1421320241130,142,2024-11-30,13,279,199,478,Hammer1584_T,"-37.81970749, 144.96795734"
1381720250830,138,2025-08-30,17,4,8,12,EntPark1671_T,"-37.81996544, 144.95981454"
1611120240710,161,2024-07-10,11,99,143,242,BirArt1109_T,"-37.81851276, 144.97131336"
712320240926,71,2024-09-26,23,1,1,2,WestWP_T,"-37.81235775, 144.97136962"
36220240723,36,2024-07-23,2,3,2,5,Que85_T,"-37.81652527, 144.96121062"
212120240514,21,2024-05-14,21,156,226,382,Bourke155_T,"-37.81267313, 144.96788288"
5620250906,5,2025-09-06,6,32,74,106,PriNW_T,"-37.81874249, 144.96787656"
107020241013,107,2024-10-13,0,31,28,59,280Will_T,"-37.81246271, 144.95690188"
1071720250429,107,2025-04-29,17,218,151,369,280Will_T,"-37.81246271, 144.95690188"
1081220240414,108,2024-04-14,12,56,68,124,261Will_T,"-37.81295822, 144.95678789"
1081520240425,108,2024-04-25,15,53,87,140,261Will_T,"-37.81295822, 144.95678789"
871820240403,87,2024-04-03,18,144,100,244,Errol23_T,"-37.80454949, 144.94921863"
872320241121,87,2024-11-21,23,18,28,46,Errol23_T,"-37.80454949, 144.94921863"
871120250225,87,2025-02-25,11,99,76,175,Errol23_T,"-37.80454949, 144.94921863"
61020250429,61,2025-04-29,0,28,14,42,RMIT14_T,"-37.80767455, 144.96309114"
61320240314,61,2024-03-14,3,12,6,18,RMIT14_T,"-37.80767455, 144.96309114"
501720250921,50,2025-09-21,17,186,212,398,Lyg309_T,"-37.79808192, 144.96721013"
43620250209,43,2025-02-09,6,1,2,3,UM2_T,"-37.79844526, 144.96411782"
3220250516,3,2025-05-16,2,33,18,51,Swa295_T,"-37.81101524, 144.96429485"
32120250902,3,2025-09-02,21,700,547,1247,Swa295_T,"-37.81101524, 144.96429485"
82120250814,8,2025-08-14,21,31,22,53,WebBN_T,"-37.82293543, 144.9471751"
781020240605,78,2024-06-05,10,21,29,50,HarEsB_T,"-37.81471642, 144.9446508"
65420240105,65,2024-01-05,4,2,14,16,SwaCs_T,"-37.81569416, 144.9668064"
771420240506,77,2024-05-06,14,149,108,257,HarEsP_T,"-37.81441438, 144.94433026"
292120240702,29,2024-07-02,21,64,57,121,AG_T,"-37.8199817, 144.96872865"
141720240217,14,2024-02-17,17,925,199,1124,SanBri_T,"-37.82011242, 144.96291897"
28820241215,28,2024-12-15,8,93,95,188,VAC_T,"-37.82129925, 144.96879309"
312020250825,31,2025-08-25,20,104,122,226,Lyg161_T,"-37.80169681, 144.96658911"
211420240123,21,2024-01-23,14,377,478,855,Bourke155_T,"-37.81267313, 144.96788288"
47620240618,47,2024-06-18,6,61,218,279,Eli250_T,"-37.81258467, 144.9625775"
471920240813,47,2024-08-13,19,615,492,1107,Eli250_T,"-37.81258467, 144.9625775"
611820250121,61,2025-01-21,18,466,422,888,RMIT14_T,"-37.80767455, 144.96309114"
451920250426,45,2025-04-26,19,435,802,1237,Swa148_T,"-37.81414075, 144.96609379"
1311820240518,131,2024-05-18,18,110,70,180,King2_T,"-37.82009057, 144.95758725"
1311520240716,131,2024-07-16,15,119,119,238,King2_T,"-37.82009057, 144.95758725"
1621020250601,162,2025-06-01,10,559,494,1053,Eli489_T,"-37.80740397, 144.95987909"
132620250128,132,2025-01-28,6,26,8,34,King335_T,"-37.81267639, 144.95386444"
1072320240602,107,2024-06-02,23,18,17,35,280Will_T,"-37.81246271, 144.95690188"
133020240115,133,2024-01-15,0,65,33,98,Spen229_T,"-37.81531435, 144.95227769"
1182220250608,118,2025-06-08,22,55,6,61,Fli114C_T,"-37.81632783, 144.97090512"
1081820250904,108,2025-09-04,18,590,149,739,261Will_T,"-37.81295822, 144.95678789"
87020240324,87,2024-03-24,0,11,5,16,Errol23_T,"-37.80454949, 144.94921863"
1841020250825,184,2025-08-25,10,574,474,1048,Eli124_T,"-37.81512416, 144.96371988"
17220250608,17,2025-06-08,2,5,11,16,Col15_T,"-37.81362543, 144.97323591"
11020240326,1,2024-03-26,10,493,460,953,Bou292_T,"-37.81349441, 144.96515323"
56720240807,56,2024-08-07,7,62,54,116,Lon364_T,"-37.81234775, 144.96153311"
861820240410,86,2024-04-10,18,84,91,175,574Qub_T,"-37.80309992, 144.94908064"
861020250409,86,2025-04-09,10,49,63,112,574Qub_T,"-37.80309992, 144.94908064"
86920250717,86,2025-07-17,9,34,27,61,574Qub_T,"-37.80309992, 144.94908064"
101620240809,10,2024-08-09,16,157,56,213,BouHbr_T,"-37.81876474, 144.94710545"
241520231228,24,2023-12-28,15,377,738,1115,Col620_T,"-37.81887963, 144.95449198"
12220231206,12,2023-12-06,2,3,5,8,NewQ_T,"-37.81457988, 144.94292398"
102120241205,10,2024-12-05,21,57,26,83,BouHbr_T,"-37.81876474, 144.94710545"
561420250622,56,2025-06-22,14,514,455,969,Lon364_T,"-37.81234775, 144.96153311"
241420250627,24,2025-06-27,14,485,831,1316,Col620_T,"-37.81887963, 144.95449198"
761420240109,76,2024-01-09,14,49,45,94,KenMac_T,"-37.79453803, 144.93036194"
21320250126,2,2025-01-26,13,685,670,1355,Bou283_T,"-37.81380668, 144.96516718"
581620240101,58,2024-01-01,16,382,272,654,Bou688_T,"-37.81686075, 144.95358075"
27620231029,27,2023-10-29,6,13,9,22,Vic_T,"-37.80606888, 144.95644692"
27420240128,27,2024-01-28,4,7,2,9,Vic_T,"-37.80606888, 144.95644692"
9320231202,9,2023-12-02,3,15,18,33,Col700_T,"-37.81982992, 144.95102555"
53220240529,53,2024-05-29,2,0,2,2,Col254_T,"-37.81564191, 144.965499"
532020231103,53,2023-11-03,20,216,210,426,Col254_T,"-37.81564191, 144.965499"
9520241002,9,2024-10-02,5,19,58,77,Col700_T,"-37.81982992, 144.95102555"
92120250412,9,2025-04-12,21,55,38,93,Col700_T,"-37.81982992, 144.95102555"
791320241203,79,2024-12-03,13,501,357,858,FliSS_T,"-37.81794046, 144.96616678"
30320231030,30,2023-10-30,3,28,32,60,Lon189_T,"-37.8112185, 144.96656806"
511420240506,51,2024-05-06,14,91,65,156,Fra118_T,"-37.80841815, 144.95906316"
23420250623,23,2025-06-23,4,3,4,7,Col623_T,"-37.81909256, 144.95452748"
191420250224,19,2025-02-24,14,461,481,942,LtB210_T,"-37.81237202, 144.96550671"
25320250714,25,2025-07-14,3,2,2,4,MCEC_T,"-37.82401776, 144.95604426"
1412320250618,141,2025-06-18,23,23,26,49,474Fl_T,"-37.81997273, 144.95834911"
1371020250107,137,2025-01-07,10,22,40,62,BouHbr2353_T,"-37.81894815, 144.94612292"
1371220250127,137,2025-01-27,12,4,19,23,BouHbr2353_T,"-37.81894815, 144.94612292"
1651220250915,165,2025-09-15,12,35,34,69,Spen475_T,"-37.80953359, 144.94939004"
1311320250706,131,2025-07-06,13,151,128,279,King2_T,"-37.82009057, 144.95758725"
162420241031,162,2024-10-31,4,13,9,22,Eli489_T,"-37.80740397, 144.95987909"
1311120231202,131,2023-12-02,11,42,23,65,King2_T,"-37.82009057, 144.95758725"
1321720240617,132,2024-06-17,17,168,131,299,King335_T,"-37.81267639, 144.95386444"
134520250930,134,2025-09-30,5,50,81,131,Spen201_T,"-37.81694221, 144.95303935"
1321420250818,132,2025-08-18,14,114,110,224,King335_T,"-37.81267639, 144.95386444"
1321120250906,132,2025-09-06,11,181,104,285,King335_T,"-37.81267639, 144.95386444"
134520231219,134,2023-12-19,5,21,33,54,Spen201_T,"-37.81694221, 144.95303935"
1181820231119,118,2023-11-19,18,36,35,71,Fli114C_T,"-37.81632783, 144.97090512"
1241120250809,124,2025-08-09,11,4,34,38,BirBridge_T,"-37.81757416, 144.97329934"
661720250217,66,2025-02-17,17,1228,1513,2741,QVN_T,"-37.81057846, 144.96444294"
66820250422,66,2025-04-22,8,105,434,539,QVN_T,"-37.81057846, 144.96444294"
61320241110,6,2024-11-10,13,863,1022,1885,FliS_T,"-37.81911705, 144.96558255"
841820250422,84,2025-04-22,18,895,1411,2306,ElFi_T,"-37.81798049, 144.96503383"
842020250731,84,2025-07-31,20,502,898,1400,ElFi_T,"-37.81798049, 144.96503383"
42020240111,4,2024-01-11,20,984,896,1880,Swa123_T,"-37.81487988, 144.9660878"
4220250413,4,2025-04-13,2,128,227,355,Swa123_T,"-37.81487988, 144.9660878"
702220250830,70,2025-08-30,22,45,75,120,Errol20_T,"-37.80456984, 144.94946228"
32120240207,3,2024-02-07,21,650,598,1248,Swa295_T,"-37.81101524, 144.96429485"
75120240913,75,2024-09-13,1,2,1,3,SprFli_T,"-37.81515276, 144.97467661"
8520250211,8,2025-02-11,5,3,1,4,WebBN_T,"-37.82293543, 144.9471751"
781420250928,78,2025-09-28,14,50,61,111,HarEsB_T,"-37.81471642, 144.9446508"
771520240423,77,2024-04-23,15,161,143,304,HarEsP_T,"-37.81441438, 144.94433026"
14620250214,14,2025-02-14,6,90,130,220,SanBri_T,"-37.82011242, 144.96291897"
141020250314,14,2025-03-14,10,205,92,297,SanBri_T,"-37.82011242, 144.96291897"
681920250726,68,2025-07-26,19,147,55,202,FLDegN_T,"-37.8168479, 144.96559789"
63920241027,63,2024-10-27,9,79,141,220,Bou231_T,"-37.81333081, 144.96675571"
68620240901,68,2024-09-01,6,0,1,1,FLDegN_T,"-37.8168479, 144.96559789"
1120250903,1,2025-09-03,1,16,20,36,Bou292_T,"-37.81349441, 144.96515323"
121920231104,12,2023-11-04,19,461,382,843,NewQ_T,"-37.81457988, 144.94292398"
11720231024,11,2023-10-24,7,51,49,100,WatCit_T,"-37.81564989, 144.93970694"
241420250710,24,2025-07-10,14,568,864,1432,Col620_T,"-37.81887963, 144.95449198"
56220250625,56,2025-06-25,2,0,3,3,Lon364_T,"-37.81234775, 144.96153311"
271320250120,27,2025-01-20,13,95,95,190,Vic_T,"-37.80606888, 144.95644692"
271020231113,27,2023-11-13,10,75,80,155,Vic_T,"-37.80606888, 144.95644692"
79420240311,79,2024-03-11,4,30,46,76,FliSS_T,"-37.81794046, 144.96616678"
511220250208,51,2025-02-08,12,174,164,338,Fra118_T,"-37.80841815, 144.95906316"
231820240911,23,2024-09-11,18,208,597,805,Col623_T,"-37.81909256, 144.95452748"
231420240203,23,2024-02-03,14,132,154,286,Col623_T,"-37.81909256, 144.95452748"
52620241002,52,2024-10-02,6,23,24,47,Eli263_T,"-37.81252157, 144.9619401"
52220240115,52,2024-01-15,2,5,16,21,Eli263_T,"-37.81252157, 144.9619401"
521320240426,52,2024-04-26,13,475,447,922,Eli263_T,"-37.81252157, 144.9619401"
521120240505,52,2024-05-05,11,237,170,407,Eli263_T,"-37.81252157, 144.9619401"
1361120240330,136,2024-03-30,11,65,87,152,BirFed1120_T,"-37.8184141, 144.97357915"
1361420240423,136,2024-04-23,14,81,83,164,BirFed1120_T,"-37.8184141, 144.97357915"
1232220250201,123,2025-02-01,22,1,1,2,BirBridge_T,"-37.81753741, 144.97329734"
1231720250711,123,2025-07-11,17,18,13,31,BirBridge_T,"-37.81753741, 144.97329734"
1301920240304,130,2024-03-04,19,9,16,25,Bou892T,"-37.8204637, 144.94126826"
1301120240807,130,2024-08-07,11,21,44,65,Bou892T,"-37.8204637, 144.94126826"
1301220241127,130,2024-11-27,12,114,79,193,Bou892T,"-37.8204637, 144.94126826"
8520240520,8,2024-05-20,5,4,2,6,WebBN_T,"-37.82293543, 144.9471751"
82120250818,8,2025-08-18,21,17,8,25,WebBN_T,"-37.82293543, 144.9471751"
78420240305,78,2024-03-05,4,0,1,1,HarEsB_T,"-37.81471642, 144.9446508"
141420231223,14,2023-12-23,14,545,186,731,SanBri_T,"-37.82011242, 144.96291897"
54720250420,54,2025-04-20,7,18,11,29,Swa607_T,"-37.804024, 144.96308399"
311020250101,31,2025-01-01,10,55,36,91,Lyg161_T,"-37.80169681, 144.96658911"
21220240919,21,2024-09-19,2,10,20,30,Bourke155_T,"-37.81267313, 144.96788288"
37020240812,37,2024-08-12,0,14,5,19,Lyg260_T,"-37.80107122, 144.96704554"
611620240301,61,2024-03-01,16,391,681,1072,RMIT14_T,"-37.80767455, 144.96309114"
5620250425,5,2025-04-25,6,896,121,1017,PriNW_T,"-37.81874249, 144.96787656"
131720250225,131,2025-02-25,7,76,32,108,King2_T,"-37.82009057, 144.95758725"
162520250207,162,2025-02-07,5,32,6,38,Eli489_T,"-37.80740397, 144.95987909"
143220240920,143,2024-09-20,2,10,7,17,Spencer_T,"-37.821728, 144.95557015"
1431720241212,143,2024-12-12,17,236,375,611,Spencer_T,"-37.821728, 144.95557015"
132320240512,132,2024-05-12,3,31,21,52,King335_T,"-37.81267639, 144.95386444"
1321420250917,132,2025-09-17,14,118,99,217,King335_T,"-37.81267639, 144.95386444"
1331820240108,133,2024-01-08,18,547,480,1027,Spen229_T,"-37.81531435, 144.95227769"
1182020240714,118,2024-07-14,20,5,13,18,Fli114C_T,"-37.81632783, 144.97090512"
108420241128,108,2024-11-28,4,0,4,4,261Will_T,"-37.81295822, 144.95678789"
1672320250912,167,2025-09-12,23,10,10,20,Lat526_T,"-37.81304149, 144.95155955"
1671020251006,167,2025-10-06,10,24,49,73,Lat526_T,"-37.81304149, 144.95155955"
661520240708,66,2024-07-08,15,1386,1362,2748,QVN_T,"-37.81057846, 144.96444294"
41320240515,4,2024-05-15,13,1655,1364,3019,Swa123_T,"-37.81487988, 144.9660878"
701120250807,70,2025-08-07,11,85,94,179,Errol20_T,"-37.80456984, 144.94946228"
701920250901,70,2025-09-01,19,64,84,148,Errol20_T,"-37.80456984, 144.94946228"
391920250830,39,2025-08-30,19,13,13,26,AlfPl_T,"-37.81379749, 144.96995745"
411020250209,41,2025-02-09,10,1275,772,2047,Swa31,"-37.81668634, 144.96689733"
67120240226,67,2024-02-26,1,1,6,7,FLDegS_T,"-37.81688755, 144.96562569"
671220240624,67,2024-06-24,12,446,661,1107,FLDegS_T,"-37.81688755, 144.96562569"
67620250525,67,2025-05-25,6,10,13,23,FLDegS_T,"-37.81688755, 144.96562569"
681020250520,68,2025-05-20,10,240,237,477,FLDegN_T,"-37.8168479, 144.96559789"
18920250709,18,2025-07-09,9,113,483,596,Col12_T,"-37.81344862, 144.97305353"
56620231110,56,2023-11-10,6,21,14,35,Lon364_T,"-37.81234775, 144.96153311"
56220250211,56,2025-02-11,2,4,12,16,Lon364_T,"-37.81234775, 144.96153311"
112020250725,11,2025-07-25,20,16,18,34,WatCit_T,"-37.81564989, 144.93970694"
121820240403,12,2024-04-03,18,197,273,470,NewQ_T,"-37.81457988, 144.94292398"
5320240725,5,2024-07-25,3,11,7,18,PriNW_T,"-37.81874249, 144.96787656"
5620241121,5,2024-11-21,6,33,53,86,PriNW_T,"-37.81874249, 144.96787656"
211920241017,21,2024-10-17,19,261,300,561,Bourke155_T,"-37.81267313, 144.96788288"
501320240623,50,2024-06-23,13,251,290,541,Lyg309_T,"-37.79808192, 144.96721013"
431320250420,43,2025-04-20,13,30,35,65,UM2_T,"-37.79844526, 144.96411782"
431420250609,43,2025-06-09,14,72,96,168,UM2_T,"-37.79844526, 144.96411782"
431720250808,43,2025-08-08,17,261,364,625,UM2_T,"-37.79844526, 144.96411782"
451120250705,45,2025-07-05,11,470,569,1039,Swa148_T,"-37.81414075, 144.96609379"
45820240119,45,2024-01-19,8,192,246,438,Swa148_T,"-37.81414075, 144.96609379"
179420250208,179,2025-02-08,4,4,6,10,Pow61_T,"-37.82392385, 144.96299677"
167920250120,167,2025-01-20,9,43,92,135,Lat526_T,"-37.81304149, 144.95155955"
1401320240526,140,2024-05-26,13,131,100,231,Boyd2837_T,"-37.82590962, 144.96185972"
143820241025,143,2024-10-25,8,108,239,347,Spencer_T,"-37.821728, 144.95557015"
107320250727,107,2025-07-27,3,12,3,15,280Will_T,"-37.81246271, 144.95690188"
1072320240827,107,2024-08-27,23,30,12,42,280Will_T,"-37.81246271, 144.95690188"
133220241115,133,2024-11-15,2,17,10,27,Spen229_T,"-37.81531435, 144.95227769"
118620231110,118,2023-11-10,6,3,2,5,Fli114C_T,"-37.81632783, 144.97090512"
108620231127,108,2023-11-27,6,21,159,180,261Will_T,"-37.81295822, 144.95678789"
671620250726,67,2025-07-26,16,461,642,1103,FLDegS_T,"-37.81688755, 144.96562569"
17420251014,17,2025-10-14,4,15,7,22,Col15_T,"-37.81362543, 144.97323591"
11120241026,1,2024-10-26,11,1074,977,2051,Bou292_T,"-37.81349441, 144.96515323"
11420250307,1,2025-03-07,14,1336,1225,2561,Bou292_T,"-37.81349441, 144.96515323"
671120240211,67,2024-02-11,11,182,234,416,FLDegS_T,"-37.81688755, 144.96562569"
681820250405,68,2025-04-05,18,375,242,617,FLDegN_T,"-37.8168479, 144.96559789"
621620240523,62,2024-05-23,16,214,161,375,Lat224_T,"-37.80996494, 144.96216521"
56120250216,56,2025-02-16,1,62,94,156,Lon364_T,"-37.81234775, 144.96153311"
112320240414,11,2024-04-14,23,31,20,51,WatCit_T,"-37.81564989, 144.93970694"
11820240807,11,2024-08-07,8,65,50,115,WatCit_T,"-37.81564989, 144.93970694"
24320250509,24,2025-05-09,3,21,20,41,Col620_T,"-37.81887963, 144.95449198"
11120250705,11,2025-07-05,1,4,2,6,WatCit_T,"-37.81564989, 144.93970694"
12420250310,12,2025-03-10,4,13,7,20,NewQ_T,"-37.81457988, 144.94292398"
76720250701,76,2025-07-01,7,22,14,36,KenMac_T,"-37.79453803, 144.93036194"
761220231116,76,2023-11-16,12,90,74,164,KenMac_T,"-37.79453803, 144.93036194"
721420240703,72,2024-07-03,14,206,393,599,ACMI_T,"-37.81726338, 144.96872809"
352320240312,35,2024-03-12,23,200,232,432,SouthB_T,"-37.82018685, 144.96508508"
58720250910,58,2025-09-10,7,745,120,865,Bou688_T,"-37.81686075, 144.95358075"
352020250705,35,2025-07-05,20,756,868,1624,SouthB_T,"-37.82018685, 144.96508508"
9120241004,9,2024-10-04,1,6,24,30,Col700_T,"-37.81982992, 144.95102555"
91420231208,9,2023-12-08,14,505,309,814,Col700_T,"-37.81982992, 144.95102555"
271120250901,27,2025-09-01,11,83,91,174,Vic_T,"-37.80606888, 144.95644692"
79920240202,79,2024-02-02,9,336,192,528,FliSS_T,"-37.81794046, 144.96616678"
301120240813,30,2024-08-13,11,149,240,389,Lon189_T,"-37.8112185, 144.96656806"
461120240123,46,2024-01-23,11,54,82,136,Pel147_T,"-37.80240719, 144.9615673"
201720240729,20,2024-07-29,17,191,178,369,LtB170_T,"-37.81172914, 144.9682466"
231720240330,23,2024-03-30,17,112,203,315,Col623_T,"-37.81909256, 144.95452748"
1641520240902,164,2024-09-02,15,79,62,141,Lat526_T,"-37.813005, 144.95160411"
117120240727,117,2024-07-27,1,68,28,96,Fli114F_T,"-37.81629332, 144.97090877"
117020250508,117,2025-05-08,0,25,18,43,Fli114F_T,"-37.81629332, 144.97090877"
481320250306,48,2025-03-06,13,445,308,753,QVMQ_T,"-37.80631581, 144.95866697"
1091420240101,109,2024-01-01,14,54,57,111,LatWill_T,"-37.81193681, 144.95621105"
192220241004,19,2024-10-04,22,395,608,1003,LtB210_T,"-37.81237202, 144.96550671"
48820240205,48,2024-02-05,8,130,62,192,QVMQ_T,"-37.80631581, 144.95866697"
66120241122,66,2024-11-22,1,81,34,115,QVN_T,"-37.81057846, 144.96444294"
6820240502,6,2024-05-02,8,963,2448,3411,FliS_T,"-37.81911705, 144.96558255"
66820240624,66,2024-06-24,8,162,484,646,QVN_T,"-37.81057846, 144.96444294"
70620250819,70,2025-08-19,6,12,7,19,Errol20_T,"-37.80456984, 144.94946228"
39720240516,39,2024-05-16,7,71,46,117,AlfPl_T,"-37.81379749, 144.96995745"
721020231225,72,2023-12-25,10,45,49,94,ACMI_T,"-37.81726338, 144.96872809"
72620250908,72,2025-09-08,6,74,27,101,ACMI_T,"-37.81726338, 144.96872809"
35020241221,35,2024-12-21,0,567,804,1371,SouthB_T,"-37.82018685, 144.96508508"
27720240105,27,2024-01-05,7,23,42,65,Vic_T,"-37.80606888, 144.95644692"
52420250908,52,2025-09-08,4,9,3,12,Eli263_T,"-37.81252157, 144.9619401"
202220240112,20,2024-01-12,22,179,416,595,LtB170_T,"-37.81172914, 144.9682466"
23820250625,23,2025-06-25,8,929,426,1355,Col623_T,"-37.81909256, 144.95452748"
1361920240316,136,2024-03-16,19,704,55,759,BirFed1120_T,"-37.8184141, 144.97357915"
1422220240430,142,2024-04-30,22,38,35,73,Hammer1584_T,"-37.81970749, 144.96795734"
1611520240730,161,2024-07-30,15,85,81,166,BirArt1109_T,"-37.81851276, 144.97131336"
161620241211,161,2024-12-11,6,66,93,159,BirArt1109_T,"-37.81851276, 144.97131336"
1172220251014,117,2025-10-14,22,165,51,216,Fli114F_T,"-37.81629332, 144.97090877"
661520241024,66,2024-10-24,15,1225,1183,2408,QVN_T,"-37.81057846, 144.96444294"
661220241030,66,2024-10-30,12,1142,1384,2526,QVN_T,"-37.81057846, 144.96444294"
61820241002,6,2024-10-02,18,1333,1033,2366,FliS_T,"-37.81911705, 144.96558255"
42020231112,4,2023-11-12,20,780,533,1313,Swa123_T,"-37.81487988, 144.9660878"
662120240629,66,2024-06-29,21,678,554,1232,QVN_T,"-37.81057846, 144.96444294"
4320250417,4,2025-04-17,3,24,24,48,Swa123_T,"-37.81487988, 144.9660878"
701820240710,70,2024-07-10,18,128,172,300,Errol20_T,"-37.80456984, 144.94946228"
392220250425,39,2025-04-25,22,11,21,32,AlfPl_T,"-37.81379749, 144.96995745"
75720231104,75,2023-11-04,7,13,11,24,SprFli_T,"-37.81515276, 144.97467661"
81720231020,8,2023-10-20,17,175,351,526,WebBN_T,"-37.82293543, 144.9471751"
782220240809,78,2024-08-09,22,4,10,14,HarEsB_T,"-37.81471642, 144.9446508"
141620251015,14,2025-10-15,16,679,170,849,SanBri_T,"-37.82011242, 144.96291897"
652320240819,65,2024-08-19,23,174,113,287,SwaCs_T,"-37.81569416, 144.9668064"
54020250407,54,2025-04-07,0,18,18,36,Swa607_T,"-37.804024, 144.96308399"
28820241128,28,2024-11-28,8,486,335,821,VAC_T,"-37.82129925, 144.96879309"
471320250322,47,2025-03-22,13,918,1184,2102,Eli250_T,"-37.81258467, 144.9625775"
451620250502,45,2025-05-02,16,564,729,1293,Swa148_T,"-37.81414075, 144.96609379"
51820250207,5,2025-02-07,18,879,2095,2974,PriNW_T,"-37.81874249, 144.96787656"
51620240807,5,2024-08-07,16,1039,671,1710,PriNW_T,"-37.81874249, 144.96787656"
181020250727,181,2025-07-27,0,223,253,476,Eli368_T,"-37.81009465, 144.96143149"
143920241003,143,2024-10-03,9,104,176,280,Spencer_T,"-37.821728, 144.95557015"
1431920250915,143,2025-09-15,19,134,151,285,Spencer_T,"-37.821728, 144.95557015"
1342120240707,134,2024-07-07,21,191,156,347,Spen201_T,"-37.81694221, 144.95303935"
134420240730,134,2024-07-30,4,13,17,30,Spen201_T,"-37.81694221, 144.95303935"
135320250125,135,2025-01-25,3,32,22,54,Spen161_T,"-37.8172861, 144.95319102"
107020231225,107,2023-12-25,0,12,16,28,280Will_T,"-37.81246271, 144.95690188"
191620241003,19,2024-10-03,16,516,475,991,LtB210_T,"-37.81237202, 144.96550671"
19520240309,19,2024-03-09,5,4,8,12,LtB210_T,"-37.81237202, 144.96550671"
482020250722,48,2025-07-22,20,47,61,108,QVMQ_T,"-37.80631581, 144.95866697"
482320240520,48,2024-05-20,23,8,19,27,QVMQ_T,"-37.80631581, 144.95866697"
139720250827,139,2025-08-27,7,20,122,142,Signal1647_T,"-37.81959923, 144.9632832"
1642020240921,164,2024-09-21,20,45,48,93,Lat526_T,"-37.813005, 144.95160411"
1642020250120,164,2025-01-20,20,49,74,123,Lat526_T,"-37.813005, 144.95160411"
1231520240124,123,2024-01-24,15,36,42,78,BirBridge_T,"-37.81753741, 144.97329734"
1171020241120,117,2024-11-20,10,126,125,251,Fli114F_T,"-37.81629332, 144.97090877"
117520241127,117,2024-11-27,5,11,10,21,Fli114F_T,"-37.81629332, 144.97090877"
66020250109,66,2025-01-09,0,71,50,121,QVN_T,"-37.81057846, 144.96444294"
6020240823,6,2024-08-23,0,93,77,170,FliS_T,"-37.81911705, 144.96558255"
391620250909,39,2025-09-09,16,74,71,145,AlfPl_T,"-37.81379749, 144.96995745"
39020240901,39,2024-09-01,0,15,23,38,AlfPl_T,"-37.81379749, 144.96995745"
8020231211,8,2023-12-11,0,5,5,10,WebBN_T,"-37.82293543, 144.9471751"
411620240322,41,2024-03-22,16,1680,1763,3443,Swa31,"-37.81668634, 144.96689733"
412320250120,41,2025-01-20,23,631,289,920,Swa31,"-37.81668634, 144.96689733"
59720231205,59,2023-12-05,7,161,105,266,RMIT_T,"-37.80825648, 144.96304859"
651020231203,65,2023-12-03,10,332,392,724,SwaCs_T,"-37.81569416, 144.9668064"
54020231102,54,2023-11-02,0,19,55,74,Swa607_T,"-37.804024, 144.96308399"
541220240121,54,2024-01-21,12,94,74,168,Swa607_T,"-37.804024, 144.96308399"
281620240212,28,2024-02-12,16,416,1352,1768,VAC_T,"-37.82129925, 144.96879309"
47720240726,47,2024-07-26,7,76,206,282,Eli250_T,"-37.81258467, 144.9625775"
40720240621,40,2024-06-21,7,107,104,211,Spr201_T,"-37.80999341, 144.97227587"
541920250603,54,2025-06-03,19,115,133,248,Swa607_T,"-37.804024, 144.96308399"
37120241223,37,2024-12-23,1,5,3,8,Lyg260_T,"-37.80107122, 144.96704554"
211620231222,21,2023-12-22,16,510,537,1047,Bourke155_T,"-37.81267313, 144.96788288"
107320250127,107,2025-01-27,3,7,5,12,280Will_T,"-37.81246271, 144.95690188"
871220240130,87,2024-01-30,12,148,152,300,Errol23_T,"-37.80454949, 144.94921863"
441220250612,44,2025-06-12,12,92,92,184,UM3_T,"-37.79698741, 144.96441306"
44720250831,44,2025-08-31,7,7,5,12,UM3_T,"-37.79698741, 144.96441306"
432320240509,43,2024-05-09,23,78,3,81,UM2_T,"-37.79844526, 144.96411782"
1811320251010,181,2025-10-10,13,840,1115,1955,Eli368_T,"-37.81009465, 144.96143149"
165620250927,165,2025-09-27,6,3,10,13,Spen475_T,"-37.80953359, 144.94939004"
1651220250413,165,2025-04-13,12,28,38,66,Spen475_T,"-37.80953359, 144.94939004"
1661220241223,166,2024-12-23,12,51,51,102,Spen484_T,"-37.80896733, 144.94931703"
167620250114,167,2025-01-14,6,4,19,23,Lat526_T,"-37.81304149, 144.95155955"
131620250118,131,2025-01-18,6,15,42,57,King2_T,"-37.82009057, 144.95758725"
143220240501,143,2024-05-01,2,30,9,39,Spencer_T,"-37.821728, 144.95557015"
143620250305,143,2025-03-05,6,27,75,102,Spencer_T,"-37.821728, 144.95557015"
851320231202,85,2023-12-02,13,140,138,278,488Mac_T,"-37.79432415, 144.92973378"
172120251008,17,2025-10-08,21,65,74,139,Col15_T,"-37.81362543, 144.97323591"
63720241011,63,2024-10-11,7,62,69,131,Bou231_T,"-37.81333081, 144.96675571"
681520241113,68,2024-11-13,15,197,176,373,FLDegN_T,"-37.8168479, 144.96559789"
68020250129,68,2025-01-29,0,2,1,3,FLDegN_T,"-37.8168479, 144.96559789"
681720250729,68,2025-07-29,17,254,159,413,FLDegN_T,"-37.8168479, 144.96559789"
391420250816,39,2025-08-16,14,65,64,129,AlfPl_T,"-37.81379749, 144.96995745"
32020250623,3,2025-06-23,20,294,249,543,Swa295_T,"-37.81101524, 144.96429485"
411020240621,41,2024-06-21,10,156,220,376,Swa31,"-37.81668634, 144.96689733"
781820250929,78,2025-09-29,18,16,66,82,HarEsB_T,"-37.81471642, 144.9446508"
652320240720,65,2024-07-20,23,159,213,372,SwaCs_T,"-37.81569416, 144.9668064"
591220231115,59,2023-11-15,12,508,587,1095,RMIT_T,"-37.80825648, 144.96304859"
771720250520,77,2025-05-20,17,383,176,559,HarEsP_T,"-37.81441438, 144.94433026"
28720241216,28,2024-12-16,7,203,136,339,VAC_T,"-37.82129925, 144.96879309"
40120240104,40,2024-01-04,1,3,4,7,Spr201_T,"-37.80999341, 144.97227587"
21620240502,21,2024-05-02,6,30,39,69,Bourke155_T,"-37.81267313, 144.96788288"
36520250917,36,2025-09-17,5,12,7,19,Que85_T,"-37.81652527, 144.96121062"
501820231220,50,2023-12-20,18,291,335,626,Lyg309_T,"-37.79808192, 144.96721013"
43620240825,43,2024-08-25,6,3,4,7,UM2_T,"-37.79844526, 144.96411782"
1662320250220,166,2025-02-20,23,0,3,3,Spen484_T,"-37.80896733, 144.94931703"
1311420250726,131,2025-07-26,14,164,163,327,King2_T,"-37.82009057, 144.95758725"
131220241026,131,2024-10-26,2,50,71,121,King2_T,"-37.82009057, 144.95758725"
143220240821,143,2024-08-21,2,20,13,33,Spencer_T,"-37.821728, 144.95557015"
132220240620,132,2024-06-20,2,9,1,10,King335_T,"-37.81267639, 144.95386444"
134620231227,134,2023-12-27,6,108,50,158,Spen201_T,"-37.81694221, 144.95303935"
135920250608,135,2025-06-08,9,141,157,298,Spen161_T,"-37.8172861, 144.95319102"
1351020231209,135,2023-12-09,10,384,401,785,Spen161_T,"-37.8172861, 144.95319102"
133220240213,133,2024-02-13,2,4,6,10,Spen229_T,"-37.81531435, 144.95227769"
133620240503,133,2024-05-03,6,287,174,461,Spen229_T,"-37.81531435, 144.95227769"
1331820240707,133,2024-07-07,18,705,458,1163,Spen229_T,"-37.81531435, 144.95227769"
1241620250827,124,2025-08-27,16,4,3,7,BirBridge_T,"-37.81757416, 144.97329934"
871920250309,87,2025-03-09,19,88,106,194,Errol23_T,"-37.80454949, 144.94921863"
671420250922,67,2025-09-22,14,363,449,812,FLDegS_T,"-37.81688755, 144.96562569"
631320240124,63,2024-01-24,13,489,525,1014,Bou231_T,"-37.81333081, 144.96675571"
622120240516,62,2024-05-16,21,210,116,326,Lat224_T,"-37.80996494, 144.96216521"
621720250803,62,2025-08-03,17,266,359,625,Lat224_T,"-37.80996494, 144.96216521"
561920240825,56,2024-08-25,19,233,326,559,Lon364_T,"-37.81234775, 144.96153311"
56920250326,56,2025-03-26,9,182,174,356,Lon364_T,"-37.81234775, 144.96153311"
86720240730,86,2024-07-30,7,17,17,34,574Qub_T,"-37.80309992, 144.94908064"
86920240819,86,2024-08-19,9,39,23,62,574Qub_T,"-37.80309992, 144.94908064"
122320240619,12,2024-06-19,23,8,16,24,NewQ_T,"-37.81457988, 144.94292398"
10720250821,10,2025-08-21,7,24,94,118,BouHbr_T,"-37.81876474, 144.94710545"
721520250808,72,2025-08-08,15,153,292,445,ACMI_T,"-37.81726338, 144.96872809"
721320240514,72,2024-05-14,13,121,290,411,ACMI_T,"-37.81726338, 144.96872809"
352220240119,35,2024-01-19,22,887,1853,2740,SouthB_T,"-37.82018685, 144.96508508"
91820240313,9,2024-03-13,18,985,480,1465,Col700_T,"-37.81982992, 144.95102555"
9620240927,9,2024-09-27,6,15,18,33,Col700_T,"-37.81982992, 144.95102555"
92120250326,9,2025-03-26,21,73,54,127,Col700_T,"-37.81982992, 144.95102555"
27320250708,27,2025-07-08,3,4,1,5,Vic_T,"-37.80606888, 144.95644692"
79120250522,79,2025-05-22,1,10,15,25,FliSS_T,"-37.81794046, 144.96616678"
46720231122,46,2023-11-22,7,20,42,62,Pel147_T,"-37.80240719, 144.9615673"
46320231216,46,2023-12-16,3,2,5,7,Pel147_T,"-37.80240719, 144.9615673"
202220240125,20,2024-01-25,22,178,488,666,LtB170_T,"-37.81172914, 144.9682466"
25820250706,25,2025-07-06,8,124,204,328,MCEC_T,"-37.82401776, 144.95604426"
231120251009,23,2025-10-09,11,226,370,596,Col623_T,"-37.81909256, 144.95452748"
1232020250808,123,2025-08-08,20,10,13,23,BirBridge_T,"-37.81753741, 144.97329734"
481520241221,48,2024-12-21,15,517,266,783,QVMQ_T,"-37.80631581, 144.95866697"
49020240317,49,2024-03-17,0,101,122,223,Eli501_T,"-37.80730068, 144.95956055"
492120240806,49,2024-08-06,21,179,127,306,Eli501_T,"-37.80730068, 144.95956055"
109120241015,109,2024-10-15,1,9,3,12,LatWill_T,"-37.81193681, 144.95621105"
1092120240730,109,2024-07-30,21,80,88,168,LatWill_T,"-37.81193681, 144.95621105"
191720250408,19,2025-04-08,17,681,507,1188,LtB210_T,"-37.81237202, 144.96550671"
139920250903,139,2025-09-03,9,31,173,204,Signal1647_T,"-37.81959923, 144.9632832"
1372020240226,137,2024-02-26,20,9,14,23,BouHbr2353_T,"-37.81894815, 144.94612292"
139720240609,139,2024-06-09,7,4,4,8,Signal1647_T,"-37.81959923, 144.9632832"
1422320250810,142,2025-08-10,23,4,1,5,Hammer1584_T,"-37.81970749, 144.96795734"
130920240405,130,2024-04-05,9,9,14,23,Bou892T,"-37.8204637, 144.94126826"
130220250303,130,2025-03-03,2,1,1,2,Bou892T,"-37.8204637, 144.94126826"
692320241028,69,2024-10-28,23,1,2,3,FLDegC_T,"-37.81687226, 144.96559144"
84720240710,84,2024-07-10,7,616,185,801,ElFi_T,"-37.81798049, 144.96503383"
841820240720,84,2024-07-20,18,641,932,1573,ElFi_T,"-37.81798049, 144.96503383"
842020240807,84,2024-08-07,20,527,839,1366,ElFi_T,"-37.81798049, 144.96503383"
61220251004,6,2025-10-04,12,972,848,1820,FliS_T,"-37.81911705, 144.96558255"
841920241226,84,2024-12-26,19,844,1124,1968,ElFi_T,"-37.81798049, 144.96503383"
70220240421,70,2024-04-21,2,1,1,2,Errol20_T,"-37.80456984, 144.94946228"
702120241115,70,2024-11-15,21,116,161,277,Errol20_T,"-37.80456984, 144.94946228"
702320250507,70,2025-05-07,23,4,7,11,Errol20_T,"-37.80456984, 144.94946228"
701120250725,70,2025-07-25,11,106,94,200,Errol20_T,"-37.80456984, 144.94946228"
8820240928,8,2024-09-28,8,71,89,160,WebBN_T,"-37.82293543, 144.9471751"
81320250207,8,2025-02-07,13,297,292,589,WebBN_T,"-37.82293543, 144.9471751"
8220250804,8,2025-08-04,2,1,0,1,WebBN_T,"-37.82293543, 144.9471751"
141920250411,14,2025-04-11,19,505,136,641,SanBri_T,"-37.82011242, 144.96291897"
71620250216,71,2025-02-16,6,0,1,1,WestWP_T,"-37.81235775, 144.97136962"
541720240401,54,2024-04-01,17,68,108,176,Swa607_T,"-37.804024, 144.96308399"
281520231107,28,2023-11-07,15,423,410,833,VAC_T,"-37.82129925, 144.96879309"
401220240917,40,2024-09-17,12,417,495,912,Spr201_T,"-37.80999341, 144.97227587"
21120231223,21,2023-12-23,1,168,162,330,Bourke155_T,"-37.81267313, 144.96788288"
362020240523,36,2024-05-23,20,90,111,201,Que85_T,"-37.81652527, 144.96121062"
87620240715,87,2024-07-15,6,11,11,22,Errol23_T,"-37.80454949, 144.94921863"
61320250506,61,2025-05-06,3,3,3,6,RMIT14_T,"-37.80767455, 144.96309114"
611020241128,61,2024-11-28,10,299,450,749,RMIT14_T,"-37.80767455, 144.96309114"
501720250826,50,2025-08-26,17,181,154,335,Lyg309_T,"-37.79808192, 144.96721013"
501620241018,50,2024-10-18,16,173,125,298,Lyg309_T,"-37.79808192, 144.96721013"
45420241114,45,2024-11-14,4,5,12,17,Swa148_T,"-37.81414075, 144.96609379"
52220241228,5,2024-12-28,22,958,970,1928,PriNW_T,"-37.81874249, 144.96787656"
1671020250919,167,2025-09-19,10,34,71,105,Lat526_T,"-37.81304149, 144.95155955"
1811620250928,181,2025-09-28,16,779,1062,1841,Eli368_T,"-37.81009465, 144.96143149"
1621320241126,162,2024-11-26,13,598,783,1381,Eli489_T,"-37.80740397, 144.95987909"
1621720241207,162,2024-12-07,17,285,344,629,Eli489_T,"-37.80740397, 144.95987909"
1081420250422,108,2025-04-22,14,415,262,677,261Will_T,"-37.81295822, 144.95678789"
132420250425,132,2025-04-25,4,21,21,42,King335_T,"-37.81267639, 144.95386444"
1331320250208,133,2025-02-08,13,690,582,1272,Spen229_T,"-37.81531435, 144.95227769"
1082020240218,108,2024-02-18,20,123,97,220,261Will_T,"-37.81295822, 144.95678789"
85420241211,85,2024-12-11,4,1,0,1,488Mac_T,"-37.79432415, 144.92973378"
1320240503,1,2024-05-03,3,7,16,23,Bou292_T,"-37.81349441, 144.96515323"
181320241113,18,2024-11-13,13,191,175,366,Col12_T,"-37.81344862, 144.97305353"
18120250110,18,2025-01-10,1,0,1,1,Col12_T,"-37.81344862, 144.97305353"
631420231110,63,2023-11-10,14,265,375,640,Bou231_T,"-37.81333081, 144.96675571"
561420231023,56,2023-10-23,14,237,141,378,Lon364_T,"-37.81234775, 144.96153311"
862020231125,86,2023-11-25,20,9,17,26,574Qub_T,"-37.80309992, 144.94908064"
861620250108,86,2025-01-08,16,30,45,75,574Qub_T,"-37.80309992, 144.94908064"
86620250424,86,2025-04-24,6,5,5,10,574Qub_T,"-37.80309992, 144.94908064"
632220250310,63,2025-03-10,22,6,62,68,Bou231_T,"-37.81333081, 144.96675571"
62220231107,62,2023-11-07,2,38,14,52,Lat224_T,"-37.80996494, 144.96216521"
62620231118,62,2023-11-18,6,101,31,132,Lat224_T,"-37.80996494, 144.96216521"
111520241224,11,2024-12-24,15,104,73,177,WatCit_T,"-37.81564989, 144.93970694"
241020250405,24,2025-04-05,10,495,352,847,Col620_T,"-37.81887963, 144.95449198"
241120250716,24,2025-07-16,11,787,500,1287,Col620_T,"-37.81887963, 144.95449198"
761520231210,76,2023-12-10,15,50,56,106,KenMac_T,"-37.79453803, 144.93036194"
76220231217,76,2023-12-17,2,2,2,4,KenMac_T,"-37.79453803, 144.93036194"
76620231228,76,2023-12-28,6,2,2,4,KenMac_T,"-37.79453803, 144.93036194"
2820241211,2,2024-12-11,8,111,237,348,Bou283_T,"-37.81380668, 144.96516718"
2420240624,2,2024-06-24,4,1,4,5,Bou283_T,"-37.81380668, 144.96516718"
2520240815,2,2024-08-15,5,4,7,11,Bou283_T,"-37.81380668, 144.96516718"
27220250318,27,2025-03-18,2,5,5,10,Vic_T,"-37.80606888, 144.95644692"
302320231127,30,2023-11-27,23,84,143,227,Lon189_T,"-37.8112185, 144.96656806"
30220240228,30,2024-02-28,2,31,39,70,Lon189_T,"-37.8112185, 144.96656806"
79520240205,79,2024-02-05,5,35,26,61,FliSS_T,"-37.81794046, 144.96616678"
53520250823,53,2025-08-23,5,7,6,13,Col254_T,"-37.81564191, 144.965499"
512120241008,51,2024-10-08,21,40,39,79,Fra118_T,"-37.80841815, 144.95906316"
52020250807,52,2025-08-07,0,14,13,27,Eli263_T,"-37.81252157, 144.9619401"
52420250904,52,2025-09-04,4,3,8,11,Eli263_T,"-37.81252157, 144.9619401"
46120231230,46,2023-12-30,1,5,3,8,Pel147_T,"-37.80240719, 144.9615673"
461820240222,46,2024-02-22,18,59,45,104,Pel147_T,"-37.80240719, 144.9615673"
461720240330,46,2024-03-30,17,58,35,93,Pel147_T,"-37.80240719, 144.9615673"
491120250205,49,2025-02-05,11,216,247,463,Eli501_T,"-37.80730068, 144.95956055"
482220250520,48,2025-05-20,22,23,48,71,QVMQ_T,"-37.80631581, 144.95866697"
1411420250126,141,2025-01-26,14,166,179,345,474Fl_T,"-37.81997273, 144.95834911"
1411320250407,141,2025-04-07,13,197,118,315,474Fl_T,"-37.81997273, 144.95834911"
1411220251005,141,2025-10-05,12,182,121,303,474Fl_T,"-37.81997273, 144.95834911"
1362020240504,136,2024-05-04,20,50,7,57,BirFed1120_T,"-37.8184141, 144.97357915"
136620240913,136,2024-09-13,6,45,38,83,BirFed1120_T,"-37.8184141, 144.97357915"
1421820231116,142,2023-11-16,18,869,612,1481,Hammer1584_T,"-37.81970749, 144.96795734"
1422120250106,142,2025-01-06,21,44,49,93,Hammer1584_T,"-37.81970749, 144.96795734"
1231120240220,123,2024-02-20,11,16,7,23,BirBridge_T,"-37.81753741, 144.97329734"
661820250303,66,2025-03-03,18,1537,1546,3083,QVN_T,"-37.81057846, 144.96444294"
66020251012,66,2025-10-12,0,179,244,423,QVN_T,"-37.81057846, 144.96444294"
6620240811,6,2024-08-11,6,70,75,145,FliS_T,"-37.81911705, 144.96558255"
84520240616,84,2024-06-16,5,45,40,85,ElFi_T,"-37.81798049, 144.96503383"
4520231203,4,2023-12-03,5,56,49,105,Swa123_T,"-37.81487988, 144.9660878"
701620241222,70,2024-12-22,16,114,123,237,Errol20_T,"-37.80456984, 144.94946228"
751120250110,75,2025-01-10,11,34,51,85,SprFli_T,"-37.81515276, 144.97467661"
782220250512,78,2025-05-12,22,4,5,9,HarEsB_T,"-37.81471642, 144.9446508"
781320250809,78,2025-08-09,13,72,81,153,HarEsB_T,"-37.81471642, 144.9446508"
711520231129,71,2023-11-29,15,19,9,28,WestWP_T,"-37.81235775, 144.97136962"
592320240807,59,2024-08-07,23,85,84,169,RMIT_T,"-37.80825648, 144.96304859"
541220240525,54,2024-05-25,12,103,134,237,Swa607_T,"-37.804024, 144.96308399"
281320240429,28,2024-04-29,13,438,397,835,VAC_T,"-37.82129925, 144.96879309"
47020240114,47,2024-01-14,0,168,220,388,Eli250_T,"-37.81258467, 144.9625775"
541920251006,54,2025-10-06,19,147,271,418,Swa607_T,"-37.804024, 144.96308399"
312320250503,31,2025-05-03,23,211,250,461,Lyg161_T,"-37.80169681, 144.96658911"
36620241219,36,2024-12-19,6,34,20,54,Que85_T,"-37.81652527, 144.96121062"
472020241104,47,2024-11-04,20,551,463,1014,Eli250_T,"-37.81258467, 144.9625775"
372120231127,37,2023-11-27,21,11,62,73,Lyg260_T,"-37.80107122, 144.96704554"
211920251010,21,2025-10-10,19,501,468,969,Bourke155_T,"-37.81267313, 144.96788288"
45120240904,45,2024-09-04,1,20,22,42,Swa148_T,"-37.81414075, 144.96609379"
51320250301,5,2025-03-01,13,1197,1682,2879,PriNW_T,"-37.81874249, 144.96787656"
108520241020,108,2024-10-20,5,7,9,16,261Will_T,"-37.81295822, 144.95678789"
165520251002,165,2025-10-02,5,1,3,4,Spen475_T,"-37.80953359, 144.94939004"
1661520241204,166,2024-12-04,15,51,56,107,Spen484_T,"-37.80896733, 144.94931703"
166020251006,166,2025-10-06,0,1,1,2,Spen484_T,"-37.80896733, 144.94931703"
851320231119,85,2023-11-19,13,114,88,202,488Mac_T,"-37.79432415, 144.92973378"
172120250925,17,2025-09-25,21,109,120,229,Col15_T,"-37.81362543, 144.97323591"
672220240213,67,2024-02-13,22,50,67,117,FLDegS_T,"-37.81688755, 144.96562569"
671720250415,67,2025-04-15,17,459,642,1101,FLDegS_T,"-37.81688755, 144.96562569"
181020240301,18,2024-03-01,10,133,222,355,Col12_T,"-37.81344862, 144.97305353"
181420241229,18,2024-12-29,14,79,74,153,Col12_T,"-37.81344862, 144.97305353"
63720240924,63,2024-09-24,7,87,86,173,Bou231_T,"-37.81333081, 144.96675571"
632220250709,63,2025-07-09,22,5,56,61,Bou231_T,"-37.81333081, 144.96675571"
62320240714,62,2024-07-14,3,29,9,38,Lat224_T,"-37.80996494, 144.96216521"
56020231122,56,2023-11-22,0,18,17,35,Lon364_T,"-37.81234775, 144.96153311"
561120250210,56,2025-02-10,11,305,247,552,Lon364_T,"-37.81234775, 144.96153311"
241020240229,24,2024-02-29,10,641,368,1009,Col620_T,"-37.81887963, 144.95449198"
10720250907,10,2025-09-07,7,5,6,11,BouHbr_T,"-37.81876474, 144.94710545"
241920250728,24,2025-07-28,19,331,508,839,Col620_T,"-37.81887963, 144.95449198"
761620250504,76,2025-05-04,16,42,45,87,KenMac_T,"-37.79453803, 144.93036194"
2820250329,2,2025-03-29,8,76,79,155,Bou283_T,"-37.81380668, 144.96516718"
532120240109,53,2024-01-09,21,137,295,432,Col254_T,"-37.81564191, 144.965499"
791820240804,79,2024-08-04,18,376,508,884,FliSS_T,"-37.81794046, 144.96616678"
302020250828,30,2025-08-28,20,217,458,675,Lon189_T,"-37.8112185, 144.96656806"
201020250725,20,2025-07-25,10,99,107,206,LtB170_T,"-37.81172914, 144.9682466"
20020250821,20,2025-08-21,0,14,36,50,LtB170_T,"-37.81172914, 144.9682466"
20620240920,20,2024-09-20,6,13,17,30,LtB170_T,"-37.81172914, 144.9682466"
232220250108,23,2025-01-08,22,66,97,163,Col623_T,"-37.81909256, 144.95452748"
492220250530,49,2025-05-30,22,174,149,323,Eli501_T,"-37.80730068, 144.95956055"
49620250622,49,2025-06-22,6,33,20,53,Eli501_T,"-37.80730068, 144.95956055"
19820241103,19,2024-11-03,8,41,34,75,LtB210_T,"-37.81237202, 144.96550671"
48720241221,48,2024-12-21,7,55,62,117,QVMQ_T,"-37.80631581, 144.95866697"
1411420250609,141,2025-06-09,14,214,151,365,474Fl_T,"-37.81997273, 144.95834911"
137920250909,137,2025-09-09,9,65,39,104,BouHbr2353_T,"-37.81894815, 144.94612292"
130720250616,130,2025-06-16,7,10,11,21,Bou892T,"-37.8204637, 144.94126826"
1172220231120,117,2023-11-20,22,45,154,199,Fli114F_T,"-37.81629332, 144.97090877"
1231720240106,123,2024-01-06,17,30,14,44,BirBridge_T,"-37.81753741, 144.97329734"
661220250918,66,2025-09-18,12,936,1312,2248,QVN_T,"-37.81057846, 144.96444294"
691720240802,69,2024-08-02,17,131,139,270,FLDegC_T,"-37.81687226, 144.96559144"
66420240119,66,2024-01-19,4,25,28,53,QVN_T,"-37.81057846, 144.96444294"
3220240627,3,2024-06-27,2,45,20,65,Swa295_T,"-37.81101524, 144.96429485"
781520231130,78,2023-11-30,15,31,98,129,HarEsB_T,"-37.81471642, 144.9446508"
77320241101,77,2024-11-01,3,2,1,3,HarEsP_T,"-37.81441438, 144.94433026"
422120240814,42,2024-08-14,21,70,108,178,UM1_T,"-37.80008566, 144.96386412"
772320240124,77,2024-01-24,23,32,20,52,HarEsP_T,"-37.81441438, 144.94433026"
78420250908,78,2025-09-08,4,0,1,1,HarEsB_T,"-37.81471642, 144.9446508"
591620241112,59,2024-11-12,16,288,522,810,RMIT_T,"-37.80825648, 144.96304859"
65720240112,65,2024-01-12,7,158,70,228,SwaCs_T,"-37.81569416, 144.9668064"
871920241009,87,2024-10-09,19,101,82,183,Errol23_T,"-37.80454949, 144.94921863"
431820250312,43,2025-03-12,18,221,331,552,UM2_T,"-37.79844526, 144.96411782"
43220231208,43,2023-12-08,2,1,0,1,UM2_T,"-37.79844526, 144.96411782"
1791620250614,179,2025-06-14,16,63,47,110,Pow61_T,"-37.82392385, 144.96299677"
1671120250106,167,2025-01-06,11,5,7,12,Lat526_T,"-37.81304149, 144.95155955"
165120250605,165,2025-06-05,1,3,0,3,Spen475_T,"-37.80953359, 144.94939004"
1401320250813,140,2025-08-13,13,99,106,205,Boyd2837_T,"-37.82590962, 144.96185972"
1431920240905,143,2024-09-05,19,82,158,240,Spencer_T,"-37.821728, 144.95557015"
1321620250816,132,2025-08-16,16,101,131,232,King335_T,"-37.81267639, 144.95386444"
1182020250403,118,2025-04-03,20,6,8,14,Fli114C_T,"-37.81632783, 144.97090512"
67020250922,67,2025-09-22,0,6,10,16,FLDegS_T,"-37.81688755, 144.96562569"
851720240416,85,2024-04-16,17,70,126,196,488Mac_T,"-37.79432415, 144.92973378"
85520240713,85,2024-07-13,5,2,1,3,488Mac_T,"-37.79432415, 144.92973378"
63520231103,63,2023-11-03,5,7,16,23,Bou231_T,"-37.81333081, 144.96675571"
63520231220,63,2023-12-20,5,13,19,32,Bou231_T,"-37.81333081, 144.96675571"
11820250523,11,2025-05-23,8,45,36,81,WatCit_T,"-37.81564989, 144.93970694"
10520240110,10,2024-01-10,5,5,3,8,BouHbr_T,"-37.81876474, 144.94710545"
10720240212,10,2024-02-12,7,41,104,145,BouHbr_T,"-37.81876474, 144.94710545"
102220240728,10,2024-07-28,22,9,4,13,BouHbr_T,"-37.81876474, 144.94710545"
101620240805,10,2024-08-05,16,161,29,190,BouHbr_T,"-37.81876474, 144.94710545"
11420240303,11,2024-03-03,4,2,1,3,WatCit_T,"-37.81564989, 144.93970694"
351220250903,35,2025-09-03,12,1256,1186,2442,SouthB_T,"-37.82018685, 144.96508508"
35020250927,35,2025-09-27,0,175,245,420,SouthB_T,"-37.82018685, 144.96508508"
2520240412,2,2024-04-12,5,8,16,24,Bou283_T,"-37.81380668, 144.96516718"
581120240126,58,2024-01-26,11,562,207,769,Bou688_T,"-37.81686075, 144.95358075"
351320250217,35,2025-02-17,13,1186,1393,2579,SouthB_T,"-37.82018685, 144.96508508"
271620240619,27,2024-06-19,16,142,101,243,Vic_T,"-37.80606888, 144.95644692"
21620240708,2,2024-07-08,16,590,575,1165,Bou283_T,"-37.81380668, 144.96516718"
79220250530,79,2025-05-30,2,7,10,17,FliSS_T,"-37.81794046, 144.96616678"
301320240119,30,2024-01-19,13,339,416,755,Lon189_T,"-37.8112185, 144.96656806"
231620250206,23,2025-02-06,16,199,591,790,Col623_T,"-37.81909256, 144.95452748"
231920250601,23,2025-06-01,19,76,201,277,Col623_T,"-37.81909256, 144.95452748"
25920240522,25,2024-05-22,9,188,526,714,MCEC_T,"-37.82401776, 144.95604426"
301620250712,30,2025-07-12,16,426,707,1133,Lon189_T,"-37.8112185, 144.96656806"
164920241221,164,2024-12-21,9,67,27,94,Lat526_T,"-37.813005, 144.95160411"
1641620250408,164,2025-04-08,16,136,106,242,Lat526_T,"-37.813005, 144.95160411"
1171920250604,117,2025-06-04,19,71,86,157,Fli114F_T,"-37.81629332, 144.97090877"
1172320241117,117,2024-11-17,23,228,35,263,Fli114F_T,"-37.81629332, 144.97090877"
117720241217,117,2024-12-17,7,110,62,172,Fli114F_T,"-37.81629332, 144.97090877"
662220231018,66,2023-10-18,22,430,336,766,QVN_T,"-37.81057846, 144.96444294"
41120250330,4,2025-03-30,11,2036,838,2874,Swa123_T,"-37.81487988, 144.9660878"
391420250911,39,2025-09-11,14,81,116,197,AlfPl_T,"-37.81379749, 144.96995745"
82220250410,8,2025-04-10,22,12,11,23,WebBN_T,"-37.82293543, 144.9471751"
81620250418,8,2025-04-18,16,133,116,249,WebBN_T,"-37.82293543, 144.9471751"
71720250228,71,2025-02-28,7,7,10,17,WestWP_T,"-37.81235775, 144.97136962"
711420250408,71,2025-04-08,14,16,19,35,WestWP_T,"-37.81235775, 144.97136962"
65320231111,65,2023-11-11,3,10,42,52,SwaCs_T,"-37.81569416, 144.9668064"
59820240628,59,2024-06-28,8,263,147,410,RMIT_T,"-37.80825648, 144.96304859"
24720240310,24,2024-03-10,7,121,163,284,Col620_T,"-37.81887963, 144.95449198"
241920240410,24,2024-04-10,19,304,586,890,Col620_T,"-37.81887963, 144.95449198"
762020250521,76,2025-05-21,20,10,14,24,KenMac_T,"-37.79453803, 144.93036194"
761620250807,76,2025-08-07,16,55,75,130,KenMac_T,"-37.79453803, 144.93036194"
58320250307,58,2025-03-07,3,13,19,32,Bou688_T,"-37.81686075, 144.95358075"
53220250928,53,2025-09-28,2,14,37,51,Col254_T,"-37.81564191, 144.965499"
9020231212,9,2023-12-12,0,13,8,21,Col700_T,"-37.81982992, 144.95102555"
53620241111,53,2024-11-11,6,23,37,60,Col254_T,"-37.81564191, 144.965499"
79620240226,79,2024-02-26,6,98,76,174,FliSS_T,"-37.81794046, 144.96616678"
53420250403,53,2025-04-03,4,2,0,2,Col254_T,"-37.81564191, 144.965499"
20120240429,20,2024-04-29,1,71,123,194,LtB170_T,"-37.81172914, 144.9682466"
252120231216,25,2023-12-16,21,958,598,1556,MCEC_T,"-37.82401776, 144.95604426"
51920241024,51,2024-10-24,9,103,56,159,Fra118_T,"-37.80841815, 144.95906316"
512120250711,51,2025-07-11,21,74,52,126,Fra118_T,"-37.80841815, 144.95906316"
231820250209,23,2025-02-09,18,93,193,286,Col623_T,"-37.81909256, 144.95452748"
231420240703,23,2024-07-03,14,227,418,645,Col623_T,"-37.81909256, 144.95452748"
1611520240621,161,2024-06-21,15,184,98,282,BirArt1109_T,"-37.81851276, 144.97131336"
164820241126,164,2024-11-26,8,125,93,218,Lat526_T,"-37.813005, 144.95160411"
1231620250622,123,2025-06-22,16,48,20,68,BirBridge_T,"-37.81753741, 144.97329734"
492220240909,49,2024-09-09,22,128,97,225,Eli501_T,"-37.80730068, 144.95956055"
19620250617,19,2025-06-17,6,20,5,25,LtB210_T,"-37.81237202, 144.96550671"
48420231027,48,2023-10-27,4,8,4,12,QVMQ_T,"-37.80631581, 144.95866697"
136820240323,136,2024-03-23,8,49,77,126,BirFed1120_T,"-37.8184141, 144.97357915"
1421320241104,142,2024-11-04,13,1002,570,1572,Hammer1584_T,"-37.81970749, 144.96795734"
1301920241014,130,2024-10-14,19,22,23,45,Bou892T,"-37.8204637, 144.94126826"
1801820250406,180,2025-04-06,18,12,19,31,Mac330_T,"-37.79497059, 144.93530329"
662020250202,66,2025-02-02,20,712,586,1298,QVN_T,"-37.81057846, 144.96444294"
692020240115,69,2024-01-15,20,77,35,112,FLDegC_T,"-37.81687226, 144.96559144"
69420250827,69,2025-08-27,4,1,1,2,FLDegC_T,"-37.81687226, 144.96559144"
61420240823,6,2024-08-23,14,902,666,1568,FliS_T,"-37.81911705, 144.96558255"
84620240112,84,2024-01-12,6,157,78,235,ElFi_T,"-37.81798049, 144.96503383"
6220250728,6,2025-07-28,2,7,7,14,FliS_T,"-37.81911705, 144.96558255"
841020250218,84,2025-02-18,10,745,499,1244,ElFi_T,"-37.81798049, 144.96503383"
4120240229,4,2024-02-29,1,63,21,84,Swa123_T,"-37.81487988, 144.9660878"
41620240827,4,2024-08-27,16,1031,950,1981,Swa123_T,"-37.81487988, 144.9660878"
31920240113,3,2024-01-13,19,1078,1328,2406,Swa295_T,"-37.81101524, 144.96429485"
3920240201,3,2024-02-01,9,242,326,568,Swa295_T,"-37.81101524, 144.96429485"
8720240110,8,2024-01-10,7,147,98,245,WebBN_T,"-37.82293543, 144.9471751"
411420240227,41,2024-02-27,14,1442,1497,2939,Swa31,"-37.81668634, 144.96689733"
77320240504,77,2024-05-04,3,5,0,5,HarEsP_T,"-37.81441438, 144.94433026"
77520250803,77,2025-08-03,5,4,4,8,HarEsP_T,"-37.81441438, 144.94433026"
42020240702,42,2024-07-02,0,2,5,7,UM1_T,"-37.80008566, 144.96386412"
29320251009,29,2025-10-09,3,1,1,2,AG_T,"-37.8199817, 144.96872865"
712120240223,71,2024-02-23,21,10,3,13,WestWP_T,"-37.81235775, 144.97136962"
31220250302,31,2025-03-02,2,15,10,25,Lyg161_T,"-37.80169681, 144.96658911"
311820250326,31,2025-03-26,18,291,186,477,Lyg161_T,"-37.80169681, 144.96658911"
541720250619,54,2025-06-19,17,143,260,403,Swa607_T,"-37.804024, 144.96308399"
28920240721,28,2024-07-21,9,286,235,521,VAC_T,"-37.82129925, 144.96879309"
361620240406,36,2024-04-06,16,122,117,239,Que85_T,"-37.81652527, 144.96121062"
361720240108,36,2024-01-08,17,184,228,412,Que85_T,"-37.81652527, 144.96121062"
291120240704,29,2024-07-04,11,133,214,347,AG_T,"-37.8199817, 144.96872865"
47720240812,47,2024-08-12,7,132,264,396,Eli250_T,"-37.81258467, 144.9625775"
402020250215,40,2025-02-15,20,142,131,273,Spr201_T,"-37.80999341, 144.97227587"
31420250608,31,2025-06-08,4,2,3,5,Lyg161_T,"-37.80169681, 144.96658911"
311820240507,31,2024-05-07,18,183,106,289,Lyg161_T,"-37.80169681, 144.96658911"
361620240311,36,2024-03-11,16,51,55,106,Que85_T,"-37.81652527, 144.96121062"
361220250428,36,2025-04-28,12,292,283,575,Que85_T,"-37.81652527, 144.96121062"
361020250504,36,2025-05-04,10,134,83,217,Que85_T,"-37.81652527, 144.96121062"
361720241126,36,2024-11-26,17,303,276,579,Que85_T,"-37.81652527, 144.96121062"
472220250423,47,2025-04-23,22,264,219,483,Eli250_T,"-37.81258467, 144.9625775"
472120250601,47,2025-06-01,21,265,179,444,Eli250_T,"-37.81258467, 144.9625775"
211620240121,21,2024-01-21,16,463,446,909,Bourke155_T,"-37.81267313, 144.96788288"
51120241122,5,2024-11-22,11,171,289,460,PriNW_T,"-37.81874249, 144.96787656"
51520241129,5,2024-11-29,15,826,822,1648,PriNW_T,"-37.81874249, 144.96787656"
211320240810,21,2024-08-10,13,479,519,998,Bourke155_T,"-37.81267313, 144.96788288"
1071620250502,107,2025-05-02,16,184,144,328,280Will_T,"-37.81246271, 144.95690188"
1081520240910,108,2024-09-10,15,371,191,562,261Will_T,"-37.81295822, 144.95678789"
61620250417,61,2025-04-17,6,38,45,83,RMIT14_T,"-37.80767455, 144.96309114"
502220240404,50,2024-04-04,22,100,53,153,Lyg309_T,"-37.79808192, 144.96721013"
50920240914,50,2024-09-14,9,73,107,180,Lyg309_T,"-37.79808192, 144.96721013"
1792320250322,179,2025-03-22,23,34,37,71,Pow61_T,"-37.82392385, 144.96299677"
1661220241206,166,2024-12-06,12,50,72,122,Spen484_T,"-37.80896733, 144.94931703"
1311920250410,131,2025-04-10,19,104,108,212,King2_T,"-37.82009057, 144.95758725"
1321920250806,132,2025-08-06,19,178,166,344,King335_T,"-37.81267639, 144.95386444"
135120250109,135,2025-01-09,1,21,25,46,Spen161_T,"-37.8172861, 144.95319102"
1182320250817,118,2025-08-17,23,24,1,25,Fli114C_T,"-37.81632783, 144.97090512"
501120250707,50,2025-07-07,11,156,174,330,Lyg309_T,"-37.79808192, 144.96721013"
50220250216,50,2025-02-16,2,4,0,4,Lyg309_T,"-37.79808192, 144.96721013"
432320240105,43,2024-01-05,23,8,10,18,UM2_T,"-37.79844526, 144.96411782"
1622020241231,162,2024-12-31,20,285,224,509,Eli489_T,"-37.80740397, 144.95987909"
185420251007,185,2025-10-07,4,10,8,18,Eli197_T,"-37.81374643, 144.96276183"
1621020250605,162,2025-06-05,10,330,329,659,Eli489_T,"-37.80740397, 144.95987909"
1321420231106,132,2023-11-06,14,132,100,232,King335_T,"-37.81267639, 144.95386444"
1322120250406,132,2025-04-06,21,50,87,137,King335_T,"-37.81267639, 144.95386444"
135120251003,135,2025-10-03,1,26,35,61,Spen161_T,"-37.8172861, 144.95319102"
133420240616,133,2024-06-16,4,17,19,36,Spen229_T,"-37.81531435, 144.95227769"
118920250720,118,2025-07-20,9,8,56,64,Fli114C_T,"-37.81632783, 144.97090512"
171520240109,17,2024-01-09,15,290,281,571,Col15_T,"-37.81362543, 144.97323591"
62920250823,62,2025-08-23,9,123,114,237,Lat224_T,"-37.80996494, 144.96216521"
56320231103,56,2023-11-03,3,10,7,17,Lon364_T,"-37.81234775, 144.96153311"
111020241002,11,2024-10-02,10,60,77,137,WatCit_T,"-37.81564989, 144.93970694"
121520240818,12,2024-08-18,15,183,459,642,NewQ_T,"-37.81457988, 144.94292398"
721620240410,72,2024-04-10,16,268,769,1037,ACMI_T,"-37.81726338, 144.96872809"
9420241028,9,2024-10-28,4,3,2,5,Col700_T,"-37.81982992, 144.95102555"
53420250429,53,2025-04-29,4,2,2,4,Col254_T,"-37.81564191, 144.965499"
53620241016,53,2024-10-16,6,48,38,86,Col254_T,"-37.81564191, 144.965499"
61120240817,61,2024-08-17,1,28,15,43,RMIT14_T,"-37.80767455, 144.96309114"
44020231020,44,2023-10-20,0,4,4,8,UM3_T,"-37.79698741, 144.96441306"
131420240514,131,2024-05-14,4,4,1,5,King2_T,"-37.82009057, 144.95758725"
132420240107,132,2024-01-07,4,8,17,25,King335_T,"-37.81267639, 144.95386444"
1341120240713,134,2024-07-13,11,439,442,881,Spen201_T,"-37.81694221, 144.95303935"
107920250402,107,2025-04-02,9,91,224,315,280Will_T,"-37.81246271, 144.95690188"
133520231126,133,2023-11-26,5,17,72,89,Spen229_T,"-37.81531435, 144.95227769"
118820240520,118,2024-05-20,8,26,15,41,Fli114C_T,"-37.81632783, 144.97090512"
672220240730,67,2024-07-30,22,24,85,109,FLDegS_T,"-37.81688755, 144.96562569"
851520231209,85,2023-12-09,15,57,72,129,488Mac_T,"-37.79432415, 144.92973378"
171020250816,17,2025-08-16,10,163,113,276,Col15_T,"-37.81362543, 144.97323591"
68620250604,68,2025-06-04,6,15,6,21,FLDegN_T,"-37.8168479, 144.96559789"
682220231107,68,2023-11-07,22,10,2,12,FLDegN_T,"-37.8168479, 144.96559789"
63620240830,63,2024-08-30,6,33,48,81,Bou231_T,"-37.81333081, 144.96675571"
631820241103,63,2024-11-03,18,291,285,576,Bou231_T,"-37.81333081, 144.96675571"
63120250109,63,2025-01-09,1,2,19,21,Bou231_T,"-37.81333081, 144.96675571"
63420250317,63,2025-03-17,4,1,2,3,Bou231_T,"-37.81333081, 144.96675571"
67120240717,67,2024-07-17,1,4,6,10,FLDegS_T,"-37.81688755, 144.96562569"
682020250311,68,2025-03-11,20,90,59,149,FLDegN_T,"-37.8168479, 144.96559789"
62520240213,62,2024-02-13,5,16,11,27,Lat224_T,"-37.80996494, 144.96216521"
621820250311,62,2025-03-11,18,330,235,565,Lat224_T,"-37.80996494, 144.96216521"
561720241006,56,2024-10-06,17,349,447,796,Lon364_T,"-37.81234775, 144.96153311"
112320250715,11,2025-07-15,23,12,6,18,WatCit_T,"-37.81564989, 144.93970694"
122120250206,12,2025-02-06,21,333,273,606,NewQ_T,"-37.81457988, 144.94292398"
101720240815,10,2024-08-15,17,172,71,243,BouHbr_T,"-37.81876474, 144.94710545"
102120241118,10,2024-11-18,21,40,42,82,BouHbr_T,"-37.81876474, 144.94710545"
76720231114,76,2023-11-14,7,33,18,51,KenMac_T,"-37.79453803, 144.93036194"
76920240503,76,2024-05-03,9,86,53,139,KenMac_T,"-37.79453803, 144.93036194"
21820241113,2,2024-11-13,18,357,361,718,Bou283_T,"-37.81380668, 144.96516718"
351920250621,35,2025-06-21,19,658,762,1420,SouthB_T,"-37.82018685, 144.96508508"
351220250929,35,2025-09-29,12,1471,1416,2887,SouthB_T,"-37.82018685, 144.96508508"
58220240916,58,2024-09-16,2,14,14,28,Bou688_T,"-37.81686075, 144.95358075"
27020240621,27,2024-06-21,0,16,7,23,Vic_T,"-37.80606888, 144.95644692"
27120250306,27,2025-03-06,1,12,6,18,Vic_T,"-37.80606888, 144.95644692"
791720231218,79,2023-12-18,17,653,508,1161,FliSS_T,"-37.81794046, 144.96616678"
791520241206,79,2024-12-06,15,512,468,980,FliSS_T,"-37.81794046, 144.96616678"
461820250515,46,2025-05-15,18,25,31,56,Pel147_T,"-37.80240719, 144.9615673"
251220240225,25,2024-02-25,12,708,812,1520,MCEC_T,"-37.82401776, 144.95604426"
25020241225,25,2024-12-25,0,57,158,215,MCEC_T,"-37.82401776, 144.95604426"
52620250821,52,2025-08-21,6,21,16,37,Eli263_T,"-37.81252157, 144.9619401"
522220240610,52,2024-06-10,22,50,75,125,Eli263_T,"-37.81252157, 144.9619401"
1611520250101,161,2025-01-01,15,67,161,228,BirArt1109_T,"-37.81851276, 144.97131336"
1611920250218,161,2025-02-18,19,336,109,445,BirArt1109_T,"-37.81851276, 144.97131336"
1411420240811,141,2024-08-11,14,164,246,410,474Fl_T,"-37.81997273, 144.95834911"
141820241226,141,2024-12-26,8,119,21,140,474Fl_T,"-37.81997273, 144.95834911"
123720241212,123,2024-12-12,7,17,1,18,BirBridge_T,"-37.81753741, 144.97329734"
1171320231227,117,2023-12-27,13,151,154,305,Fli114F_T,"-37.81629332, 144.97090877"
49920240406,49,2024-04-06,9,212,271,483,Eli501_T,"-37.80730068, 144.95956055"
48820240817,48,2024-08-17,8,98,97,195,QVMQ_T,"-37.80631581, 144.95866697"
1391120250430,139,2025-04-30,11,44,47,91,Signal1647_T,"-37.81959923, 144.9632832"
136620240329,136,2024-03-29,6,2,0,2,BirFed1120_T,"-37.8184141, 144.97357915"
1301320231214,130,2023-12-14,13,45,80,125,Bou892T,"-37.8204637, 144.94126826"
69020240811,69,2024-08-11,0,3,9,12,FLDegC_T,"-37.81687226, 144.96559144"
41420250908,4,2025-09-08,14,1459,1157,2616,Swa123_T,"-37.81487988, 144.9660878"
70820241123,70,2024-11-23,8,53,55,108,Errol20_T,"-37.80456984, 144.94946228"
23120240211,23,2024-02-11,1,16,47,63,Col623_T,"-37.81909256, 144.95452748"
20420240414,20,2024-04-14,4,66,55,121,LtB170_T,"-37.81172914, 144.9682466"
109420250828,109,2025-08-28,4,2,0,2,LatWill_T,"-37.81193681, 144.95621105"
49820240909,49,2024-09-09,8,105,136,241,Eli501_T,"-37.80730068, 144.95956055"
491320241211,49,2024-12-11,13,324,397,721,Eli501_T,"-37.80730068, 144.95956055"
19120241017,19,2024-10-17,1,34,35,69,LtB210_T,"-37.81237202, 144.96550671"
251620250226,25,2025-02-26,16,579,399,978,MCEC_T,"-37.82401776, 144.95604426"
201720250514,20,2025-05-14,17,440,288,728,LtB170_T,"-37.81172914, 144.9682466"
481920240403,48,2024-04-03,19,167,186,353,QVMQ_T,"-37.80631581, 144.95866697"
1301720240710,130,2024-07-10,17,1,13,14,Bou892T,"-37.8204637, 144.94126826"
1381320240714,138,2024-07-14,13,4,8,12,EntPark1671_T,"-37.81996544, 144.95981454"
1171420250629,117,2025-06-29,14,216,149,365,Fli114F_T,"-37.81629332, 144.97090877"
123920231019,123,2023-10-19,9,28,9,37,BirBridge_T,"-37.81753741, 144.97329734"
691020240909,69,2024-09-09,10,256,251,507,FLDegC_T,"-37.81687226, 144.96559144"
842020231105,84,2023-11-05,20,855,841,1696,ElFi_T,"-37.81798049, 144.96503383"
84420250518,84,2025-05-18,4,53,71,124,ElFi_T,"-37.81798049, 144.96503383"
391120231123,39,2023-11-23,11,137,115,252,AlfPl_T,"-37.81379749, 144.96995745"
391520240317,39,2024-03-17,15,61,52,113,AlfPl_T,"-37.81379749, 144.96995745"
39020240429,39,2024-04-29,0,11,4,15,AlfPl_T,"-37.81379749, 144.96995745"
32020250524,3,2025-05-24,20,1412,1045,2457,Swa295_T,"-37.81101524, 144.96429485"
81920250901,8,2025-09-01,19,22,28,50,WebBN_T,"-37.82293543, 144.9471751"
8620231216,8,2023-12-16,6,17,23,40,WebBN_T,"-37.82293543, 144.9471751"
41420240207,41,2024-02-07,4,28,43,71,Swa31,"-37.81668634, 144.96689733"
422220240723,42,2024-07-23,22,33,62,95,UM1_T,"-37.80008566, 144.96386412"
141320240723,14,2024-07-23,13,327,147,474,SanBri_T,"-37.82011242, 144.96291897"
28520250426,28,2025-04-26,5,12,15,27,VAC_T,"-37.82129925, 144.96879309"
40020231223,40,2023-12-23,0,29,23,52,Spr201_T,"-37.80999341, 144.97227587"
40620240414,40,2024-04-14,6,7,5,12,Spr201_T,"-37.80999341, 144.97227587"
40520240419,40,2024-04-19,5,8,14,22,Spr201_T,"-37.80999341, 144.97227587"
31520240407,31,2024-04-07,5,13,2,15,Lyg161_T,"-37.80169681, 144.96658911"
54920250709,54,2025-07-09,9,78,45,123,Swa607_T,"-37.804024, 144.96308399"
36020250518,36,2025-05-18,0,131,165,296,Que85_T,"-37.81652527, 144.96121062"
451920250422,45,2025-04-22,19,200,570,770,Swa148_T,"-37.81414075, 144.96609379"
51520240731,5,2024-07-31,15,819,617,1436,PriNW_T,"-37.81874249, 144.96787656"
21020241115,21,2024-11-15,0,63,83,146,Bourke155_T,"-37.81267313, 144.96788288"
107820240510,107,2024-05-10,8,70,218,288,280Will_T,"-37.81246271, 144.95690188"
50620250210,50,2025-02-10,6,7,9,16,Lyg309_T,"-37.79808192, 144.96721013"
691220240311,69,2024-03-11,12,76,91,167,FLDegC_T,"-37.81687226, 144.96559144"
701020250105,70,2025-01-05,10,80,66,146,Errol20_T,"-37.80456984, 144.94946228"
39520240422,39,2024-04-22,5,5,2,7,AlfPl_T,"-37.81379749, 144.96995745"
391020250202,39,2025-02-02,10,37,47,84,AlfPl_T,"-37.81379749, 144.96995745"
392220250408,39,2025-04-08,22,24,14,38,AlfPl_T,"-37.81379749, 144.96995745"
81420250827,8,2025-08-27,14,120,196,316,WebBN_T,"-37.82293543, 144.9471751"
82120250831,8,2025-08-31,21,1,3,4,WebBN_T,"-37.82293543, 144.9471751"
81120231221,8,2023-12-21,11,110,255,365,WebBN_T,"-37.82293543, 144.9471751"
412020250208,41,2025-02-08,20,1089,1185,2274,Swa31,"-37.81668634, 144.96689733"
59020241218,59,2024-12-18,0,44,41,85,RMIT_T,"-37.80825648, 144.96304859"
711020241016,71,2024-10-16,10,24,21,45,WestWP_T,"-37.81235775, 144.97136962"
591920240122,59,2024-01-22,19,443,314,757,RMIT_T,"-37.80825648, 144.96304859"
591620240128,59,2024-01-28,16,431,406,837,RMIT_T,"-37.80825648, 144.96304859"
42220241216,42,2024-12-16,2,3,1,4,UM1_T,"-37.80008566, 144.96386412"
291220240617,29,2024-06-17,12,231,273,504,AG_T,"-37.8199817, 144.96872865"
411520250806,41,2025-08-06,15,1276,1912,3188,Swa31,"-37.81668634, 144.96689733"
411820250207,41,2025-02-07,18,1663,1806,3469,Swa31,"-37.81668634, 144.96689733"
781020250403,78,2025-04-03,10,28,36,64,HarEsB_T,"-37.81471642, 144.9446508"
651620240123,65,2024-01-23,16,428,770,1198,SwaCs_T,"-37.81569416, 144.9668064"
311820241022,31,2024-10-22,18,164,118,282,Lyg161_T,"-37.80169681, 144.96658911"
542020240607,54,2024-06-07,20,125,175,300,Swa607_T,"-37.804024, 144.96308399"
251720250516,25,2025-05-16,17,769,771,1540,MCEC_T,"-37.82401776, 144.95604426"
521620250520,52,2025-05-20,16,376,300,676,Eli263_T,"-37.81252157, 144.9619401"
141520240110,141,2024-01-10,5,10,4,14,474Fl_T,"-37.81997273, 144.95834911"
1412320250328,141,2025-03-28,23,115,75,190,474Fl_T,"-37.81997273, 144.95834911"
191820250722,19,2025-07-22,18,627,385,1012,LtB210_T,"-37.81237202, 144.96550671"
1092020240312,109,2024-03-12,20,119,92,211,LatWill_T,"-37.81193681, 144.95621105"
48120240705,48,2024-07-05,1,16,10,26,QVMQ_T,"-37.80631581, 144.95866697"
180820250824,180,2025-08-24,8,27,7,34,Mac330_T,"-37.79497059, 144.93530329"
1371120231110,137,2023-11-10,11,25,70,95,BouHbr2353_T,"-37.81894815, 144.94612292"
1372320241109,137,2024-11-09,23,7,5,12,BouHbr2353_T,"-37.81894815, 144.94612292"
137520250605,137,2025-06-05,5,0,2,2,BouHbr2353_T,"-37.81894815, 144.94612292"
1361620250817,136,2025-08-17,16,70,42,112,BirFed1120_T,"-37.8184141, 144.97357915"
1421620240317,142,2024-03-17,16,553,539,1092,Hammer1584_T,"-37.81970749, 144.96795734"
142520240719,142,2024-07-19,5,13,0,13,Hammer1584_T,"-37.81970749, 144.96795734"
68820250806,68,2025-08-06,8,212,214,426,FLDegN_T,"-37.8168479, 144.96559789"
631620250220,63,2025-02-20,16,367,428,795,Bou231_T,"-37.81333081, 144.96675571"
861720250908,86,2025-09-08,17,46,80,126,574Qub_T,"-37.80309992, 144.94908064"
101920251004,10,2025-10-04,19,97,90,187,BouHbr_T,"-37.81876474, 144.94710545"
352120240805,35,2024-08-05,21,278,501,779,SouthB_T,"-37.82018685, 144.96508508"
35620241113,35,2024-11-13,6,358,432,790,SouthB_T,"-37.82018685, 144.96508508"
351320250804,35,2025-08-04,13,1080,1125,2205,SouthB_T,"-37.82018685, 144.96508508"
9020250923,9,2025-09-23,0,1,4,5,Col700_T,"-37.81982992, 144.95102555"
791920240310,79,2024-03-10,19,1155,409,1564,FliSS_T,"-37.81794046, 144.96616678"
30420240701,30,2024-07-01,4,26,36,62,Lon189_T,"-37.8112185, 144.96656806"
301020231230,30,2023-12-30,10,105,201,306,Lon189_T,"-37.8112185, 144.96656806"
20920241108,20,2024-11-08,9,56,81,137,LtB170_T,"-37.81172914, 144.9682466"
251920231204,25,2023-12-04,19,369,223,592,MCEC_T,"-37.82401776, 144.95604426"
472320240427,47,2024-04-27,23,308,281,589,Eli250_T,"-37.81258467, 144.9625775"
612220250201,61,2025-02-01,22,231,96,327,RMIT14_T,"-37.80767455, 144.96309114"
612120250624,61,2025-06-24,21,123,74,197,RMIT14_T,"-37.80767455, 144.96309114"
432220240416,43,2024-04-16,22,36,50,86,UM2_T,"-37.79844526, 144.96411782"
431520241123,43,2024-11-23,15,37,31,68,UM2_T,"-37.79844526, 144.96411782"
431120250628,43,2025-06-28,11,136,66,202,UM2_T,"-37.79844526, 144.96411782"
441220240321,44,2024-03-21,12,149,118,267,UM3_T,"-37.79698741, 144.96441306"
44020250316,44,2025-03-16,0,9,3,12,UM3_T,"-37.79698741, 144.96441306"
371520240726,37,2024-07-26,15,94,109,203,Lyg260_T,"-37.80107122, 144.96704554"
45020250716,45,2025-07-16,0,24,56,80,Swa148_T,"-37.81414075, 144.96609379"
612020231205,61,2023-12-05,20,248,269,517,RMIT14_T,"-37.80767455, 144.96309114"
441720250329,44,2025-03-29,17,53,77,130,UM3_T,"-37.79698741, 144.96441306"
182120250728,182,2025-07-28,1,38,36,74,King163_T,"-37.81627451, 144.95550503"
162120240808,162,2024-08-08,1,30,26,56,Eli489_T,"-37.80740397, 144.95987909"
131720241006,131,2024-10-06,7,22,45,67,King2_T,"-37.82009057, 144.95758725"
132520240917,132,2024-09-17,5,17,8,25,King335_T,"-37.81267639, 144.95386444"
1341020240511,134,2024-05-11,10,286,334,620,Spen201_T,"-37.81694221, 144.95303935"
1351320241026,135,2024-10-26,13,452,539,991,Spen161_T,"-37.8172861, 144.95319102"
118220250228,118,2025-02-28,2,0,3,3,Fli114C_T,"-37.81632783, 144.97090512"
164820250426,164,2025-04-26,8,45,23,68,Lat526_T,"-37.813005, 144.95160411"
1381320240223,138,2024-02-23,13,12,9,21,EntPark1671_T,"-37.81996544, 144.95981454"
1611020250121,161,2025-01-21,10,1479,126,1605,BirArt1109_T,"-37.81851276, 144.97131336"
671420240722,67,2024-07-22,14,361,633,994,FLDegS_T,"-37.81688755, 144.96562569"
17720241210,17,2024-12-10,7,451,101,552,Col15_T,"-37.81362543, 144.97323591"
17920250928,17,2025-09-28,9,91,46,137,Col15_T,"-37.81362543, 144.97323591"
11720240708,1,2024-07-08,17,1113,936,2049,Bou292_T,"-37.81349441, 144.96515323"
63620231029,63,2023-10-29,6,8,23,31,Bou231_T,"-37.81333081, 144.96675571"
63620231115,63,2023-11-15,6,35,31,66,Bou231_T,"-37.81333081, 144.96675571"
68320250511,68,2025-05-11,3,4,3,7,FLDegN_T,"-37.8168479, 144.96559789"
62720240516,62,2024-05-16,7,52,54,106,Lat224_T,"-37.80996494, 144.96216521"
24320240711,24,2024-07-11,3,13,9,22,Col620_T,"-37.81887963, 144.95449198"
56820250721,56,2025-07-21,8,132,210,342,Lon364_T,"-37.81234775, 144.96153311"
242220250118,24,2025-01-18,22,259,436,695,Col620_T,"-37.81887963, 144.95449198"
581620240604,58,2024-06-04,16,529,1217,1746,Bou688_T,"-37.81686075, 144.95358075"
27820241205,27,2024-12-05,8,61,98,159,Vic_T,"-37.80606888, 144.95644692"
21620240621,2,2024-06-21,16,606,580,1186,Bou283_T,"-37.81380668, 144.96516718"
53820240203,53,2024-02-03,8,143,85,228,Col254_T,"-37.81564191, 144.965499"
27620250728,27,2025-07-28,6,9,22,31,Vic_T,"-37.80606888, 144.95644692"
53020240708,53,2024-07-08,0,7,9,16,Col254_T,"-37.81564191, 144.965499"
791220231220,79,2023-12-20,12,696,459,1155,FliSS_T,"-37.81794046, 144.96616678"
23020241105,23,2024-11-05,0,13,20,33,Col623_T,"-37.81909256, 144.95452748"
521420240516,52,2024-05-16,14,447,315,762,Eli263_T,"-37.81252157, 144.9619401"
109620240510,109,2024-05-10,6,19,73,92,LatWill_T,"-37.81193681, 144.95621105"
25820250818,25,2025-08-18,8,279,815,1094,MCEC_T,"-37.82401776, 144.95604426"
137520240928,137,2024-09-28,5,0,1,1,BouHbr2353_T,"-37.81894815, 144.94612292"
661120240714,66,2024-07-14,11,733,938,1671,QVN_T,"-37.81057846, 144.96444294"
691720250409,69,2025-04-09,17,141,240,381,FLDegC_T,"-37.81687226, 144.96559144"
61620250329,6,2025-03-29,16,1042,1191,2233,FliS_T,"-37.81911705, 144.96558255"
84620240211,84,2024-02-11,6,75,98,173,ElFi_T,"-37.81798049, 144.96503383"
84620240611,84,2024-06-11,6,184,96,280,ElFi_T,"-37.81798049, 144.96503383"
61920250808,6,2025-08-08,19,694,841,1535,FliS_T,"-37.81911705, 144.96558255"
84320241106,84,2024-11-06,3,17,16,33,ElFi_T,"-37.81798049, 144.96503383"
42020240917,4,2024-09-17,20,456,521,977,Swa123_T,"-37.81487988, 144.9660878"
82020250604,8,2025-06-04,20,10,10,20,WebBN_T,"-37.82293543, 144.9471751"
8220250916,8,2025-09-16,2,2,0,2,WebBN_T,"-37.82293543, 144.9471751"
411520250901,41,2025-09-01,15,1014,1433,2447,Swa31,"-37.81668634, 144.96689733"
142020240116,14,2024-01-16,20,303,403,706,SanBri_T,"-37.82011242, 144.96291897"
711320250722,71,2025-07-22,13,18,27,45,WestWP_T,"-37.81235775, 144.97136962"
421420241226,42,2024-12-26,14,20,15,35,UM1_T,"-37.80008566, 144.96386412"
282220240514,28,2024-05-14,22,67,24,91,VAC_T,"-37.82129925, 144.96879309"
282120240605,28,2024-06-05,21,110,196,306,VAC_T,"-37.82129925, 144.96879309"
282320240809,28,2024-08-09,23,65,44,109,VAC_T,"-37.82129925, 144.96879309"
37320250121,37,2025-01-21,3,4,2,6,Lyg260_T,"-37.80107122, 144.96704554"
211120240202,21,2024-02-02,11,263,238,501,Bourke155_T,"-37.81267313, 144.96788288"
51020251004,5,2025-10-04,10,694,1345,2039,PriNW_T,"-37.81874249, 144.96787656"
21020250316,21,2025-03-16,0,273,220,493,Bourke155_T,"-37.81267313, 144.96788288"
108020240624,108,2024-06-24,0,3,12,15,261Will_T,"-37.81295822, 144.95678789"
872020240729,87,2024-07-29,20,25,38,63,Errol23_T,"-37.80454949, 144.94921863"
872120241004,87,2024-10-04,21,29,38,67,Errol23_T,"-37.80454949, 144.94921863"
611720250206,61,2025-02-06,17,554,812,1366,RMIT14_T,"-37.80767455, 144.96309114"
50820240504,50,2024-05-04,8,22,42,64,Lyg309_T,"-37.79808192, 144.96721013"
501320250512,50,2025-05-12,13,211,172,383,Lyg309_T,"-37.79808192, 144.96721013"
441820250811,44,2025-08-11,18,68,48,116,UM3_T,"-37.79698741, 144.96441306"
442220250908,44,2025-09-08,22,10,29,39,UM3_T,"-37.79698741, 144.96441306"
1651120250915,165,2025-09-15,11,34,33,67,Spen475_T,"-37.80953359, 144.94939004"
1671320241025,167,2024-10-25,13,10,23,33,Lat526_T,"-37.81304149, 144.95155955"
1431520250603,143,2025-06-03,15,146,108,254,Spencer_T,"-37.821728, 144.95557015"
1342020250115,134,2025-01-15,20,343,291,634,Spen201_T,"-37.81694221, 144.95303935"
1352020240511,135,2024-05-11,20,166,265,431,Spen161_T,"-37.8172861, 144.95319102"
135220241205,135,2024-12-05,2,12,11,23,Spen161_T,"-37.8172861, 144.95319102"
1351720250414,135,2025-04-14,17,595,504,1099,Spen161_T,"-37.8172861, 144.95319102"
1331020231215,133,2023-12-15,10,418,408,826,Spen229_T,"-37.81531435, 144.95227769"
17420240727,17,2024-07-27,4,6,1,7,Col15_T,"-37.81362543, 144.97323591"
172220240828,17,2024-08-28,22,58,55,113,Col15_T,"-37.81362543, 144.97323591"
12320241224,1,2024-12-24,23,426,350,776,Bou292_T,"-37.81349441, 144.96515323"
1820250418,1,2025-04-18,8,83,46,129,Bou292_T,"-37.81349441, 144.96515323"
63520240822,63,2024-08-22,5,11,14,25,Bou231_T,"-37.81333081, 144.96675571"
182020240203,18,2024-02-03,20,45,29,74,Col12_T,"-37.81344862, 144.97305353"
181920240831,18,2024-08-31,19,25,29,54,Col12_T,"-37.81344862, 144.97305353"
18120250222,18,2025-02-22,1,3,1,4,Col12_T,"-37.81344862, 144.97305353"
671120240308,67,2024-03-08,11,291,295,586,FLDegS_T,"-37.81688755, 144.96562569"
671320250216,67,2025-02-16,13,377,470,847,FLDegS_T,"-37.81688755, 144.96562569"
62920250806,62,2025-08-06,9,115,133,248,Lat224_T,"-37.80996494, 144.96216521"
562220240429,56,2024-04-29,22,68,127,195,Lon364_T,"-37.81234775, 144.96153311"
111720250822,11,2025-08-22,17,90,63,153,WatCit_T,"-37.81564989, 144.93970694"
241320250919,24,2025-09-19,13,660,756,1416,Col620_T,"-37.81887963, 144.95449198"
581320240919,58,2024-09-19,13,785,619,1404,Bou688_T,"-37.81686075, 144.95358075"
76920250915,76,2025-09-15,9,59,64,123,KenMac_T,"-37.79453803, 144.93036194"
58520231122,58,2023-11-22,5,75,20,95,Bou688_T,"-37.81686075, 144.95358075"
351420240723,35,2024-07-23,14,742,820,1562,SouthB_T,"-37.82018685, 144.96508508"
762320250627,76,2025-06-27,23,1,2,3,KenMac_T,"-37.79453803, 144.93036194"
791420250609,79,2025-06-09,14,484,355,839,FliSS_T,"-37.81794046, 144.96616678"
40220250915,40,2025-09-15,2,0,9,9,Spr201_T,"-37.80999341, 144.97227587"
31620250107,31,2025-01-07,6,3,12,15,Lyg161_T,"-37.80169681, 144.96658911"
31420250612,31,2025-06-12,4,1,0,1,Lyg161_T,"-37.80169681, 144.96658911"
542120250115,54,2025-01-15,21,71,71,142,Swa607_T,"-37.804024, 144.96308399"
36420240713,36,2024-07-13,4,25,29,54,Que85_T,"-37.81652527, 144.96121062"
361520241214,36,2024-12-14,15,124,150,274,Que85_T,"-37.81652527, 144.96121062"
471420250930,47,2025-09-30,14,942,1024,1966,Eli250_T,"-37.81258467, 144.9625775"
47520240926,47,2024-09-26,5,21,67,88,Eli250_T,"-37.81258467, 144.9625775"
451220231127,45,2023-11-27,12,672,768,1440,Swa148_T,"-37.81414075, 144.96609379"
212320231029,21,2023-10-29,23,133,115,248,Bourke155_T,"-37.81267313, 144.96788288"
1432020250830,143,2025-08-30,20,172,211,383,Spencer_T,"-37.821728, 144.95557015"
132420250828,132,2025-08-28,4,4,2,6,King335_T,"-37.81267639, 144.95386444"
1341020240502,134,2024-05-02,10,227,309,536,Spen201_T,"-37.81694221, 144.95303935"
1341420241222,134,2024-12-22,14,321,284,605,Spen201_T,"-37.81694221, 144.95303935"
1342320250713,134,2025-07-13,23,47,74,121,Spen201_T,"-37.81694221, 144.95303935"
135420240809,135,2024-08-09,4,10,12,22,Spen161_T,"-37.8172861, 144.95319102"
107020231229,107,2023-12-29,0,23,18,41,280Will_T,"-37.81246271, 144.95690188"
107020241112,107,2024-11-12,0,9,12,21,280Will_T,"-37.81246271, 144.95690188"
31520250121,31,2025-01-21,5,14,0,14,Lyg161_T,"-37.80169681, 144.96658911"
502320231128,50,2023-11-28,23,20,12,32,Lyg309_T,"-37.79808192, 144.96721013"
1671220241021,167,2024-10-21,12,15,46,61,Lat526_T,"-37.81304149, 144.95155955"
1311820250706,131,2025-07-06,18,113,65,178,King2_T,"-37.82009057, 144.95758725"
132120250226,132,2025-02-26,1,13,27,40,King335_T,"-37.81267639, 144.95386444"
134720250526,134,2025-05-26,7,260,233,493,Spen201_T,"-37.81694221, 144.95303935"
1341520250808,134,2025-08-08,15,472,506,978,Spen201_T,"-37.81694221, 144.95303935"
135220241218,135,2024-12-18,2,14,12,26,Spen161_T,"-37.8172861, 144.95319102"
133620250216,133,2025-02-16,6,52,86,138,Spen229_T,"-37.81531435, 144.95227769"
1241720231117,124,2023-11-17,17,0,1,1,BirBridge_T,"-37.81757416, 144.97329934"
118720240725,118,2024-07-25,7,17,2,19,Fli114C_T,"-37.81632783, 144.97090512"
108320240515,108,2024-05-15,3,0,5,5,261Will_T,"-37.81295822, 144.95678789"
85020231222,85,2023-12-22,0,2,16,18,488Mac_T,"-37.79432415, 144.92973378"
852120240308,85,2024-03-08,21,19,14,33,488Mac_T,"-37.79432415, 144.92973378"
17220240715,17,2024-07-15,2,4,2,6,Col15_T,"-37.81362543, 144.97323591"
691520250109,69,2025-01-09,15,201,287,488,FLDegC_T,"-37.81687226, 144.96559144"
39620240421,39,2024-04-21,6,2,2,4,AlfPl_T,"-37.81379749, 144.96995745"
411920241221,41,2024-12-21,19,1846,1772,3618,Swa31,"-37.81668634, 144.96689733"
42520250622,42,2025-06-22,5,0,1,1,UM1_T,"-37.80008566, 144.96386412"
42820240904,42,2024-09-04,8,358,98,456,UM1_T,"-37.80008566, 144.96386412"
291320250226,29,2025-02-26,13,242,145,387,AG_T,"-37.8199817, 144.96872865"
591020250923,59,2025-09-23,10,982,688,1670,RMIT_T,"-37.80825648, 144.96304859"
651920240629,65,2024-06-29,19,459,267,726,SwaCs_T,"-37.81569416, 144.9668064"
311020240902,31,2024-09-02,10,106,97,203,Lyg161_T,"-37.80169681, 144.96658911"
542020250310,54,2025-03-10,20,76,83,159,Swa607_T,"-37.804024, 144.96308399"
131520250119,131,2025-01-19,5,10,45,55,King2_T,"-37.82009057, 144.95758725"
1321420240405,132,2024-04-05,14,143,147,290,King335_T,"-37.81267639, 144.95386444"
1342120241109,134,2024-11-09,21,352,276,628,Spen201_T,"-37.81694221, 144.95303935"
871120250713,87,2025-07-13,11,76,107,183,Errol23_T,"-37.80454949, 144.94921863"
671520241103,67,2024-11-03,15,398,627,1025,FLDegS_T,"-37.81688755, 144.96562569"
85520250419,85,2025-04-19,5,0,1,1,488Mac_T,"-37.79432415, 144.92973378"
11820250219,1,2025-02-19,18,961,675,1636,Bou292_T,"-37.81349441, 144.96515323"
63420240917,63,2024-09-17,4,1,3,4,Bou231_T,"-37.81333081, 144.96675571"
11720240613,11,2024-06-13,7,31,27,58,WatCit_T,"-37.81564989, 144.93970694"
11320251006,1,2025-10-06,13,1277,1114,2391,Bou292_T,"-37.81349441, 144.96515323"
35120250922,35,2025-09-22,1,15,14,29,SouthB_T,"-37.82018685, 144.96508508"
21920240619,2,2024-06-19,19,139,158,297,Bou283_T,"-37.81380668, 144.96516718"
2320231210,2,2023-12-10,3,19,97,116,Bou283_T,"-37.81380668, 144.96516718"
76420250720,76,2025-07-20,4,1,0,1,KenMac_T,"-37.79453803, 144.93036194"
27920240529,27,2024-05-29,9,56,107,163,Vic_T,"-37.80606888, 144.95644692"
531920240127,53,2024-01-27,19,300,223,523,Col254_T,"-37.81564191, 144.965499"
30820240317,30,2024-03-17,8,27,95,122,Lon189_T,"-37.8112185, 144.96656806"
20220250211,20,2025-02-11,2,2,5,7,LtB170_T,"-37.81172914, 144.9682466"
202120240104,20,2024-01-04,21,181,452,633,LtB170_T,"-37.81172914, 144.9682466"
521420241031,52,2024-10-31,14,470,239,709,Eli263_T,"-37.81252157, 144.9619401"
521020240324,52,2024-03-24,10,176,105,281,Eli263_T,"-37.81252157, 144.9619401"
172020241017,17,2024-10-17,20,54,85,139,Col15_T,"-37.81362543, 144.97323591"
17720250908,17,2025-09-08,7,369,87,456,Col15_T,"-37.81362543, 144.97323591"
631920240613,63,2024-06-13,19,193,253,446,Bou231_T,"-37.81333081, 144.96675571"
671820250228,67,2025-02-28,18,372,444,816,FLDegS_T,"-37.81688755, 144.96562569"
67420241222,67,2024-12-22,4,10,10,20,FLDegS_T,"-37.81688755, 144.96562569"
631020250301,63,2025-03-01,10,202,293,495,Bou231_T,"-37.81333081, 144.96675571"
62620240204,62,2024-02-04,6,22,22,44,Lat224_T,"-37.80996494, 144.96216521"
561820240630,56,2024-06-30,18,330,386,716,Lon364_T,"-37.81234775, 144.96153311"
861120231203,86,2023-12-03,11,56,50,106,574Qub_T,"-37.80309992, 144.94908064"
86320250125,86,2025-01-25,3,2,2,4,574Qub_T,"-37.80309992, 144.94908064"
101020240420,10,2024-04-20,10,57,47,104,BouHbr_T,"-37.81876474, 144.94710545"
72920240219,72,2024-02-19,9,240,74,314,ACMI_T,"-37.81726338, 144.96872809"
352320240823,35,2024-08-23,23,343,919,1262,SouthB_T,"-37.82018685, 144.96508508"
532220240130,53,2024-01-30,22,118,100,218,Col254_T,"-37.81564191, 144.965499"
9720241117,9,2024-11-17,7,31,12,43,Col700_T,"-37.81982992, 144.95102555"
791920250601,79,2025-06-01,19,198,171,369,FliSS_T,"-37.81794046, 144.96616678"
30620241124,30,2024-11-24,6,54,80,134,Lon189_T,"-37.8112185, 144.96656806"
532220250903,53,2025-09-03,22,66,83,149,Col254_T,"-37.81564191, 144.965499"
792120240313,79,2024-03-13,21,255,241,496,FliSS_T,"-37.81794046, 144.96616678"
51120240114,51,2024-01-14,1,7,19,26,Fra118_T,"-37.80841815, 144.95906316"
20820240914,20,2024-09-14,8,34,18,52,LtB170_T,"-37.81172914, 144.9682466"
521420240602,52,2024-06-02,14,352,299,651,Eli263_T,"-37.81252157, 144.9619401"
521020240908,52,2024-09-08,10,134,98,232,Eli263_T,"-37.81252157, 144.9619401"
141820240312,141,2024-03-12,8,143,103,246,474Fl_T,"-37.81997273, 144.95834911"
1392120240209,139,2024-02-09,21,29,52,81,Signal1647_T,"-37.81959923, 144.9632832"
1361920250828,136,2025-08-28,19,24,2,26,BirFed1120_T,"-37.8184141, 144.97357915"
1421820250901,142,2025-09-01,18,76,45,121,Hammer1584_T,"-37.81970749, 144.96795734"
1611420250302,161,2025-03-02,14,142,134,276,BirArt1109_T,"-37.81851276, 144.97131336"
161920250608,161,2025-06-08,9,75,70,145,BirArt1109_T,"-37.81851276, 144.97131336"
164720251016,164,2025-10-16,7,43,52,95,Lat526_T,"-37.813005, 144.95160411"
138820250331,138,2025-03-31,8,6,3,9,EntPark1671_T,"-37.81996544, 144.95981454"
171420240404,17,2024-04-04,14,487,423,910,Col15_T,"-37.81362543, 144.97323591"
18920241019,18,2024-10-19,9,48,60,108,Col12_T,"-37.81344862, 144.97305353"
631020231130,63,2023-11-30,10,213,246,459,Bou231_T,"-37.81333081, 144.96675571"
861520250114,86,2025-01-14,15,41,43,84,574Qub_T,"-37.80309992, 144.94908064"
86120250613,86,2025-06-13,1,1,0,1,574Qub_T,"-37.80309992, 144.94908064"
241720241102,24,2024-11-02,17,701,930,1631,Col620_T,"-37.81887963, 144.95449198"
56320250707,56,2025-07-07,3,3,4,7,Lon364_T,"-37.81234775, 144.96153311"
241120240917,24,2024-09-17,11,584,473,1057,Col620_T,"-37.81887963, 144.95449198"
351120240612,35,2024-06-12,11,513,535,1048,SouthB_T,"-37.82018685, 144.96508508"
791120250715,79,2025-07-15,11,376,359,735,FliSS_T,"-37.81794046, 144.96616678"
301620250215,30,2025-02-15,16,381,451,832,Lon189_T,"-37.8112185, 144.96656806"
201320241220,20,2024-12-20,13,202,208,410,LtB170_T,"-37.81172914, 144.9682466"
251520240822,25,2024-08-22,15,588,496,1084,MCEC_T,"-37.82401776, 144.95604426"
30820250721,30,2025-07-21,8,61,81,142,Lon189_T,"-37.8112185, 144.96656806"
1372320240724,137,2024-07-24,23,1,0,1,BouHbr2353_T,"-37.81894815, 144.94612292"
1411820240319,141,2024-03-19,18,130,145,275,474Fl_T,"-37.81997273, 144.95834911"
1372220250219,137,2025-02-19,22,0,4,4,BouHbr2353_T,"-37.81894815, 144.94612292"
136820250209,136,2025-02-09,8,66,80,146,BirFed1120_T,"-37.8184141, 144.97357915"
1362320240107,136,2024-01-07,23,2,0,2,BirFed1120_T,"-37.8184141, 144.97357915"
1171520251006,117,2025-10-06,15,104,201,305,Fli114F_T,"-37.81629332, 144.97090877"
1232220250110,123,2025-01-10,22,2,0,2,BirBridge_T,"-37.81753741, 144.97329734"
1422320240205,142,2024-02-05,23,14,34,48,Hammer1584_T,"-37.81970749, 144.96795734"
1171420250716,117,2025-07-16,14,176,211,387,Fli114F_T,"-37.81629332, 144.97090877"
69220231112,69,2023-11-12,2,1,1,2,FLDegC_T,"-37.81687226, 144.96559144"
61920250409,6,2025-04-09,19,769,749,1518,FliS_T,"-37.81911705, 144.96558255"
41120241125,4,2024-11-25,11,1301,746,2047,Swa123_T,"-37.81487988, 144.9660878"
702220241123,70,2024-11-23,22,138,76,214,Errol20_T,"-37.80456984, 144.94946228"
702220250813,70,2025-08-13,22,97,44,141,Errol20_T,"-37.80456984, 144.94946228"
32220241108,3,2024-11-08,22,710,590,1300,Swa295_T,"-37.81101524, 144.96429485"
39320240510,39,2024-05-10,3,3,17,20,AlfPl_T,"-37.81379749, 144.96995745"
411620240725,41,2024-07-25,16,332,271,603,Swa31,"-37.81668634, 144.96689733"
77420241126,77,2024-11-26,4,1,3,4,HarEsP_T,"-37.81441438, 144.94433026"
77820231219,77,2023-12-19,8,78,74,152,HarEsP_T,"-37.81441438, 144.94433026"
77620240107,77,2024-01-07,6,11,10,21,HarEsP_T,"-37.81441438, 144.94433026"
78520241028,78,2024-10-28,5,1,1,2,HarEsB_T,"-37.81471642, 144.9446508"
141720241219,14,2024-12-19,17,850,195,1045,SanBri_T,"-37.82011242, 144.96291897"
141220231125,14,2023-11-25,12,428,161,589,SanBri_T,"-37.82011242, 144.96291897"
141820250819,14,2025-08-19,18,31,10,41,SanBri_T,"-37.82011242, 144.96291897"
712020250622,71,2025-06-22,20,2,2,4,WestWP_T,"-37.81235775, 144.97136962"
711520250824,71,2025-08-24,15,12,3,15,WestWP_T,"-37.81235775, 144.97136962"
59820241117,59,2024-11-17,8,80,60,140,RMIT_T,"-37.80825648, 144.96304859"
65720240129,65,2024-01-29,7,216,78,294,SwaCs_T,"-37.81569416, 144.9668064"
421220250904,42,2025-09-04,12,268,403,671,UM1_T,"-37.80008566, 144.96386412"
29120240723,29,2024-07-23,1,1,4,5,AG_T,"-37.8199817, 144.96872865"
311720240209,31,2024-02-09,17,210,126,336,Lyg161_T,"-37.80169681, 144.96658911"
361920240217,36,2024-02-17,19,151,156,307,Que85_T,"-37.81652527, 144.96121062"
211520250602,21,2025-06-02,15,264,279,543,Bourke155_T,"-37.81267313, 144.96788288"
36520250110,36,2025-01-10,5,14,8,22,Que85_T,"-37.81652527, 144.96121062"
47420241204,47,2024-12-04,4,16,26,42,Eli250_T,"-37.81258467, 144.9625775"
51220241209,5,2024-12-09,12,1307,1134,2441,PriNW_T,"-37.81874249, 144.96787656"
5820240323,5,2024-03-23,8,289,316,605,PriNW_T,"-37.81874249, 144.96787656"
1081120251013,108,2025-10-13,11,302,315,617,261Will_T,"-37.81295822, 144.95678789"
442020240611,44,2024-06-11,20,10,19,29,UM3_T,"-37.79698741, 144.96441306"
43020250626,43,2025-06-26,0,3,6,9,UM2_T,"-37.79844526, 144.96411782"
431320250823,43,2025-08-23,13,125,127,252,UM2_T,"-37.79844526, 144.96411782"
1811220250716,181,2025-07-16,12,623,965,1588,Eli368_T,"-37.81009465, 144.96143149"
1841520250727,184,2025-07-27,15,1016,1088,2104,Eli124_T,"-37.81512416, 144.96371988"
1791320250514,179,2025-05-14,13,54,35,89,Pow61_T,"-37.82392385, 144.96299677"
179720250525,179,2025-05-25,7,17,9,26,Pow61_T,"-37.82392385, 144.96299677"
1661420250923,166,2025-09-23,14,56,49,105,Spen484_T,"-37.80896733, 144.94931703"
140920250106,140,2025-01-06,9,16,5,21,Boyd2837_T,"-37.82590962, 144.96185972"
1322320250922,132,2025-09-22,23,48,29,77,King335_T,"-37.81267639, 144.95386444"
134620250527,134,2025-05-27,6,124,133,257,Spen201_T,"-37.81694221, 144.95303935"
1351320240610,135,2024-06-10,13,343,397,740,Spen161_T,"-37.8172861, 144.95319102"
1351320240210,135,2024-02-10,13,420,421,841,Spen161_T,"-37.8172861, 144.95319102"
17520240201,17,2024-02-01,5,46,18,64,Col15_T,"-37.81362543, 144.97323591"
171420250519,17,2025-05-19,14,325,288,613,Col15_T,"-37.81362543, 144.97323591"
67020240903,67,2024-09-03,0,10,10,20,FLDegS_T,"-37.81688755, 144.96562569"
122220231115,12,2023-11-15,22,70,77,147,NewQ_T,"-37.81457988, 144.94292398"
62020231113,62,2023-11-13,0,53,39,92,Lat224_T,"-37.80996494, 144.96216521"
621920250319,62,2025-03-19,19,326,251,577,Lat224_T,"-37.80996494, 144.96216521"
562120250204,56,2025-02-04,21,152,262,414,Lon364_T,"-37.81234775, 144.96153311"
511920241009,51,2024-10-09,19,102,119,221,Fra118_T,"-37.80841815, 144.95906316"
231620240904,23,2024-09-04,16,206,529,735,Col623_T,"-37.81909256, 144.95452748"
231720250212,23,2025-02-12,17,389,827,1216,Col623_T,"-37.81909256, 144.95452748"
109620241025,109,2024-10-25,6,15,85,100,LatWill_T,"-37.81193681, 144.95621105"
492320241118,49,2024-11-18,23,62,77,139,Eli501_T,"-37.80730068, 144.95956055"
491020240124,49,2024-01-24,10,100,176,276,Eli501_T,"-37.80730068, 144.95956055"
192020240630,19,2024-06-30,20,331,558,889,LtB210_T,"-37.81237202, 144.96550671"
201620250923,20,2025-09-23,16,169,201,370,LtB170_T,"-37.81172914, 144.9682466"
1411620250103,141,2025-01-03,16,151,131,282,474Fl_T,"-37.81997273, 144.95834911"
1391020250226,139,2025-02-26,10,64,34,98,Signal1647_T,"-37.81959923, 144.9632832"
1231120240229,123,2024-02-29,11,17,14,31,BirBridge_T,"-37.81753741, 144.97329734"
1641520250731,164,2025-07-31,15,123,90,213,Lat526_T,"-37.813005, 144.95160411"
1381220250107,138,2025-01-07,12,14,6,20,EntPark1671_T,"-37.81996544, 144.95981454"
1381020250704,138,2025-07-04,10,4,11,15,EntPark1671_T,"-37.81996544, 144.95981454"
138920250820,138,2025-08-20,9,4,4,8,EntPark1671_T,"-37.81996544, 144.95981454"
1171020240804,117,2024-08-04,10,87,91,178,Fli114F_T,"-37.81629332, 144.97090877"
661120250416,66,2025-04-16,11,876,1238,2114,QVN_T,"-37.81057846, 144.96444294"
691120231128,69,2023-11-28,11,219,172,391,FLDegC_T,"-37.81687226, 144.96559144"
692220250915,69,2025-09-15,22,4,4,8,FLDegC_T,"-37.81687226, 144.96559144"
70020240505,70,2024-05-05,0,3,4,7,Errol20_T,"-37.80456984, 144.94946228"
3920241120,3,2024-11-20,9,220,320,540,Swa295_T,"-37.81101524, 144.96429485"
3820251010,3,2025-10-10,8,203,272,475,Swa295_T,"-37.81101524, 144.96429485"
391720240728,39,2024-07-28,17,54,35,89,AlfPl_T,"-37.81379749, 144.96995745"
751620231224,75,2023-12-24,16,37,35,72,SprFli_T,"-37.81515276, 144.97467661"
8720250702,8,2025-07-02,7,67,48,115,WebBN_T,"-37.82293543, 144.9471751"
78420240217,78,2024-02-17,4,3,0,3,HarEsB_T,"-37.81471642, 144.9446508"
421420250928,42,2025-09-28,14,65,76,141,UM1_T,"-37.80008566, 144.96386412"
422320240927,42,2024-09-27,23,25,35,60,UM1_T,"-37.80008566, 144.96386412"
77420241113,77,2024-11-13,4,7,2,9,HarEsP_T,"-37.81441438, 144.94433026"
77020250223,77,2025-02-23,0,34,33,67,HarEsP_T,"-37.81441438, 144.94433026"
29820250429,29,2025-04-29,8,241,145,386,AG_T,"-37.8199817, 144.96872865"
29820240124,29,2024-01-24,8,211,186,397,AG_T,"-37.8199817, 144.96872865"
141220231112,14,2023-11-12,12,473,171,644,SanBri_T,"-37.82011242, 144.96291897"
59820240215,59,2024-02-15,8,1221,324,1545,RMIT_T,"-37.80825648, 144.96304859"
59920240623,59,2024-06-23,9,100,154,254,RMIT_T,"-37.80825648, 144.96304859"
401520240812,40,2024-08-12,15,184,192,376,Spr201_T,"-37.80999341, 144.97227587"
401420250921,40,2025-09-21,14,198,139,337,Spr201_T,"-37.80999341, 144.97227587"
471320231108,47,2023-11-08,13,878,1028,1906,Eli250_T,"-37.81258467, 144.9625775"
311620241019,31,2024-10-19,16,217,183,400,Lyg161_T,"-37.80169681, 144.96658911"
431920231119,43,2023-11-19,19,42,50,92,UM2_T,"-37.79844526, 144.96411782"
431020240211,43,2024-02-11,10,22,35,57,UM2_T,"-37.79844526, 144.96411782"
43820250117,43,2025-01-17,8,81,19,100,UM2_T,"-37.79844526, 144.96411782"
45820240506,45,2024-05-06,8,283,256,539,Swa148_T,"-37.81414075, 144.96609379"
5220250510,5,2025-05-10,2,29,25,54,PriNW_T,"-37.81874249, 144.96787656"
131020240927,131,2024-09-27,0,67,50,117,King2_T,"-37.82009057, 144.95758725"
1621720241107,162,2024-11-07,17,230,305,535,Eli489_T,"-37.80740397, 144.95987909"
132320231117,132,2023-11-17,3,4,3,7,King335_T,"-37.81267639, 144.95386444"
132020240522,132,2024-05-22,0,18,15,33,King335_T,"-37.81267639, 144.95386444"
134020240108,134,2024-01-08,0,49,60,109,Spen201_T,"-37.81694221, 144.95303935"
134020240125,134,2024-01-25,0,54,51,105,Spen201_T,"-37.81694221, 144.95303935"
135520231229,135,2023-12-29,5,31,21,52,Spen161_T,"-37.8172861, 144.95319102"
1071020250702,107,2025-07-02,10,29,47,76,280Will_T,"-37.81246271, 144.95690188"
1071720241125,107,2024-11-25,17,205,102,307,280Will_T,"-37.81246271, 144.95690188"
241820250107,24,2025-01-07,18,412,973,1385,Col620_T,"-37.81887963, 144.95449198"
2020231207,2,2023-12-07,0,13,70,83,Bou283_T,"-37.81380668, 144.96516718"
21020240825,2,2024-08-25,10,236,298,534,Bou283_T,"-37.81380668, 144.96516718"
531820240817,53,2024-08-17,18,366,306,672,Col254_T,"-37.81564191, 144.965499"
30120231113,30,2023-11-13,1,67,56,123,Lon189_T,"-37.8112185, 144.96656806"
201620240428,20,2024-04-28,16,273,242,515,LtB170_T,"-37.81172914, 144.9682466"
52220241008,52,2024-10-08,2,1,11,12,Eli263_T,"-37.81252157, 144.9619401"
1092020250309,109,2025-03-09,20,105,139,244,LatWill_T,"-37.81193681, 144.95621105"
1091520240505,109,2024-05-05,15,65,203,268,LatWill_T,"-37.81193681, 144.95621105"
491620250111,49,2025-01-11,16,143,276,419,Eli501_T,"-37.80730068, 144.95956055"
191020240302,19,2024-03-02,10,233,217,450,LtB210_T,"-37.81237202, 144.96550671"
192220240419,19,2024-04-19,22,464,741,1205,LtB210_T,"-37.81237202, 144.96550671"
252020241214,25,2024-12-14,20,1479,643,2122,MCEC_T,"-37.82401776, 144.95604426"
481220231201,48,2023-12-01,12,292,288,580,QVMQ_T,"-37.80631581, 144.95866697"
48520240130,48,2024-01-30,5,7,13,20,QVMQ_T,"-37.80631581, 144.95866697"
139020240510,139,2024-05-10,0,1,3,4,Signal1647_T,"-37.81959923, 144.9632832"
1421720250415,142,2025-04-15,17,782,632,1414,Hammer1584_T,"-37.81970749, 144.96795734"
1612220250327,161,2025-03-27,22,0,2,2,BirArt1109_T,"-37.81851276, 144.97131336"
66420240201,66,2024-02-01,4,7,19,26,QVN_T,"-37.81057846, 144.96444294"
39220231207,39,2023-12-07,2,1,4,5,AlfPl_T,"-37.81379749, 144.96995745"
3220250503,3,2025-05-03,2,125,133,258,Swa295_T,"-37.81101524, 144.96429485"
14220231213,14,2023-12-13,2,13,2,15,SanBri_T,"-37.82011242, 144.96291897"
711620240730,71,2024-07-30,16,33,18,51,WestWP_T,"-37.81235775, 144.97136962"
59920240610,59,2024-06-10,9,116,140,256,RMIT_T,"-37.80825648, 144.96304859"
281120241126,28,2024-11-26,11,381,332,713,VAC_T,"-37.82129925, 144.96879309"
401920250913,40,2025-09-13,19,87,91,178,Spr201_T,"-37.80999341, 144.97227587"
402020250616,40,2025-06-16,20,55,17,72,Spr201_T,"-37.80999341, 144.97227587"
542020250812,54,2025-08-12,20,87,233,320,Swa607_T,"-37.804024, 144.96308399"
37020250515,37,2025-05-15,0,5,9,14,Lyg260_T,"-37.80107122, 144.96704554"
45020240524,45,2024-05-24,0,26,59,85,Swa148_T,"-37.81414075, 144.96609379"
51420231111,5,2023-11-11,14,948,1273,2221,PriNW_T,"-37.81874249, 144.96787656"
5720240218,5,2024-02-18,7,93,84,177,PriNW_T,"-37.81874249, 144.96787656"
1081820240630,108,2024-06-30,18,13,84,97,261Will_T,"-37.81295822, 144.95678789"
612220250719,61,2025-07-19,22,114,72,186,RMIT14_T,"-37.80767455, 144.96309114"
502120240426,50,2024-04-26,21,286,175,461,Lyg309_T,"-37.79808192, 144.96721013"
441620250903,44,2025-09-03,16,129,72,201,UM3_T,"-37.79698741, 144.96441306"
1671220250507,167,2025-05-07,12,27,27,54,Lat526_T,"-37.81304149, 144.95155955"
1431320240811,143,2024-08-11,13,262,286,548,Spencer_T,"-37.821728, 144.95557015"
1342020250706,134,2025-07-06,20,435,378,813,Spen201_T,"-37.81694221, 144.95303935"
1342020240912,134,2024-09-12,20,294,271,565,Spen201_T,"-37.81694221, 144.95303935"
108220250927,108,2025-09-27,2,23,19,42,261Will_T,"-37.81295822, 144.95678789"
87920250731,87,2025-07-31,9,69,80,149,Errol23_T,"-37.80454949, 144.94921863"
1081720240720,108,2024-07-20,17,24,80,104,261Will_T,"-37.81295822, 144.95678789"
1821320251016,182,2025-10-16,13,294,321,615,King163_T,"-37.81627451, 144.95550503"
1791120250626,179,2025-06-26,11,52,48,100,Pow61_T,"-37.82392385, 144.96299677"
85020250426,85,2025-04-26,0,7,3,10,488Mac_T,"-37.79432415, 144.92973378"
171920250610,17,2025-06-10,19,54,85,139,Col15_T,"-37.81362543, 144.97323591"
18220250131,18,2025-01-31,2,1,2,3,Col12_T,"-37.81344862, 144.97305353"
63520240307,63,2024-03-07,5,9,24,33,Bou231_T,"-37.81333081, 144.96675571"
68620240914,68,2024-09-14,6,4,4,8,FLDegN_T,"-37.8168479, 144.96559789"
11120250330,1,2025-03-30,11,931,961,1892,Bou292_T,"-37.81349441, 144.96515323"
561020240308,56,2024-03-08,10,220,143,363,Lon364_T,"-37.81234775, 144.96153311"
102120240330,10,2024-03-30,21,41,32,73,BouHbr_T,"-37.81876474, 144.94710545"
102020250128,10,2025-01-28,20,34,24,58,BouHbr_T,"-37.81876474, 144.94710545"
10920250927,10,2025-09-27,9,31,35,66,BouHbr_T,"-37.81876474, 144.94710545"
241320250421,24,2025-04-21,13,641,475,1116,Col620_T,"-37.81887963, 144.95449198"
562020250918,56,2025-09-18,20,330,364,694,Lon364_T,"-37.81234775, 144.96153311"
21920250421,2,2025-04-21,19,128,187,315,Bou283_T,"-37.81380668, 144.96516718"
351920240207,35,2024-02-07,19,998,994,1992,SouthB_T,"-37.82018685, 144.96508508"
581520240922,58,2024-09-22,15,423,334,757,Bou688_T,"-37.81686075, 144.95358075"
301820250119,30,2025-01-19,18,292,333,625,Lon189_T,"-37.8112185, 144.96656806"
251920240905,25,2024-09-05,19,228,154,382,MCEC_T,"-37.82401776, 144.95604426"
201920240522,20,2024-05-22,19,286,313,599,LtB170_T,"-37.81172914, 144.9682466"
521420231213,52,2023-12-13,14,470,293,763,Eli263_T,"-37.81252157, 144.9619401"
46020240620,46,2024-06-20,0,4,5,9,Pel147_T,"-37.80240719, 144.9615673"
191220250519,19,2025-05-19,12,548,398,946,LtB210_T,"-37.81237202, 144.96550671"
109720240630,109,2024-06-30,7,6,12,18,LatWill_T,"-37.81193681, 144.95621105"
1091920250102,109,2025-01-02,19,74,93,167,LatWill_T,"-37.81193681, 144.95621105"
1092120250506,109,2025-05-06,21,90,88,178,LatWill_T,"-37.81193681, 144.95621105"
492320241101,49,2024-11-01,23,102,115,217,Eli501_T,"-37.80730068, 144.95956055"
191920240927,19,2024-09-27,19,739,723,1462,LtB210_T,"-37.81237202, 144.96550671"
481720240102,48,2024-01-02,17,82,101,183,QVMQ_T,"-37.80631581, 144.95866697"
180820250811,180,2025-08-11,8,88,32,120,Mac330_T,"-37.79497059, 144.93530329"
1361920250116,136,2025-01-16,19,141,102,243,BirFed1120_T,"-37.8184141, 144.97357915"
1301520240801,130,2024-08-01,15,10,20,30,Bou892T,"-37.8204637, 144.94126826"
130320251017,130,2025-10-17,3,1,0,1,Bou892T,"-37.8204637, 144.94126826"
1381620231225,138,2023-12-25,16,10,6,16,EntPark1671_T,"-37.81996544, 144.95981454"
1172220231207,117,2023-12-07,22,170,157,327,Fli114F_T,"-37.81629332, 144.97090877"
61920240326,6,2024-03-26,19,793,685,1478,FliS_T,"-37.81911705, 144.96558255"
662320231210,66,2023-12-10,23,199,141,340,QVN_T,"-37.81057846, 144.96444294"
75020250305,75,2025-03-05,0,3,4,7,SprFli_T,"-37.81515276, 144.97467661"
391520240815,39,2024-08-15,15,95,81,176,AlfPl_T,"-37.81379749, 144.96995745"
751420240317,75,2024-03-17,14,33,40,73,SprFli_T,"-37.81515276, 144.97467661"
781120250519,78,2025-05-19,11,30,32,62,HarEsB_T,"-37.81471642, 144.9446508"
77820240118,77,2024-01-18,8,131,194,325,HarEsP_T,"-37.81441438, 144.94433026"
29820241212,29,2024-12-12,8,158,184,342,AG_T,"-37.8199817, 144.96872865"
291420250331,29,2025-03-31,14,245,220,465,AG_T,"-37.8199817, 144.96872865"
14420250914,14,2025-09-14,4,27,4,31,SanBri_T,"-37.82011242, 144.96291897"
28020250321,28,2025-03-21,0,25,5,30,VAC_T,"-37.82129925, 144.96879309"
1091920250516,109,2025-05-16,19,112,104,216,LatWill_T,"-37.81193681, 144.95621105"
109220240220,109,2024-02-20,2,7,5,12,LatWill_T,"-37.81193681, 144.95621105"
180620250622,180,2025-06-22,6,1,0,1,Mac330_T,"-37.79497059, 144.93530329"
841520250927,84,2025-09-27,15,804,1139,1943,ElFi_T,"-37.81798049, 144.96503383"
4820231018,4,2023-10-18,8,629,348,977,Swa123_T,"-37.81487988, 144.9660878"
4820250509,4,2025-05-09,8,454,356,810,Swa123_T,"-37.81487988, 144.9660878"
32220241125,3,2024-11-25,22,292,233,525,Swa295_T,"-37.81101524, 144.96429485"
391520240229,39,2024-02-29,15,145,161,306,AlfPl_T,"-37.81379749, 144.96995745"
39620240305,39,2024-03-05,6,22,17,39,AlfPl_T,"-37.81379749, 144.96995745"
411320231217,41,2023-12-17,13,2761,2109,4870,Swa31,"-37.81668634, 144.96689733"
591820240127,59,2024-01-27,18,531,366,897,RMIT_T,"-37.80825648, 144.96304859"
652020231102,65,2023-11-02,20,117,326,443,SwaCs_T,"-37.81569416, 144.9668064"
42120241212,42,2024-12-12,1,7,4,11,UM1_T,"-37.80008566, 144.96386412"
711520240312,71,2024-03-12,15,20,13,33,WestWP_T,"-37.81235775, 144.97136962"
31720250303,31,2025-03-03,7,38,28,66,Lyg161_T,"-37.80169681, 144.96658911"
37520231120,37,2023-11-20,5,2,1,3,Lyg260_T,"-37.80107122, 144.96704554"
311320250612,31,2025-06-12,13,180,183,363,Lyg161_T,"-37.80169681, 144.96658911"
21420250521,21,2025-05-21,4,2,2,4,Bourke155_T,"-37.81267313, 144.96788288"
87920250601,87,2025-06-01,9,61,69,130,Errol23_T,"-37.80454949, 144.94921863"
1081720240503,108,2024-05-03,17,341,249,590,261Will_T,"-37.81295822, 144.95678789"
61020250223,61,2025-02-23,0,125,102,227,RMIT14_T,"-37.80767455, 144.96309114"
45120231124,45,2023-11-24,1,31,47,78,Swa148_T,"-37.81414075, 144.96609379"
1661520250220,166,2025-02-20,15,64,58,122,Spen484_T,"-37.80896733, 144.94931703"
167220250802,167,2025-08-02,2,3,0,3,Lat526_T,"-37.81304149, 144.95155955"
165620251001,165,2025-10-01,6,13,22,35,Spen475_T,"-37.80953359, 144.94939004"
118920231216,118,2023-12-16,9,7,11,18,Fli114C_T,"-37.81632783, 144.97090512"
6220240912,6,2024-09-12,2,18,9,27,FliS_T,"-37.81911705, 144.96558255"
751520250617,75,2025-06-17,15,48,40,88,SprFli_T,"-37.81515276, 144.97467661"
652220240723,65,2024-07-23,22,163,186,349,SwaCs_T,"-37.81569416, 144.9668064"
421320250826,42,2025-08-26,13,432,335,767,UM1_T,"-37.80008566, 144.96386412"
281520250724,28,2025-07-24,15,485,820,1305,VAC_T,"-37.82129925, 144.96879309"
281820250125,28,2025-01-25,18,806,798,1604,VAC_T,"-37.82129925, 144.96879309"
36620250101,36,2025-01-01,6,12,16,28,Que85_T,"-37.81652527, 144.96121062"
441720250528,44,2025-05-28,17,125,84,209,UM3_T,"-37.79698741, 144.96441306"
45020241026,45,2024-10-26,0,95,220,315,Swa148_T,"-37.81414075, 144.96609379"
451720250120,45,2025-01-20,17,545,664,1209,Swa148_T,"-37.81414075, 144.96609379"
5020250702,5,2025-07-02,0,12,20,32,PriNW_T,"-37.81874249, 144.96787656"
212220250921,21,2025-09-21,22,57,110,167,Bourke155_T,"-37.81267313, 144.96788288"
1431420240926,143,2024-09-26,14,134,237,371,Spencer_T,"-37.821728, 144.95557015"
42520240721,42,2024-07-21,5,3,3,6,UM1_T,"-37.80008566, 144.96386412"
29920250729,29,2025-07-29,9,1,1,2,AG_T,"-37.8199817, 144.96872865"
402120240629,40,2024-06-29,21,111,58,169,Spr201_T,"-37.80999341, 144.97227587"
311820250910,31,2025-09-10,18,161,117,278,Lyg161_T,"-37.80169681, 144.96658911"
312320240519,31,2024-05-19,23,24,40,64,Lyg161_T,"-37.80169681, 144.96658911"
371020240703,37,2024-07-03,10,49,61,110,Lyg260_T,"-37.80107122, 144.96704554"
47920240620,47,2024-06-20,9,251,573,824,Eli250_T,"-37.81258467, 144.9625775"
5420250405,5,2025-04-05,4,9,7,16,PriNW_T,"-37.81874249, 144.96787656"
1082320240512,108,2024-05-12,23,16,46,62,261Will_T,"-37.81295822, 144.95678789"
43220231203,43,2023-12-03,2,2,1,3,UM2_T,"-37.79844526, 144.96411782"
45220251010,45,2025-10-10,2,5,12,17,Swa148_T,"-37.81414075, 144.96609379"
45420250131,45,2025-01-31,4,9,22,31,Swa148_T,"-37.81414075, 144.96609379"
45920250303,45,2025-03-03,9,226,369,595,Swa148_T,"-37.81414075, 144.96609379"
1311220250512,131,2025-05-12,12,117,195,312,King2_T,"-37.82009057, 144.95758725"
1321220250104,132,2025-01-04,12,103,87,190,King335_T,"-37.81267639, 144.95386444"
1321520250115,132,2025-01-15,15,114,92,206,King335_T,"-37.81267639, 144.95386444"
1312120240508,131,2024-05-08,21,56,49,105,King2_T,"-37.82009057, 144.95758725"
135220240207,135,2024-02-07,2,5,14,19,Spen161_T,"-37.8172861, 144.95319102"
1351220231217,135,2023-12-17,12,413,416,829,Spen161_T,"-37.8172861, 144.95319102"
133020241009,133,2024-10-09,0,50,8,58,Spen229_T,"-37.81531435, 144.95227769"
1651520250210,165,2025-02-10,15,56,28,84,Spen475_T,"-37.80953359, 144.94939004"
621520250817,62,2025-08-17,15,355,315,670,Lat224_T,"-37.80996494, 144.96216521"
63220240219,63,2024-02-19,2,7,24,31,Bou231_T,"-37.81333081, 144.96675571"
631520250411,63,2025-04-11,15,401,469,870,Bou231_T,"-37.81333081, 144.96675571"
12020231207,12,2023-12-07,0,26,19,45,NewQ_T,"-37.81457988, 144.94292398"
861820250202,86,2025-02-02,18,23,36,59,574Qub_T,"-37.80309992, 144.94908064"
111520240925,11,2024-09-25,15,83,65,148,WatCit_T,"-37.81564989, 144.93970694"
72220231111,72,2023-11-11,2,25,19,44,ACMI_T,"-37.81726338, 144.96872809"
762020250404,76,2025-04-04,20,19,29,48,KenMac_T,"-37.79453803, 144.93036194"
582220241203,58,2024-12-03,22,150,157,307,Bou688_T,"-37.81686075, 144.95358075"
27720250113,27,2025-01-13,7,27,41,68,Vic_T,"-37.80606888, 144.95644692"
92120240610,9,2024-06-10,21,28,27,55,Col700_T,"-37.81982992, 144.95102555"
53620231128,53,2023-11-28,6,41,31,72,Col254_T,"-37.81564191, 144.965499"
9120250215,9,2025-02-15,1,12,18,30,Col700_T,"-37.81982992, 144.95102555"
25820240817,25,2024-08-17,8,157,249,406,MCEC_T,"-37.82401776, 144.95604426"
521120250402,52,2025-04-02,11,246,214,460,Eli263_T,"-37.81252157, 144.9619401"
52720240215,52,2024-02-15,7,96,152,248,Eli263_T,"-37.81252157, 144.9619401"
232120240608,23,2024-06-08,21,107,147,254,Col623_T,"-37.81909256, 144.95452748"
1371720240223,137,2024-02-23,17,41,179,220,BouHbr2353_T,"-37.81894815, 144.94612292"
141320241221,141,2024-12-21,3,78,36,114,474Fl_T,"-37.81997273, 144.95834911"
1411620250823,141,2025-08-23,16,267,104,371,474Fl_T,"-37.81997273, 144.95834911"
1362220241212,136,2024-12-12,22,3,0,3,BirFed1120_T,"-37.8184141, 144.97357915"
1361020250506,136,2025-05-06,10,57,87,144,BirFed1120_T,"-37.8184141, 144.97357915"
1231920231229,123,2023-12-29,19,34,10,44,BirBridge_T,"-37.81753741, 144.97329734"
1381020240823,138,2024-08-23,10,0,3,3,EntPark1671_T,"-37.81996544, 144.95981454"
48620250829,48,2025-08-29,6,15,38,53,QVMQ_T,"-37.80631581, 144.95866697"
1171320250315,117,2025-03-15,13,123,157,280,Fli114F_T,"-37.81629332, 144.97090877"
49320250412,49,2025-04-12,3,36,62,98,Eli501_T,"-37.80730068, 144.95956055"
19120240702,19,2024-07-02,1,16,35,51,LtB210_T,"-37.81237202, 144.96550671"
1301320240821,130,2024-08-21,13,27,64,91,Bou892T,"-37.8204637, 144.94126826"
161620250830,161,2025-08-30,6,15,6,21,BirArt1109_T,"-37.81851276, 144.97131336"
1081720240610,108,2024-06-10,17,20,98,118,261Will_T,"-37.81295822, 144.95678789"
612020240308,61,2024-03-08,20,355,395,750,RMIT14_T,"-37.80767455, 144.96309114"
43620240519,43,2024-05-19,6,3,2,5,UM2_T,"-37.79844526, 144.96411782"
1671120250828,167,2025-08-28,11,28,62,90,Lat526_T,"-37.81304149, 144.95155955"
1652120241002,165,2024-10-02,21,31,14,45,Spen475_T,"-37.80953359, 144.94939004"
167420241125,167,2024-11-25,4,1,0,1,Lat526_T,"-37.81304149, 144.95155955"
1811520250401,181,2025-04-01,15,693,1224,1917,Eli368_T,"-37.81009465, 144.96143149"
131420240124,131,2024-01-24,4,2,3,5,King2_T,"-37.82009057, 144.95758725"
1312220240225,131,2024-02-25,22,59,29,88,King2_T,"-37.82009057, 144.95758725"
132120241209,132,2024-12-09,1,21,16,37,King335_T,"-37.81267639, 144.95386444"
132620241215,132,2024-12-15,6,24,11,35,King335_T,"-37.81267639, 144.95386444"
1331920240421,133,2024-04-21,19,470,348,818,Spen229_T,"-37.81531435, 144.95227769"
1331620240427,133,2024-04-27,16,502,485,987,Spen229_T,"-37.81531435, 144.95227769"
1332220240831,133,2024-08-31,22,237,196,433,Spen229_T,"-37.81531435, 144.95227769"
11720250312,1,2025-03-12,17,1371,992,2363,Bou292_T,"-37.81349441, 144.96515323"
63220241208,63,2024-12-08,2,4,102,106,Bou231_T,"-37.81333081, 144.96675571"
632020240912,63,2024-09-12,20,107,254,361,Bou231_T,"-37.81333081, 144.96675571"
681120240611,68,2024-06-11,11,205,134,339,FLDegN_T,"-37.8168479, 144.96559789"
181320250622,18,2025-06-22,13,56,32,88,Col12_T,"-37.81344862, 144.97305353"
111020240407,11,2024-04-07,10,58,85,143,WatCit_T,"-37.81564989, 144.93970694"
56620250821,56,2025-08-21,6,29,25,54,Lon364_T,"-37.81234775, 144.96153311"
72420240419,72,2024-04-19,4,1,4,5,ACMI_T,"-37.81726338, 144.96872809"
721820240104,72,2024-01-04,18,184,255,439,ACMI_T,"-37.81726338, 144.96872809"
581820240829,58,2024-08-29,18,598,628,1226,Bou688_T,"-37.81686075, 144.95358075"
58620250510,58,2025-05-10,6,73,33,106,Bou688_T,"-37.81686075, 144.95358075"
351020231019,35,2023-10-19,10,723,724,1447,SouthB_T,"-37.82018685, 144.96508508"
58020240304,58,2024-03-04,0,41,63,104,Bou688_T,"-37.81686075, 144.95358075"
21020250501,2,2025-05-01,10,195,292,487,Bou283_T,"-37.81380668, 144.96516718"
91420240828,9,2024-08-28,14,579,239,818,Col700_T,"-37.81982992, 144.95102555"
92220240909,9,2024-09-09,22,35,27,62,Col700_T,"-37.81982992, 144.95102555"
271220241222,27,2024-12-22,12,302,246,548,Vic_T,"-37.80606888, 144.95644692"
30820240109,30,2024-01-09,8,106,106,212,Lon189_T,"-37.8112185, 144.96656806"
792020240808,79,2024-08-08,20,190,196,386,FliSS_T,"-37.81794046, 144.96616678"
511220240105,51,2024-01-05,12,144,100,244,Fra118_T,"-37.80841815, 144.95906316"
511820240309,51,2024-03-09,18,114,75,189,Fra118_T,"-37.80841815, 144.95906316"
23320231119,23,2023-11-19,3,8,32,40,Col623_T,"-37.81909256, 144.95452748"
201220240702,20,2024-07-02,12,298,343,641,LtB170_T,"-37.81172914, 144.9682466"
202120251015,20,2025-10-15,21,164,400,564,LtB170_T,"-37.81172914, 144.9682466"
251220250404,25,2025-04-04,12,393,768,1161,MCEC_T,"-37.82401776, 144.95604426"
117720241010,117,2024-10-10,7,114,48,162,Fli114F_T,"-37.81629332, 144.97090877"
117820241104,117,2024-11-04,8,182,70,252,Fli114F_T,"-37.81629332, 144.97090877"
1641220241228,164,2024-12-28,12,106,55,161,Lat526_T,"-37.813005, 144.95160411"
1641620250214,164,2025-02-14,16,133,79,212,Lat526_T,"-37.813005, 144.95160411"
1372220241124,137,2024-11-24,22,0,2,2,BouHbr2353_T,"-37.81894815, 144.94612292"
1422120240128,142,2024-01-28,21,295,209,504,Hammer1584_T,"-37.81970749, 144.96795734"
1301120240127,130,2024-01-27,11,29,39,68,Bou892T,"-37.8204637, 144.94126826"
1611620251003,161,2025-10-03,16,251,154,405,BirArt1109_T,"-37.81851276, 144.97131336"
67220240529,67,2024-05-29,2,3,3,6,FLDegS_T,"-37.81688755, 144.96562569"
671120250901,67,2025-09-01,11,275,390,665,FLDegS_T,"-37.81688755, 144.96562569"
671720251010,67,2025-10-10,17,427,613,1040,FLDegS_T,"-37.81688755, 144.96562569"
85220241001,85,2024-10-01,2,1,1,2,488Mac_T,"-37.79432415, 144.92973378"
32320250421,3,2025-04-21,23,149,145,294,Swa295_T,"-37.81101524, 144.96429485"
70720251012,70,2025-10-12,7,12,7,19,Errol20_T,"-37.80456984, 144.94946228"
3020240904,3,2024-09-04,0,117,122,239,Swa295_T,"-37.81101524, 144.96429485"
77220231031,77,2023-10-31,2,2,1,3,HarEsP_T,"-37.81441438, 144.94433026"
141620240906,14,2024-09-06,16,539,161,700,SanBri_T,"-37.82011242, 144.96291897"
591520240226,59,2024-02-26,15,725,1331,2056,RMIT_T,"-37.80825648, 144.96304859"
711120240407,71,2024-04-07,11,8,4,12,WestWP_T,"-37.81235775, 144.97136962"
282120231110,28,2023-11-10,21,250,362,612,VAC_T,"-37.82129925, 144.96879309"
291220231109,29,2023-11-09,12,178,239,417,AG_T,"-37.8199817, 144.96872865"
37320231229,37,2023-12-29,3,9,6,15,Lyg260_T,"-37.80107122, 144.96704554"
211320240603,21,2024-06-03,13,382,534,916,Bourke155_T,"-37.81267313, 144.96788288"
51020231111,5,2023-11-11,10,603,788,1391,PriNW_T,"-37.81874249, 144.96787656"
1072020240929,107,2024-09-29,20,64,52,116,280Will_T,"-37.81246271, 144.95690188"
50320250429,50,2025-04-29,3,9,3,12,Lyg309_T,"-37.79808192, 144.96721013"
441920250526,44,2025-05-26,19,43,35,78,UM3_T,"-37.79698741, 144.96441306"
43020240531,43,2024-05-31,0,12,10,22,UM2_T,"-37.79844526, 144.96411782"
441220240614,44,2024-06-14,12,75,101,176,UM3_T,"-37.79698741, 144.96441306"
185320250803,185,2025-08-03,3,98,83,181,Eli197_T,"-37.81374643, 144.96276183"
1661820241119,166,2024-11-19,18,107,92,199,Spen484_T,"-37.80896733, 144.94931703"
1661920241013,166,2024-10-13,19,66,80,146,Spen484_T,"-37.80896733, 144.94931703"
162120250501,162,2025-05-01,1,21,12,33,Eli489_T,"-37.80740397, 144.95987909"
167020250324,167,2025-03-24,0,2,8,10,Lat526_T,"-37.81304149, 144.95155955"
1672120250506,167,2025-05-06,21,15,26,41,Lat526_T,"-37.81304149, 144.95155955"
1401720250507,140,2025-05-07,17,90,94,184,Boyd2837_T,"-37.82590962, 144.96185972"
1821020250916,182,2025-09-16,10,107,145,252,King163_T,"-37.81627451, 144.95550503"
1352020250520,135,2025-05-20,20,116,136,252,Spen161_T,"-37.8172861, 144.95319102"
124720250914,124,2025-09-14,7,3,5,8,BirBridge_T,"-37.81757416, 144.97329934"
1181220240426,118,2024-04-26,12,12,18,30,Fli114C_T,"-37.81632783, 144.97090512"
671520231110,67,2023-11-10,15,301,558,859,FLDegS_T,"-37.81688755, 144.96562569"
1020240201,1,2024-02-01,0,30,44,74,Bou292_T,"-37.81349441, 144.96515323"
67320250222,67,2025-02-22,3,16,13,29,FLDegS_T,"-37.81688755, 144.96562569"
63420250928,63,2025-09-28,4,2,33,35,Bou231_T,"-37.81333081, 144.96675571"
63620241123,63,2024-11-23,6,26,28,54,Bou231_T,"-37.81333081, 144.96675571"
631320241014,63,2024-10-14,13,446,543,989,Bou231_T,"-37.81333081, 144.96675571"
622120250912,62,2025-09-12,21,275,296,571,Lat224_T,"-37.80996494, 144.96216521"
86720250323,86,2025-03-23,7,6,3,9,574Qub_T,"-37.80309992, 144.94908064"
62520250405,62,2025-04-05,5,22,18,40,Lat224_T,"-37.80996494, 144.96216521"
111320250128,11,2025-01-28,13,128,104,232,WatCit_T,"-37.81564989, 144.93970694"
1620250921,1,2025-09-21,6,13,13,26,Bou292_T,"-37.81349441, 144.96515323"
241620250510,24,2025-05-10,16,418,870,1288,Col620_T,"-37.81887963, 144.95449198"
10620250128,10,2025-01-28,6,6,33,39,BouHbr_T,"-37.81876474, 144.94710545"
76620251010,76,2025-10-10,6,9,3,12,KenMac_T,"-37.79453803, 144.93036194"
35520240409,35,2024-04-09,5,75,41,116,SouthB_T,"-37.82018685, 144.96508508"
4420250214,4,2025-02-14,4,17,22,39,Swa123_T,"-37.81487988, 144.9660878"
31020250909,3,2025-09-09,10,414,425,839,Swa295_T,"-37.81101524, 144.96429485"
751820240722,75,2024-07-22,18,34,28,62,SprFli_T,"-37.81515276, 144.97467661"
781320240422,78,2024-04-22,13,24,72,96,HarEsB_T,"-37.81471642, 144.9446508"
141020231126,14,2023-11-26,10,281,96,377,SanBri_T,"-37.82011242, 144.96291897"
71020250608,71,2025-06-08,0,7,4,11,WestWP_T,"-37.81235775, 144.97136962"
71520250302,71,2025-03-02,5,1,0,1,WestWP_T,"-37.81235775, 144.97136962"
421820240730,42,2024-07-30,18,190,517,707,UM1_T,"-37.80008566, 144.96386412"
401620231109,40,2023-11-09,16,163,247,410,Spr201_T,"-37.80999341, 144.97227587"
5420241009,5,2024-10-09,4,14,2,16,PriNW_T,"-37.81874249, 144.96787656"
612220231115,61,2023-11-15,22,169,122,291,RMIT14_T,"-37.80767455, 144.96309114"
611520250715,61,2025-07-15,15,401,588,989,RMIT14_T,"-37.80767455, 144.96309114"
441920250513,44,2025-05-13,19,49,58,107,UM3_T,"-37.79698741, 144.96441306"
431820240324,43,2024-03-24,18,127,97,224,UM2_T,"-37.79844526, 144.96411782"
1621720250524,162,2025-05-24,17,212,332,544,Eli489_T,"-37.80740397, 144.95987909"
131320250926,131,2025-09-26,3,19,48,67,King2_T,"-37.82009057, 144.95758725"
131520251014,131,2025-10-14,5,8,4,12,King2_T,"-37.82009057, 144.95758725"
1321320241217,132,2024-12-17,13,206,164,370,King335_T,"-37.81267639, 144.95386444"
108820250408,108,2025-04-08,8,204,2769,2973,261Will_T,"-37.81295822, 144.95678789"
134320240907,134,2024-09-07,3,55,33,88,Spen201_T,"-37.81694221, 144.95303935"
1341320240422,134,2024-04-22,13,326,354,680,Spen201_T,"-37.81694221, 144.95303935"
1352220250506,135,2025-05-06,22,96,117,213,Spen161_T,"-37.8172861, 144.95319102"
135320231218,135,2023-12-18,3,21,13,34,Spen161_T,"-37.8172861, 144.95319102"
1071620240531,107,2024-05-31,16,176,114,290,280Will_T,"-37.81246271, 144.95690188"
1181820250929,118,2025-09-29,18,16,16,32,Fli114C_T,"-37.81632783, 144.97090512"
179520250216,179,2025-02-16,5,1,3,4,Pow61_T,"-37.82392385, 144.96299677"
1791220250518,179,2025-05-18,12,67,35,102,Pow61_T,"-37.82392385, 144.96299677"
671920240917,67,2024-09-17,19,211,359,570,FLDegS_T,"-37.81688755, 144.96562569"
85820240831,85,2024-08-31,8,57,46,103,488Mac_T,"-37.79432415, 144.92973378"
11520240924,1,2024-09-24,15,1361,1161,2522,Bou292_T,"-37.81349441, 144.96515323"
621120240731,62,2024-07-31,11,163,131,294,Lat224_T,"-37.80996494, 144.96216521"
621420250604,62,2025-06-04,14,211,224,435,Lat224_T,"-37.80996494, 144.96216521"
56920240224,56,2024-02-24,9,238,107,345,Lon364_T,"-37.81234775, 144.96153311"
271520240603,27,2024-06-03,15,87,86,173,Vic_T,"-37.80606888, 144.95644692"
91720250521,9,2025-05-21,17,2956,139,3095,Col700_T,"-37.81982992, 144.95102555"
791420240625,79,2024-06-25,14,536,426,962,FliSS_T,"-37.81794046, 144.96616678"
91120240729,9,2024-07-29,11,169,215,384,Col700_T,"-37.81982992, 144.95102555"
202020240912,20,2024-09-12,20,187,356,543,LtB170_T,"-37.81172914, 144.9682466"
512120250810,51,2025-08-10,21,47,52,99,Fra118_T,"-37.80841815, 144.95906316"
461220250913,46,2025-09-13,12,53,46,99,Pel147_T,"-37.80240719, 144.9615673"
461420240720,46,2024-07-20,14,33,51,84,Pel147_T,"-37.80240719, 144.9615673"
1092320240718,109,2024-07-18,23,32,45,77,LatWill_T,"-37.81193681, 144.95621105"
1171620240808,117,2024-08-08,16,127,232,359,Fli114F_T,"-37.81629332, 144.97090877"
492220250121,49,2025-01-21,22,116,83,199,Eli501_T,"-37.80730068, 144.95956055"
251520250923,25,2025-09-23,15,802,826,1628,MCEC_T,"-37.82401776, 144.95604426"
252120240123,25,2024-01-23,21,298,342,640,MCEC_T,"-37.82401776, 144.95604426"
1412120231113,141,2023-11-13,21,65,63,128,474Fl_T,"-37.81997273, 144.95834911"
1372220241116,137,2024-11-16,22,22,11,33,BouHbr2353_T,"-37.81894815, 144.94612292"
1372020250114,137,2025-01-14,20,3,28,31,BouHbr2353_T,"-37.81894815, 144.94612292"
1372220241004,137,2024-10-04,22,1,3,4,BouHbr2353_T,"-37.81894815, 144.94612292"
139620250802,139,2025-08-02,6,1,0,1,Signal1647_T,"-37.81959923, 144.9632832"
1392020240503,139,2024-05-03,20,34,25,59,Signal1647_T,"-37.81959923, 144.9632832"
1361220240724,136,2024-07-24,12,57,46,103,BirFed1120_T,"-37.8184141, 144.97357915"
1361920250313,136,2025-03-13,19,1896,43,1939,BirFed1120_T,"-37.8184141, 144.97357915"
1362020250522,136,2025-05-22,20,10,1,11,BirFed1120_T,"-37.8184141, 144.97357915"
1381520250405,138,2025-04-05,15,7,10,17,EntPark1671_T,"-37.81996544, 144.95981454"
1381420250511,138,2025-05-11,14,7,53,60,EntPark1671_T,"-37.81996544, 144.95981454"
66920250907,66,2025-09-07,9,158,269,427,QVN_T,"-37.81057846, 144.96444294"
691720240207,69,2024-02-07,17,101,131,232,FLDegC_T,"-37.81687226, 144.96559144"
69920240922,69,2024-09-22,9,150,85,235,FLDegC_T,"-37.81687226, 144.96559144"
842320241021,84,2024-10-21,23,130,168,298,ElFi_T,"-37.81798049, 144.96503383"
701120250828,70,2025-08-28,11,106,114,220,Errol20_T,"-37.80456984, 144.94946228"
391820250826,39,2025-08-26,18,72,34,106,AlfPl_T,"-37.81379749, 144.96995745"
8820241106,8,2024-11-06,8,269,174,443,WebBN_T,"-37.82293543, 144.9471751"
411420240405,41,2024-04-05,14,1763,1707,3470,Swa31,"-37.81668634, 144.96689733"
781520250521,78,2025-05-21,15,20,76,96,HarEsB_T,"-37.81471642, 144.9446508"
77120250519,77,2025-05-19,1,1,2,3,HarEsP_T,"-37.81441438, 144.94433026"
14720240608,14,2024-06-08,7,80,45,125,SanBri_T,"-37.82011242, 144.96291897"
14920240801,14,2024-08-01,9,187,341,528,SanBri_T,"-37.82011242, 144.96291897"
59520240820,59,2024-08-20,5,23,19,42,RMIT_T,"-37.80825648, 144.96304859"
59320240913,59,2024-09-13,3,8,3,11,RMIT_T,"-37.80825648, 144.96304859"
281020241106,28,2024-11-06,10,380,226,606,VAC_T,"-37.82129925, 144.96879309"
28020241211,28,2024-12-11,0,37,6,43,VAC_T,"-37.82129925, 144.96879309"
291120250618,29,2025-06-18,11,143,128,271,AG_T,"-37.8199817, 144.96872865"
29320250815,29,2025-08-15,3,1,6,7,AG_T,"-37.8199817, 144.96872865"
291620240124,29,2024-01-24,16,248,288,536,AG_T,"-37.8199817, 144.96872865"
141820231106,14,2023-11-06,18,505,151,656,SanBri_T,"-37.82011242, 144.96291897"
541520241116,54,2024-11-16,15,78,84,162,Swa607_T,"-37.804024, 144.96308399"
28620240103,28,2024-01-03,6,65,88,153,VAC_T,"-37.82129925, 144.96879309"
36120240525,36,2024-05-25,1,96,140,236,Que85_T,"-37.81652527, 144.96121062"
36420250614,36,2025-06-14,4,16,12,28,Que85_T,"-37.81652527, 144.96121062"
50420241120,50,2024-11-20,4,8,1,9,Lyg309_T,"-37.79808192, 144.96721013"
502020251010,50,2025-10-10,20,284,235,519,Lyg309_T,"-37.79808192, 144.96721013"
452220240713,45,2024-07-13,22,598,558,1156,Swa148_T,"-37.81414075, 144.96609379"
441120231108,44,2023-11-08,11,34,46,80,UM3_T,"-37.79698741, 144.96441306"
108420231224,108,2023-12-24,4,9,7,16,261Will_T,"-37.81295822, 144.95678789"
611620241023,61,2024-10-23,16,618,908,1526,RMIT14_T,"-37.80767455, 144.96309114"
179520250727,179,2025-07-27,5,6,2,8,Pow61_T,"-37.82392385, 144.96299677"
1661820250704,166,2025-07-04,18,32,43,75,Spen484_T,"-37.80896733, 144.94931703"
791820241106,79,2024-11-06,18,481,347,828,FliSS_T,"-37.81794046, 144.96616678"
791720250622,79,2025-06-22,17,321,329,650,FliSS_T,"-37.81794046, 144.96616678"
30220240909,30,2024-09-09,2,40,59,99,Lon189_T,"-37.8112185, 144.96656806"
301120241117,30,2024-11-17,11,203,288,491,Lon189_T,"-37.8112185, 144.96656806"
251920250923,25,2025-09-23,19,338,377,715,MCEC_T,"-37.82401776, 144.95604426"
251320240109,25,2024-01-09,13,644,766,1410,MCEC_T,"-37.82401776, 144.95604426"
25820241110,25,2024-11-10,8,197,206,403,MCEC_T,"-37.82401776, 144.95604426"
1391420250206,139,2025-02-06,14,53,38,91,Signal1647_T,"-37.81959923, 144.9632832"
1421820240601,142,2024-06-01,18,271,185,456,Hammer1584_T,"-37.81970749, 144.96795734"
130920240522,130,2024-05-22,9,13,9,22,Bou892T,"-37.8204637, 144.94126826"
1301120241109,130,2024-11-09,11,67,64,131,Bou892T,"-37.8204637, 144.94126826"
1611620241205,161,2024-12-05,16,70,65,135,BirArt1109_T,"-37.81851276, 144.97131336"
1611620250108,161,2025-01-08,16,284,83,367,BirArt1109_T,"-37.81851276, 144.97131336"
164020240924,164,2024-09-24,0,1,15,16,Lat526_T,"-37.813005, 144.95160411"
164620241119,164,2024-11-19,6,27,31,58,Lat526_T,"-37.813005, 144.95160411"
49020240729,49,2024-07-29,0,36,36,72,Eli501_T,"-37.80730068, 144.95956055"
481520241104,48,2024-11-04,15,122,142,264,QVMQ_T,"-37.80631581, 144.95866697"
1802320251016,180,2025-10-16,23,0,4,4,Mac330_T,"-37.79497059, 144.93530329"
691620231208,69,2023-12-08,16,124,130,254,FLDegC_T,"-37.81687226, 144.96559144"
6320231110,6,2023-11-10,3,7,7,14,FliS_T,"-37.81911705, 144.96558255"
6420250118,6,2025-01-18,4,38,42,80,FliS_T,"-37.81911705, 144.96558255"
4120240308,4,2024-03-08,1,43,34,77,Swa123_T,"-37.81487988, 144.9660878"
6120250806,6,2025-08-06,1,11,35,46,FliS_T,"-37.81911705, 144.96558255"
42220241123,4,2024-11-23,22,1005,591,1596,Swa123_T,"-37.81487988, 144.9660878"
3120240714,3,2024-07-14,1,283,325,608,Swa295_T,"-37.81101524, 144.96429485"
391920240620,39,2024-06-20,19,76,70,146,AlfPl_T,"-37.81379749, 144.96995745"
392120241121,39,2024-11-21,21,5,10,15,AlfPl_T,"-37.81379749, 144.96995745"
78920240502,78,2024-05-02,9,46,49,95,HarEsB_T,"-37.81471642, 144.9446508"
541720250711,54,2025-07-11,17,106,188,294,Swa607_T,"-37.804024, 144.96308399"
541820250901,54,2025-09-01,18,139,338,477,Swa607_T,"-37.804024, 144.96308399"
52120250320,5,2025-03-20,21,704,345,1049,PriNW_T,"-37.81874249, 144.96787656"
5420250526,5,2025-05-26,4,20,5,25,PriNW_T,"-37.81874249, 144.96787656"
21720241119,21,2024-11-19,7,31,56,87,Bourke155_T,"-37.81267313, 144.96788288"
37220250301,37,2025-03-01,2,2,11,13,Lyg260_T,"-37.80107122, 144.96704554"
872020251016,87,2025-10-16,20,75,87,162,Errol23_T,"-37.80454949, 144.94921863"
87820240105,87,2024-01-05,8,38,31,69,Errol23_T,"-37.80454949, 144.94921863"
441420250227,44,2025-02-27,14,106,131,237,UM3_T,"-37.79698741, 144.96441306"
431020250413,43,2025-04-13,10,70,49,119,UM2_T,"-37.79844526, 144.96411782"
43620240523,43,2024-05-23,6,27,6,33,UM2_T,"-37.79844526, 144.96411782"
431820241125,43,2024-11-25,18,92,102,194,UM2_T,"-37.79844526, 144.96411782"
162620250802,162,2025-08-02,6,36,37,73,Eli489_T,"-37.80740397, 144.95987909"
184220250911,184,2025-09-11,2,6,14,20,Eli124_T,"-37.81512416, 144.96371988"
131620250731,131,2025-07-31,6,17,20,37,King2_T,"-37.82009057, 144.95758725"
1401020231228,140,2023-12-28,10,71,20,91,Boyd2837_T,"-37.82590962, 144.96185972"
1311020240423,131,2024-04-23,10,52,124,176,King2_T,"-37.82009057, 144.95758725"
135520240727,135,2024-07-27,5,9,23,32,Spen161_T,"-37.8172861, 144.95319102"
1071020240614,107,2024-06-14,10,83,112,195,280Will_T,"-37.81246271, 144.95690188"
1331620240105,133,2024-01-05,16,562,600,1162,Spen229_T,"-37.81531435, 144.95227769"
1182220250923,118,2025-09-23,22,5,6,11,Fli114C_T,"-37.81632783, 144.97090512"
1241120250407,124,2025-04-07,11,3,6,9,BirBridge_T,"-37.81757416, 144.97329934"
165520241014,165,2024-10-14,5,1,2,3,Spen475_T,"-37.80953359, 144.94939004"
531220240808,53,2024-08-08,12,857,727,1584,Col254_T,"-37.81564191, 144.965499"
531420240914,53,2024-09-14,14,684,554,1238,Col254_T,"-37.81564191, 144.965499"
53320250126,53,2025-01-26,3,2,14,16,Col254_T,"-37.81564191, 144.965499"
302020250106,30,2025-01-06,20,195,291,486,Lon189_T,"-37.8112185, 144.96656806"
301520250702,30,2025-07-02,15,150,355,505,Lon189_T,"-37.8112185, 144.96656806"
302120231230,30,2023-12-30,21,352,501,853,Lon189_T,"-37.8112185, 144.96656806"
51920240317,51,2024-03-17,9,63,98,161,Fra118_T,"-37.80841815, 144.95906316"
23420231201,23,2023-12-01,4,4,9,13,Col623_T,"-37.81909256, 144.95452748"
20620241214,20,2024-12-14,6,8,22,30,LtB170_T,"-37.81172914, 144.9682466"
522220250214,52,2025-02-14,22,262,220,482,Eli263_T,"-37.81252157, 144.9619401"
52320250603,52,2025-06-03,3,1,6,7,Eli263_T,"-37.81252157, 144.9619401"
521920231106,52,2023-11-06,19,325,424,749,Eli263_T,"-37.81252157, 144.9619401"
482320251005,48,2025-10-05,23,20,21,41,QVMQ_T,"-37.80631581, 144.95866697"
117620241011,117,2024-10-11,6,35,35,70,Fli114F_T,"-37.81629332, 144.97090877"
109320231103,109,2023-11-03,3,1,6,7,LatWill_T,"-37.81193681, 144.95621105"
109520240306,109,2024-03-06,5,13,27,40,LatWill_T,"-37.81193681, 144.95621105"
1091620250317,109,2025-03-17,16,339,117,456,LatWill_T,"-37.81193681, 144.95621105"
136820241101,136,2024-11-01,8,68,88,156,BirFed1120_T,"-37.8184141, 144.97357915"
1421820250426,142,2025-04-26,18,83,50,133,Hammer1584_T,"-37.81970749, 144.96795734"
161920240629,161,2024-06-29,9,89,89,178,BirArt1109_T,"-37.81851276, 144.97131336"
138620250414,138,2025-04-14,6,0,1,1,EntPark1671_T,"-37.81996544, 144.95981454"
1382020231130,138,2023-11-30,20,2,0,2,EntPark1671_T,"-37.81996544, 144.95981454"
661020250622,66,2025-06-22,10,420,464,884,QVN_T,"-37.81057846, 144.96444294"
692020241005,69,2024-10-05,20,48,42,90,FLDegC_T,"-37.81687226, 144.96559144"
841520241220,84,2024-12-20,15,921,1332,2253,ElFi_T,"-37.81798049, 144.96503383"
841320250417,84,2025-04-17,13,1199,1410,2609,ElFi_T,"-37.81798049, 144.96503383"
841520250604,84,2025-06-04,15,780,1161,1941,ElFi_T,"-37.81798049, 144.96503383"
4920231218,4,2023-12-18,9,797,416,1213,Swa123_T,"-37.81487988, 144.9660878"
39020240307,39,2024-03-07,0,3,14,17,AlfPl_T,"-37.81379749, 144.96995745"
8720250523,8,2025-05-23,7,105,92,197,WebBN_T,"-37.82293543, 144.9471751"
412220231218,41,2023-12-18,22,835,957,1792,Swa31,"-37.81668634, 144.96689733"
412320240112,41,2024-01-12,23,483,779,1262,Swa31,"-37.81668634, 144.96689733"
771620240905,77,2024-09-05,16,94,65,159,HarEsP_T,"-37.81441438, 144.94433026"
402320240519,40,2024-05-19,23,18,11,29,Spr201_T,"-37.80999341, 144.97227587"
36520231203,36,2023-12-03,5,14,7,21,Que85_T,"-37.81652527, 144.96121062"
362320251013,36,2025-10-13,23,19,16,35,Que85_T,"-37.81652527, 144.96121062"
37020240605,37,2024-06-05,0,14,7,21,Lyg260_T,"-37.80107122, 144.96704554"
37420241124,37,2024-11-24,4,5,10,15,Lyg260_T,"-37.80107122, 144.96704554"
36520240504,36,2024-05-04,5,11,9,20,Que85_T,"-37.81652527, 144.96121062"
471720240117,47,2024-01-17,17,1541,910,2451,Eli250_T,"-37.81258467, 144.9625775"
471620240513,47,2024-05-13,16,957,686,1643,Eli250_T,"-37.81258467, 144.9625775"
45320240629,45,2024-06-29,3,22,53,75,Swa148_T,"-37.81414075, 144.96609379"
451220251009,45,2025-10-09,12,674,795,1469,Swa148_T,"-37.81414075, 144.96609379"
21920240812,21,2024-08-12,9,113,110,223,Bourke155_T,"-37.81267313, 144.96788288"
1071620240813,107,2024-08-13,16,166,133,299,280Will_T,"-37.81246271, 144.95690188"
108720240801,108,2024-08-01,7,26,521,547,261Will_T,"-37.81295822, 144.95678789"
611020240419,61,2024-04-19,10,402,517,919,RMIT14_T,"-37.80767455, 144.96309114"
441720250204,44,2025-02-04,17,95,44,139,UM3_T,"-37.79698741, 144.96441306"
501120240207,50,2024-02-07,11,133,144,277,Lyg309_T,"-37.79808192, 144.96721013"
1662320241129,166,2024-11-29,23,18,2,20,Spen484_T,"-37.80896733, 144.94931703"
1652020241125,165,2024-11-25,20,31,19,50,Spen475_T,"-37.80953359, 144.94939004"
167720241022,167,2024-10-22,7,9,54,63,Lat526_T,"-37.81304149, 144.95155955"
167620250312,167,2025-03-12,6,1,14,15,Lat526_T,"-37.81304149, 144.95155955"
1401920231112,140,2023-11-12,19,82,59,141,Boyd2837_T,"-37.82590962, 144.96185972"
1321020241102,132,2024-11-02,10,193,118,311,King335_T,"-37.81267639, 144.95386444"
1341820231224,134,2023-12-24,18,382,403,785,Spen201_T,"-37.81694221, 144.95303935"
1351920250813,135,2025-08-13,19,162,222,384,Spen161_T,"-37.8172861, 144.95319102"
1811320250911,181,2025-09-11,13,710,1043,1753,Eli368_T,"-37.81009465, 144.96143149"
140620250413,140,2025-04-13,6,2,1,3,Boyd2837_T,"-37.82590962, 144.96185972"
131920250616,131,2025-06-16,9,77,61,138,King2_T,"-37.82009057, 144.95758725"
140820240107,140,2024-01-07,8,55,9,64,Boyd2837_T,"-37.82590962, 144.96185972"
1342320250310,134,2025-03-10,23,104,86,190,Spen201_T,"-37.81694221, 144.95303935"
1342120250418,134,2025-04-18,21,320,275,595,Spen201_T,"-37.81694221, 144.95303935"
134920240528,134,2024-05-28,9,229,246,475,Spen201_T,"-37.81694221, 144.95303935"
135720250601,135,2025-06-01,7,47,71,118,Spen161_T,"-37.8172861, 144.95319102"
142620231128,142,2023-11-28,6,76,25,101,Hammer1584_T,"-37.81970749, 144.96795734"
1611820250827,161,2025-08-27,18,137,33,170,BirArt1109_T,"-37.81851276, 144.97131336"
117220250420,117,2025-04-20,2,10,11,21,Fli114F_T,"-37.81629332, 144.97090877"
671020241024,67,2024-10-24,10,402,455,857,FLDegS_T,"-37.81688755, 144.96562569"
171420231019,17,2023-10-19,14,388,370,758,Col15_T,"-37.81362543, 144.97323591"
18420250203,18,2025-02-03,4,2,5,7,Col12_T,"-37.81344862, 144.97305353"
56520241003,56,2024-10-03,5,6,7,13,Lon364_T,"-37.81234775, 144.96153311"
861320240830,86,2024-08-30,13,83,79,162,574Qub_T,"-37.80309992, 144.94908064"
56120250621,56,2025-06-21,1,16,49,65,Lon364_T,"-37.81234775, 144.96153311"
11420250806,11,2025-08-06,4,4,1,5,WatCit_T,"-37.81564989, 144.93970694"
721120240127,72,2024-01-27,11,186,316,502,ACMI_T,"-37.81726338, 144.96872809"
27020240815,27,2024-08-15,0,14,4,18,Vic_T,"-37.80606888, 144.95644692"
27520240119,27,2024-01-19,5,9,6,15,Vic_T,"-37.80606888, 144.95644692"
2020240618,2,2024-06-18,0,5,11,16,Bou283_T,"-37.81380668, 144.96516718"
232020240713,23,2024-07-13,20,103,184,287,Col623_T,"-37.81909256, 144.95452748"
51220250427,51,2025-04-27,2,26,11,37,Fra118_T,"-37.80841815, 144.95906316"
511620250505,51,2025-05-05,16,78,80,158,Fra118_T,"-37.80841815, 144.95906316"
521920241222,52,2024-12-22,19,316,244,560,Eli263_T,"-37.81252157, 144.9619401"
522120240801,52,2024-08-01,21,244,161,405,Eli263_T,"-37.81252157, 144.9619401"
46420231124,46,2023-11-24,4,1,1,2,Pel147_T,"-37.80240719, 144.9615673"
192320251002,19,2025-10-02,23,137,184,321,LtB210_T,"-37.81237202, 144.96550671"
109620240722,109,2024-07-22,6,19,104,123,LatWill_T,"-37.81193681, 144.95621105"
491820240716,49,2024-07-16,18,231,254,485,Eli501_T,"-37.80730068, 144.95956055"
251220241007,25,2024-10-07,12,372,523,895,MCEC_T,"-37.82401776, 144.95604426"
251020250106,25,2025-01-06,10,9,87,96,MCEC_T,"-37.82401776, 144.95604426"
1641820250428,164,2025-04-28,18,95,99,194,Lat526_T,"-37.813005, 144.95160411"
137620250829,137,2025-08-29,6,8,2,10,BouHbr2353_T,"-37.81894815, 144.94612292"
141620240318,141,2024-03-18,6,21,20,41,474Fl_T,"-37.81997273, 144.95834911"
139620241216,139,2024-12-16,6,13,15,28,Signal1647_T,"-37.81959923, 144.9632832"
66720241016,66,2024-10-16,7,79,252,331,QVN_T,"-37.81057846, 144.96444294"
41820240518,4,2024-05-18,18,1446,674,2120,Swa123_T,"-37.81487988, 144.9660878"
4620250120,4,2025-01-20,6,121,50,171,Swa123_T,"-37.81487988, 144.9660878"
42220250322,4,2025-03-22,22,1009,813,1822,Swa123_T,"-37.81487988, 144.9660878"
411220240607,41,2024-06-07,12,1622,1240,2862,Swa31,"-37.81668634, 144.96689733"
421920250721,42,2025-07-21,19,45,67,112,UM1_T,"-37.80008566, 144.96386412"
42720250819,42,2025-08-19,7,34,46,80,UM1_T,"-37.80008566, 144.96386412"
712020240512,71,2024-05-12,20,17,5,22,WestWP_T,"-37.81235775, 144.97136962"
29620250809,29,2025-08-09,6,30,26,56,AG_T,"-37.8199817, 144.96872865"
281520240102,28,2024-01-02,15,806,1014,1820,VAC_T,"-37.82129925, 144.96879309"
40220241117,40,2024-11-17,2,10,13,23,Spr201_T,"-37.80999341, 144.97227587"
36720231117,36,2023-11-17,7,84,74,158,Que85_T,"-37.81652527, 144.96121062"
44720240903,44,2024-09-03,7,9,31,40,UM3_T,"-37.79698741, 144.96441306"
441920241107,44,2024-11-07,19,37,60,97,UM3_T,"-37.79698741, 144.96441306"
43220250416,43,2025-04-16,2,1,1,2,UM2_T,"-37.79844526, 144.96411782"
45420240331,45,2024-03-31,4,23,74,97,Swa148_T,"-37.81414075, 144.96609379"
451820240607,45,2024-06-07,18,656,777,1433,Swa148_T,"-37.81414075, 144.96609379"
451920240702,45,2024-07-02,19,330,529,859,Swa148_T,"-37.81414075, 144.96609379"
1331220241226,133,2024-12-26,12,408,415,823,Spen229_T,"-37.81531435, 144.95227769"
1322220251016,132,2025-10-16,22,100,78,178,King335_T,"-37.81267639, 144.95386444"
118520250731,118,2025-07-31,5,1,0,1,Fli114C_T,"-37.81632783, 144.97090512"
118020250925,118,2025-09-25,0,1,0,1,Fli114C_T,"-37.81632783, 144.97090512"
108920231204,108,2023-12-04,9,207,881,1088,261Will_T,"-37.81295822, 144.95678789"
108520240109,108,2024-01-09,5,17,53,70,261Will_T,"-37.81295822, 144.95678789"
87720250517,87,2025-05-17,7,13,10,23,Errol23_T,"-37.80454949, 144.94921863"
87020251010,87,2025-10-10,0,6,7,13,Errol23_T,"-37.80454949, 144.94921863"
61220250507,61,2025-05-07,2,22,4,26,RMIT14_T,"-37.80767455, 144.96309114"
1651820250325,165,2025-03-25,18,57,28,85,Spen475_T,"-37.80953359, 144.94939004"
1662020241127,166,2024-11-27,20,29,28,57,Spen484_T,"-37.80896733, 144.94931703"
1401520250412,140,2025-04-12,15,110,83,193,Boyd2837_T,"-37.82590962, 144.96185972"
1621520250525,162,2025-05-25,15,517,820,1337,Eli489_T,"-37.80740397, 144.95987909"
143720250517,143,2025-05-17,7,26,79,105,Spencer_T,"-37.821728, 144.95557015"
1431920250609,143,2025-06-09,19,153,120,273,Spencer_T,"-37.821728, 144.95557015"
1432120250211,143,2025-02-11,21,132,121,253,Spencer_T,"-37.821728, 144.95557015"
132820241105,132,2024-11-05,8,72,46,118,King335_T,"-37.81267639, 144.95386444"
172120240708,17,2024-07-08,21,50,56,106,Col15_T,"-37.81362543, 144.97323591"
1920241018,1,2024-10-18,9,160,192,352,Bou292_T,"-37.81349441, 144.96515323"
111120231116,11,2023-11-16,11,54,55,109,WatCit_T,"-37.81564989, 144.93970694"
621420241104,62,2024-11-04,14,281,311,592,Lat224_T,"-37.80996494, 144.96216521"
122220250324,12,2025-03-24,22,73,66,139,NewQ_T,"-37.81457988, 144.94292398"
86020250614,86,2025-06-14,0,2,3,5,574Qub_T,"-37.80309992, 144.94908064"
241920231115,24,2023-11-15,19,330,560,890,Col620_T,"-37.81887963, 144.95449198"
561920250719,56,2025-07-19,19,420,565,985,Lon364_T,"-37.81234775, 144.96153311"
24920240905,24,2024-09-05,9,1450,369,1819,Col620_T,"-37.81887963, 144.95449198"
242020231221,24,2023-12-21,20,324,484,808,Col620_T,"-37.81887963, 144.95449198"
24120240213,24,2024-02-13,1,44,42,86,Col620_T,"-37.81887963, 144.95449198"
10320250305,10,2025-03-05,3,1,1,2,BouHbr_T,"-37.81876474, 144.94710545"
581920241002,58,2024-10-02,19,332,345,677,Bou688_T,"-37.81686075, 144.95358075"
762120251007,76,2025-10-07,21,2,18,20,KenMac_T,"-37.79453803, 144.93036194"
27520240904,27,2024-09-04,5,5,7,12,Vic_T,"-37.80606888, 144.95644692"
91120240608,9,2024-06-08,11,67,128,195,Col700_T,"-37.81982992, 144.95102555"
301120250210,30,2025-02-10,11,127,256,383,Lon189_T,"-37.8112185, 144.96656806"
532120241214,53,2024-12-14,21,353,392,745,Col254_T,"-37.81564191, 144.965499"
232120250418,23,2025-04-18,21,97,197,294,Col623_T,"-37.81909256, 144.95452748"
232220240402,23,2024-04-02,22,29,87,116,Col623_T,"-37.81909256, 144.95452748"
20420240609,20,2024-06-09,4,40,44,84,LtB170_T,"-37.81172914, 144.9682466"
109620240705,109,2024-07-05,6,20,78,98,LatWill_T,"-37.81193681, 144.95621105"
49720250408,49,2025-04-08,7,80,104,184,Eli501_T,"-37.80730068, 144.95956055"
191220241029,19,2024-10-29,12,412,400,812,LtB210_T,"-37.81237202, 144.96550671"
251820250803,25,2025-08-03,18,1165,839,2004,MCEC_T,"-37.82401776, 144.95604426"
251220250809,25,2025-08-09,12,637,812,1449,MCEC_T,"-37.82401776, 144.95604426"
164820250208,164,2025-02-08,8,71,42,113,Lat526_T,"-37.813005, 144.95160411"
1411820250420,141,2025-04-20,18,178,172,350,474Fl_T,"-37.81997273, 144.95834911"
1421720240514,142,2024-05-14,17,308,211,519,Hammer1584_T,"-37.81970749, 144.96795734"
1302020250205,130,2025-02-05,20,44,41,85,Bou892T,"-37.8204637, 144.94126826"
1231320250413,123,2025-04-13,13,64,44,108,BirBridge_T,"-37.81753741, 144.97329734"
117520241119,117,2024-11-19,5,8,7,15,Fli114F_T,"-37.81629332, 144.97090877"
701220250309,70,2025-03-09,12,103,106,209,Errol20_T,"-37.80456984, 144.94946228"
3320240913,3,2024-09-13,3,32,13,45,Swa295_T,"-37.81101524, 144.96429485"
18020241108,18,2024-11-08,0,0,1,1,Col12_T,"-37.81344862, 144.97305353"
62420250918,62,2025-09-18,4,3,7,10,Lat224_T,"-37.80996494, 144.96216521"
62720240124,62,2024-01-24,7,78,47,125,Lat224_T,"-37.80996494, 144.96216521"
561620240304,56,2024-03-04,16,230,250,480,Lon364_T,"-37.81234775, 144.96153311"
861320250704,86,2025-07-04,13,72,88,160,574Qub_T,"-37.80309992, 144.94908064"
86020250907,86,2025-09-07,0,0,7,7,574Qub_T,"-37.80309992, 144.94908064"
11720250306,11,2025-03-06,7,75,63,138,WatCit_T,"-37.81564989, 144.93970694"
58020250117,58,2025-01-17,0,105,66,171,Bou688_T,"-37.81686075, 144.95358075"
351820241024,35,2024-10-24,18,1682,1328,3010,SouthB_T,"-37.82018685, 144.96508508"
2120250523,2,2025-05-23,1,2,29,31,Bou283_T,"-37.81380668, 144.96516718"
9820250712,9,2025-07-12,8,39,29,68,Col700_T,"-37.81982992, 144.95102555"
271820250712,27,2025-07-12,18,118,86,204,Vic_T,"-37.80606888, 144.95644692"
511620240306,51,2024-03-06,16,102,131,233,Fra118_T,"-37.80841815, 144.95906316"
231720241206,23,2024-12-06,17,240,378,618,Col623_T,"-37.81909256, 144.95452748"
23120250219,23,2025-02-19,1,6,15,21,Col623_T,"-37.81909256, 144.95452748"
231720250508,23,2025-05-08,17,382,895,1277,Col623_T,"-37.81909256, 144.95452748"
20420240801,20,2024-08-01,4,2,1,3,LtB170_T,"-37.81172914, 144.9682466"
52520240718,52,2024-07-18,5,5,3,8,Eli263_T,"-37.81252157, 144.9619401"
481620250325,48,2025-03-25,16,139,151,290,QVMQ_T,"-37.80631581, 144.95866697"
117420240516,117,2024-05-16,4,0,1,1,Fli114F_T,"-37.81629332, 144.97090877"
109220240413,109,2024-04-13,2,22,25,47,LatWill_T,"-37.81193681, 144.95621105"
48620231203,48,2023-12-03,6,18,20,38,QVMQ_T,"-37.80631581, 144.95866697"
1641920250626,164,2025-06-26,19,54,67,121,Lat526_T,"-37.813005, 144.95160411"
1371120240703,137,2024-07-03,11,22,54,76,BouHbr2353_T,"-37.81894815, 144.94612292"
137220250419,137,2025-04-19,2,0,2,2,BouHbr2353_T,"-37.81894815, 144.94612292"
1611820251006,161,2025-10-06,18,424,162,586,BirArt1109_T,"-37.81851276, 144.97131336"
164020240823,164,2024-08-23,0,4,7,11,Lat526_T,"-37.813005, 144.95160411"
138020250511,138,2025-05-11,0,1,0,1,EntPark1671_T,"-37.81996544, 144.95981454"
691920240214,69,2024-02-14,19,33,28,61,FLDegC_T,"-37.81687226, 144.96559144"
69120250427,69,2025-04-27,1,2,2,4,FLDegC_T,"-37.81687226, 144.96559144"
84320240328,84,2024-03-28,3,20,17,37,ElFi_T,"-37.81798049, 144.96503383"
42320251016,4,2025-10-16,23,298,221,519,Swa123_T,"-37.81487988, 144.9660878"
32120240419,3,2024-04-19,21,1255,1257,2512,Swa295_T,"-37.81101524, 144.96429485"
3120250212,3,2025-02-12,1,88,39,127,Swa295_T,"-37.81101524, 144.96429485"
392320231208,39,2023-12-08,23,57,71,128,AlfPl_T,"-37.81379749, 144.96995745"
751620240217,75,2024-02-17,16,94,310,404,SprFli_T,"-37.81515276, 144.97467661"
32320250921,3,2025-09-21,23,176,148,324,Swa295_T,"-37.81101524, 144.96429485"
81620231110,8,2023-11-10,16,145,223,368,WebBN_T,"-37.82293543, 144.9471751"
771020240119,77,2024-01-19,10,133,105,238,HarEsP_T,"-37.81441438, 144.94433026"
59320240905,59,2024-09-05,3,23,5,28,RMIT_T,"-37.80825648, 144.96304859"
65920240926,65,2024-09-26,9,558,325,883,SwaCs_T,"-37.81569416, 144.9668064"
49520250930,49,2025-09-30,5,22,27,49,Eli501_T,"-37.80730068, 144.95956055"
121020240722,12,2024-07-22,10,70,125,195,NewQ_T,"-37.81457988, 144.94292398"
111720240122,11,2024-01-22,17,118,104,222,WatCit_T,"-37.81564989, 144.93970694"
56320241209,56,2024-12-09,3,1,8,9,Lon364_T,"-37.81234775, 144.96153311"
122020250307,12,2025-03-07,20,382,340,722,NewQ_T,"-37.81457988, 144.94292398"
12520250104,12,2025-01-04,5,9,8,17,NewQ_T,"-37.81457988, 144.94292398"
12420250122,12,2025-01-22,4,1,3,4,NewQ_T,"-37.81457988, 144.94292398"
101020250508,10,2025-05-08,10,52,70,122,BouHbr_T,"-37.81876474, 144.94710545"
241120241027,24,2024-10-27,11,633,470,1103,Col620_T,"-37.81887963, 144.95449198"
761420241110,76,2024-11-10,14,62,50,112,KenMac_T,"-37.79453803, 144.93036194"
35020231111,35,2023-11-11,0,325,587,912,SouthB_T,"-37.82018685, 144.96508508"
351820240208,35,2024-02-08,18,1559,1344,2903,SouthB_T,"-37.82018685, 144.96508508"
72620250311,72,2025-03-11,6,53,21,74,ACMI_T,"-37.81726338, 144.96872809"
721020250408,72,2025-04-08,10,177,130,307,ACMI_T,"-37.81726338, 144.96872809"
11420250530,11,2025-05-30,4,2,0,2,WatCit_T,"-37.81564989, 144.93970694"
58820231207,58,2023-12-07,8,1630,196,1826,Bou688_T,"-37.81686075, 144.95358075"
21820241122,2,2024-11-22,18,631,501,1132,Bou283_T,"-37.81380668, 144.96516718"
272320250315,27,2025-03-15,23,85,33,118,Vic_T,"-37.80606888, 144.95644692"
27420250905,27,2025-09-05,4,3,2,5,Vic_T,"-37.80606888, 144.95644692"
302220240905,30,2024-09-05,22,165,213,378,Lon189_T,"-37.8112185, 144.96656806"
302320240225,30,2024-02-25,23,144,128,272,Lon189_T,"-37.8112185, 144.96656806"
481420240520,48,2024-05-20,14,119,123,242,QVMQ_T,"-37.80631581, 144.95866697"
19420241205,19,2024-12-05,4,3,5,8,LtB210_T,"-37.81237202, 144.96550671"
137720240815,137,2024-08-15,7,35,5,40,BouHbr2353_T,"-37.81894815, 144.94612292"
1392320240202,139,2024-02-02,23,20,21,41,Signal1647_T,"-37.81959923, 144.9632832"
1391420240605,139,2024-06-05,14,27,34,61,Signal1647_T,"-37.81959923, 144.9632832"
1391420250329,139,2025-03-29,14,55,83,138,Signal1647_T,"-37.81959923, 144.9632832"
139720231203,139,2023-12-03,7,7,9,16,Signal1647_T,"-37.81959923, 144.9632832"
1611320250901,161,2025-09-01,13,138,188,326,BirArt1109_T,"-37.81851276, 144.97131336"
123120250311,123,2025-03-11,1,1,0,1,BirBridge_T,"-37.81753741, 144.97329734"
1231920240115,123,2024-01-15,19,53,25,78,BirBridge_T,"-37.81753741, 144.97329734"
1381120241017,138,2024-10-17,11,8,9,17,EntPark1671_T,"-37.81996544, 144.95981454"
161220250920,161,2025-09-20,2,0,1,1,BirArt1109_T,"-37.81851276, 144.97131336"
1171120240301,117,2024-03-01,11,108,170,278,Fli114F_T,"-37.81629332, 144.97090877"
1092020240111,109,2024-01-11,20,121,93,214,LatWill_T,"-37.81193681, 144.95621105"
69720240108,69,2024-01-08,7,31,14,45,FLDegC_T,"-37.81687226, 144.96559144"
69120250508,69,2025-05-08,1,2,0,2,FLDegC_T,"-37.81687226, 144.96559144"
69020250928,69,2025-09-28,0,10,4,14,FLDegC_T,"-37.81687226, 144.96559144"
4420250128,4,2025-01-28,4,7,13,20,Swa123_T,"-37.81487988, 144.9660878"
70220250221,70,2025-02-21,2,0,2,2,Errol20_T,"-37.80456984, 144.94946228"
32320250730,3,2025-07-30,23,117,94,211,Swa295_T,"-37.81101524, 144.96429485"
3620240130,3,2024-01-30,6,24,107,131,Swa295_T,"-37.81101524, 144.96429485"
82120240929,8,2024-09-29,21,27,23,50,WebBN_T,"-37.82293543, 144.9471751"
75520240609,75,2024-06-09,5,0,1,1,SprFli_T,"-37.81515276, 144.97467661"
712220240106,71,2024-01-06,22,8,7,15,WestWP_T,"-37.81235775, 144.97136962"
712020240322,71,2024-03-22,20,8,7,15,WestWP_T,"-37.81235775, 144.97136962"
28720250304,28,2025-03-04,7,416,181,597,VAC_T,"-37.82129925, 144.96879309"
28820250926,28,2025-09-26,8,74,97,171,VAC_T,"-37.82129925, 144.96879309"
402020240303,40,2024-03-03,20,73,48,121,Spr201_T,"-37.80999341, 144.97227587"
401620231126,40,2023-11-26,16,157,146,303,Spr201_T,"-37.80999341, 144.97227587"
281320240122,28,2024-01-22,13,792,792,1584,VAC_T,"-37.82129925, 144.96879309"
291820241029,29,2024-10-29,18,299,1364,1663,AG_T,"-37.8199817, 144.96872865"
542220250821,54,2025-08-21,22,89,109,198,Swa607_T,"-37.804024, 144.96308399"
371520240504,37,2024-05-04,15,150,145,295,Lyg260_T,"-37.80107122, 144.96704554"
47920250714,47,2025-07-14,9,272,523,795,Eli250_T,"-37.81258467, 144.9625775"
45720240802,45,2024-08-02,7,138,125,263,Swa148_T,"-37.81414075, 144.96609379"
211620240829,21,2024-08-29,16,248,293,541,Bourke155_T,"-37.81267313, 144.96788288"
1081820231109,108,2023-11-09,18,577,173,750,261Will_T,"-37.81295822, 144.95678789"
611220250207,61,2025-02-07,12,551,674,1225,RMIT14_T,"-37.80767455, 144.96309114"
441620240215,44,2024-02-15,16,26,20,46,UM3_T,"-37.79698741, 144.96441306"
181220250921,181,2025-09-21,2,139,113,252,Eli368_T,"-37.81009465, 144.96143149"
1661620250418,166,2025-04-18,16,28,36,64,Spen484_T,"-37.80896733, 144.94931703"
1651720250416,165,2025-04-16,17,92,37,129,Spen475_T,"-37.80953359, 144.94939004"
162020250506,162,2025-05-06,0,38,22,60,Eli489_T,"-37.80740397, 144.95987909"
135520250205,135,2025-02-05,5,27,26,53,Spen161_T,"-37.8172861, 144.95319102"
1351320250621,135,2025-06-21,13,304,434,738,Spen161_T,"-37.8172861, 144.95319102"
133820250718,133,2025-07-18,8,399,424,823,Spen229_T,"-37.81531435, 144.95227769"
1331420240403,133,2024-04-03,14,398,442,840,Spen229_T,"-37.81531435, 144.95227769"
118020241202,118,2024-12-02,0,0,2,2,Fli114C_T,"-37.81632783, 144.97090512"
171320241226,17,2024-12-26,13,90,54,144,Col15_T,"-37.81362543, 144.97323591"
172320250531,17,2025-05-31,23,36,33,69,Col15_T,"-37.81362543, 144.97323591"
17620250720,17,2025-07-20,6,22,12,34,Col15_T,"-37.81362543, 144.97323591"
11520240519,1,2024-05-19,15,1395,1082,2477,Bou292_T,"-37.81349441, 144.96515323"
181420250824,18,2025-08-24,14,315,143,458,Col12_T,"-37.81344862, 144.97305353"
62520250905,62,2025-09-05,5,9,2,11,Lat224_T,"-37.80996494, 144.96216521"
63720240203,63,2024-02-03,7,35,53,88,Bou231_T,"-37.81333081, 144.96675571"
63620250508,63,2025-05-08,6,4,9,13,Bou231_T,"-37.81333081, 144.96675571"
86220231225,86,2023-12-25,2,0,1,1,574Qub_T,"-37.80309992, 144.94908064"
622020240402,62,2024-04-02,20,157,67,224,Lat224_T,"-37.80996494, 144.96216521"
561120240606,56,2024-06-06,11,213,171,384,Lon364_T,"-37.81234775, 144.96153311"
561320240911,56,2024-09-11,13,405,330,735,Lon364_T,"-37.81234775, 144.96153311"
241520240419,24,2024-04-19,15,566,1010,1576,Col620_T,"-37.81887963, 144.95449198"
111420250319,11,2025-03-19,14,77,55,132,WatCit_T,"-37.81564989, 144.93970694"
2220240813,2,2024-08-13,2,3,12,15,Bou283_T,"-37.81380668, 144.96516718"
272320231218,27,2023-12-18,23,29,15,44,Vic_T,"-37.80606888, 144.95644692"
53120240911,53,2024-09-11,1,4,14,18,Col254_T,"-37.81564191, 144.965499"
531320250430,53,2025-04-30,13,882,678,1560,Col254_T,"-37.81564191, 144.965499"
231120250802,23,2025-08-02,11,155,254,409,Col623_T,"-37.81909256, 144.95452748"
20220250503,20,2025-05-03,2,52,120,172,LtB170_T,"-37.81172914, 144.9682466"
521220240130,52,2024-01-30,12,387,313,700,Eli263_T,"-37.81252157, 144.9619401"
46720250627,46,2025-06-27,7,13,11,24,Pel147_T,"-37.80240719, 144.9615673"
1091620240502,109,2024-05-02,16,435,185,620,LatWill_T,"-37.81193681, 144.95621105"
192120250505,19,2025-05-05,21,216,357,573,LtB210_T,"-37.81237202, 144.96550671"
481320250125,48,2025-01-25,13,572,389,961,QVMQ_T,"-37.80631581, 144.95866697"
1641020250514,164,2025-05-14,10,113,42,155,Lat526_T,"-37.813005, 144.95160411"
136320250316,136,2025-03-16,3,1,1,2,BirFed1120_T,"-37.8184141, 144.97357915"
1361120250328,136,2025-03-28,11,50,79,129,BirFed1120_T,"-37.8184141, 144.97357915"
1381720240503,138,2024-05-03,17,7,5,12,EntPark1671_T,"-37.81996544, 144.95981454"
84320250128,84,2025-01-28,3,12,7,19,ElFi_T,"-37.81798049, 144.96503383"
311720250131,31,2025-01-31,17,187,99,286,Lyg161_T,"-37.80169681, 144.96658911"
542220240318,54,2024-03-18,22,73,101,174,Swa607_T,"-37.804024, 144.96308399"
471720250922,47,2025-09-22,17,1169,778,1947,Eli250_T,"-37.81258467, 144.9625775"
47120250723,47,2025-07-23,1,34,35,69,Eli250_T,"-37.81258467, 144.9625775"
451020240817,45,2024-08-17,10,398,338,736,Swa148_T,"-37.81414075, 144.96609379"
36620240208,36,2024-02-08,6,44,19,63,Que85_T,"-37.81652527, 144.96121062"
108220240918,108,2024-09-18,2,4,2,6,261Will_T,"-37.81295822, 144.95678789"
87720250724,87,2025-07-24,7,34,30,64,Errol23_T,"-37.80454949, 144.94921863"
61120250307,61,2025-03-07,1,77,19,96,RMIT14_T,"-37.80767455, 144.96309114"
501020241227,50,2024-12-27,10,118,122,240,Lyg309_T,"-37.79808192, 144.96721013"
50520250525,50,2025-05-25,5,6,0,6,Lyg309_T,"-37.79808192, 144.96721013"
441820231031,44,2023-10-31,18,51,13,64,UM3_T,"-37.79698741, 144.96441306"
45820250827,45,2025-08-27,8,293,405,698,Swa148_T,"-37.81414075, 144.96609379"
167920251002,167,2025-10-02,9,40,78,118,Lat526_T,"-37.81304149, 144.95155955"
1312220240819,131,2024-08-19,22,23,23,46,King2_T,"-37.82009057, 144.95758725"
135220240104,135,2024-01-04,2,5,8,13,Spen161_T,"-37.8172861, 144.95319102"
118020240512,118,2024-05-12,0,6,11,17,Fli114C_T,"-37.81632783, 144.97090512"
67820250405,67,2025-04-05,8,149,133,282,FLDegS_T,"-37.81688755, 144.96562569"
85420240127,85,2024-01-27,4,0,2,2,488Mac_T,"-37.79432415, 144.92973378"
17620250707,17,2025-07-07,6,79,39,118,Col15_T,"-37.81362543, 144.97323591"
632220240129,63,2024-01-29,22,56,132,188,Bou231_T,"-37.81333081, 144.96675571"
63820240521,63,2024-05-21,8,187,171,358,Bou231_T,"-37.81333081, 144.96675571"
1920240811,1,2024-08-11,9,256,262,518,Bou292_T,"-37.81349441, 144.96515323"
62720240407,62,2024-04-07,7,13,20,33,Lat224_T,"-37.80996494, 144.96216521"
11120231019,11,2023-10-19,1,1,7,8,WatCit_T,"-37.81564989, 144.93970694"
24920240629,24,2024-06-29,9,463,325,788,Col620_T,"-37.81887963, 144.95449198"
351620241207,35,2024-12-07,16,1493,1730,3223,SouthB_T,"-37.82018685, 144.96508508"
76020231028,76,2023-10-28,0,5,3,8,KenMac_T,"-37.79453803, 144.93036194"
76720241224,76,2024-12-24,7,24,8,32,KenMac_T,"-37.79453803, 144.93036194"
2320250405,2,2025-04-05,3,7,30,37,Bou283_T,"-37.81380668, 144.96516718"
21820250709,2,2025-07-09,18,404,335,739,Bou283_T,"-37.81380668, 144.96516718"
91220241028,9,2024-10-28,12,562,493,1055,Col700_T,"-37.81982992, 144.95102555"
9320241202,9,2024-12-02,3,0,2,2,Col700_T,"-37.81982992, 144.95102555"
482320240203,48,2024-02-03,23,51,66,117,QVMQ_T,"-37.80631581, 144.95866697"
46920240328,46,2024-03-28,9,59,140,199,Pel147_T,"-37.80240719, 144.9615673"
521420250221,52,2025-02-21,14,322,264,586,Eli263_T,"-37.81252157, 144.9619401"
46520231219,46,2023-12-19,5,0,7,7,Pel147_T,"-37.80240719, 144.9615673"
1372020241107,137,2024-11-07,20,4,6,10,BouHbr2353_T,"-37.81894815, 144.94612292"
1372120250113,137,2025-01-13,21,3,6,9,BouHbr2353_T,"-37.81894815, 144.94612292"
141320241014,141,2024-10-14,3,9,11,20,474Fl_T,"-37.81997273, 144.95834911"
123720240714,123,2024-07-14,7,1,0,1,BirBridge_T,"-37.81753741, 144.97329734"
1232020240220,123,2024-02-20,20,18,3,21,BirBridge_T,"-37.81753741, 144.97329734"
1381320250316,138,2025-03-16,13,3,5,8,EntPark1671_T,"-37.81996544, 144.95981454"
1381420250718,138,2025-07-18,14,2,5,7,EntPark1671_T,"-37.81996544, 144.95981454"
6720240407,6,2024-04-07,7,141,89,230,FliS_T,"-37.81911705, 144.96558255"
842120240328,84,2024-03-28,21,574,1039,1613,ElFi_T,"-37.81798049, 144.96503383"
84920240523,84,2024-05-23,9,999,394,1393,ElFi_T,"-37.81798049, 144.96503383"
66620240427,66,2024-04-27,6,15,25,40,QVN_T,"-37.81057846, 144.96444294"
411120231205,41,2023-12-05,11,1610,1184,2794,Swa31,"-37.81668634, 144.96689733"
8920250409,8,2025-04-09,9,241,125,366,WebBN_T,"-37.82293543, 144.9471751"
781020231207,78,2023-12-07,10,39,46,85,HarEsB_T,"-37.81471642, 144.9446508"
78920250304,78,2025-03-04,9,58,31,89,HarEsB_T,"-37.81471642, 144.9446508"
42720240930,42,2024-09-30,7,51,50,101,UM1_T,"-37.80008566, 144.96386412"
421820241109,42,2024-11-09,18,59,89,148,UM1_T,"-37.80008566, 144.96386412"
592220240607,59,2024-06-07,22,321,178,499,RMIT_T,"-37.80825648, 144.96304859"
281820240715,28,2024-07-15,18,213,77,290,VAC_T,"-37.82129925, 144.96879309"
311420240714,31,2024-07-14,14,289,251,540,Lyg161_T,"-37.80169681, 144.96658911"
31120240718,31,2024-07-18,1,2,3,5,Lyg161_T,"-37.80169681, 144.96658911"
311120241005,31,2024-10-05,11,334,262,596,Lyg161_T,"-37.80169681, 144.96658911"
31620251015,31,2025-10-15,6,7,4,11,Lyg161_T,"-37.80169681, 144.96658911"
47620250528,47,2025-05-28,6,37,217,254,Eli250_T,"-37.81258467, 144.9625775"
40420250516,40,2025-05-16,4,1,3,4,Spr201_T,"-37.80999341, 144.97227587"
37320240517,37,2024-05-17,3,2,0,2,Lyg260_T,"-37.80107122, 144.96704554"
43820240304,43,2024-03-04,8,308,118,426,UM2_T,"-37.79844526, 144.96411782"
45720240714,45,2024-07-14,7,46,43,89,Swa148_T,"-37.81414075, 144.96609379"
451520250224,45,2025-02-24,15,390,760,1150,Swa148_T,"-37.81414075, 144.96609379"
1072220250223,107,2025-02-23,22,73,39,112,280Will_T,"-37.81246271, 144.95690188"
1071220231109,107,2023-11-09,12,172,166,338,280Will_T,"-37.81246271, 144.95690188"
1082220241018,108,2024-10-18,22,78,124,202,261Will_T,"-37.81295822, 144.95678789"
871020250905,87,2025-09-05,10,110,105,215,Errol23_T,"-37.80454949, 144.94921863"
871520241031,87,2024-10-31,15,73,123,196,Errol23_T,"-37.80454949, 144.94921863"
87620240308,87,2024-03-08,6,17,10,27,Errol23_T,"-37.80454949, 144.94921863"
131920231212,131,2023-12-12,9,83,50,133,King2_T,"-37.82009057, 144.95758725"
1312020240930,131,2024-09-30,20,47,66,113,King2_T,"-37.82009057, 144.95758725"
134920240614,134,2024-06-14,9,222,243,465,Spen201_T,"-37.81694221, 144.95303935"
851020240701,85,2024-07-01,10,69,51,120,488Mac_T,"-37.79432415, 144.92973378"
851620241022,85,2024-10-22,16,55,71,126,488Mac_T,"-37.79432415, 144.92973378"
85220241117,85,2024-11-17,2,0,2,2,488Mac_T,"-37.79432415, 144.92973378"
11420240522,1,2024-05-22,14,1069,971,2040,Bou292_T,"-37.81349441, 144.96515323"
18920231023,18,2023-10-23,9,109,457,566,Col12_T,"-37.81344862, 144.97305353"
63920241125,63,2024-11-25,9,111,137,248,Bou231_T,"-37.81333081, 144.96675571"
622220240121,62,2024-01-21,22,180,110,290,Lat224_T,"-37.80996494, 144.96216521"
86620250317,86,2025-03-17,6,1,3,4,574Qub_T,"-37.80309992, 144.94908064"
111120251011,11,2025-10-11,11,104,92,196,WatCit_T,"-37.81564989, 144.93970694"
72520240318,72,2024-03-18,5,10,14,24,ACMI_T,"-37.81726338, 144.96872809"
76920250512,76,2025-05-12,9,64,57,121,KenMac_T,"-37.79453803, 144.93036194"
271920250819,27,2025-08-19,19,109,82,191,Vic_T,"-37.80606888, 144.95644692"
53120241201,53,2024-12-01,1,43,70,113,Col254_T,"-37.81564191, 144.965499"
23820250310,23,2025-03-10,8,66,67,133,Col623_T,"-37.81909256, 144.95452748"
4520240325,4,2024-03-25,5,38,17,55,Swa123_T,"-37.81487988, 144.9660878"
701320241006,70,2024-10-06,13,139,125,264,Errol20_T,"-37.80456984, 144.94946228"
31820231128,3,2023-11-28,18,1166,1184,2350,Swa295_T,"-37.81101524, 144.96429485"
82020231227,8,2023-12-27,20,96,140,236,WebBN_T,"-37.82293543, 144.9471751"
421620240625,42,2024-06-25,16,138,217,355,UM1_T,"-37.80008566, 144.96386412"
78520250104,78,2025-01-04,5,2,1,3,HarEsB_T,"-37.81471642, 144.9446508"
141420240229,14,2024-02-29,14,339,121,460,SanBri_T,"-37.82011242, 144.96291897"
711620250310,71,2025-03-10,16,3,5,8,WestWP_T,"-37.81235775, 144.97136962"
711320240615,71,2024-06-15,13,17,23,40,WestWP_T,"-37.81235775, 144.97136962"
28820231205,28,2023-12-05,8,573,385,958,VAC_T,"-37.82129925, 144.96879309"
31620250329,31,2025-03-29,6,5,2,7,Lyg161_T,"-37.80169681, 144.96658911"
361520231123,36,2023-11-23,15,161,206,367,Que85_T,"-37.81652527, 144.96121062"
36420250304,36,2025-03-04,4,3,4,7,Que85_T,"-37.81652527, 144.96121062"
372120240119,37,2024-01-19,21,69,60,129,Lyg260_T,"-37.80107122, 144.96704554"
1081320240528,108,2024-05-28,13,210,508,718,261Will_T,"-37.81295822, 144.95678789"
61720250318,61,2025-03-18,7,251,173,424,RMIT14_T,"-37.80767455, 144.96309114"
61720250831,61,2025-08-31,7,22,45,67,RMIT14_T,"-37.80767455, 144.96309114"
44920251015,44,2025-10-15,9,100,112,212,UM3_T,"-37.79698741, 144.96441306"
441720240419,44,2024-04-19,17,114,89,203,UM3_T,"-37.79698741, 144.96441306"
182720250610,182,2025-06-10,7,49,71,120,King163_T,"-37.81627451, 144.95550503"
1651020250106,165,2025-01-06,10,7,16,23,Spen475_T,"-37.80953359, 144.94939004"
181720250503,181,2025-05-03,7,85,128,213,Eli368_T,"-37.81009465, 144.96143149"
1072120231020,107,2023-10-20,21,113,91,204,280Will_T,"-37.81246271, 144.95690188"
1312320240405,131,2024-04-05,23,129,72,201,King2_T,"-37.82009057, 144.95758725"
1431120241115,143,2024-11-15,11,130,184,314,Spencer_T,"-37.821728, 144.95557015"
132720240727,132,2024-07-27,7,27,21,48,King335_T,"-37.81267639, 144.95386444"
134520250208,134,2025-02-08,5,50,28,78,Spen201_T,"-37.81694221, 144.95303935"
135220250315,135,2025-03-15,2,3,11,14,Spen161_T,"-37.8172861, 144.95319102"
1332320240106,133,2024-01-06,23,225,109,334,Spen229_T,"-37.81531435, 144.95227769"
252320250617,25,2025-06-17,23,28,15,43,MCEC_T,"-37.82401776, 144.95604426"
1371820240306,137,2024-03-06,18,15,47,62,BouHbr2353_T,"-37.81894815, 144.94612292"
1411220240411,141,2024-04-11,12,182,239,421,474Fl_T,"-37.81997273, 144.95834911"
1361520240420,136,2024-04-20,15,76,182,258,BirFed1120_T,"-37.8184141, 144.97357915"
136620240425,136,2024-04-25,6,16,7,23,BirFed1120_T,"-37.8184141, 144.97357915"
1421820251009,142,2025-10-09,18,733,521,1254,Hammer1584_T,"-37.81970749, 144.96795734"
142620240920,142,2024-09-20,6,81,28,109,Hammer1584_T,"-37.81970749, 144.96795734"
130720250827,130,2025-08-27,7,15,12,27,Bou892T,"-37.8204637, 144.94126826"
123720240602,123,2024-06-02,7,2,1,3,BirBridge_T,"-37.81753741, 144.97329734"
123920241025,123,2024-10-25,9,1,1,2,BirBridge_T,"-37.81753741, 144.97329734"
682220250930,68,2025-09-30,22,26,16,42,FLDegN_T,"-37.8168479, 144.96559789"
851620250322,85,2025-03-22,16,89,60,149,488Mac_T,"-37.79432415, 144.92973378"
682220241115,68,2024-11-15,22,94,54,148,FLDegN_T,"-37.8168479, 144.96559789"
861820241117,86,2024-11-17,18,51,40,91,574Qub_T,"-37.80309992, 144.94908064"
561920240130,56,2024-01-30,19,247,307,554,Lon364_T,"-37.81234775, 144.96153311"
102020240702,10,2024-07-02,20,29,13,42,BouHbr_T,"-37.81876474, 144.94710545"
721020240802,72,2024-08-02,10,159,151,310,ACMI_T,"-37.81726338, 144.96872809"
721920250814,72,2025-08-14,19,97,246,343,ACMI_T,"-37.81726338, 144.96872809"
752020250110,75,2025-01-10,20,31,52,83,SprFli_T,"-37.81515276, 144.97467661"
82120240213,8,2024-02-13,21,26,33,59,WebBN_T,"-37.82293543, 144.9471751"
81320240321,8,2024-03-21,13,273,257,530,WebBN_T,"-37.82293543, 144.9471751"
14020231231,14,2023-12-31,0,189,48,237,SanBri_T,"-37.82011242, 144.96291897"
71020250729,71,2025-07-29,0,8,6,14,WestWP_T,"-37.81235775, 144.97136962"
711720250525,71,2025-05-25,17,11,6,17,WestWP_T,"-37.81235775, 144.97136962"
65620240220,65,2024-02-20,6,65,41,106,SwaCs_T,"-37.81569416, 144.9668064"
401320240805,40,2024-08-05,13,366,240,606,Spr201_T,"-37.80999341, 144.97227587"
311120250418,31,2025-04-18,11,152,115,267,Lyg161_T,"-37.80169681, 144.96658911"
542020241206,54,2024-12-06,20,76,72,148,Swa607_T,"-37.804024, 144.96308399"
472020240703,47,2024-07-03,20,427,569,996,Eli250_T,"-37.81258467, 144.9625775"
871820250807,87,2025-08-07,18,108,102,210,Errol23_T,"-37.80454949, 144.94921863"
872220250904,87,2025-09-04,22,17,15,32,Errol23_T,"-37.80454949, 144.94921863"
611620240816,61,2024-08-16,16,560,553,1113,RMIT14_T,"-37.80767455, 144.96309114"
61620250629,61,2025-06-29,6,2,16,18,RMIT14_T,"-37.80767455, 144.96309114"
501520240222,50,2024-02-22,15,152,136,288,Lyg309_T,"-37.79808192, 144.96721013"
501820241128,50,2024-11-28,18,185,223,408,Lyg309_T,"-37.79808192, 144.96721013"
1812320250610,181,2025-06-10,23,183,181,364,Eli368_T,"-37.81009465, 144.96143149"
1621320240926,162,2024-09-26,13,661,926,1587,Eli489_T,"-37.80740397, 144.95987909"
1321220250924,132,2025-09-24,12,205,188,393,King335_T,"-37.81267639, 144.95386444"
134320250424,134,2025-04-24,3,8,12,20,Spen201_T,"-37.81694221, 144.95303935"
1341220240423,134,2024-04-23,12,427,396,823,Spen201_T,"-37.81694221, 144.95303935"
1071820240508,107,2024-05-08,18,135,128,263,280Will_T,"-37.81246271, 144.95690188"
1072220240605,107,2024-06-05,22,60,69,129,280Will_T,"-37.81246271, 144.95690188"
1181620250712,118,2025-07-12,16,32,31,63,Fli114C_T,"-37.81632783, 144.97090512"
1661420250928,166,2025-09-28,14,54,63,117,Spen484_T,"-37.80896733, 144.94931703"
851120240825,85,2024-08-25,11,100,86,186,488Mac_T,"-37.79432415, 144.92973378"
121820240305,12,2024-03-05,18,202,263,465,NewQ_T,"-37.81457988, 144.94292398"
111220231209,11,2023-12-09,12,22,14,36,WatCit_T,"-37.81564989, 144.93970694"
561020250228,56,2025-02-28,10,285,184,469,Lon364_T,"-37.81234775, 144.96153311"
10620240704,10,2024-07-04,6,8,18,26,BouHbr_T,"-37.81876474, 144.94710545"
10520241021,10,2024-10-21,5,2,3,5,BouHbr_T,"-37.81876474, 144.94710545"
242020231126,24,2023-11-26,20,245,342,587,Col620_T,"-37.81887963, 144.95449198"
721320240522,72,2024-05-22,13,259,408,667,ACMI_T,"-37.81726338, 144.96872809"
10120241027,10,2024-10-27,1,6,0,6,BouHbr_T,"-37.81876474, 144.94710545"
352020250209,35,2025-02-09,20,621,1070,1691,SouthB_T,"-37.82018685, 144.96508508"
35120231216,35,2023-12-16,1,399,442,841,SouthB_T,"-37.82018685, 144.96508508"
351320250903,35,2025-09-03,13,1186,1100,2286,SouthB_T,"-37.82018685, 144.96508508"
9720231018,9,2023-10-18,7,62,1120,1182,Col700_T,"-37.81982992, 144.95102555"
9320250702,9,2025-07-02,3,2,1,3,Col700_T,"-37.81982992, 144.95102555"
79120250319,79,2025-03-19,1,9,20,29,FliSS_T,"-37.81794046, 144.96616678"
201020250612,20,2025-06-12,10,119,97,216,LtB170_T,"-37.81172914, 144.9682466"
201120251013,20,2025-10-13,11,120,144,264,LtB170_T,"-37.81172914, 144.9682466"
25820240903,25,2024-09-03,8,240,609,849,MCEC_T,"-37.82401776, 144.95604426"
52620240318,52,2024-03-18,6,31,15,46,Eli263_T,"-37.81252157, 144.9619401"
522220241001,52,2024-10-01,22,98,80,178,Eli263_T,"-37.81252157, 144.9619401"
1371420250322,137,2025-03-22,14,15,21,36,BouHbr2353_T,"-37.81894815, 144.94612292"
1411820250524,141,2025-05-24,18,200,247,447,474Fl_T,"-37.81997273, 144.95834911"
1391120240611,139,2024-06-11,11,28,58,86,Signal1647_T,"-37.81959923, 144.9632832"
1361720240630,136,2024-06-30,17,33,66,99,BirFed1120_T,"-37.8184141, 144.97357915"
1361120250717,136,2025-07-17,11,61,32,93,BirFed1120_T,"-37.8184141, 144.97357915"
52220250815,52,2025-08-15,2,3,4,7,Eli263_T,"-37.81252157, 144.9619401"
1091520250324,109,2025-03-24,15,243,112,355,LatWill_T,"-37.81193681, 144.95621105"
1091420231207,109,2023-12-07,14,148,136,284,LatWill_T,"-37.81193681, 144.95621105"
191520240411,19,2024-04-11,15,551,473,1024,LtB210_T,"-37.81237202, 144.96550671"
252120240908,25,2024-09-08,21,67,68,135,MCEC_T,"-37.82401776, 144.95604426"
1371520240312,137,2024-03-12,15,9,146,155,BouHbr2353_T,"-37.81894815, 144.94612292"
1361120250510,136,2025-05-10,11,466,81,547,BirFed1120_T,"-37.8184141, 144.97357915"
1301020240812,130,2024-08-12,10,19,18,37,Bou892T,"-37.8204637, 144.94126826"
752120240706,75,2024-07-06,21,22,18,40,SprFli_T,"-37.81515276, 144.97467661"
411920250325,41,2025-03-25,19,820,1379,2199,Swa31,"-37.81668634, 144.96689733"
772120231024,77,2023-10-24,21,90,58,148,HarEsP_T,"-37.81441438, 144.94433026"
65820240701,65,2024-07-01,8,985,192,1177,SwaCs_T,"-37.81569416, 144.9668064"
141520231218,14,2023-12-18,15,443,102,545,SanBri_T,"-37.82011242, 144.96291897"
591020241108,59,2024-11-08,10,233,240,473,RMIT_T,"-37.80825648, 144.96304859"
31920240408,31,2024-04-08,9,77,70,147,Lyg161_T,"-37.80169681, 144.96658911"
54120240726,54,2024-07-26,1,23,15,38,Swa607_T,"-37.804024, 144.96308399"
472320241024,47,2024-10-24,23,176,207,383,Eli250_T,"-37.81258467, 144.9625775"
472020241030,47,2024-10-30,20,492,419,911,Eli250_T,"-37.81258467, 144.9625775"
402220250725,40,2025-07-25,22,101,54,155,Spr201_T,"-37.80999341, 144.97227587"
361920250812,36,2025-08-12,19,90,94,184,Que85_T,"-37.81652527, 144.96121062"
1321420250516,132,2025-05-16,14,180,177,357,King335_T,"-37.81267639, 144.95386444"
1322220250929,132,2025-09-29,22,61,65,126,King335_T,"-37.81267639, 144.95386444"
87520250514,87,2025-05-14,5,1,2,3,Errol23_T,"-37.80454949, 144.94921863"
87320240331,87,2024-03-31,3,2,0,2,Errol23_T,"-37.80454949, 144.94921863"
1671520250925,167,2025-09-25,15,68,64,132,Lat526_T,"-37.81304149, 144.95155955"
1811020250626,181,2025-06-26,10,278,481,759,Eli368_T,"-37.81009465, 144.96143149"
1432320250120,143,2025-01-20,23,82,113,195,Spencer_T,"-37.821728, 144.95557015"
132820240924,132,2024-09-24,8,106,118,224,King335_T,"-37.81267639, 144.95386444"
4020231023,4,2023-10-23,0,72,34,106,Swa123_T,"-37.81487988, 144.9660878"
682120241203,68,2024-12-03,21,72,63,135,FLDegN_T,"-37.8168479, 144.96559789"
671220231122,67,2023-11-22,12,559,678,1237,FLDegS_T,"-37.81688755, 144.96562569"
671420250324,67,2025-03-24,14,305,530,835,FLDegS_T,"-37.81688755, 144.96562569"
18620240809,18,2024-08-09,6,1,13,14,Col12_T,"-37.81344862, 144.97305353"
18620240826,18,2024-08-26,6,1,67,68,Col12_T,"-37.81344862, 144.97305353"
621120250714,62,2025-07-14,11,234,172,406,Lat224_T,"-37.80996494, 144.96216521"
561620240207,56,2024-02-07,16,291,274,565,Lon364_T,"-37.81234775, 144.96153311"
56520250606,56,2025-06-06,5,9,5,14,Lon364_T,"-37.81234775, 144.96153311"
242120240314,24,2024-03-14,21,281,412,693,Col620_T,"-37.81887963, 144.95449198"
581320250415,58,2025-04-15,13,859,540,1399,Bou688_T,"-37.81686075, 144.95358075"
582320240506,58,2024-05-06,23,76,79,155,Bou688_T,"-37.81686075, 144.95358075"
35920240506,35,2024-05-06,9,470,758,1228,SouthB_T,"-37.82018685, 144.96508508"
92020241107,9,2024-11-07,20,133,50,183,Col700_T,"-37.81982992, 144.95102555"
301320250710,30,2025-07-10,13,359,500,859,Lon189_T,"-37.8112185, 144.96656806"
30920231220,30,2023-12-20,9,77,122,199,Lon189_T,"-37.8112185, 144.96656806"
51720240213,51,2024-02-13,7,35,30,65,Fra118_T,"-37.80841815, 144.95906316"
231420250309,23,2025-03-09,14,118,175,293,Col623_T,"-37.81909256, 144.95452748"
1092220231104,109,2023-11-04,22,772,120,892,LatWill_T,"-37.81193681, 144.95621105"
1091220240815,109,2024-08-15,12,242,229,471,LatWill_T,"-37.81193681, 144.95621105"
109420250201,109,2025-02-01,4,8,6,14,LatWill_T,"-37.81193681, 144.95621105"
42620250712,42,2025-07-12,6,1,4,5,UM1_T,"-37.80008566, 144.96386412"
42620250209,42,2025-02-09,6,0,6,6,UM1_T,"-37.80008566, 144.96386412"
282220250707,28,2025-07-07,22,63,33,96,VAC_T,"-37.82129925, 144.96879309"
28120240904,28,2024-09-04,1,11,7,18,VAC_T,"-37.82129925, 144.96879309"
401620231122,40,2023-11-22,16,159,219,378,Spr201_T,"-37.80999341, 144.97227587"
40920250722,40,2025-07-22,9,224,257,481,Spr201_T,"-37.80999341, 144.97227587"
36420231216,36,2023-12-16,4,18,11,29,Que85_T,"-37.81652527, 144.96121062"
36120240519,36,2024-05-19,1,125,79,204,Que85_T,"-37.81652527, 144.96121062"
472020240629,47,2024-06-29,20,497,450,947,Eli250_T,"-37.81258467, 144.9625775"
108720240329,108,2024-03-29,7,13,36,49,261Will_T,"-37.81295822, 144.95678789"
50720240620,50,2024-06-20,7,22,40,62,Lyg309_T,"-37.79808192, 144.96721013"
501020231223,50,2023-12-23,10,288,349,637,Lyg309_T,"-37.79808192, 144.96721013"
431220241020,43,2024-10-20,12,64,53,117,UM2_T,"-37.79844526, 144.96411782"
1651720250929,165,2025-09-29,17,68,39,107,Spen475_T,"-37.80953359, 144.94939004"
1671320240915,167,2024-09-15,13,8,17,25,Lat526_T,"-37.81304149, 144.95155955"
134420231107,134,2023-11-07,4,35,28,63,Spen201_T,"-37.81694221, 144.95303935"
133220240311,133,2024-03-11,2,18,11,29,Spen229_T,"-37.81531435, 144.95227769"
133420250127,133,2025-01-27,4,9,29,38,Spen229_T,"-37.81531435, 144.95227769"
701120240313,70,2024-03-13,11,131,94,225,Errol20_T,"-37.80456984, 144.94946228"
81420250103,8,2025-01-03,14,171,232,403,WebBN_T,"-37.82293543, 144.9471751"
82320250725,8,2025-07-25,23,3,0,3,WebBN_T,"-37.82293543, 144.9471751"
752320250224,75,2025-02-24,23,4,2,6,SprFli_T,"-37.81515276, 144.97467661"
772020250421,77,2025-04-21,20,23,19,42,HarEsP_T,"-37.81441438, 144.94433026"
781920240522,78,2024-05-22,19,9,17,26,HarEsB_T,"-37.81471642, 144.9446508"
771920231113,77,2023-11-13,19,191,147,338,HarEsP_T,"-37.81441438, 144.94433026"
65720240309,65,2024-03-09,7,65,72,137,SwaCs_T,"-37.81569416, 144.9668064"
681420240104,68,2024-01-04,14,300,216,516,FLDegN_T,"-37.8168479, 144.96559789"
851920250329,85,2025-03-29,19,53,58,111,488Mac_T,"-37.79432415, 144.92973378"
17320240410,17,2024-04-10,3,4,3,7,Col15_T,"-37.81362543, 144.97323591"
17720250814,17,2025-08-14,7,442,90,532,Col15_T,"-37.81362543, 144.97323591"
671920241124,67,2024-11-24,19,212,321,533,FLDegS_T,"-37.81688755, 144.96562569"
63220250925,63,2025-09-25,2,1,5,6,Bou231_T,"-37.81333081, 144.96675571"
671420240511,67,2024-05-11,14,437,565,1002,FLDegS_T,"-37.81688755, 144.96562569"
63920240223,63,2024-02-23,9,143,243,386,Bou231_T,"-37.81333081, 144.96675571"
621320250722,62,2025-07-22,13,186,168,354,Lat224_T,"-37.80996494, 144.96216521"
561820240710,56,2024-07-10,18,391,481,872,Lon364_T,"-37.81234775, 144.96153311"
241620240111,24,2024-01-11,16,516,1494,2010,Col620_T,"-37.81887963, 144.95449198"
1381120241103,138,2024-11-03,11,7,13,20,EntPark1671_T,"-37.81996544, 144.95981454"
117020250711,117,2025-07-11,0,18,13,31,Fli114F_T,"-37.81629332, 144.97090877"
692020240210,69,2024-02-10,20,44,63,107,FLDegC_T,"-37.81687226, 144.96559144"
691320250627,69,2025-06-27,13,306,239,545,FLDegC_T,"-37.81687226, 144.96559144"
62320240728,6,2024-07-28,23,110,70,180,FliS_T,"-37.81911705, 144.96558255"
841420250111,84,2025-01-11,14,956,1198,2154,ElFi_T,"-37.81798049, 144.96503383"
42320250410,4,2025-04-10,23,305,316,621,Swa123_T,"-37.81487988, 144.9660878"
3320240921,3,2024-09-21,3,74,77,151,Swa295_T,"-37.81101524, 144.96429485"
391520250929,39,2025-09-29,15,69,53,122,AlfPl_T,"-37.81379749, 144.96995745"
41520250816,41,2025-08-16,5,67,53,120,Swa31,"-37.81668634, 144.96689733"
771520250530,77,2025-05-30,15,176,126,302,HarEsP_T,"-37.81441438, 144.94433026"
711320240927,71,2024-09-27,13,5,8,13,WestWP_T,"-37.81235775, 144.97136962"
65020240303,65,2024-03-03,0,74,212,286,SwaCs_T,"-37.81569416, 144.9668064"
77320251003,77,2025-10-03,3,3,1,4,HarEsP_T,"-37.81441438, 144.94433026"
282220250605,28,2025-06-05,22,777,210,987,VAC_T,"-37.82129925, 144.96879309"
29120250814,29,2025-08-14,1,1,7,8,AG_T,"-37.8199817, 144.96872865"
14920250508,14,2025-05-08,9,228,349,577,SanBri_T,"-37.82011242, 144.96291897"
54820250519,54,2025-05-19,8,206,48,254,Swa607_T,"-37.804024, 144.96308399"
45520240322,45,2024-03-22,5,10,23,33,Swa148_T,"-37.81414075, 144.96609379"
361320250428,36,2025-04-28,13,269,303,572,Que85_T,"-37.81652527, 144.96121062"
1672020250507,167,2025-05-07,20,8,21,29,Lat526_T,"-37.81304149, 144.95155955"
132220240624,132,2024-06-24,2,5,4,9,King335_T,"-37.81267639, 144.95386444"
135520250224,135,2025-02-24,5,33,21,54,Spen161_T,"-37.8172861, 144.95319102"
1072320240607,107,2024-06-07,23,34,42,76,280Will_T,"-37.81246271, 144.95690188"
1331920231126,133,2023-11-26,19,448,404,852,Spen229_T,"-37.81531435, 144.95227769"
1181820240826,118,2024-08-26,18,5,12,17,Fli114C_T,"-37.81632783, 144.97090512"
1662320250613,166,2025-06-13,23,4,1,5,Spen484_T,"-37.80896733, 144.94931703"
851820250731,85,2025-07-31,18,56,97,153,488Mac_T,"-37.79432415, 144.92973378"
12520240330,12,2024-03-30,5,7,1,8,NewQ_T,"-37.81457988, 144.94292398"
12520240503,12,2024-05-03,5,8,4,12,NewQ_T,"-37.81457988, 144.94292398"
121220240716,12,2024-07-16,12,127,179,306,NewQ_T,"-37.81457988, 144.94292398"
111520240226,11,2024-02-26,15,78,59,137,WatCit_T,"-37.81564989, 144.93970694"
11020240310,11,2024-03-10,0,54,37,91,WatCit_T,"-37.81564989, 144.93970694"
56620240616,56,2024-06-16,6,15,17,32,Lon364_T,"-37.81234775, 144.96153311"
561120240813,56,2024-08-13,11,275,164,439,Lon364_T,"-37.81234775, 144.96153311"
111620250613,11,2025-06-13,16,74,94,168,WatCit_T,"-37.81564989, 144.93970694"
101220240605,10,2024-06-05,12,193,139,332,BouHbr_T,"-37.81876474, 144.94710545"
121520240813,12,2024-08-13,15,136,147,283,NewQ_T,"-37.81457988, 144.94292398"
101520250426,10,2025-04-26,15,55,63,118,BouHbr_T,"-37.81876474, 144.94710545"
241120241113,24,2024-11-13,11,763,488,1251,Col620_T,"-37.81887963, 144.95449198"
241120241130,24,2024-11-30,11,761,490,1251,Col620_T,"-37.81887963, 144.95449198"
35520241209,35,2024-12-09,5,85,62,147,SouthB_T,"-37.82018685, 144.96508508"
721520250413,72,2025-04-13,15,514,689,1203,ACMI_T,"-37.81726338, 144.96872809"
352320250429,35,2025-04-29,23,86,296,382,SouthB_T,"-37.82018685, 144.96508508"
581220240525,58,2024-05-25,12,1009,749,1758,Bou688_T,"-37.81686075, 144.95358075"
531120250729,53,2025-07-29,11,554,385,939,Col254_T,"-37.81564191, 144.965499"
531120250901,53,2025-09-01,11,516,433,949,Col254_T,"-37.81564191, 144.965499"
91520250901,9,2025-09-01,15,785,162,947,Col700_T,"-37.81982992, 144.95102555"
92320240312,9,2024-03-12,23,735,67,802,Col700_T,"-37.81982992, 144.95102555"
301120241204,30,2024-12-04,11,224,297,521,Lon189_T,"-37.8112185, 144.96656806"
462320241102,46,2024-11-02,23,1,0,1,Pel147_T,"-37.80240719, 144.9615673"
23020250929,23,2025-09-29,0,6,27,33,Col623_T,"-37.81909256, 144.95452748"
19920250624,19,2025-06-24,9,79,51,130,LtB210_T,"-37.81237202, 144.96550671"
19420250722,19,2025-07-22,4,6,5,11,LtB210_T,"-37.81237202, 144.96550671"
137820250228,137,2025-02-28,8,49,27,76,BouHbr2353_T,"-37.81894815, 144.94612292"
142820240425,142,2024-04-25,8,574,128,702,Hammer1584_T,"-37.81970749, 144.96795734"
1232020241126,123,2024-11-26,20,4,1,5,BirBridge_T,"-37.81753741, 144.97329734"
117920231119,117,2023-11-19,9,52,94,146,Fli114F_T,"-37.81629332, 144.97090877"
1171120240508,117,2024-05-08,11,128,86,214,Fli114F_T,"-37.81629332, 144.97090877"
109920231212,109,2023-12-12,9,85,380,465,LatWill_T,"-37.81193681, 144.95621105"
491720250212,49,2025-02-12,17,349,258,607,Eli501_T,"-37.80730068, 144.95956055"
62320250331,6,2025-03-31,23,247,116,363,FliS_T,"-37.81911705, 144.96558255"
841620240807,84,2024-08-07,16,936,1534,2470,ElFi_T,"-37.81798049, 144.96503383"
701620240611,70,2024-06-11,16,181,182,363,Errol20_T,"-37.80456984, 144.94946228"
391420241018,39,2024-10-18,14,49,87,136,AlfPl_T,"-37.81379749, 144.96995745"
751820231206,75,2023-12-06,18,91,177,268,SprFli_T,"-37.81515276, 144.97467661"
751320250804,75,2025-08-04,13,62,61,123,SprFli_T,"-37.81515276, 144.97467661"
8520250927,8,2025-09-27,5,4,5,9,WebBN_T,"-37.82293543, 144.9471751"
14520240129,14,2024-01-29,5,33,29,62,SanBri_T,"-37.82011242, 144.96291897"
712320240125,71,2024-01-25,23,3,3,6,WestWP_T,"-37.81235775, 144.97136962"
65120240614,65,2024-06-14,1,15,32,47,SwaCs_T,"-37.81569416, 144.9668064"
401620240202,40,2024-02-02,16,126,201,327,Spr201_T,"-37.80999341, 144.97227587"
311720250720,31,2025-07-20,17,219,156,375,Lyg161_T,"-37.80169681, 144.96658911"
472320240204,47,2024-02-04,23,154,136,290,Eli250_T,"-37.81258467, 144.9625775"
361720231019,36,2023-10-19,17,307,261,568,Que85_T,"-37.81652527, 144.96121062"
36320240302,36,2024-03-02,3,185,78,263,Que85_T,"-37.81652527, 144.96121062"
362020241211,36,2024-12-11,20,114,134,248,Que85_T,"-37.81652527, 144.96121062"
612120250214,61,2025-02-14,21,180,101,281,RMIT14_T,"-37.80767455, 144.96309114"
451320250310,45,2025-03-10,13,403,751,1154,Swa148_T,"-37.81414075, 144.96609379"
1671320250922,167,2025-09-22,13,6,14,20,Lat526_T,"-37.81304149, 144.95155955"
133520250323,133,2025-03-23,5,26,38,64,Spen229_T,"-37.81531435, 144.95227769"
133520250409,133,2025-04-09,5,86,105,191,Spen229_T,"-37.81531435, 144.95227769"
1181820241119,118,2024-11-19,18,35,57,92,Fli114C_T,"-37.81632783, 144.97090512"
1182120231113,118,2023-11-13,21,3,6,9,Fli114C_T,"-37.81632783, 144.97090512"
118820240909,118,2024-09-09,8,29,16,45,Fli114C_T,"-37.81632783, 144.97090512"
108320251013,108,2025-10-13,3,7,4,11,261Will_T,"-37.81295822, 144.95678789"
1791820250225,179,2025-02-25,18,80,111,191,Pow61_T,"-37.82392385, 144.96299677"
1651820241109,165,2024-11-09,18,55,31,86,Spen475_T,"-37.80953359, 144.94939004"
1651920250919,165,2025-09-19,19,47,39,86,Spen475_T,"-37.80953359, 144.94939004"
72920250721,72,2025-07-21,9,191,94,285,ACMI_T,"-37.81726338, 144.96872809"
122020240324,12,2024-03-24,20,286,288,574,NewQ_T,"-37.81457988, 144.94292398"
10620240220,10,2024-02-20,6,16,48,64,BouHbr_T,"-37.81876474, 144.94710545"
101020240413,10,2024-04-13,10,62,40,102,BouHbr_T,"-37.81876474, 144.94710545"
12620250925,12,2025-09-25,6,44,27,71,NewQ_T,"-37.81457988, 144.94292398"
10220251003,10,2025-10-03,2,0,1,1,BouHbr_T,"-37.81876474, 144.94710545"
352220231213,35,2023-12-13,22,1621,2178,3799,SouthB_T,"-37.82018685, 144.96508508"
76920250105,76,2025-01-05,9,45,34,79,KenMac_T,"-37.79453803, 144.93036194"
351620240810,35,2024-08-10,16,1631,2060,3691,SouthB_T,"-37.82018685, 144.96508508"
2920240715,2,2024-07-15,9,143,207,350,Bou283_T,"-37.81380668, 144.96516718"
91120240728,9,2024-07-28,11,38,65,103,Col700_T,"-37.81982992, 144.95102555"
9820231218,9,2023-12-18,8,97,1923,2020,Col700_T,"-37.81982992, 144.95102555"
511720240928,51,2024-09-28,17,78,76,154,Fra118_T,"-37.80841815, 144.95906316"
791420240831,79,2024-08-31,14,626,448,1074,FliSS_T,"-37.81794046, 144.96616678"
30320240721,30,2024-07-21,3,127,234,361,Lon189_T,"-37.8112185, 144.96656806"
481220241230,48,2024-12-30,12,268,201,469,QVMQ_T,"-37.80631581, 144.95866697"
482120250502,48,2025-05-02,21,72,113,185,QVMQ_T,"-37.80631581, 144.95866697"
201420240826,20,2024-08-26,14,146,253,399,LtB170_T,"-37.81172914, 144.9682466"
141520250609,141,2025-06-09,5,22,9,31,474Fl_T,"-37.81997273, 144.95834911"
136520250206,136,2025-02-06,5,1,2,3,BirFed1120_T,"-37.8184141, 144.97357915"
1391720250326,139,2025-03-26,17,344,77,421,Signal1647_T,"-37.81959923, 144.9632832"
1421420250220,142,2025-02-20,14,420,363,783,Hammer1584_T,"-37.81970749, 144.96795734"
1301020250907,130,2025-09-07,10,21,26,47,Bou892T,"-37.8204637, 144.94126826"
1301020251011,130,2025-10-11,10,90,86,176,Bou892T,"-37.8204637, 144.94126826"
1421920240403,142,2024-04-03,19,187,184,371,Hammer1584_T,"-37.81970749, 144.96795734"
1642020250302,164,2025-03-02,20,90,69,159,Lat526_T,"-37.813005, 144.95160411"
1381420250304,138,2025-03-04,14,11,11,22,EntPark1671_T,"-37.81996544, 144.95981454"
1171720240127,117,2024-01-27,17,281,191,472,Fli114F_T,"-37.81629332, 144.97090877"
191420250101,19,2025-01-01,14,557,638,1195,LtB210_T,"-37.81237202, 144.96550671"
66920231210,66,2023-12-10,9,165,198,363,QVN_T,"-37.81057846, 144.96444294"
851620240711,85,2024-07-11,16,60,70,130,488Mac_T,"-37.79432415, 144.92973378"
85220250114,85,2025-01-14,2,0,1,1,488Mac_T,"-37.79432415, 144.92973378"
171320231126,17,2023-11-26,13,222,135,357,Col15_T,"-37.81362543, 144.97323591"
1620240208,1,2024-02-08,6,38,39,77,Bou292_T,"-37.81349441, 144.96515323"
1520240521,1,2024-05-21,5,5,11,16,Bou292_T,"-37.81349441, 144.96515323"
67820250803,67,2025-08-03,8,96,122,218,FLDegS_T,"-37.81688755, 144.96562569"
111220240113,11,2024-01-13,12,150,98,248,WatCit_T,"-37.81564989, 144.93970694"
24220231020,24,2023-10-20,2,26,42,68,Col620_T,"-37.81887963, 144.95449198"
86220240908,86,2024-09-08,2,0,1,1,574Qub_T,"-37.80309992, 144.94908064"
56320250710,56,2025-07-10,3,4,1,5,Lon364_T,"-37.81234775, 144.96153311"
102120250610,10,2025-06-10,21,15,11,26,BouHbr_T,"-37.81876474, 144.94710545"
76920231115,76,2023-11-15,9,72,62,134,KenMac_T,"-37.79453803, 144.93036194"
582020250721,58,2025-07-21,20,203,189,392,Bou688_T,"-37.81686075, 144.95358075"
27620240113,27,2024-01-13,6,18,18,36,Vic_T,"-37.80606888, 144.95644692"
92320250922,9,2025-09-22,23,16,5,21,Col700_T,"-37.81982992, 144.95102555"
53620250421,53,2025-04-21,6,10,7,17,Col254_T,"-37.81564191, 144.965499"
30320240504,30,2024-05-04,3,85,163,248,Lon189_T,"-37.8112185, 144.96656806"
201320240708,20,2024-07-08,13,261,404,665,LtB170_T,"-37.81172914, 144.9682466"
461920240115,46,2024-01-15,19,49,44,93,Pel147_T,"-37.80240719, 144.9615673"
521220240307,52,2024-03-07,12,510,344,854,Eli263_T,"-37.81252157, 144.9619401"
19720250818,19,2025-08-18,7,32,12,44,LtB210_T,"-37.81237202, 144.96550671"
109220241212,109,2024-12-12,2,0,7,7,LatWill_T,"-37.81193681, 144.95621105"
49820250926,49,2025-09-26,8,106,94,200,Eli501_T,"-37.80730068, 144.95956055"
49120250315,49,2025-03-15,1,54,53,107,Eli501_T,"-37.80730068, 144.95956055"
1412120250914,141,2025-09-14,21,48,72,120,474Fl_T,"-37.81997273, 144.95834911"
6920240229,6,2024-02-29,9,591,1201,1792,FliS_T,"-37.81911705, 144.96558255"
84120240728,84,2024-07-28,1,130,163,293,ElFi_T,"-37.81798049, 144.96503383"
32120231123,3,2023-11-23,21,1068,982,2050,Swa295_T,"-37.81101524, 144.96429485"
70020231109,70,2023-11-09,0,1,1,2,Errol20_T,"-37.80456984, 144.94946228"
32120250223,3,2025-02-23,21,639,504,1143,Swa295_T,"-37.81101524, 144.96429485"
41020250510,41,2025-05-10,0,303,468,771,Swa31,"-37.81668634, 144.96689733"
771920240713,77,2024-07-13,19,6,4,10,HarEsP_T,"-37.81441438, 144.94433026"
781920250606,78,2025-06-06,19,1,9,10,HarEsB_T,"-37.81471642, 144.9446508"
59320240204,59,2024-02-04,3,96,12,108,RMIT_T,"-37.80825648, 144.96304859"
59920250808,59,2025-08-08,9,994,413,1407,RMIT_T,"-37.80825648, 144.96304859"
14420250130,14,2025-01-30,4,17,1,18,SanBri_T,"-37.82011242, 144.96291897"
281020250803,28,2025-08-03,10,589,221,810,VAC_T,"-37.82129925, 144.96879309"
31220250313,31,2025-03-13,2,6,3,9,Lyg161_T,"-37.80169681, 144.96658911"
36920240621,36,2024-06-21,9,188,132,320,Que85_T,"-37.81652527, 144.96121062"
37920241103,37,2024-11-03,9,25,32,57,Lyg260_T,"-37.80107122, 144.96704554"
1071020250305,107,2025-03-05,10,96,120,216,280Will_T,"-37.81246271, 144.95690188"
1071120250619,107,2025-06-19,11,107,117,224,280Will_T,"-37.81246271, 144.95690188"
107020241228,107,2024-12-28,0,26,21,47,280Will_T,"-37.81246271, 144.95690188"
108120250315,108,2025-03-15,1,33,27,60,261Will_T,"-37.81295822, 144.95678789"
872020240120,87,2024-01-20,20,78,67,145,Errol23_T,"-37.80454949, 144.94921863"
1671420241108,167,2024-11-08,14,27,59,86,Lat526_T,"-37.81304149, 144.95155955"
1811520250518,181,2025-05-18,15,743,1221,1964,Eli368_T,"-37.81009465, 144.96143149"
1311420241112,131,2024-11-12,14,165,151,316,King2_T,"-37.82009057, 144.95758725"
1311220241114,131,2024-11-14,12,156,197,353,King2_T,"-37.82009057, 144.95758725"
1432120250101,143,2025-01-01,21,159,120,279,Spencer_T,"-37.821728, 144.95557015"
631420240819,63,2024-08-19,14,319,356,675,Bou231_T,"-37.81333081, 144.96675571"
11520240916,11,2024-09-16,5,0,1,1,WatCit_T,"-37.81564989, 144.93970694"
621220240108,62,2024-01-08,12,197,196,393,Lat224_T,"-37.80996494, 144.96216521"
562020240910,56,2024-09-10,20,228,295,523,Lon364_T,"-37.81234775, 144.96153311"
862220250517,86,2025-05-17,22,4,27,31,574Qub_T,"-37.80309992, 144.94908064"
121220241112,12,2024-11-12,12,171,195,366,NewQ_T,"-37.81457988, 144.94292398"
10820240829,10,2024-08-29,8,87,173,260,BouHbr_T,"-37.81876474, 144.94710545"
241520250717,24,2025-07-17,15,570,1308,1878,Col620_T,"-37.81887963, 144.95449198"
21720240121,2,2024-01-21,17,615,534,1149,Bou283_T,"-37.81380668, 144.96516718"
9520250530,9,2025-05-30,5,17,27,44,Col700_T,"-37.81982992, 144.95102555"
30820240710,30,2024-07-10,8,75,96,171,Lon189_T,"-37.8112185, 144.96656806"
79120240327,79,2024-03-27,1,35,23,58,FliSS_T,"-37.81794046, 144.96616678"
482220231117,48,2023-11-17,22,64,92,156,QVMQ_T,"-37.80631581, 144.95866697"
251520250311,25,2025-03-11,15,426,357,783,MCEC_T,"-37.82401776, 144.95604426"
62320240315,6,2024-03-15,23,655,408,1063,FliS_T,"-37.81911705, 144.96558255"
6320240317,6,2024-03-17,3,89,69,158,FliS_T,"-37.81911705, 144.96558255"
6820250208,6,2025-02-08,8,270,265,535,FliS_T,"-37.81911705, 144.96558255"
84120231031,84,2023-10-31,1,22,26,48,ElFi_T,"-37.81798049, 144.96503383"
42220250805,4,2025-08-05,22,283,437,720,Swa123_T,"-37.81487988, 144.9660878"
661420240420,66,2024-04-20,14,1562,1538,3100,QVN_T,"-37.81057846, 144.96444294"
42320241126,4,2024-11-26,23,174,116,290,Swa123_T,"-37.81487988, 144.9660878"
81020250716,8,2025-07-16,10,118,218,336,WebBN_T,"-37.82293543, 144.9471751"
781520250711,78,2025-07-11,15,18,88,106,HarEsB_T,"-37.81471642, 144.9446508"
78920250112,78,2025-01-12,9,38,43,81,HarEsB_T,"-37.81471642, 144.9446508"
42720250311,42,2025-03-11,7,75,54,129,UM1_T,"-37.80008566, 144.96386412"
42320250408,42,2025-04-08,3,1,0,1,UM1_T,"-37.80008566, 144.96386412"
77220240106,77,2024-01-06,2,9,4,13,HarEsP_T,"-37.81441438, 144.94433026"
77520240115,77,2024-01-15,5,4,14,18,HarEsP_T,"-37.81441438, 144.94433026"
591720250801,59,2025-08-01,17,835,1383,2218,RMIT_T,"-37.80825648, 144.96304859"
711420240216,71,2024-02-16,14,12,26,38,WestWP_T,"-37.81235775, 144.97136962"
28620240708,28,2024-07-08,6,89,47,136,VAC_T,"-37.82129925, 144.96879309"
401320241227,40,2024-12-27,13,123,109,232,Spr201_T,"-37.80999341, 144.97227587"
50420250118,50,2025-01-18,4,1,0,1,Lyg309_T,"-37.79808192, 144.96721013"
44920231020,44,2023-10-20,9,58,66,124,UM3_T,"-37.79698741, 144.96441306"
1351520241226,135,2024-12-26,15,337,422,759,Spen161_T,"-37.8172861, 144.95319102"
1182120250111,118,2025-01-11,21,16,7,23,Fli114C_T,"-37.81632783, 144.97090512"
1181220250131,118,2025-01-31,12,16,11,27,Fli114C_T,"-37.81632783, 144.97090512"
87020240828,87,2024-08-28,0,3,2,5,Errol23_T,"-37.80454949, 144.94921863"
872020241017,87,2024-10-17,20,69,80,149,Errol23_T,"-37.80454949, 144.94921863"
872220250109,87,2025-01-09,22,36,22,58,Errol23_T,"-37.80454949, 144.94921863"
1821620250413,182,2025-04-13,16,202,128,330,King163_T,"-37.81627451, 144.95550503"
162620240828,162,2024-08-28,6,45,28,73,Eli489_T,"-37.80740397, 144.95987909"
162420250118,162,2025-01-18,4,31,10,41,Eli489_T,"-37.80740397, 144.95987909"
1791120250511,179,2025-05-11,11,70,67,137,Pow61_T,"-37.82392385, 144.96299677"
1652220241008,165,2024-10-08,22,17,7,24,Spen475_T,"-37.80953359, 144.94939004"
1432020240912,143,2024-09-12,20,143,207,350,Spencer_T,"-37.821728, 144.95557015"
1431920250307,143,2025-03-07,19,152,250,402,Spencer_T,"-37.821728, 144.95557015"
851220250401,85,2025-04-01,12,104,100,204,488Mac_T,"-37.79432415, 144.92973378"
181020240423,18,2024-04-23,10,299,327,626,Col12_T,"-37.81344862, 144.97305353"
18620240412,18,2024-04-12,6,0,47,47,Col12_T,"-37.81344862, 144.97305353"
561520231212,56,2023-12-12,15,250,258,508,Lon364_T,"-37.81234775, 144.96153311"
841620240116,84,2024-01-16,16,815,1645,2460,ElFi_T,"-37.81798049, 144.96503383"
701220240731,70,2024-07-31,12,179,180,359,Errol20_T,"-37.80456984, 144.94946228"
391720250912,39,2025-09-12,17,135,52,187,AlfPl_T,"-37.81379749, 144.96995745"
751120251006,75,2025-10-06,11,37,40,77,SprFli_T,"-37.81515276, 144.97467661"
82320250812,8,2025-08-12,23,1,1,2,WebBN_T,"-37.82293543, 144.9471751"
75020250321,75,2025-03-21,0,3,0,3,SprFli_T,"-37.81515276, 144.97467661"
781120240917,78,2024-09-17,11,29,30,59,HarEsB_T,"-37.81471642, 144.9446508"
77220250331,77,2025-03-31,2,3,1,4,HarEsP_T,"-37.81441438, 144.94433026"
771220231124,77,2023-11-24,12,325,115,440,HarEsP_T,"-37.81441438, 144.94433026"
28320240817,28,2024-08-17,3,7,6,13,VAC_T,"-37.82129925, 144.96879309"
291620231118,29,2023-11-18,16,870,600,1470,AG_T,"-37.8199817, 144.96872865"
40020231124,40,2023-11-24,0,25,9,34,Spr201_T,"-37.80999341, 144.97227587"
681820250304,68,2025-03-04,18,234,193,427,FLDegN_T,"-37.8168479, 144.96559789"
171020231210,17,2023-12-10,10,162,106,268,Col15_T,"-37.81362543, 144.97323591"
171320250105,17,2025-01-05,13,55,55,110,Col15_T,"-37.81362543, 144.97323591"
63120250823,63,2025-08-23,1,13,57,70,Bou231_T,"-37.81333081, 144.96675571"
67220250214,67,2025-02-14,2,7,15,22,FLDegS_T,"-37.81688755, 144.96562569"
68220241009,68,2024-10-09,2,2,0,2,FLDegN_T,"-37.8168479, 144.96559789"
62020240217,62,2024-02-17,0,139,67,206,Lat224_T,"-37.80996494, 144.96216521"
86920241004,86,2024-10-04,9,62,43,105,574Qub_T,"-37.80309992, 144.94908064"
86220251004,86,2025-10-04,2,0,1,1,574Qub_T,"-37.80309992, 144.94908064"
12420231203,12,2023-12-03,4,2,15,17,NewQ_T,"-37.81457988, 144.94292398"
72520231129,72,2023-11-29,5,17,20,37,ACMI_T,"-37.81726338, 144.96872809"
35320250819,35,2025-08-19,3,3,3,6,SouthB_T,"-37.82018685, 144.96508508"
58820231018,58,2023-10-18,8,1591,172,1763,Bou688_T,"-37.81686075, 144.95358075"
27720240805,27,2024-08-05,7,31,38,69,Vic_T,"-37.80606888, 144.95644692"
271620240911,27,2024-09-11,16,90,66,156,Vic_T,"-37.80606888, 144.95644692"
53120231107,53,2023-11-07,1,12,36,48,Col254_T,"-37.81564191, 144.965499"
531220231219,53,2023-12-19,12,1125,903,2028,Col254_T,"-37.81564191, 144.965499"
231320240309,23,2024-03-09,13,91,139,230,Col623_T,"-37.81909256, 144.95452748"
792120250926,79,2025-09-26,21,467,332,799,FliSS_T,"-37.81794046, 144.96616678"
251820250528,25,2025-05-28,18,401,219,620,MCEC_T,"-37.82401776, 144.95604426"
202020241007,20,2024-10-07,20,210,318,528,LtB170_T,"-37.81172914, 144.9682466"
251320250326,25,2025-03-26,13,493,513,1006,MCEC_T,"-37.82401776, 144.95604426"
521120250625,52,2025-06-25,11,211,142,353,Eli263_T,"-37.81252157, 144.9619401"
46620250104,46,2025-01-04,6,2,3,5,Pel147_T,"-37.80240719, 144.9615673"
461320250413,46,2025-04-13,13,45,49,94,Pel147_T,"-37.80240719, 144.9615673"
142920241108,142,2024-11-08,9,148,199,347,Hammer1584_T,"-37.81970749, 144.96795734"
1381220231206,138,2023-12-06,12,18,24,42,EntPark1671_T,"-37.81996544, 144.95981454"
1381620241214,138,2024-12-14,16,7,11,18,EntPark1671_T,"-37.81996544, 144.95981454"
1231420240625,123,2024-06-25,14,9,2,11,BirBridge_T,"-37.81753741, 144.97329734"
1301320240804,130,2024-08-04,13,26,23,49,Bou892T,"-37.8204637, 144.94126826"
117720240305,117,2024-03-05,7,101,78,179,Fli114F_T,"-37.81629332, 144.97090877"
481220250919,48,2025-09-19,12,392,204,596,QVMQ_T,"-37.80631581, 144.95866697"
49620231217,49,2023-12-17,6,27,22,49,Eli501_T,"-37.80730068, 144.95956055"
371820240820,37,2024-08-20,18,128,108,236,Lyg260_T,"-37.80107122, 144.96704554"
471520250501,47,2025-05-01,15,982,910,1892,Eli250_T,"-37.81258467, 144.9625775"
45820250430,45,2025-04-30,8,275,296,571,Swa148_T,"-37.81414075, 144.96609379"
45620250512,45,2025-05-12,6,31,33,64,Swa148_T,"-37.81414075, 144.96609379"
1401820240405,140,2024-04-05,18,124,146,270,Boyd2837_T,"-37.82590962, 144.96185972"
1622020250215,162,2025-02-15,20,234,147,381,Eli489_T,"-37.80740397, 144.95987909"
162420250724,162,2025-07-24,4,13,10,23,Eli489_T,"-37.80740397, 144.95987909"
107520231112,107,2023-11-12,5,12,12,24,280Will_T,"-37.81246271, 144.95690188"
131120250711,131,2025-07-11,1,11,14,25,King2_T,"-37.82009057, 144.95758725"
131820250804,131,2025-08-04,8,158,71,229,King2_T,"-37.82009057, 144.95758725"
1311220251011,131,2025-10-11,12,123,131,254,King2_T,"-37.82009057, 144.95758725"
132520240704,132,2024-07-04,5,8,5,13,King335_T,"-37.81267639, 144.95386444"
131520241109,131,2024-11-09,5,17,37,54,King2_T,"-37.82009057, 144.95758725"
1331220250906,133,2025-09-06,12,425,425,850,Spen229_T,"-37.81531435, 144.95227769"
133320250215,133,2025-02-15,3,21,17,38,Spen229_T,"-37.81531435, 144.95227769"
1331020250509,133,2025-05-09,10,380,353,733,Spen229_T,"-37.81531435, 144.95227769"
1081120250730,108,2025-07-30,11,267,283,550,261Will_T,"-37.81295822, 144.95678789"
179920250224,179,2025-02-24,9,62,43,105,Pow61_T,"-37.82392385, 144.96299677"
1811220250405,181,2025-04-05,12,702,1104,1806,Eli368_T,"-37.81009465, 144.96143149"
67720250920,67,2025-09-20,7,67,88,155,FLDegS_T,"-37.81688755, 144.96562569"
85720240501,85,2024-05-01,7,69,21,90,488Mac_T,"-37.79432415, 144.92973378"
63620240619,63,2024-06-19,6,35,54,89,Bou231_T,"-37.81333081, 144.96675571"
672120250513,67,2025-05-13,21,103,240,343,FLDegS_T,"-37.81688755, 144.96562569"
681820240718,68,2024-07-18,18,96,18,114,FLDegN_T,"-37.8168479, 144.96559789"
67220251001,67,2025-10-01,2,7,2,9,FLDegS_T,"-37.81688755, 144.96562569"
1320250605,1,2025-06-05,3,3,4,7,Bou292_T,"-37.81349441, 144.96515323"
112220240420,11,2024-04-20,22,60,62,122,WatCit_T,"-37.81564989, 144.93970694"
111020231215,11,2023-12-15,10,48,71,119,WatCit_T,"-37.81564989, 144.93970694"
121120240510,12,2024-05-10,11,79,100,179,NewQ_T,"-37.81457988, 144.94292398"
72220240808,72,2024-08-08,2,4,5,9,ACMI_T,"-37.81726338, 144.96872809"
2320231104,2,2023-11-04,3,6,50,56,Bou283_T,"-37.81380668, 144.96516718"
2620240113,2,2024-01-13,6,5,6,11,Bou283_T,"-37.81380668, 144.96516718"
76720240827,76,2024-08-27,7,41,28,69,KenMac_T,"-37.79453803, 144.93036194"
762320250914,76,2025-09-14,23,3,3,6,KenMac_T,"-37.79453803, 144.93036194"
92120241119,9,2024-11-19,21,69,36,105,Col700_T,"-37.81982992, 144.95102555"
271820250501,27,2025-05-01,18,195,113,308,Vic_T,"-37.80606888, 144.95644692"
91320240622,9,2024-06-22,13,72,137,209,Col700_T,"-37.81982992, 144.95102555"
301120231126,30,2023-11-26,11,196,342,538,Lon189_T,"-37.8112185, 144.96656806"
531120240806,53,2024-08-06,11,484,437,921,Col254_T,"-37.81564191, 144.965499"
25820240317,25,2024-03-17,8,211,172,383,MCEC_T,"-37.82401776, 144.95604426"
1411120241117,141,2024-11-17,11,156,167,323,474Fl_T,"-37.81997273, 144.95834911"
1372020250323,137,2025-03-23,20,2,4,6,BouHbr2353_T,"-37.81894815, 144.94612292"
1361020241205,136,2024-12-05,10,51,47,98,BirFed1120_T,"-37.8184141, 144.97357915"
1391720250212,139,2025-02-12,17,290,55,345,Signal1647_T,"-37.81959923, 144.9632832"
1301520250515,130,2025-05-15,15,61,53,114,Bou892T,"-37.8204637, 144.94126826"
1301320250814,130,2025-08-14,13,124,89,213,Bou892T,"-37.8204637, 144.94126826"
1301020231201,130,2023-12-01,10,10,19,29,Bou892T,"-37.8204637, 144.94126826"
132120240510,132,2024-05-10,1,14,19,33,King335_T,"-37.81267639, 144.95386444"
1321620241004,132,2024-10-04,16,165,140,305,King335_T,"-37.81267639, 144.95386444"
1351120240923,135,2024-09-23,11,420,413,833,Spen161_T,"-37.8172861, 144.95319102"
1241120250914,124,2025-09-14,11,3,6,9,BirBridge_T,"-37.81757416, 144.97329934"
51220240403,51,2024-04-03,2,7,11,18,Fra118_T,"-37.80841815, 144.95906316"
511020231116,51,2023-11-16,10,94,100,194,Fra118_T,"-37.80841815, 144.95906316"
491620240611,49,2024-06-11,16,239,262,501,Eli501_T,"-37.80730068, 144.95956055"
1092220250725,109,2025-07-25,22,128,77,205,LatWill_T,"-37.81193681, 144.95621105"
491520250320,49,2025-03-20,15,193,347,540,Eli501_T,"-37.80730068, 144.95956055"
1801120251003,180,2025-10-03,11,29,25,54,Mac330_T,"-37.79497059, 144.93530329"
1371520250701,137,2025-07-01,15,26,223,249,BouHbr2353_T,"-37.81894815, 144.94612292"
1362220251006,136,2025-10-06,22,1,139,140,BirFed1120_T,"-37.8184141, 144.97357915"
1361020240627,136,2024-06-27,10,113,40,153,BirFed1120_T,"-37.8184141, 144.97357915"
1611620250706,161,2025-07-06,16,216,485,701,BirArt1109_T,"-37.81851276, 144.97131336"
123720231127,123,2023-11-27,7,14,6,20,BirBridge_T,"-37.81753741, 144.97329734"
67620240226,67,2024-02-26,6,37,21,58,FLDegS_T,"-37.81688755, 144.96562569"
63220240730,63,2024-07-30,2,4,21,25,Bou231_T,"-37.81333081, 144.96675571"
681320250108,68,2025-01-08,13,307,247,554,FLDegN_T,"-37.8168479, 144.96559789"
67420250813,67,2025-08-13,4,3,3,6,FLDegS_T,"-37.81688755, 144.96562569"
56920231219,56,2023-12-19,9,165,94,259,Lon364_T,"-37.81234775, 144.96153311"
56920240518,56,2024-05-18,9,217,97,314,Lon364_T,"-37.81234775, 144.96153311"
86620250413,86,2025-04-13,6,2,0,2,574Qub_T,"-37.80309992, 144.94908064"
861920250427,86,2025-04-27,19,14,33,47,574Qub_T,"-37.80309992, 144.94908064"
121920250114,12,2025-01-14,19,233,275,508,NewQ_T,"-37.81457988, 144.94292398"
101920250927,10,2025-09-27,19,47,44,91,BouHbr_T,"-37.81876474, 144.94710545"
722120231202,72,2023-12-02,21,358,363,721,ACMI_T,"-37.81726338, 144.96872809"
72320240902,72,2024-09-02,3,4,4,8,ACMI_T,"-37.81726338, 144.96872809"
721020250306,72,2025-03-06,10,206,171,377,ACMI_T,"-37.81726338, 144.96872809"
22220241204,2,2024-12-04,22,77,197,274,Bou283_T,"-37.81380668, 144.96516718"
582320250227,58,2025-02-27,23,191,171,362,Bou688_T,"-37.81686075, 144.95358075"
581120250424,58,2025-04-24,11,799,302,1101,Bou688_T,"-37.81686075, 144.95358075"
53220240131,53,2024-01-31,2,2,8,10,Col254_T,"-37.81564191, 144.965499"
231520231212,23,2023-12-12,15,180,324,504,Col623_T,"-37.81909256, 144.95452748"
30420250301,30,2025-03-01,4,69,75,144,Lon189_T,"-37.8112185, 144.96656806"
252320250514,25,2025-05-14,23,37,54,91,MCEC_T,"-37.82401776, 144.95604426"
52620231208,52,2023-12-08,6,27,24,51,Eli263_T,"-37.81252157, 144.9619401"
54920240831,54,2024-08-31,9,62,92,154,Swa607_T,"-37.804024, 144.96308399"
54620240118,54,2024-01-18,6,21,12,33,Swa607_T,"-37.804024, 144.96308399"
28520250724,28,2025-07-24,5,33,23,56,VAC_T,"-37.82129925, 144.96879309"
281620250823,28,2025-08-23,16,693,1079,1772,VAC_T,"-37.82129925, 144.96879309"
28620250929,28,2025-09-29,6,130,49,179,VAC_T,"-37.82129925, 144.96879309"
471920250216,47,2025-02-16,19,488,468,956,Eli250_T,"-37.81258467, 144.9625775"
47420240226,47,2024-02-26,4,14,12,26,Eli250_T,"-37.81258467, 144.9625775"
36920250518,36,2025-05-18,9,76,49,125,Que85_T,"-37.81652527, 144.96121062"
37220231025,37,2023-10-25,2,3,1,4,Lyg260_T,"-37.80107122, 144.96704554"
45820240611,45,2024-06-11,8,329,274,603,Swa148_T,"-37.81414075, 144.96609379"
5220250429,5,2025-04-29,2,6,13,19,PriNW_T,"-37.81874249, 144.96787656"
211920250314,21,2025-03-14,19,505,543,1048,Bourke155_T,"-37.81267313, 144.96788288"
107520241111,107,2024-11-11,5,4,10,14,280Will_T,"-37.81246271, 144.95690188"
872220240326,87,2024-03-26,22,15,25,40,Errol23_T,"-37.80454949, 144.94921863"
841620250308,84,2025-03-08,16,1037,1593,2630,ElFi_T,"-37.81798049, 144.96503383"
41920250527,4,2025-05-27,19,654,766,1420,Swa123_T,"-37.81487988, 144.9660878"
701020240514,70,2024-05-14,10,92,74,166,Errol20_T,"-37.80456984, 144.94946228"
39520240810,39,2024-08-10,5,3,1,4,AlfPl_T,"-37.81379749, 144.96995745"
81620250529,8,2025-05-29,16,180,391,571,WebBN_T,"-37.82293543, 144.9471751"
77620250419,77,2025-04-19,6,14,20,34,HarEsP_T,"-37.81441438, 144.94433026"
42020250804,42,2025-08-04,0,9,9,18,UM1_T,"-37.80008566, 144.96386412"
771820240704,77,2024-07-04,18,122,53,175,HarEsP_T,"-37.81441438, 144.94433026"
782320250101,78,2025-01-01,23,4,2,6,HarEsB_T,"-37.81471642, 144.9446508"
59920250723,59,2025-07-23,9,815,391,1206,RMIT_T,"-37.80825648, 144.96304859"
471420240805,47,2024-08-05,14,817,739,1556,Eli250_T,"-37.81258467, 144.9625775"
40520240516,40,2024-05-16,5,4,8,12,Spr201_T,"-37.80999341, 144.97227587"
40420240221,40,2024-02-21,4,1,2,3,Spr201_T,"-37.80999341, 144.97227587"
361920250914,36,2025-09-14,19,63,53,116,Que85_T,"-37.81652527, 144.96121062"
37520250423,37,2025-04-23,5,0,6,6,Lyg260_T,"-37.80107122, 144.96704554"
37220250801,37,2025-08-01,2,4,3,7,Lyg260_T,"-37.80107122, 144.96704554"
61720250208,61,2025-02-08,7,46,72,118,RMIT14_T,"-37.80767455, 144.96309114"
442320250527,44,2025-05-27,23,7,5,12,UM3_T,"-37.79698741, 144.96441306"
45320250621,45,2025-06-21,3,9,53,62,Swa148_T,"-37.81414075, 144.96609379"
132020250304,132,2025-03-04,0,22,24,46,King335_T,"-37.81267639, 144.95386444"
1321720240219,132,2024-02-19,17,227,175,402,King335_T,"-37.81267639, 144.95386444"
132720240508,132,2024-05-08,7,64,41,105,King335_T,"-37.81267639, 144.95386444"
1341720241123,134,2024-11-23,17,499,410,909,Spen201_T,"-37.81694221, 144.95303935"
1311020250110,131,2025-01-10,10,72,146,218,King2_T,"-37.82009057, 144.95758725"
1351020250412,135,2025-04-12,10,369,509,878,Spen161_T,"-37.8172861, 144.95319102"
1331020240429,133,2024-04-29,10,440,440,880,Spen229_T,"-37.81531435, 144.95227769"
1072220240811,107,2024-08-11,22,36,37,73,280Will_T,"-37.81246271, 144.95690188"
87320250305,87,2025-03-05,3,1,2,3,Errol23_T,"-37.80454949, 144.94921863"
1821520250812,182,2025-08-12,15,175,203,378,King163_T,"-37.81627451, 144.95550503"
184620250811,184,2025-08-11,6,57,91,148,Eli124_T,"-37.81512416, 144.96371988"
1841520251007,184,2025-10-07,15,1024,1099,2123,Eli124_T,"-37.81512416, 144.96371988"
1661320250820,166,2025-08-20,13,50,42,92,Spen484_T,"-37.80896733, 144.94931703"
852220250319,85,2025-03-19,22,11,15,26,488Mac_T,"-37.79432415, 144.92973378"
181320240907,18,2024-09-07,13,131,98,229,Col12_T,"-37.81344862, 144.97305353"
181720250722,18,2025-07-22,17,685,77,762,Col12_T,"-37.81344862, 144.97305353"
63820250702,63,2025-07-02,8,148,131,279,Bou231_T,"-37.81333081, 144.96675571"
671420241014,67,2024-10-14,14,446,767,1213,FLDegS_T,"-37.81688755, 144.96562569"
622020250129,62,2025-01-29,20,228,217,445,Lat224_T,"-37.80996494, 144.96216521"
56320240105,56,2024-01-05,3,4,9,13,Lon364_T,"-37.81234775, 144.96153311"
11620231230,11,2023-12-30,6,4,10,14,WatCit_T,"-37.81564989, 144.93970694"
24120241025,24,2024-10-25,1,22,46,68,Col620_T,"-37.81887963, 144.95449198"
2920250905,2,2025-09-05,9,223,378,601,Bou283_T,"-37.81380668, 144.96516718"
91020240103,9,2024-01-03,10,103,186,289,Col700_T,"-37.81982992, 144.95102555"
92120240404,9,2024-04-04,21,58,48,106,Col700_T,"-37.81982992, 144.95102555"
35220250613,35,2025-06-13,2,1,8,9,SouthB_T,"-37.82018685, 144.96508508"
791420240115,79,2024-01-15,14,547,455,1002,FliSS_T,"-37.81794046, 144.96616678"
231820240614,23,2024-06-14,18,207,296,503,Col623_T,"-37.81909256, 144.95452748"
481520240501,48,2024-05-01,15,140,168,308,QVMQ_T,"-37.80631581, 144.95866697"
20520250427,20,2025-04-27,5,45,57,102,LtB170_T,"-37.81172914, 144.9682466"
251620250413,25,2025-04-13,16,1078,617,1695,MCEC_T,"-37.82401776, 144.95604426"
52220240711,52,2024-07-11,2,3,6,9,Eli263_T,"-37.81252157, 144.9619401"
461720250223,46,2025-02-23,17,49,68,117,Pel147_T,"-37.80240719, 144.9615673"
561220240906,56,2024-09-06,12,417,329,746,Lon364_T,"-37.81234775, 144.96153311"
1120250801,1,2025-08-01,1,23,13,36,Bou292_T,"-37.81349441, 144.96515323"
101820241125,10,2024-11-25,18,85,52,137,BouHbr_T,"-37.81876474, 144.94710545"
24220240319,24,2024-03-19,2,21,31,52,Col620_T,"-37.81887963, 144.95449198"
721220240918,72,2024-09-18,12,173,322,495,ACMI_T,"-37.81726338, 144.96872809"
721520250110,72,2025-01-10,15,195,328,523,ACMI_T,"-37.81726338, 144.96872809"
241920250813,24,2025-08-13,19,301,667,968,Col620_T,"-37.81887963, 144.95449198"
721420250320,72,2025-03-20,14,186,368,554,ACMI_T,"-37.81726338, 144.96872809"
72320241231,72,2024-12-31,3,0,7,7,ACMI_T,"-37.81726338, 144.96872809"
21220240912,2,2024-09-12,12,731,770,1501,Bou283_T,"-37.81380668, 144.96516718"
91320241226,9,2024-12-26,13,69,74,143,Col700_T,"-37.81982992, 144.95102555"
271920240725,27,2024-07-25,19,96,50,146,Vic_T,"-37.80606888, 144.95644692"
271020250711,27,2025-07-11,10,100,113,213,Vic_T,"-37.80606888, 144.95644692"
271620250420,27,2025-04-20,16,120,88,208,Vic_T,"-37.80606888, 144.95644692"
302020240707,30,2024-07-07,20,177,357,534,Lon189_T,"-37.8112185, 144.96656806"
301620250105,30,2025-01-05,16,214,293,507,Lon189_T,"-37.8112185, 144.96656806"
791420240107,79,2024-01-07,14,401,339,740,FliSS_T,"-37.81794046, 144.96616678"
532120250715,53,2025-07-15,21,101,181,282,Col254_T,"-37.81564191, 144.965499"
231620250613,23,2025-06-13,16,201,453,654,Col623_T,"-37.81909256, 144.95452748"
482220240703,48,2024-07-03,22,260,106,366,QVMQ_T,"-37.80631581, 144.95866697"
301320250830,30,2025-08-30,13,324,417,741,Lon189_T,"-37.8112185, 144.96656806"
52320241117,52,2024-11-17,3,98,53,151,Eli263_T,"-37.81252157, 144.9619401"
136020240203,136,2024-02-03,0,4,0,4,BirFed1120_T,"-37.8184141, 144.97357915"
1361620250102,136,2025-01-02,16,99,138,237,BirFed1120_T,"-37.8184141, 144.97357915"
139320240127,139,2024-01-27,3,7,4,11,Signal1647_T,"-37.81959923, 144.9632832"
138720250529,138,2025-05-29,7,2,3,5,EntPark1671_T,"-37.81996544, 144.95981454"
1611720240810,161,2024-08-10,17,793,176,969,BirArt1109_T,"-37.81851276, 144.97131336"
1231920240226,123,2024-02-26,19,28,14,42,BirBridge_T,"-37.81753741, 144.97329734"
130020231202,130,2023-12-02,0,0,1,1,Bou892T,"-37.8204637, 144.94126826"
1801320250603,180,2025-06-03,13,12,21,33,Mac330_T,"-37.79497059, 144.93530329"
1411420231208,141,2023-12-08,14,141,137,278,474Fl_T,"-37.81997273, 144.95834911"
137020250601,137,2025-06-01,0,0,5,5,BouHbr2353_T,"-37.81894815, 144.94612292"
1371020231222,137,2023-12-22,10,26,33,59,BouHbr2353_T,"-37.81894815, 144.94612292"
841420240121,84,2024-01-21,14,1012,1552,2564,ElFi_T,"-37.81798049, 144.96503383"
84620241215,84,2024-12-15,6,90,84,174,ElFi_T,"-37.81798049, 144.96503383"
41420241217,4,2024-12-17,14,1926,1793,3719,Swa123_T,"-37.81487988, 144.9660878"
39220241222,39,2024-12-22,2,0,1,1,AlfPl_T,"-37.81379749, 144.96995745"
81120250209,8,2025-02-09,11,169,290,459,WebBN_T,"-37.82293543, 144.9471751"
781720231219,78,2023-12-19,17,38,169,207,HarEsB_T,"-37.81471642, 144.9446508"
591920240112,59,2024-01-12,19,406,345,751,RMIT_T,"-37.80825648, 144.96304859"
711020231023,71,2023-10-23,10,38,32,70,WestWP_T,"-37.81235775, 144.97136962"
282320250314,28,2025-03-14,23,217,314,531,VAC_T,"-37.82129925, 144.96879309"
291420241111,29,2024-11-11,14,245,261,506,AG_T,"-37.8199817, 144.96872865"
31720231019,31,2023-10-19,7,26,37,63,Lyg161_T,"-37.80169681, 144.96658911"
311420240229,31,2024-02-29,14,129,109,238,Lyg161_T,"-37.80169681, 144.96658911"
47720240228,47,2024-02-28,7,159,295,454,Eli250_T,"-37.81258467, 144.9625775"
361420240409,36,2024-04-09,14,197,274,471,Que85_T,"-37.81652527, 144.96121062"
212120241221,21,2024-12-21,21,309,456,765,Bourke155_T,"-37.81267313, 144.96788288"
361420240306,36,2024-03-06,14,194,284,478,Que85_T,"-37.81652527, 144.96121062"
142920241220,142,2024-12-20,9,313,213,526,Hammer1584_T,"-37.81970749, 144.96795734"
1361220231129,136,2023-11-29,12,44,24,68,BirFed1120_T,"-37.8184141, 144.97357915"
1302320251004,130,2025-10-04,23,4,15,19,Bou892T,"-37.8204637, 144.94126826"
138820240704,138,2024-07-04,8,10,10,20,EntPark1671_T,"-37.81996544, 144.95981454"
492320250824,49,2025-08-24,23,88,65,153,Eli501_T,"-37.80730068, 144.95956055"
191720241124,19,2024-11-24,17,669,424,1093,LtB210_T,"-37.81237202, 144.96550671"
69720240523,69,2024-05-23,7,69,25,94,FLDegC_T,"-37.81687226, 144.96559144"
62120250423,6,2025-04-23,21,477,495,972,FliS_T,"-37.81911705, 144.96558255"
84920240203,84,2024-02-03,9,537,423,960,ElFi_T,"-37.81798049, 144.96503383"
842220250725,84,2025-07-25,22,449,588,1037,ElFi_T,"-37.81798049, 144.96503383"
42020250907,4,2025-09-07,20,633,546,1179,Swa123_T,"-37.81487988, 144.9660878"
41820240603,4,2024-06-03,18,863,534,1397,Swa123_T,"-37.81487988, 144.9660878"
4720240806,4,2024-08-06,7,154,102,256,Swa123_T,"-37.81487988, 144.9660878"
701220240808,70,2024-08-08,12,163,168,331,Errol20_T,"-37.80456984, 144.94946228"
391420231210,39,2023-12-10,14,61,65,126,AlfPl_T,"-37.81379749, 144.96995745"
32120240915,3,2024-09-15,21,513,454,967,Swa295_T,"-37.81101524, 144.96429485"
751120250616,75,2025-06-16,11,30,34,64,SprFli_T,"-37.81515276, 144.97467661"
81620250702,8,2025-07-02,16,90,151,241,WebBN_T,"-37.82293543, 144.9471751"
78920241105,78,2024-11-05,9,59,83,142,HarEsB_T,"-37.81471642, 144.9446508"
41620250524,41,2025-05-24,6,131,60,191,Swa31,"-37.81668634, 144.96689733"
77120240923,77,2024-09-23,1,14,2,16,HarEsP_T,"-37.81441438, 144.94433026"
14020240220,14,2024-02-20,0,18,12,30,SanBri_T,"-37.82011242, 144.96291897"
282320250306,28,2025-03-06,23,58,87,145,VAC_T,"-37.82129925, 144.96879309"
402020240509,40,2024-05-09,20,109,69,178,Spr201_T,"-37.80999341, 144.97227587"
402020241105,40,2024-11-05,20,63,53,116,Spr201_T,"-37.80999341, 144.97227587"
312320240216,31,2024-02-16,23,172,153,325,Lyg161_T,"-37.80169681, 144.96658911"
361420241228,36,2024-12-28,14,113,93,206,Que85_T,"-37.81652527, 144.96121062"
47620250519,47,2025-05-19,6,40,184,224,Eli250_T,"-37.81258467, 144.9625775"
47320250525,47,2025-05-25,3,60,90,150,Eli250_T,"-37.81258467, 144.9625775"
471720241018,47,2024-10-18,17,913,794,1707,Eli250_T,"-37.81258467, 144.9625775"
472020250106,47,2025-01-06,20,500,432,932,Eli250_T,"-37.81258467, 144.9625775"
501020240123,50,2024-01-23,10,121,134,255,Lyg309_T,"-37.79808192, 144.96721013"
44820240320,44,2024-03-20,8,60,26,86,UM3_T,"-37.79698741, 144.96441306"
431820231126,43,2023-11-26,18,42,35,77,UM2_T,"-37.79844526, 144.96411782"
452020240618,45,2024-06-18,20,329,478,807,Swa148_T,"-37.81414075, 144.96609379"
451720250701,45,2025-07-01,17,709,826,1535,Swa148_T,"-37.81414075, 144.96609379"
1311220250830,131,2025-08-30,12,104,98,202,King2_T,"-37.82009057, 144.95758725"
143920250504,143,2025-05-04,9,108,200,308,Spencer_T,"-37.821728, 144.95557015"
1321520250418,132,2025-04-18,15,136,138,274,King335_T,"-37.81267639, 144.95386444"
132620240927,132,2024-09-27,6,33,15,48,King335_T,"-37.81267639, 144.95386444"
135220240510,135,2024-05-10,2,3,5,8,Spen161_T,"-37.8172861, 144.95319102"
1332020240929,133,2024-09-29,20,363,274,637,Spen229_T,"-37.81531435, 144.95227769"
1331920240201,133,2024-02-01,19,484,437,921,Spen229_T,"-37.81531435, 144.95227769"
107620240921,107,2024-09-21,6,11,16,27,280Will_T,"-37.81246271, 144.95690188"
182320250810,182,2025-08-10,3,73,90,163,King163_T,"-37.81627451, 144.95550503"
1651320240821,165,2024-08-21,13,41,27,68,Spen475_T,"-37.80953359, 144.94939004"
167120250905,167,2025-09-05,1,1,1,2,Lat526_T,"-37.81304149, 144.95155955"
164220241211,164,2024-12-11,2,1,3,4,Lat526_T,"-37.813005, 144.95160411"
1231220250103,123,2025-01-03,12,26,51,77,BirBridge_T,"-37.81753741, 144.97329734"
1171120251015,117,2025-10-15,11,133,143,276,Fli114F_T,"-37.81629332, 144.97090877"
1172120241105,117,2024-11-05,21,78,57,135,Fli114F_T,"-37.81629332, 144.97090877"
1091720250815,109,2025-08-15,17,214,93,307,LatWill_T,"-37.81193681, 144.95621105"
1091720231108,109,2023-11-08,17,394,99,493,LatWill_T,"-37.81193681, 144.95621105"
672120250401,67,2025-04-01,21,109,253,362,FLDegS_T,"-37.81688755, 144.96562569"
851620240426,85,2024-04-26,16,76,72,148,488Mac_T,"-37.79432415, 144.92973378"
1320240311,1,2024-03-11,3,22,15,37,Bou292_T,"-37.81349441, 144.96515323"
12220250308,1,2025-03-08,22,311,242,553,Bou292_T,"-37.81349441, 144.96515323"
61220250910,61,2025-09-10,2,17,6,23,RMIT14_T,"-37.80767455, 144.96309114"
502220250214,50,2025-02-14,22,170,96,266,Lyg309_T,"-37.79808192, 144.96721013"
184720250915,184,2025-09-15,7,125,117,242,Eli124_T,"-37.81512416, 144.96371988"
1851120250921,185,2025-09-21,11,497,473,970,Eli197_T,"-37.81374643, 144.96276183"
1672120241116,167,2024-11-16,21,16,44,60,Lat526_T,"-37.81304149, 144.95155955"
165220250201,165,2025-02-01,2,7,1,8,Spen475_T,"-37.80953359, 144.94939004"
181820250603,181,2025-06-03,8,387,334,721,Eli368_T,"-37.81009465, 144.96143149"
1622220240805,162,2024-08-05,22,107,59,166,Eli489_T,"-37.80740397, 144.95987909"
143520250831,143,2025-08-31,5,30,19,49,Spencer_T,"-37.821728, 144.95557015"
1342220250514,134,2025-05-14,22,163,146,309,Spen201_T,"-37.81694221, 144.95303935"
1352220250106,135,2025-01-06,22,72,91,163,Spen161_T,"-37.8172861, 144.95319102"
133720240317,133,2024-03-17,7,215,450,665,Spen229_T,"-37.81531435, 144.95227769"
124920250622,124,2025-06-22,9,1,1,2,BirBridge_T,"-37.81757416, 144.97329934"
66520250216,66,2025-02-16,5,13,16,29,QVN_T,"-37.81057846, 144.96444294"
691420250729,69,2025-07-29,14,203,186,389,FLDegC_T,"-37.81687226, 144.96559144"
691120250804,69,2025-08-04,11,292,214,506,FLDegC_T,"-37.81687226, 144.96559144"
6520250430,6,2025-04-30,5,65,83,148,FliS_T,"-37.81911705, 144.96558255"
84320231103,84,2023-11-03,3,35,30,65,ElFi_T,"-37.81798049, 144.96503383"
841920250420,84,2025-04-20,19,800,1043,1843,ElFi_T,"-37.81798049, 144.96503383"
842020250612,84,2025-06-12,20,431,690,1121,ElFi_T,"-37.81798049, 144.96503383"
41420250305,4,2025-03-05,14,1629,1402,3031,Swa123_T,"-37.81487988, 144.9660878"
701120240222,70,2024-02-22,11,103,107,210,Errol20_T,"-37.80456984, 144.94946228"
701520250915,70,2025-09-15,15,141,119,260,Errol20_T,"-37.80456984, 144.94946228"
751620240712,75,2024-07-12,16,64,95,159,SprFli_T,"-37.81515276, 144.97467661"
411420250817,41,2025-08-17,14,2551,1754,4305,Swa31,"-37.81668634, 144.96689733"
771620231030,77,2023-10-30,16,145,80,225,HarEsP_T,"-37.81441438, 144.94433026"
65220231117,65,2023-11-17,2,8,15,23,SwaCs_T,"-37.81569416, 144.9668064"
71620241011,71,2024-10-11,6,6,2,8,WestWP_T,"-37.81235775, 144.97136962"
651020240611,65,2024-06-11,10,234,228,462,SwaCs_T,"-37.81569416, 144.9668064"
541920241228,54,2024-12-28,19,49,43,92,Swa607_T,"-37.804024, 144.96308399"
67120231104,67,2023-11-04,1,24,37,61,FLDegS_T,"-37.81688755, 144.96562569"
67620240504,67,2024-05-04,6,34,24,58,FLDegS_T,"-37.81688755, 144.96562569"
852320250511,85,2025-05-11,23,0,2,2,488Mac_T,"-37.79432415, 144.92973378"
631620240925,63,2024-09-25,16,293,384,677,Bou231_T,"-37.81333081, 144.96675571"
18120240307,18,2024-03-07,1,0,2,2,Col12_T,"-37.81344862, 144.97305353"
111820250907,11,2025-09-07,18,127,114,241,WatCit_T,"-37.81564989, 144.93970694"
861820250410,86,2025-04-10,18,50,72,122,574Qub_T,"-37.80309992, 144.94908064"
101320250221,10,2025-02-21,13,110,100,210,BouHbr_T,"-37.81876474, 144.94710545"
722220231201,72,2023-12-01,22,423,496,919,ACMI_T,"-37.81726338, 144.96872809"
72620250628,72,2025-06-28,6,23,20,43,ACMI_T,"-37.81726338, 144.96872809"
35120250328,35,2025-03-28,1,100,92,192,SouthB_T,"-37.82018685, 144.96508508"
351020231109,35,2023-11-09,10,895,549,1444,SouthB_T,"-37.82018685, 144.96508508"
58520250330,58,2025-03-30,5,28,40,68,Bou688_T,"-37.81686075, 144.95358075"
58320250508,58,2025-05-08,3,1,2,3,Bou688_T,"-37.81686075, 144.95358075"
9220250616,9,2025-06-16,2,1,2,3,Col700_T,"-37.81982992, 144.95102555"
231320240420,23,2024-04-20,13,178,198,376,Col623_T,"-37.81909256, 144.95452748"
201320250509,20,2025-05-09,13,229,275,504,LtB170_T,"-37.81172914, 144.9682466"
521520240531,52,2024-05-31,15,376,270,646,Eli263_T,"-37.81252157, 144.9619401"
511620250504,51,2025-05-04,16,107,125,232,Fra118_T,"-37.80841815, 144.95906316"
511320250528,51,2025-05-28,13,100,102,202,Fra118_T,"-37.80841815, 144.95906316"
51420240311,51,2024-03-11,4,7,6,13,Fra118_T,"-37.80841815, 144.95906316"
51920231117,51,2023-11-17,9,71,65,136,Fra118_T,"-37.80841815, 144.95906316"
49920240730,49,2024-07-30,9,203,208,411,Eli501_T,"-37.80730068, 144.95956055"
50020240909,50,2024-09-09,0,6,7,13,Lyg309_T,"-37.79808192, 144.96721013"
441920250418,44,2025-04-18,19,9,35,44,UM3_T,"-37.79698741, 144.96441306"
44420250115,44,2025-01-15,4,0,1,1,UM3_T,"-37.79698741, 144.96441306"
1351520240511,135,2024-05-11,15,963,539,1502,Spen161_T,"-37.8172861, 144.95319102"
1351620250510,135,2025-05-10,16,633,502,1135,Spen161_T,"-37.8172861, 144.95319102"
1181320250217,118,2025-02-17,13,21,14,35,Fli114C_T,"-37.81632783, 144.97090512"
1081020250622,108,2025-06-22,10,135,103,238,261Will_T,"-37.81295822, 144.95678789"
871420250928,87,2025-09-28,14,79,107,186,Errol23_T,"-37.80454949, 144.94921863"
108720240414,108,2024-04-14,7,10,27,37,261Will_T,"-37.81295822, 144.95678789"
143920250323,143,2025-03-23,9,105,261,366,Spencer_T,"-37.821728, 144.95557015"
1321020240827,132,2024-08-27,10,282,99,381,King335_T,"-37.81267639, 144.95386444"
1321420250126,132,2025-01-26,14,118,134,252,King335_T,"-37.81267639, 144.95386444"
134220240207,134,2024-02-07,2,22,26,48,Spen201_T,"-37.81694221, 144.95303935"
171420231130,17,2023-11-30,14,416,391,807,Col15_T,"-37.81362543, 144.97323591"
17720240502,17,2024-05-02,7,494,98,592,Col15_T,"-37.81362543, 144.97323591"
631720250116,63,2025-01-16,17,495,558,1053,Bou231_T,"-37.81333081, 144.96675571"
631120250704,63,2025-07-04,11,258,354,612,Bou231_T,"-37.81333081, 144.96675571"
68520250215,68,2025-02-15,5,1,1,2,FLDegN_T,"-37.8168479, 144.96559789"
631720240202,63,2024-02-02,17,411,374,785,Bou231_T,"-37.81333081, 144.96675571"
86120240520,86,2024-05-20,1,0,2,2,574Qub_T,"-37.80309992, 144.94908064"
121820241029,12,2024-10-29,18,233,275,508,NewQ_T,"-37.81457988, 144.94292398"
121320240127,12,2024-01-27,13,232,231,463,NewQ_T,"-37.81457988, 144.94292398"
121020240220,12,2024-02-20,10,119,112,231,NewQ_T,"-37.81457988, 144.94292398"
101320241009,10,2024-10-09,13,146,106,252,BouHbr_T,"-37.81876474, 144.94710545"
241320240109,24,2024-01-09,13,737,646,1383,Col620_T,"-37.81887963, 144.95449198"
582020250504,58,2025-05-04,20,202,212,414,Bou688_T,"-37.81686075, 144.95358075"
231220250204,23,2025-02-04,12,332,443,775,Col623_T,"-37.81909256, 144.95452748"
301120250902,30,2025-09-02,11,152,212,364,Lon189_T,"-37.8112185, 144.96656806"
251420250821,25,2025-08-21,14,610,574,1184,MCEC_T,"-37.82401776, 144.95604426"
46720250116,46,2025-01-16,7,23,9,32,Pel147_T,"-37.80240719, 144.9615673"
201020250311,20,2025-03-11,10,94,95,189,LtB170_T,"-37.81172914, 144.9682466"
201820240901,20,2024-09-01,18,369,284,653,LtB170_T,"-37.81172914, 144.9682466"
251320240920,25,2024-09-20,13,427,585,1012,MCEC_T,"-37.82401776, 144.95604426"
522320250511,52,2025-05-11,23,37,49,86,Eli263_T,"-37.81252157, 144.9619401"
1422020251008,142,2025-10-08,20,9,5,14,Hammer1584_T,"-37.81970749, 144.96795734"
1421420250109,142,2025-01-09,14,532,478,1010,Hammer1584_T,"-37.81970749, 144.96795734"
130820250322,130,2025-03-22,8,6,12,18,Bou892T,"-37.8204637, 144.94126826"
1381120240724,138,2024-07-24,11,5,4,9,EntPark1671_T,"-37.81996544, 144.95981454"
1411620250218,141,2025-02-18,16,138,135,273,474Fl_T,"-37.81997273, 144.95834911"
49620240223,49,2024-02-23,6,39,43,82,Eli501_T,"-37.80730068, 144.95956055"
541320250328,54,2025-03-28,13,194,225,419,Swa607_T,"-37.804024, 144.96308399"
28620251009,28,2025-10-09,6,212,60,272,VAC_T,"-37.82129925, 144.96879309"
40220250402,40,2025-04-02,2,3,4,7,Spr201_T,"-37.80999341, 144.97227587"
451820231211,45,2023-12-11,18,419,576,995,Swa148_T,"-37.81414075, 144.96609379"
36020240610,36,2024-06-10,0,67,65,132,Que85_T,"-37.81652527, 144.96121062"
212120241014,21,2024-10-14,21,160,226,386,Bourke155_T,"-37.81267313, 144.96788288"
50220240626,50,2024-06-26,2,0,1,1,Lyg309_T,"-37.79808192, 144.96721013"
501220241023,50,2024-10-23,12,185,203,388,Lyg309_T,"-37.79808192, 144.96721013"
442320240803,44,2024-08-03,23,23,1,24,UM3_T,"-37.79698741, 144.96441306"
432320241209,43,2024-12-09,23,62,11,73,UM2_T,"-37.79844526, 144.96411782"
45820250221,45,2025-02-21,8,149,277,426,Swa148_T,"-37.81414075, 144.96609379"
1351020240118,135,2024-01-18,10,452,524,976,Spen161_T,"-37.8172861, 144.95319102"
1351120240130,135,2024-01-30,11,359,335,694,Spen161_T,"-37.8172861, 144.95319102"
133820240303,133,2024-03-03,8,249,261,510,Spen229_T,"-37.81531435, 144.95227769"
118820250105,118,2025-01-05,8,3,2,5,Fli114C_T,"-37.81632783, 144.97090512"
1071720240713,107,2024-07-13,17,92,98,190,280Will_T,"-37.81246271, 144.95690188"
871920250515,87,2025-05-15,19,77,96,173,Errol23_T,"-37.80454949, 144.94921863"
87420240402,87,2024-04-02,4,1,0,1,Errol23_T,"-37.80454949, 144.94921863"
1821920250622,182,2025-06-22,19,208,173,381,King163_T,"-37.81627451, 144.95550503"
1851320250823,185,2025-08-23,13,928,939,1867,Eli197_T,"-37.81374643, 144.96276183"
1662120250920,166,2025-09-20,21,9,6,15,Spen484_T,"-37.80896733, 144.94931703"
1401520250524,140,2025-05-24,15,109,70,179,Boyd2837_T,"-37.82590962, 144.96185972"
140620250905,140,2025-09-05,6,28,7,35,Boyd2837_T,"-37.82590962, 144.96185972"
140720250502,140,2025-05-02,7,64,13,77,Boyd2837_T,"-37.82590962, 144.96185972"
661720231229,66,2023-12-29,17,1465,1462,2927,QVN_T,"-37.81057846, 144.96444294"
84420240119,84,2024-01-19,4,29,37,66,ElFi_T,"-37.81798049, 144.96503383"
84320240402,84,2024-04-02,3,16,14,30,ElFi_T,"-37.81798049, 144.96503383"
3620240415,3,2024-04-15,6,47,91,138,Swa295_T,"-37.81101524, 144.96429485"
3920240810,3,2024-08-10,9,192,243,435,Swa295_T,"-37.81101524, 144.96429485"
41420240502,4,2024-05-02,14,1719,1481,3200,Swa123_T,"-37.81487988, 144.9660878"
4120250227,4,2025-02-27,1,46,46,92,Swa123_T,"-37.81487988, 144.9660878"
751920250228,75,2025-02-28,19,41,45,86,SprFli_T,"-37.81515276, 144.97467661"
78020250929,78,2025-09-29,0,1,7,8,HarEsB_T,"-37.81471642, 144.9446508"
412320250822,41,2025-08-22,23,1078,1094,2172,Swa31,"-37.81668634, 144.96689733"
772020240610,77,2024-06-10,20,2,3,5,HarEsP_T,"-37.81441438, 144.94433026"
141420241218,14,2024-12-18,14,418,160,578,SanBri_T,"-37.82011242, 144.96291897"
67920240527,67,2024-05-27,9,414,296,710,FLDegS_T,"-37.81688755, 144.96562569"
852120241128,85,2024-11-28,21,12,32,44,488Mac_T,"-37.79432415, 144.92973378"
85820250306,85,2025-03-06,8,142,55,197,488Mac_T,"-37.79432415, 144.92973378"
631120250618,63,2025-06-18,11,401,508,909,Bou231_T,"-37.81333081, 144.96675571"
62220240928,62,2024-09-28,2,47,23,70,Lat224_T,"-37.80996494, 144.96216521"
56620231230,56,2023-12-30,6,12,7,19,Lon364_T,"-37.81234775, 144.96153311"
56720240722,56,2024-07-22,7,40,41,81,Lon364_T,"-37.81234775, 144.96153311"
56420250314,56,2025-03-14,4,1,18,19,Lon364_T,"-37.81234775, 144.96153311"
241820231123,24,2023-11-23,18,570,1295,1865,Col620_T,"-37.81887963, 144.95449198"
242120250130,24,2025-01-30,21,236,447,683,Col620_T,"-37.81887963, 144.95449198"
72820241220,72,2024-12-20,8,335,78,413,ACMI_T,"-37.81726338, 144.96872809"
721220250902,72,2025-09-02,12,205,435,640,ACMI_T,"-37.81726338, 144.96872809"
581620250318,58,2025-03-18,16,588,1304,1892,Bou688_T,"-37.81686075, 144.95358075"
352120250409,35,2025-04-09,21,527,841,1368,SouthB_T,"-37.82018685, 144.96508508"
21120250222,2,2025-02-22,11,503,532,1035,Bou283_T,"-37.81380668, 144.96516718"
21220231120,2,2023-11-20,12,828,834,1662,Bou283_T,"-37.81380668, 144.96516718"
91920250210,9,2025-02-10,19,170,61,231,Col700_T,"-37.81982992, 144.95102555"
791520240719,79,2024-07-19,15,407,378,785,FliSS_T,"-37.81794046, 144.96616678"
232120250607,23,2025-06-07,21,67,133,200,Col623_T,"-37.81909256, 144.95452748"
302020250205,30,2025-02-05,20,197,310,507,Lon189_T,"-37.8112185, 144.96656806"
301420250602,30,2025-06-02,14,149,269,418,Lon189_T,"-37.8112185, 144.96656806"
461920250529,46,2025-05-29,19,2,5,7,Pel147_T,"-37.80240719, 144.9615673"
462220231110,46,2023-11-10,22,21,45,66,Pel147_T,"-37.80240719, 144.9615673"
20520241117,20,2024-11-17,5,20,29,49,LtB170_T,"-37.81172914, 144.9682466"
252120240924,25,2024-09-24,21,280,217,497,MCEC_T,"-37.82401776, 144.95604426"
161220250515,161,2025-05-15,2,0,1,1,BirArt1109_T,"-37.81851276, 144.97131336"
117920250911,117,2025-09-11,9,276,103,379,Fli114F_T,"-37.81629332, 144.97090877"
1092220250802,109,2025-08-02,22,41,68,109,LatWill_T,"-37.81193681, 144.95621105"
49420240312,49,2024-03-12,4,11,14,25,Eli501_T,"-37.80730068, 144.95956055"
19120241122,19,2024-11-22,1,45,68,113,LtB210_T,"-37.81237202, 144.96550671"
1411220241123,141,2024-11-23,12,167,75,242,474Fl_T,"-37.81997273, 144.95834911"
1421020250810,142,2025-08-10,10,562,437,999,Hammer1584_T,"-37.81970749, 144.96795734"
1421220240718,142,2024-07-18,12,466,304,770,Hammer1584_T,"-37.81970749, 144.96795734"
142520240221,142,2024-02-21,5,15,0,15,Hammer1584_T,"-37.81970749, 144.96795734"
1641120250625,164,2025-06-25,11,87,50,137,Lat526_T,"-37.813005, 144.95160411"
138720231124,138,2023-11-24,7,0,3,3,EntPark1671_T,"-37.81996544, 144.95981454"
661120250315,66,2025-03-15,11,707,1418,2125,QVN_T,"-37.81057846, 144.96444294"
69820241120,69,2024-11-20,8,270,62,332,FLDegC_T,"-37.81687226, 144.96559144"
841820240920,84,2024-09-20,18,718,1094,1812,ElFi_T,"-37.81798049, 144.96503383"
41020241020,4,2024-10-20,10,764,601,1365,Swa123_T,"-37.81487988, 144.9660878"
771420240108,77,2024-01-08,14,50,39,89,HarEsP_T,"-37.81441438, 144.94433026"
71620240311,71,2024-03-11,6,2,3,5,WestWP_T,"-37.81235775, 144.97136962"
71220250517,71,2025-05-17,2,5,1,6,WestWP_T,"-37.81235775, 144.97136962"
65420231025,65,2023-10-25,4,0,8,8,SwaCs_T,"-37.81569416, 144.9668064"
29620250317,29,2025-03-17,6,68,61,129,AG_T,"-37.8199817, 144.96872865"
281520250601,28,2025-06-01,15,553,761,1314,VAC_T,"-37.82129925, 144.96879309"
451420250217,45,2025-02-17,14,377,782,1159,Swa148_T,"-37.81414075, 144.96609379"
452320240110,45,2024-01-10,23,89,211,300,Swa148_T,"-37.81414075, 144.96609379"
45820240404,45,2024-04-04,8,262,269,531,Swa148_T,"-37.81414075, 144.96609379"
211920240220,21,2024-02-20,19,389,436,825,Bourke155_T,"-37.81267313, 144.96788288"
5620231020,5,2023-10-20,6,74,172,246,PriNW_T,"-37.81874249, 144.96787656"
5520241007,5,2024-10-07,5,19,29,48,PriNW_T,"-37.81874249, 144.96787656"
51120241103,5,2024-11-03,11,768,1022,1790,PriNW_T,"-37.81874249, 144.96787656"
871020250803,87,2025-08-03,10,85,96,181,Errol23_T,"-37.80454949, 144.94921863"
1081220231109,108,2023-11-09,12,606,478,1084,261Will_T,"-37.81295822, 144.95678789"
872120231018,87,2023-10-18,21,27,35,62,Errol23_T,"-37.80454949, 144.94921863"
872120231214,87,2023-12-14,21,46,54,100,Errol23_T,"-37.80454949, 144.94921863"
611120250428,61,2025-04-28,11,489,513,1002,RMIT14_T,"-37.80767455, 144.96309114"
611920250128,61,2025-01-28,19,367,352,719,RMIT14_T,"-37.80767455, 144.96309114"
50120250728,50,2025-07-28,1,5,0,5,Lyg309_T,"-37.79808192, 144.96721013"
431020231207,43,2023-12-07,10,83,62,145,UM2_T,"-37.79844526, 144.96411782"
43820241020,43,2024-10-20,8,28,13,41,UM2_T,"-37.79844526, 144.96411782"
179320250604,179,2025-06-04,3,2,0,2,Pow61_T,"-37.82392385, 144.96299677"
1791320250619,179,2025-06-19,13,67,42,109,Pow61_T,"-37.82392385, 144.96299677"
135720241212,135,2024-12-12,7,185,200,385,Spen161_T,"-37.8172861, 144.95319102"
1241120250305,124,2025-03-05,11,10,7,17,BirBridge_T,"-37.81757416, 144.97329934"
67020231105,67,2023-11-05,0,64,116,180,FLDegS_T,"-37.81688755, 144.96562569"
171720241117,17,2024-11-17,17,142,146,288,Col15_T,"-37.81362543, 144.97323591"
172120241217,17,2024-12-17,21,92,82,174,Col15_T,"-37.81362543, 144.97323591"
11020240809,1,2024-08-09,10,503,501,1004,Bou292_T,"-37.81349441, 144.96515323"
18120250815,18,2025-08-15,1,2,1,3,Col12_T,"-37.81344862, 144.97305353"
62120251012,62,2025-10-12,1,74,65,139,Lat224_T,"-37.80996494, 144.96216521"
56420240529,56,2024-05-29,4,3,4,7,Lon364_T,"-37.81234775, 144.96153311"
86320241202,86,2024-12-02,3,2,0,2,574Qub_T,"-37.80309992, 144.94908064"
861320250527,86,2025-05-27,13,35,53,88,574Qub_T,"-37.80309992, 144.94908064"
861420250802,86,2025-08-02,14,56,68,124,574Qub_T,"-37.80309992, 144.94908064"
861820241023,86,2024-10-23,18,61,88,149,574Qub_T,"-37.80309992, 144.94908064"
86520250626,86,2025-06-26,5,2,0,2,574Qub_T,"-37.80309992, 144.94908064"
111320250110,11,2025-01-10,13,112,69,181,WatCit_T,"-37.81564989, 144.93970694"
112320231104,11,2023-11-04,23,24,24,48,WatCit_T,"-37.81564989, 144.93970694"
241220240205,24,2024-02-05,12,576,598,1174,Col620_T,"-37.81887963, 144.95449198"
121120241003,12,2024-10-03,11,97,158,255,NewQ_T,"-37.81457988, 144.94292398"
722020240416,72,2024-04-16,20,195,237,432,ACMI_T,"-37.81726338, 144.96872809"
72020250823,72,2025-08-23,0,44,84,128,ACMI_T,"-37.81726338, 144.96872809"
721020241202,72,2024-12-02,10,125,122,247,ACMI_T,"-37.81726338, 144.96872809"
72020241229,72,2024-12-29,0,31,37,68,ACMI_T,"-37.81726338, 144.96872809"
762020250817,76,2025-08-17,20,13,12,25,KenMac_T,"-37.79453803, 144.93036194"
91920250107,9,2025-01-07,19,115,54,169,Col700_T,"-37.81982992, 144.95102555"
271120250723,27,2025-07-23,11,85,111,196,Vic_T,"-37.80606888, 144.95644692"
91820240107,9,2024-01-07,18,32,37,69,Col700_T,"-37.81982992, 144.95102555"
91820251014,9,2025-10-14,18,910,124,1034,Col700_T,"-37.81982992, 144.95102555"
79120250628,79,2025-06-28,1,53,91,144,FliSS_T,"-37.81794046, 144.96616678"
302320250321,30,2025-03-21,23,382,436,818,Lon189_T,"-37.8112185, 144.96656806"
25720250522,25,2025-05-22,7,155,253,408,MCEC_T,"-37.82401776, 144.95604426"
461020240920,46,2024-09-20,10,86,61,147,Pel147_T,"-37.80240719, 144.9615673"
1412120231112,141,2023-11-12,21,52,92,144,474Fl_T,"-37.81997273, 144.95834911"
1361320241111,136,2024-11-11,13,86,61,147,BirFed1120_T,"-37.8184141, 144.97357915"
1392120240725,139,2024-07-25,21,17,8,25,Signal1647_T,"-37.81959923, 144.9632832"
1391420241104,139,2024-11-04,14,140,61,201,Signal1647_T,"-37.81959923, 144.9632832"
1302120250204,130,2025-02-04,21,15,4,19,Bou892T,"-37.8204637, 144.94126826"
661820251012,66,2025-10-12,18,981,1066,2047,QVN_T,"-37.81057846, 144.96444294"
84620240319,84,2024-03-19,6,282,111,393,ElFi_T,"-37.81798049, 144.96503383"
70420250605,70,2025-06-05,4,1,1,2,Errol20_T,"-37.80456984, 144.94946228"
4420250518,4,2025-05-18,4,34,30,64,Swa123_T,"-37.81487988, 144.9660878"
8920240202,8,2024-02-02,9,159,129,288,WebBN_T,"-37.82293543, 144.9471751"
81820240514,8,2024-05-14,18,104,152,256,WebBN_T,"-37.82293543, 144.9471751"
751120250219,75,2025-02-19,11,51,43,94,SprFli_T,"-37.81515276, 144.97467661"
42720250414,42,2025-04-14,7,68,88,156,UM1_T,"-37.80008566, 144.96386412"
29720240820,29,2024-08-20,7,94,67,161,AG_T,"-37.8199817, 144.96872865"
292220240906,29,2024-09-06,22,84,640,724,AG_T,"-37.8199817, 144.96872865"
14120250202,14,2025-02-02,1,168,33,201,SanBri_T,"-37.82011242, 144.96291897"
29720231227,29,2023-12-27,7,37,30,67,AG_T,"-37.8199817, 144.96872865"
711520250118,71,2025-01-18,15,5,1,6,WestWP_T,"-37.81235775, 144.97136962"
592120240131,59,2024-01-31,21,275,178,453,RMIT_T,"-37.80825648, 144.96304859"
59520240415,59,2024-04-15,5,17,28,45,RMIT_T,"-37.80825648, 144.96304859"
28220250420,28,2025-04-20,2,46,23,69,VAC_T,"-37.82129925, 144.96879309"
541420241006,54,2024-10-06,14,187,123,310,Swa607_T,"-37.804024, 144.96308399"
471420240624,47,2024-06-24,14,779,725,1504,Eli250_T,"-37.81258467, 144.9625775"
47920240213,47,2024-02-13,9,287,651,938,Eli250_T,"-37.81258467, 144.9625775"
312220240128,31,2024-01-28,22,133,187,320,Lyg161_T,"-37.80169681, 144.96658911"
361620250817,36,2025-08-17,16,79,83,162,Que85_T,"-37.81652527, 144.96121062"
501120250825,50,2025-08-25,11,113,165,278,Lyg309_T,"-37.79808192, 144.96721013"
441720250322,44,2025-03-22,17,62,77,139,UM3_T,"-37.79698741, 144.96441306"
1401920241215,140,2024-12-15,19,86,80,166,Boyd2837_T,"-37.82590962, 144.96185972"
1371020241014,137,2024-10-14,10,24,21,45,BouHbr2353_T,"-37.81894815, 144.94612292"
66520250925,66,2025-09-25,5,15,38,53,QVN_T,"-37.81057846, 144.96444294"
691120240915,69,2024-09-15,11,323,235,558,FLDegC_T,"-37.81687226, 144.96559144"
69620250529,69,2025-05-29,6,8,5,13,FLDegC_T,"-37.81687226, 144.96559144"
661420240627,66,2024-06-27,14,1122,1047,2169,QVN_T,"-37.81057846, 144.96444294"
41320231214,4,2023-12-14,13,2218,1854,4072,Swa123_T,"-37.81487988, 144.9660878"
70520250119,70,2025-01-19,5,0,4,4,Errol20_T,"-37.80456984, 144.94946228"
75720250110,75,2025-01-10,7,17,19,36,SprFli_T,"-37.81515276, 144.97467661"
41020231227,41,2023-12-27,0,181,138,319,Swa31,"-37.81668634, 144.96689733"
772020231025,77,2023-10-25,20,64,58,122,HarEsP_T,"-37.81441438, 144.94433026"
41720240629,41,2024-06-29,7,29,36,65,Swa31,"-37.81668634, 144.96689733"
71920231216,71,2023-12-16,9,3,4,7,WestWP_T,"-37.81235775, 144.97136962"
281320240418,28,2024-04-18,13,501,503,1004,VAC_T,"-37.82129925, 144.96879309"
292320241106,29,2024-11-06,23,23,20,43,AG_T,"-37.8199817, 144.96872865"
29920250531,29,2025-05-31,9,146,147,293,AG_T,"-37.8199817, 144.96872865"
28520240204,28,2024-02-04,5,13,22,35,VAC_T,"-37.82129925, 144.96879309"
141220240508,14,2024-05-08,12,342,206,548,SanBri_T,"-37.82011242, 144.96291897"
312320240924,31,2024-09-24,23,24,25,49,Lyg161_T,"-37.80169681, 144.96658911"
54620241015,54,2024-10-15,6,20,10,30,Swa607_T,"-37.804024, 144.96308399"
471020240523,47,2024-05-23,10,369,513,882,Eli250_T,"-37.81258467, 144.9625775"
51920250405,5,2025-04-05,19,1169,2105,3274,PriNW_T,"-37.81874249, 144.96787656"
212320240312,21,2024-03-12,23,92,69,161,Bourke155_T,"-37.81267313, 144.96788288"
502320231213,50,2023-12-13,23,39,19,58,Lyg309_T,"-37.79808192, 144.96721013"
50220250316,50,2025-03-16,2,4,1,5,Lyg309_T,"-37.79808192, 144.96721013"
135720251015,135,2025-10-15,7,1,1,2,Spen161_T,"-37.8172861, 144.95319102"
1181320240530,118,2024-05-30,13,17,9,26,Fli114C_T,"-37.81632783, 144.97090512"
1081520240627,108,2024-06-27,15,178,191,369,261Will_T,"-37.81295822, 144.95678789"
87820240623,87,2024-06-23,8,20,16,36,Errol23_T,"-37.80454949, 144.94921863"
1822020250530,182,2025-05-30,20,314,265,579,King163_T,"-37.81627451, 144.95550503"
167520250530,167,2025-05-30,5,0,3,3,Lat526_T,"-37.81304149, 144.95155955"
1322220241207,132,2024-12-07,22,82,115,197,King335_T,"-37.81267639, 144.95386444"
1341620240304,134,2024-03-04,16,439,521,960,Spen201_T,"-37.81694221, 144.95303935"
171420241113,17,2024-11-13,14,291,331,622,Col15_T,"-37.81362543, 144.97323591"
172320241116,17,2024-11-16,23,74,88,162,Col15_T,"-37.81362543, 144.97323591"
11420240918,1,2024-09-18,14,985,972,1957,Bou292_T,"-37.81349441, 144.96515323"
181620241021,18,2024-10-21,16,484,116,600,Col12_T,"-37.81344862, 144.97305353"
112220231111,11,2023-11-11,22,42,61,103,WatCit_T,"-37.81564989, 144.93970694"
111420240901,11,2024-09-01,14,99,99,198,WatCit_T,"-37.81564989, 144.93970694"
62320231205,62,2023-12-05,3,20,5,25,Lat224_T,"-37.80996494, 144.96216521"
1120250612,1,2025-06-12,1,12,7,19,Bou292_T,"-37.81349441, 144.96515323"
241920241227,24,2024-12-27,19,361,549,910,Col620_T,"-37.81887963, 144.95449198"
721220250116,72,2025-01-16,12,340,436,776,ACMI_T,"-37.81726338, 144.96872809"
58520240320,58,2024-03-20,5,111,26,137,Bou688_T,"-37.81686075, 144.95358075"
351420250226,35,2025-02-26,14,861,871,1732,SouthB_T,"-37.82018685, 144.96508508"
351820250606,35,2025-06-06,18,859,698,1557,SouthB_T,"-37.82018685, 144.96508508"
2520240528,2,2024-05-28,5,1,5,6,Bou283_T,"-37.81380668, 144.96516718"
21220240706,2,2024-07-06,12,722,799,1521,Bou283_T,"-37.81380668, 144.96516718"
53620240706,53,2024-07-06,6,12,15,27,Col254_T,"-37.81564191, 144.965499"
27320250706,27,2025-07-06,3,17,6,23,Vic_T,"-37.80606888, 144.95644692"
301320241210,30,2024-12-10,13,358,419,777,Lon189_T,"-37.8112185, 144.96656806"
791520250305,79,2025-03-05,15,450,480,930,FliSS_T,"-37.81794046, 144.96616678"
231620240717,23,2024-07-17,16,230,645,875,Col623_T,"-37.81909256, 144.95452748"
251820250128,25,2025-01-28,18,727,339,1066,MCEC_T,"-37.82401776, 144.95604426"
201420231026,20,2023-10-26,14,155,149,304,LtB170_T,"-37.81172914, 144.9682466"
86220241115,86,2024-11-15,2,0,1,1,574Qub_T,"-37.80309992, 144.94908064"
24620241226,24,2024-12-26,6,55,85,140,Col620_T,"-37.81887963, 144.95449198"
122320250913,12,2025-09-13,23,43,57,100,NewQ_T,"-37.81457988, 144.94292398"
792320250802,79,2025-08-02,23,209,578,787,FliSS_T,"-37.81794046, 144.96616678"
301220241028,30,2024-10-28,12,214,364,578,Lon189_T,"-37.8112185, 144.96656806"
30820241211,30,2024-12-11,8,89,109,198,Lon189_T,"-37.8112185, 144.96656806"
302220240921,30,2024-09-21,22,450,659,1109,Lon189_T,"-37.8112185, 144.96656806"
461420250910,46,2025-09-10,14,141,113,254,Pel147_T,"-37.80240719, 144.9615673"
1172020240406,117,2024-04-06,20,187,192,379,Fli114F_T,"-37.81629332, 144.97090877"
481520231106,48,2023-11-06,15,126,131,257,QVMQ_T,"-37.80631581, 144.95866697"
180620250503,180,2025-05-03,6,6,2,8,Mac330_T,"-37.79497059, 144.93530329"
1361020231230,136,2023-12-30,10,46,24,70,BirFed1120_T,"-37.8184141, 144.97357915"
142620240220,142,2024-02-20,6,116,26,142,Hammer1584_T,"-37.81970749, 144.96795734"
69920231201,69,2023-12-01,9,230,71,301,FLDegC_T,"-37.81687226, 144.96559144"
84520240601,84,2024-06-01,5,31,26,57,ElFi_T,"-37.81798049, 144.96503383"
842120240620,84,2024-06-20,21,407,781,1188,ElFi_T,"-37.81798049, 144.96503383"
841520250722,84,2025-07-22,15,755,1122,1877,ElFi_T,"-37.81798049, 144.96503383"
751420240714,75,2024-07-14,14,35,81,116,SprFli_T,"-37.81515276, 144.97467661"
781820250729,78,2025-07-29,18,3,16,19,HarEsB_T,"-37.81471642, 144.9446508"
771420231101,77,2023-11-01,14,118,96,214,HarEsP_T,"-37.81441438, 144.94433026"
282320241106,28,2024-11-06,23,52,25,77,VAC_T,"-37.82129925, 144.96879309"
541020250429,54,2025-04-29,10,152,115,267,Swa607_T,"-37.804024, 144.96308399"
471720250413,47,2025-04-13,17,919,775,1694,Eli250_T,"-37.81258467, 144.9625775"
47120240618,47,2024-06-18,1,40,46,86,Eli250_T,"-37.81258467, 144.9625775"
401720250729,40,2025-07-29,17,152,282,434,Spr201_T,"-37.80999341, 144.97227587"
311420250413,31,2025-04-13,14,250,211,461,Lyg161_T,"-37.80169681, 144.96658911"
362320231112,36,2023-11-12,23,13,16,29,Que85_T,"-37.81652527, 144.96121062"
108420231225,108,2023-12-25,4,9,15,24,261Will_T,"-37.81295822, 144.95678789"
61120250323,61,2025-03-23,1,95,47,142,RMIT14_T,"-37.80767455, 144.96309114"
501020241211,50,2024-12-11,10,121,152,273,Lyg309_T,"-37.79808192, 144.96721013"
432220240405,43,2024-04-05,22,26,27,53,UM2_T,"-37.79844526, 144.96411782"
43420240420,43,2024-04-20,4,0,1,1,UM2_T,"-37.79844526, 144.96411782"
1661520250609,166,2025-06-09,15,55,58,113,Spen484_T,"-37.80896733, 144.94931703"
131220240408,131,2024-04-08,2,9,19,28,King2_T,"-37.82009057, 144.95758725"
1311020250930,131,2025-09-30,10,74,123,197,King2_T,"-37.82009057, 144.95758725"
1321820240911,132,2024-09-11,18,117,159,276,King335_T,"-37.81267639, 144.95386444"
132720241001,132,2024-10-01,7,71,42,113,King335_T,"-37.81267639, 144.95386444"
1341920240427,134,2024-04-27,19,250,197,447,Spen201_T,"-37.81694221, 144.95303935"
85320250131,85,2025-01-31,3,1,0,1,488Mac_T,"-37.79432415, 144.92973378"
17220250714,17,2025-07-14,2,4,3,7,Col15_T,"-37.81362543, 144.97323591"
67720240715,67,2024-07-15,7,144,124,268,FLDegS_T,"-37.81688755, 144.96562569"
67420250410,67,2025-04-10,4,3,4,7,FLDegS_T,"-37.81688755, 144.96562569"
671520240806,67,2024-08-06,15,290,638,928,FLDegS_T,"-37.81688755, 144.96562569"
62020241116,62,2024-11-16,0,102,78,180,Lat224_T,"-37.80996494, 144.96216521"
562020241231,56,2024-12-31,20,425,420,845,Lon364_T,"-37.81234775, 144.96153311"
112120231117,11,2023-11-17,21,107,92,199,WatCit_T,"-37.81564989, 144.93970694"
241320231214,24,2023-12-14,13,580,656,1236,Col620_T,"-37.81887963, 144.95449198"
12720231109,12,2023-11-09,7,92,89,181,NewQ_T,"-37.81457988, 144.94292398"
121520231123,12,2023-11-23,15,184,186,370,NewQ_T,"-37.81457988, 144.94292398"
241820250406,24,2025-04-06,18,435,558,993,Col620_T,"-37.81887963, 144.95449198"
101720240210,10,2024-02-10,17,57,38,95,BouHbr_T,"-37.81876474, 144.94710545"
51620250319,51,2025-03-19,6,39,13,52,Fra118_T,"-37.80841815, 144.95906316"
1361920240305,136,2024-03-05,19,919,63,982,BirFed1120_T,"-37.8184141, 144.97357915"
1361920241227,136,2024-12-27,19,48,169,217,BirFed1120_T,"-37.8184141, 144.97357915"
139120240308,139,2024-03-08,1,5,10,15,Signal1647_T,"-37.81959923, 144.9632832"
1301620241212,130,2024-12-12,16,59,52,111,Bou892T,"-37.8204637, 144.94126826"
1301220250529,130,2025-05-29,12,133,97,230,Bou892T,"-37.8204637, 144.94126826"
117020250209,117,2025-02-09,0,71,46,117,Fli114F_T,"-37.81629332, 144.97090877"
1231020250825,123,2025-08-25,10,11,9,20,BirBridge_T,"-37.81753741, 144.97329734"
1091420240724,109,2024-07-24,14,64,174,238,LatWill_T,"-37.81193681, 144.95621105"
661420250211,66,2025-02-11,14,860,968,1828,QVN_T,"-37.81057846, 144.96444294"
69920240430,69,2024-04-30,9,181,57,238,FLDegC_T,"-37.81687226, 144.96559144"
701120250827,70,2025-08-27,11,127,147,274,Errol20_T,"-37.80456984, 144.94946228"
4920250706,4,2025-07-06,9,400,258,658,Swa123_T,"-37.81487988, 144.9660878"
81720231205,8,2023-12-05,17,245,436,681,WebBN_T,"-37.82293543, 144.9471751"
591520240329,59,2024-03-29,15,507,401,908,RMIT_T,"-37.80825648, 144.96304859"
14820231224,14,2023-12-24,8,100,45,145,SanBri_T,"-37.82011242, 144.96291897"
281320241203,28,2024-12-03,13,375,392,767,VAC_T,"-37.82129925, 144.96879309"
311320231115,31,2023-11-15,13,203,195,398,Lyg161_T,"-37.80169681, 144.96658911"
31020241105,31,2024-11-05,0,4,24,28,Lyg161_T,"-37.80169681, 144.96658911"
31720250204,31,2025-02-04,7,26,21,47,Lyg161_T,"-37.80169681, 144.96658911"
54620240808,54,2024-08-08,6,19,5,24,Swa607_T,"-37.804024, 144.96308399"
28120240108,28,2024-01-08,1,13,11,24,VAC_T,"-37.82129925, 144.96879309"
5220250816,5,2025-08-16,2,32,61,93,PriNW_T,"-37.81874249, 144.96787656"
211420240412,21,2024-04-12,14,336,473,809,Bourke155_T,"-37.81267313, 144.96788288"
43420241109,43,2024-11-09,4,2,0,2,UM2_T,"-37.79844526, 144.96411782"
1311420241120,131,2024-11-20,14,148,99,247,King2_T,"-37.82009057, 144.95758725"
87520250927,87,2025-09-27,5,5,2,7,Errol23_T,"-37.80454949, 144.94921863"
87220250322,87,2025-03-22,2,1,0,1,Errol23_T,"-37.80454949, 144.94921863"
612220240113,61,2024-01-13,22,114,120,234,RMIT14_T,"-37.80767455, 144.96309114"
1851720250713,185,2025-07-13,17,603,546,1149,Eli197_T,"-37.81374643, 144.96276183"
1651320241028,165,2024-10-28,13,51,45,96,Spen475_T,"-37.80953359, 144.94939004"
1652220250628,165,2025-06-28,22,59,3,62,Spen475_T,"-37.80953359, 144.94939004"
1651520250713,165,2025-07-13,15,48,26,74,Spen475_T,"-37.80953359, 144.94939004"
242320250212,24,2025-02-12,23,130,257,387,Col620_T,"-37.81887963, 144.95449198"
581920250415,58,2025-04-15,19,312,369,681,Bou688_T,"-37.81686075, 144.95358075"
2920241112,2,2024-11-12,9,156,201,357,Bou283_T,"-37.81380668, 144.96516718"
2320241225,2,2024-12-25,3,8,32,40,Bou283_T,"-37.81380668, 144.96516718"
91420240928,9,2024-09-28,14,45,82,127,Col700_T,"-37.81982992, 144.95102555"
92020250203,9,2025-02-03,20,73,39,112,Col700_T,"-37.81982992, 144.95102555"
27320240618,27,2024-06-18,3,5,4,9,Vic_T,"-37.80606888, 144.95644692"
27020241022,27,2024-10-22,0,24,6,30,Vic_T,"-37.80606888, 144.95644692"
271320250514,27,2025-05-14,13,96,98,194,Vic_T,"-37.80606888, 144.95644692"
301220240131,30,2024-01-31,12,316,417,733,Lon189_T,"-37.8112185, 144.96656806"
531920241221,53,2024-12-21,19,433,258,691,Col254_T,"-37.81564191, 144.965499"
23020240714,23,2024-07-14,0,24,64,88,Col623_T,"-37.81909256, 144.95452748"
512320240703,51,2024-07-03,23,45,51,96,Fra118_T,"-37.80841815, 144.95906316"
791520250512,79,2025-05-12,15,415,525,940,FliSS_T,"-37.81794046, 144.96616678"
301120250505,30,2025-05-05,11,145,217,362,Lon189_T,"-37.8112185, 144.96656806"
721820240406,72,2024-04-06,18,224,380,604,ACMI_T,"-37.81726338, 144.96872809"
12220250829,12,2025-08-29,2,2,0,2,NewQ_T,"-37.81457988, 144.94292398"
722020240615,72,2024-06-15,20,325,388,713,ACMI_T,"-37.81726338, 144.96872809"
351120231124,35,2023-11-24,11,854,1048,1902,SouthB_T,"-37.82018685, 144.96508508"
202120240402,20,2024-04-02,21,173,379,552,LtB170_T,"-37.81172914, 144.9682466"
201720240531,20,2024-05-31,17,401,231,632,LtB170_T,"-37.81172914, 144.9682466"
461720240311,46,2024-03-11,17,135,106,241,Pel147_T,"-37.80240719, 144.9615673"
462320250810,46,2025-08-10,23,5,0,5,Pel147_T,"-37.80240719, 144.9615673"
522120240221,52,2024-02-21,21,203,143,346,Eli263_T,"-37.81252157, 144.9619401"
512120250929,51,2025-09-29,21,47,58,105,Fra118_T,"-37.80841815, 144.95906316"
51420240920,51,2024-09-20,4,8,9,17,Fra118_T,"-37.80841815, 144.95906316"
512320231109,51,2023-11-09,23,43,37,80,Fra118_T,"-37.80841815, 144.95906316"
491820241027,49,2024-10-27,18,188,204,392,Eli501_T,"-37.80730068, 144.95956055"
1172020250305,117,2025-03-05,20,124,136,260,Fli114F_T,"-37.81629332, 144.97090877"
491420240406,49,2024-04-06,14,396,737,1133,Eli501_T,"-37.80730068, 144.95956055"
1092120240308,109,2024-03-08,21,92,128,220,LatWill_T,"-37.81193681, 144.95621105"
109820250103,109,2025-01-03,8,39,130,169,LatWill_T,"-37.81193681, 144.95621105"
1411520250910,141,2025-09-10,15,102,89,191,474Fl_T,"-37.81997273, 144.95834911"
142520250524,142,2025-05-24,5,1,0,1,Hammer1584_T,"-37.81970749, 144.96795734"
142620251008,142,2025-10-08,6,104,70,174,Hammer1584_T,"-37.81970749, 144.96795734"
142820241004,142,2024-10-04,8,172,160,332,Hammer1584_T,"-37.81970749, 144.96795734"
69420240728,69,2024-07-28,4,3,4,7,FLDegC_T,"-37.81687226, 144.96559144"
61420250519,6,2025-05-19,14,738,571,1309,FliS_T,"-37.81911705, 144.96558255"
841620241116,84,2024-11-16,16,943,1213,2156,ElFi_T,"-37.81798049, 144.96503383"
39120231102,39,2023-11-02,1,0,1,1,AlfPl_T,"-37.81379749, 144.96995745"
411020250215,41,2025-02-15,10,1340,878,2218,Swa31,"-37.81668634, 144.96689733"
71920250816,71,2025-08-16,9,17,19,36,WestWP_T,"-37.81235775, 144.97136962"
592220240830,59,2024-08-30,22,504,309,813,RMIT_T,"-37.80825648, 144.96304859"
65220240208,65,2024-02-08,2,10,9,19,SwaCs_T,"-37.81569416, 144.9668064"
54720250414,54,2025-04-14,7,42,16,58,Swa607_T,"-37.804024, 144.96308399"
541420250704,54,2025-07-04,14,109,141,250,Swa607_T,"-37.804024, 144.96308399"
401020250623,40,2025-06-23,10,157,145,302,Spr201_T,"-37.80999341, 144.97227587"
401320241201,40,2024-12-01,13,133,175,308,Spr201_T,"-37.80999341, 144.97227587"
361620250714,36,2025-07-14,16,178,176,354,Que85_T,"-37.81652527, 144.96121062"
45220250821,45,2025-08-21,2,4,4,8,Swa148_T,"-37.81414075, 144.96609379"
452020250125,45,2025-01-25,20,385,828,1213,Swa148_T,"-37.81414075, 144.96609379"
51520240621,5,2024-06-21,15,1015,682,1697,PriNW_T,"-37.81874249, 144.96787656"
107720250623,107,2025-06-23,7,29,83,112,280Will_T,"-37.81246271, 144.95690188"
107320231213,107,2023-12-13,3,4,6,10,280Will_T,"-37.81246271, 144.95690188"
1081820240402,108,2024-04-02,18,509,111,620,261Will_T,"-37.81295822, 144.95678789"
108420240428,108,2024-04-28,4,0,8,8,261Will_T,"-37.81295822, 144.95678789"
872320240828,87,2024-08-28,23,9,3,12,Errol23_T,"-37.80454949, 144.94921863"
871620231029,87,2023-10-29,16,77,72,149,Errol23_T,"-37.80454949, 144.94921863"
502320240316,50,2024-03-16,23,144,30,174,Lyg309_T,"-37.79808192, 144.96721013"
166420250211,166,2025-02-11,4,0,4,4,Spen484_T,"-37.80896733, 144.94931703"
1662020250707,166,2025-07-07,20,1,11,12,Spen484_T,"-37.80896733, 144.94931703"
179720250419,179,2025-04-19,7,18,6,24,Pow61_T,"-37.82392385, 144.96299677"
179220250518,179,2025-05-18,2,3,7,10,Pow61_T,"-37.82392385, 144.96299677"
1311220250513,131,2025-05-13,12,151,197,348,King2_T,"-37.82009057, 144.95758725"
1431820250806,143,2025-08-06,18,139,156,295,Spencer_T,"-37.821728, 144.95557015"
132420240729,132,2024-07-29,4,6,3,9,King335_T,"-37.81267639, 144.95386444"
1181520241230,118,2024-12-30,15,19,27,46,Fli114C_T,"-37.81632783, 144.97090512"
1351720250725,135,2025-07-25,17,515,500,1015,Spen161_T,"-37.8172861, 144.95319102"
682120240209,68,2024-02-09,21,120,31,151,FLDegN_T,"-37.8168479, 144.96559789"
171120231214,17,2023-12-14,11,483,338,821,Col15_T,"-37.81362543, 144.97323591"
17220250507,17,2025-05-07,2,1,0,1,Col15_T,"-37.81362543, 144.97323591"
111120240306,11,2024-03-06,11,57,52,109,WatCit_T,"-37.81564989, 144.93970694"
862020240929,86,2024-09-29,20,12,27,39,574Qub_T,"-37.80309992, 144.94908064"
72920250617,72,2025-06-17,9,325,97,422,ACMI_T,"-37.81726338, 144.96872809"
351820241115,35,2024-11-15,18,1872,1879,3751,SouthB_T,"-37.82018685, 144.96508508"
351620240611,35,2024-06-11,16,1007,797,1804,SouthB_T,"-37.82018685, 144.96508508"
56420250830,56,2025-08-30,4,9,13,22,Lon364_T,"-37.81234775, 144.96153311"
582020240822,58,2024-08-22,20,261,233,494,Bou688_T,"-37.81686075, 144.95358075"
271920250613,27,2025-06-13,19,111,100,211,Vic_T,"-37.80606888, 144.95644692"
9920240304,9,2024-03-04,9,145,1448,1593,Col700_T,"-37.81982992, 144.95102555"
53220250503,53,2025-05-03,2,12,12,24,Col254_T,"-37.81564191, 144.965499"
792020240911,79,2024-09-11,20,223,215,438,FliSS_T,"-37.81794046, 144.96616678"
30320240226,30,2024-02-26,3,48,52,100,Lon189_T,"-37.8112185, 144.96656806"
201520240814,20,2024-08-14,15,185,317,502,LtB170_T,"-37.81172914, 144.9682466"
52120251013,52,2025-10-13,1,8,40,48,Eli263_T,"-37.81252157, 144.9619401"
25120240603,25,2024-06-03,1,18,7,25,MCEC_T,"-37.82401776, 144.95604426"
25420240613,25,2024-06-13,4,2,5,7,MCEC_T,"-37.82401776, 144.95604426"
52820231219,52,2023-12-19,8,130,188,318,Eli263_T,"-37.81252157, 144.9619401"
23820250619,23,2025-06-19,8,980,441,1421,Col623_T,"-37.81909256, 144.95452748"
491920241217,49,2024-12-17,19,192,155,347,Eli501_T,"-37.80730068, 144.95956055"
49420250129,49,2025-01-29,4,9,19,28,Eli501_T,"-37.80730068, 144.95956055"
109620240125,109,2024-01-25,6,23,95,118,LatWill_T,"-37.81193681, 144.95621105"
1091820250505,109,2025-05-05,18,183,116,299,LatWill_T,"-37.81193681, 144.95621105"
482220250418,48,2025-04-18,22,51,83,134,QVMQ_T,"-37.80631581, 144.95866697"
48020240317,48,2024-03-17,0,44,65,109,QVMQ_T,"-37.80631581, 144.95866697"
1371720241111,137,2024-11-11,17,10,102,112,BouHbr2353_T,"-37.81894815, 144.94612292"
141420231217,141,2023-12-17,4,80,38,118,474Fl_T,"-37.81997273, 144.95834911"
1392020240630,139,2024-06-30,20,8,8,16,Signal1647_T,"-37.81959923, 144.9632832"
1392120240905,139,2024-09-05,21,11,18,29,Signal1647_T,"-37.81959923, 144.9632832"
1391920250126,139,2025-01-26,19,73,41,114,Signal1647_T,"-37.81959923, 144.9632832"
1231120240306,123,2024-03-06,11,28,13,41,BirBridge_T,"-37.81753741, 144.97329734"
164220250609,164,2025-06-09,2,2,9,11,Lat526_T,"-37.813005, 144.95160411"
164420241126,164,2024-11-26,4,2,1,3,Lat526_T,"-37.813005, 144.95160411"
1381620241128,138,2024-11-28,16,12,6,18,EntPark1671_T,"-37.81996544, 144.95981454"
661320231210,66,2023-12-10,13,1507,2154,3661,QVN_T,"-37.81057846, 144.96444294"
66220250312,66,2025-03-12,2,23,16,39,QVN_T,"-37.81057846, 144.96444294"
75420240818,75,2024-08-18,4,1,4,5,SprFli_T,"-37.81515276, 144.97467661"
411120240731,41,2024-07-31,11,227,204,431,Swa31,"-37.81668634, 144.96689733"
772020250525,77,2025-05-25,20,124,82,206,HarEsP_T,"-37.81441438, 144.94433026"
42420240826,42,2024-08-26,4,3,1,4,UM1_T,"-37.80008566, 144.96386412"
541520240919,54,2024-09-19,15,147,278,425,Swa607_T,"-37.804024, 144.96308399"
402020240405,40,2024-04-05,20,148,141,289,Spr201_T,"-37.80999341, 144.97227587"
31120250923,31,2025-09-23,1,3,4,7,Lyg161_T,"-37.80169681, 144.96658911"
25020250705,25,2025-07-05,0,31,58,89,MCEC_T,"-37.82401776, 144.95604426"
25020231101,25,2023-11-01,0,13,11,24,MCEC_T,"-37.82401776, 144.95604426"
511820250628,51,2025-06-28,18,96,98,194,Fra118_T,"-37.80841815, 144.95906316"
1361420250908,136,2025-09-08,14,90,41,131,BirFed1120_T,"-37.8184141, 144.97357915"
1421520241205,142,2024-12-05,15,222,157,379,Hammer1584_T,"-37.81970749, 144.96795734"
1421520250108,142,2025-01-08,15,487,367,854,Hammer1584_T,"-37.81970749, 144.96795734"
1641820250117,164,2025-01-17,18,98,96,194,Lat526_T,"-37.813005, 144.95160411"
1171320250625,117,2025-06-25,13,102,155,257,Fli114F_T,"-37.81629332, 144.97090877"
123820250828,123,2025-08-28,8,63,16,79,BirBridge_T,"-37.81753741, 144.97329734"
1231220250923,123,2025-09-23,12,65,58,123,BirBridge_T,"-37.81753741, 144.97329734"
141420240430,141,2024-04-30,4,12,6,18,474Fl_T,"-37.81997273, 144.95834911"
1411520250412,141,2025-04-12,15,183,158,341,474Fl_T,"-37.81997273, 144.95834911"
171520240818,17,2024-08-18,15,214,185,399,Col15_T,"-37.81362543, 144.97323591"
62920231230,62,2023-12-30,9,26,38,64,Lat224_T,"-37.80996494, 144.96216521"
621220240824,62,2024-08-24,12,154,141,295,Lat224_T,"-37.80996494, 144.96216521"
691320250912,69,2025-09-12,13,349,279,628,FLDegC_T,"-37.81687226, 144.96559144"
4920231206,4,2023-12-06,9,861,439,1300,Swa123_T,"-37.81487988, 144.9660878"
4320240413,4,2024-04-13,3,87,105,192,Swa123_T,"-37.81487988, 144.9660878"
751820250108,75,2025-01-08,18,48,46,94,SprFli_T,"-37.81515276, 144.97467661"
772120240403,77,2024-04-03,21,73,64,137,HarEsP_T,"-37.81441438, 144.94433026"
42820241020,42,2024-10-20,8,10,19,29,UM1_T,"-37.80008566, 144.96386412"
592320250807,59,2025-08-07,23,205,94,299,RMIT_T,"-37.80825648, 144.96304859"
541820240609,54,2024-06-09,18,183,173,356,Swa607_T,"-37.804024, 144.96308399"
472220250729,47,2025-07-29,22,192,197,389,Eli250_T,"-37.81258467, 144.9625775"
472220241108,47,2024-11-08,22,445,352,797,Eli250_T,"-37.81258467, 144.9625775"
371420231030,37,2023-10-30,14,80,72,152,Lyg260_T,"-37.80107122, 144.96704554"
441420250705,44,2025-07-05,14,74,101,175,UM3_T,"-37.79698741, 144.96441306"
451620251010,45,2025-10-10,16,475,839,1314,Swa148_T,"-37.81414075, 144.96609379"
135620251003,135,2025-10-03,6,80,109,189,Spen161_T,"-37.8172861, 144.95319102"
131820250701,131,2025-07-01,8,161,33,194,King2_T,"-37.82009057, 144.95758725"
1331120241115,133,2024-11-15,11,465,497,962,Spen229_T,"-37.81531435, 144.95227769"
133220240614,133,2024-06-14,2,10,11,21,Spen229_T,"-37.81531435, 144.95227769"
1181020241003,118,2024-10-03,10,11,18,29,Fli114C_T,"-37.81632783, 144.97090512"
1181620231127,118,2023-11-27,16,11,32,43,Fli114C_T,"-37.81632783, 144.97090512"
1071620240506,107,2024-05-06,16,83,103,186,280Will_T,"-37.81246271, 144.95690188"
1851120250826,185,2025-08-26,11,436,456,892,Eli197_T,"-37.81374643, 144.96276183"
1851520250921,185,2025-09-21,15,626,714,1340,Eli197_T,"-37.81374643, 144.96276183"
1651520250919,165,2025-09-19,15,38,40,78,Spen475_T,"-37.80953359, 144.94939004"
1401520250818,140,2025-08-18,15,80,86,166,Boyd2837_T,"-37.82590962, 144.96185972"
132820250223,132,2025-02-23,8,63,30,93,King335_T,"-37.81267639, 144.95386444"
132520231110,132,2023-11-10,5,9,14,23,King335_T,"-37.81267639, 144.95386444"
1321020231208,132,2023-12-08,10,124,62,186,King335_T,"-37.81267639, 144.95386444"
1341420240618,134,2024-06-18,14,295,319,614,Spen201_T,"-37.81694221, 144.95303935"
68820250929,68,2025-09-29,8,158,109,267,FLDegN_T,"-37.8168479, 144.96559789"
181220240331,18,2024-03-31,12,50,89,139,Col12_T,"-37.81344862, 144.97305353"
108020250822,108,2025-08-22,0,36,28,64,261Will_T,"-37.81295822, 144.95678789"
108920241202,108,2024-12-02,9,211,930,1141,261Will_T,"-37.81295822, 144.95678789"
108420250327,108,2025-03-27,4,8,1,9,261Will_T,"-37.81295822, 144.95678789"
871320250330,87,2025-03-30,13,114,125,239,Errol23_T,"-37.80454949, 144.94921863"
61120250919,61,2025-09-19,1,24,7,31,RMIT14_T,"-37.80767455, 144.96309114"
612320250316,61,2025-03-16,23,107,65,172,RMIT14_T,"-37.80767455, 144.96309114"
611720240203,61,2024-02-03,17,301,430,731,RMIT14_T,"-37.80767455, 144.96309114"
501420240416,50,2024-04-16,14,170,123,293,Lyg309_T,"-37.79808192, 144.96721013"
502120240701,50,2024-07-01,21,94,51,145,Lyg309_T,"-37.79808192, 144.96721013"
271520240706,27,2024-07-06,15,305,225,530,Vic_T,"-37.80606888, 144.95644692"
91120231220,9,2023-12-20,11,273,374,647,Col700_T,"-37.81982992, 144.95102555"
23820240110,23,2024-01-10,8,653,215,868,Col623_T,"-37.81909256, 144.95452748"
79720240619,79,2024-06-19,7,195,124,319,FliSS_T,"-37.81794046, 144.96616678"
30620241109,30,2024-11-09,6,17,31,48,Lon189_T,"-37.8112185, 144.96656806"
20120250406,20,2025-04-06,1,197,272,469,LtB170_T,"-37.81172914, 144.9682466"
462020240919,46,2024-09-19,20,1,0,1,Pel147_T,"-37.80240719, 144.9615673"
461520240925,46,2024-09-25,15,65,54,119,Pel147_T,"-37.80240719, 144.9615673"
461620241010,46,2024-10-10,16,126,200,326,Pel147_T,"-37.80240719, 144.9615673"
491920240329,49,2024-03-29,19,200,245,445,Eli501_T,"-37.80730068, 144.95956055"
49320240413,49,2024-04-13,3,39,53,92,Eli501_T,"-37.80730068, 144.95956055"
1372020241108,137,2024-11-08,20,3,5,8,BouHbr2353_T,"-37.81894815, 144.94612292"
1391820240527,139,2024-05-27,18,22,11,33,Signal1647_T,"-37.81959923, 144.9632832"
137620240510,137,2024-05-10,6,2,0,2,BouHbr2353_T,"-37.81894815, 144.94612292"
164820250909,164,2025-09-09,8,111,68,179,Lat526_T,"-37.813005, 144.95160411"
1611820250613,161,2025-06-13,18,85,6,91,BirArt1109_T,"-37.81851276, 144.97131336"
691120240905,69,2024-09-05,11,189,168,357,FLDegC_T,"-37.81687226, 144.96559144"
66920240331,66,2024-03-31,9,164,204,368,QVN_T,"-37.81057846, 144.96444294"
41220241102,4,2024-11-02,12,1959,1183,3142,Swa123_T,"-37.81487988, 144.9660878"
411520251007,41,2025-10-07,15,1488,2271,3759,Swa31,"-37.81668634, 144.96689733"
711620250107,71,2025-01-07,16,14,7,21,WestWP_T,"-37.81235775, 144.97136962"
59120240730,59,2024-07-30,1,7,4,11,RMIT_T,"-37.80825648, 144.96304859"
291520231024,29,2023-10-24,15,172,293,465,AG_T,"-37.8199817, 144.96872865"
361120250603,36,2025-06-03,11,189,146,335,Que85_T,"-37.81652527, 144.96121062"
361020231119,36,2023-11-19,10,77,35,112,Que85_T,"-37.81652527, 144.96121062"
442120240507,44,2024-05-07,21,25,34,59,UM3_T,"-37.79698741, 144.96441306"
441920240927,44,2024-09-27,19,8,18,26,UM3_T,"-37.79698741, 144.96441306"
451620250215,45,2025-02-15,16,460,990,1450,Swa148_T,"-37.81414075, 144.96609379"
45120241027,45,2024-10-27,1,66,218,284,Swa148_T,"-37.81414075, 144.96609379"
162920250411,162,2025-04-11,9,292,234,526,Eli489_T,"-37.80740397, 144.95987909"
1321320240708,132,2024-07-08,13,171,152,323,King335_T,"-37.81267639, 144.95386444"
1351320250213,135,2025-02-13,13,418,499,917,Spen161_T,"-37.8172861, 144.95319102"
135320231019,135,2023-10-19,3,16,8,24,Spen161_T,"-37.8172861, 144.95319102"
1181620240824,118,2024-08-24,16,23,73,96,Fli114C_T,"-37.81632783, 144.97090512"
182220250429,182,2025-04-29,2,12,18,30,King163_T,"-37.81627451, 144.95550503"
1661320241130,166,2024-11-30,13,32,45,77,Spen484_T,"-37.80896733, 144.94931703"
1720240420,1,2024-04-20,7,49,46,95,Bou292_T,"-37.81349441, 144.96515323"
11920240624,1,2024-06-24,19,406,279,685,Bou292_T,"-37.81349441, 144.96515323"
182020240214,18,2024-02-14,20,24,27,51,Col12_T,"-37.81344862, 144.97305353"
68020240825,68,2024-08-25,0,4,0,4,FLDegN_T,"-37.8168479, 144.96559789"
68820250101,68,2025-01-01,8,61,51,112,FLDegN_T,"-37.8168479, 144.96559789"
62720231028,62,2023-10-28,7,45,29,74,Lat224_T,"-37.80996494, 144.96216521"
62720250520,62,2025-05-20,7,36,42,78,Lat224_T,"-37.80996494, 144.96216521"
111120250925,11,2025-09-25,11,43,46,89,WatCit_T,"-37.81564989, 144.93970694"
11120240120,11,2024-01-20,1,8,13,21,WatCit_T,"-37.81564989, 144.93970694"
102320241129,10,2024-11-29,23,29,15,44,BouHbr_T,"-37.81876474, 144.94710545"
101020241206,10,2024-12-06,10,78,71,149,BouHbr_T,"-37.81876474, 144.94710545"
351820231228,35,2023-12-28,18,1469,2114,3583,SouthB_T,"-37.82018685, 144.96508508"
581020231222,58,2023-12-22,10,627,207,834,Bou688_T,"-37.81686075, 144.95358075"
21320250619,2,2025-06-19,13,780,791,1571,Bou283_T,"-37.81380668, 144.96516718"
58220250716,58,2025-07-16,2,9,27,36,Bou688_T,"-37.81686075, 144.95358075"
2620250122,2,2025-01-22,6,21,31,52,Bou283_T,"-37.81380668, 144.96516718"
271820240914,27,2024-09-14,18,127,52,179,Vic_T,"-37.80606888, 144.95644692"
23420240831,23,2024-08-31,4,10,15,25,Col623_T,"-37.81909256, 144.95452748"
79120250525,79,2025-05-25,1,72,117,189,FliSS_T,"-37.81794046, 144.96616678"
20420250919,20,2025-09-19,4,13,27,40,LtB170_T,"-37.81172914, 144.9682466"
461420240315,46,2024-03-15,14,160,151,311,Pel147_T,"-37.80240719, 144.9615673"
20520250608,20,2025-06-08,5,25,40,65,LtB170_T,"-37.81172914, 144.9682466"
25420231219,25,2023-12-19,4,5,3,8,MCEC_T,"-37.82401776, 144.95604426"
137620240329,137,2024-03-29,6,0,1,1,BouHbr2353_T,"-37.81894815, 144.94612292"
137620240502,137,2024-05-02,6,7,3,10,BouHbr2353_T,"-37.81894815, 144.94612292"
1361020250902,136,2025-09-02,10,53,52,105,BirFed1120_T,"-37.8184141, 144.97357915"
1391420240207,139,2024-02-07,14,56,64,120,Signal1647_T,"-37.81959923, 144.9632832"
139120250617,139,2025-06-17,1,2,0,2,Signal1647_T,"-37.81959923, 144.9632832"
1361220240110,136,2024-01-10,12,210,125,335,BirFed1120_T,"-37.8184141, 144.97357915"
1301720240317,130,2024-03-17,17,22,18,40,Bou892T,"-37.8204637, 144.94126826"
661820250225,66,2025-02-25,18,1290,1414,2704,QVN_T,"-37.81057846, 144.96444294"
41320241006,4,2024-10-06,13,1573,1801,3374,Swa123_T,"-37.81487988, 144.9660878"
41220250514,4,2025-05-14,12,1575,1229,2804,Swa123_T,"-37.81487988, 144.9660878"
392020250207,39,2025-02-07,20,18,14,32,AlfPl_T,"-37.81379749, 144.96995745"
391420250312,39,2025-03-12,14,95,110,205,AlfPl_T,"-37.81379749, 144.96995745"
3620250606,3,2025-06-06,6,15,52,67,Swa295_T,"-37.81101524, 144.96429485"
452220240918,45,2024-09-18,22,130,221,351,Swa148_T,"-37.81414075, 144.96609379"
1072120240104,107,2024-01-04,21,67,39,106,280Will_T,"-37.81246271, 144.95690188"
107920240720,107,2024-07-20,9,63,62,125,280Will_T,"-37.81246271, 144.95690188"
87520250515,87,2025-05-15,5,12,6,18,Errol23_T,"-37.80454949, 144.94921863"
61820250504,61,2025-05-04,8,70,130,200,RMIT14_T,"-37.80767455, 144.96309114"
611720250101,61,2025-01-01,17,220,215,435,RMIT14_T,"-37.80767455, 144.96309114"
441620250623,44,2025-06-23,16,86,51,137,UM3_T,"-37.79698741, 144.96441306"
50220231120,50,2023-11-20,2,2,0,2,Lyg309_T,"-37.79808192, 144.96721013"
1851920250930,185,2025-09-30,19,449,503,952,Eli197_T,"-37.81374643, 144.96276183"
1661620250314,166,2025-03-14,16,47,45,92,Spen484_T,"-37.80896733, 144.94931703"
1672320250906,167,2025-09-06,23,12,14,26,Lat526_T,"-37.81304149, 144.95155955"
1401320241022,140,2024-10-22,13,88,51,139,Boyd2837_T,"-37.82590962, 144.96185972"
131820250329,131,2025-03-29,8,41,38,79,King2_T,"-37.82009057, 144.95758725"
1431220250923,143,2025-09-23,12,120,193,313,Spencer_T,"-37.821728, 144.95557015"
134220240828,134,2024-08-28,2,7,16,23,Spen201_T,"-37.81694221, 144.95303935"
1311020231115,131,2023-11-15,10,323,137,460,King2_T,"-37.82009057, 144.95758725"
131820231227,131,2023-12-27,8,15,23,38,King2_T,"-37.82009057, 144.95758725"
1331820250402,133,2025-04-02,18,753,526,1279,Spen229_T,"-37.81531435, 144.95227769"
17520231104,17,2023-11-04,5,10,2,12,Col15_T,"-37.81362543, 144.97323591"
172220251009,17,2025-10-09,22,54,110,164,Col15_T,"-37.81362543, 144.97323591"
681320231111,68,2023-11-11,13,279,227,506,FLDegN_T,"-37.8168479, 144.96559789"
112120250202,11,2025-02-02,21,90,106,196,WatCit_T,"-37.81564989, 144.93970694"
56420241210,56,2024-12-10,4,4,6,10,Lon364_T,"-37.81234775, 144.96153311"
561820241218,56,2024-12-18,18,415,382,797,Lon364_T,"-37.81234775, 144.96153311"
12420241220,12,2024-12-20,4,6,2,8,NewQ_T,"-37.81457988, 144.94292398"
85020231106,85,2023-11-06,0,0,2,2,488Mac_T,"-37.79432415, 144.92973378"
85620240103,85,2024-01-03,6,9,9,18,488Mac_T,"-37.79432415, 144.92973378"
85020250206,85,2025-02-06,0,0,2,2,488Mac_T,"-37.79432415, 144.92973378"
181520250301,18,2025-03-01,15,100,65,165,Col12_T,"-37.81344862, 144.97305353"
11520250323,11,2025-03-23,5,3,3,6,WatCit_T,"-37.81564989, 144.93970694"
101820231116,10,2023-11-16,18,75,51,126,BouHbr_T,"-37.81876474, 144.94710545"
24620240304,24,2024-03-04,6,330,152,482,Col620_T,"-37.81887963, 144.95449198"
761720250529,76,2025-05-29,17,53,68,121,KenMac_T,"-37.79453803, 144.93036194"
24320250921,24,2025-09-21,3,34,70,104,Col620_T,"-37.81887963, 144.95449198"
21420240815,2,2024-08-15,14,585,614,1199,Bou283_T,"-37.81380668, 144.96516718"
22120250226,2,2025-02-26,21,90,197,287,Bou283_T,"-37.81380668, 144.96516718"
532320250828,53,2025-08-28,23,15,50,65,Col254_T,"-37.81564191, 144.965499"
9220231204,9,2023-12-04,2,1,2,3,Col700_T,"-37.81982992, 144.95102555"
23120240527,23,2024-05-27,1,3,11,14,Col623_T,"-37.81909256, 144.95452748"
20420240116,20,2024-01-16,4,6,8,14,LtB170_T,"-37.81172914, 144.9682466"
251720250301,25,2025-03-01,17,1202,824,2026,MCEC_T,"-37.82401776, 144.95604426"
522220240603,52,2024-06-03,22,32,60,92,Eli263_T,"-37.81252157, 144.9619401"
521220241218,52,2024-12-18,12,437,429,866,Eli263_T,"-37.81252157, 144.9619401"
461820251010,46,2025-10-10,18,132,153,285,Pel147_T,"-37.80240719, 144.9615673"
46220240517,46,2024-05-17,2,6,5,11,Pel147_T,"-37.80240719, 144.9615673"
231020240824,23,2024-08-24,10,210,190,400,Col623_T,"-37.81909256, 144.95452748"
491720240731,49,2024-07-31,17,595,332,927,Eli501_T,"-37.80730068, 144.95956055"
492220240323,49,2024-03-23,22,111,100,211,Eli501_T,"-37.80730068, 144.95956055"
49920231110,49,2023-11-10,9,136,157,293,Eli501_T,"-37.80730068, 144.95956055"
191520241024,19,2024-10-24,15,323,319,642,LtB210_T,"-37.81237202, 144.96550671"
191420240221,19,2024-02-21,14,415,558,973,LtB210_T,"-37.81237202, 144.96550671"
192320240226,19,2024-02-26,23,87,120,207,LtB210_T,"-37.81237202, 144.96550671"
191720240306,19,2024-03-06,17,627,359,986,LtB210_T,"-37.81237202, 144.96550671"
141720250102,141,2025-01-02,7,39,24,63,474Fl_T,"-37.81997273, 144.95834911"
1412220250407,141,2025-04-07,22,34,34,68,474Fl_T,"-37.81997273, 144.95834911"
1392320250523,139,2025-05-23,23,8,16,24,Signal1647_T,"-37.81959923, 144.9632832"
1422120241222,142,2024-12-22,21,15,4,19,Hammer1584_T,"-37.81970749, 144.96795734"
164820241011,164,2024-10-11,8,120,56,176,Lat526_T,"-37.813005, 144.95160411"
66620250919,66,2025-09-19,6,17,58,75,QVN_T,"-37.81057846, 144.96444294"
691520250503,69,2025-05-03,15,269,295,564,FLDegC_T,"-37.81687226, 144.96559144"
841020250923,84,2025-09-23,10,722,539,1261,ElFi_T,"-37.81798049, 144.96503383"
31720231114,3,2023-11-14,17,1261,1277,2538,Swa295_T,"-37.81101524, 144.96429485"
3820240824,3,2024-08-24,8,96,130,226,Swa295_T,"-37.81101524, 144.96429485"
31620240420,3,2024-04-20,16,1341,1591,2932,Swa295_T,"-37.81101524, 144.96429485"
8120240917,8,2024-09-17,1,1,0,1,WebBN_T,"-37.82293543, 144.9471751"
751920250602,75,2025-06-02,19,9,14,23,SprFli_T,"-37.81515276, 144.97467661"
77720240403,77,2024-04-03,7,77,101,178,HarEsP_T,"-37.81441438, 144.94433026"
772220250327,77,2025-03-27,22,683,76,759,HarEsP_T,"-37.81441438, 144.94433026"
782220250809,78,2025-08-09,22,5,74,79,HarEsB_T,"-37.81471642, 144.9446508"
28720231201,28,2023-12-01,7,268,117,385,VAC_T,"-37.82129925, 144.96879309"
141420241226,14,2024-12-26,14,435,154,589,SanBri_T,"-37.82011242, 144.96291897"
54920250129,54,2025-01-29,9,87,30,117,Swa607_T,"-37.804024, 144.96308399"
311320240217,31,2024-02-17,13,254,247,501,Lyg161_T,"-37.80169681, 144.96658911"
281820250524,28,2025-05-24,18,629,354,983,VAC_T,"-37.82129925, 144.96879309"
40820250901,40,2025-09-01,8,182,286,468,Spr201_T,"-37.80999341, 144.97227587"
402020241224,40,2024-12-24,20,71,73,144,Spr201_T,"-37.80999341, 144.97227587"
401120231101,40,2023-11-01,11,264,314,578,Spr201_T,"-37.80999341, 144.97227587"
361320240228,36,2024-02-28,13,303,372,675,Que85_T,"-37.81652527, 144.96121062"
51220241030,5,2024-10-30,12,784,1026,1810,PriNW_T,"-37.81874249, 144.96787656"
1081820250910,108,2025-09-10,18,511,192,703,261Will_T,"-37.81295822, 144.95678789"
118420240326,118,2024-03-26,4,0,1,1,Fli114C_T,"-37.81632783, 144.97090512"
612020250214,61,2025-02-14,20,345,369,714,RMIT14_T,"-37.80767455, 144.96309114"
50620240312,50,2024-03-12,6,17,24,41,Lyg309_T,"-37.79808192, 144.96721013"
50720241113,50,2024-11-13,7,28,54,82,Lyg309_T,"-37.79808192, 144.96721013"
431520250529,43,2025-05-29,15,202,323,525,UM2_T,"-37.79844526, 144.96411782"
43820240813,43,2024-08-13,8,246,79,325,UM2_T,"-37.79844526, 144.96411782"
1661720241020,166,2024-10-20,17,97,72,169,Spen484_T,"-37.80896733, 144.94931703"
1671520250201,167,2025-02-01,15,1,4,5,Lat526_T,"-37.81304149, 144.95155955"
1432120250310,143,2025-03-10,21,140,122,262,Spencer_T,"-37.821728, 144.95557015"
1311120231221,131,2023-12-21,11,100,102,202,King2_T,"-37.82009057, 144.95758725"
118620250429,118,2025-04-29,6,1,1,2,Fli114C_T,"-37.81632783, 144.97090512"
1241420250124,124,2025-01-24,14,10,14,24,BirBridge_T,"-37.81757416, 144.97329934"
1241320250911,124,2025-09-11,13,6,4,10,BirBridge_T,"-37.81757416, 144.97329934"
691620231209,69,2023-12-09,16,64,102,166,FLDegC_T,"-37.81687226, 144.96559144"
42320231117,4,2023-11-17,23,675,681,1356,Swa123_T,"-37.81487988, 144.9660878"
70420250623,70,2025-06-23,4,0,1,1,Errol20_T,"-37.80456984, 144.94946228"
32020241218,3,2024-12-18,20,833,982,1815,Swa295_T,"-37.81101524, 144.96429485"
39420250604,39,2025-06-04,4,1,0,1,AlfPl_T,"-37.81379749, 144.96995745"
42120241010,42,2024-10-10,1,4,11,15,UM1_T,"-37.80008566, 144.96386412"
59620241225,59,2024-12-25,6,10,10,20,RMIT_T,"-37.80825648, 144.96304859"
592020250315,59,2025-03-15,20,159,122,281,RMIT_T,"-37.80825648, 144.96304859"
651620240113,65,2024-01-13,16,542,878,1420,SwaCs_T,"-37.81569416, 144.9668064"
292120250706,29,2025-07-06,21,51,63,114,AG_T,"-37.8199817, 144.96872865"
291720250315,29,2025-03-15,17,882,945,1827,AG_T,"-37.8199817, 144.96872865"
291920231102,29,2023-11-02,19,155,139,294,AG_T,"-37.8199817, 144.96872865"
752020250430,75,2025-04-30,20,10,12,22,SprFli_T,"-37.81515276, 144.97467661"
39120241006,39,2024-10-06,1,1,0,1,AlfPl_T,"-37.81379749, 144.96995745"
782220240101,78,2024-01-01,22,2,15,17,HarEsB_T,"-37.81471642, 144.9446508"
77720241206,77,2024-12-06,7,78,110,188,HarEsP_T,"-37.81441438, 144.94433026"
14020240402,14,2024-04-02,0,28,33,61,SanBri_T,"-37.82011242, 144.96291897"
651920240210,65,2024-02-10,19,696,934,1630,SwaCs_T,"-37.81569416, 144.9668064"
28820240917,28,2024-09-17,8,778,321,1099,VAC_T,"-37.82129925, 144.96879309"
471120231122,47,2023-11-22,11,631,712,1343,Eli250_T,"-37.81258467, 144.9625775"
361120241019,36,2024-10-19,11,151,123,274,Que85_T,"-37.81652527, 144.96121062"
37520250501,37,2025-05-01,5,1,12,13,Lyg260_T,"-37.80107122, 144.96704554"
37120250619,37,2025-06-19,1,1,4,5,Lyg260_T,"-37.80107122, 144.96704554"
612220240321,61,2024-03-21,22,187,124,311,RMIT14_T,"-37.80767455, 144.96309114"
44620250917,44,2025-09-17,6,4,6,10,UM3_T,"-37.79698741, 144.96441306"
45220240906,45,2024-09-06,2,8,21,29,Swa148_T,"-37.81414075, 144.96609379"
442220240220,44,2024-02-20,22,24,9,33,UM3_T,"-37.79698741, 144.96441306"
5220250824,5,2025-08-24,2,53,92,145,PriNW_T,"-37.81874249, 144.96787656"
5420250827,5,2025-08-27,4,28,12,40,PriNW_T,"-37.81874249, 144.96787656"
52120231130,5,2023-11-30,21,1033,615,1648,PriNW_T,"-37.81874249, 144.96787656"
51820240127,5,2024-01-27,18,1345,1779,3124,PriNW_T,"-37.81874249, 144.96787656"
1401520231111,140,2023-11-11,15,86,69,155,Boyd2837_T,"-37.82590962, 144.96185972"
1401520231215,140,2023-12-15,15,96,86,182,Boyd2837_T,"-37.82590962, 144.96185972"
134620250521,134,2025-05-21,6,118,105,223,Spen201_T,"-37.81694221, 144.95303935"
134320231210,134,2023-12-10,3,26,26,52,Spen201_T,"-37.81694221, 144.95303935"
134020231224,134,2023-12-24,0,132,102,234,Spen201_T,"-37.81694221, 144.95303935"
1312320240415,131,2024-04-15,23,25,17,42,King2_T,"-37.82009057, 144.95758725"
1331520250225,133,2025-02-25,15,453,583,1036,Spen229_T,"-37.81531435, 144.95227769"
108620240516,108,2024-05-16,6,14,207,221,261Will_T,"-37.81295822, 144.95678789"
87820241201,87,2024-12-01,8,28,22,50,Errol23_T,"-37.80454949, 144.94921863"
179020250422,179,2025-04-22,0,5,4,9,Pow61_T,"-37.82392385, 144.96299677"
1792220250731,179,2025-07-31,22,42,45,87,Pow61_T,"-37.82392385, 144.96299677"
1671720250511,167,2025-05-11,17,37,61,98,Lat526_T,"-37.81304149, 144.95155955"
68620250926,68,2025-09-26,6,14,6,20,FLDegN_T,"-37.8168479, 144.96559789"
682020250910,68,2025-09-10,20,93,54,147,FLDegN_T,"-37.8168479, 144.96559789"
85020240710,85,2024-07-10,0,3,1,4,488Mac_T,"-37.79432415, 144.92973378"
17820251004,17,2025-10-04,8,83,73,156,Col15_T,"-37.81362543, 144.97323591"
181720241205,18,2024-12-05,17,816,117,933,Col12_T,"-37.81344862, 144.97305353"
18820250529,18,2025-05-29,8,87,1302,1389,Col12_T,"-37.81344862, 144.97305353"
68120240716,68,2024-07-16,1,2,0,2,FLDegN_T,"-37.8168479, 144.96559789"
12020250117,12,2025-01-17,0,13,22,35,NewQ_T,"-37.81457988, 144.94292398"
101220250718,10,2025-07-18,12,152,118,270,BouHbr_T,"-37.81876474, 144.94710545"
722320250926,72,2025-09-26,23,158,187,345,ACMI_T,"-37.81726338, 144.96872809"
352320250722,35,2025-07-22,23,70,81,151,SouthB_T,"-37.82018685, 144.96508508"
762020250706,76,2025-07-06,20,15,29,44,KenMac_T,"-37.79453803, 144.93036194"
21120240527,2,2024-05-27,11,370,389,759,Bou283_T,"-37.81380668, 144.96516718"
792320231026,79,2023-10-26,23,99,119,218,FliSS_T,"-37.81794046, 144.96616678"
86420250723,86,2025-07-23,4,1,0,1,574Qub_T,"-37.80309992, 144.94908064"
861620240908,86,2024-09-08,16,28,34,62,574Qub_T,"-37.80309992, 144.94908064"
67420240522,67,2024-05-22,4,8,3,11,FLDegS_T,"-37.81688755, 144.96562569"
62820250315,62,2025-03-15,8,49,69,118,Lat224_T,"-37.80996494, 144.96216521"
11120250511,1,2025-05-11,11,1011,965,1976,Bou292_T,"-37.81349441, 144.96515323"
12720240927,12,2024-09-27,7,60,53,113,NewQ_T,"-37.81457988, 144.94292398"
121520240322,12,2024-03-22,15,129,174,303,NewQ_T,"-37.81457988, 144.94292398"
68020240817,68,2024-08-17,0,3,0,3,FLDegN_T,"-37.8168479, 144.96559789"
241620240621,24,2024-06-21,16,714,1276,1990,Col620_T,"-37.81887963, 144.95449198"
58520250304,58,2025-03-04,5,97,27,124,Bou688_T,"-37.81686075, 144.95358075"
531620240408,53,2024-04-08,16,476,369,845,Col254_T,"-37.81564191, 144.965499"
91120250417,9,2025-04-17,11,314,323,637,Col700_T,"-37.81982992, 144.95102555"
22320250809,2,2025-08-09,23,62,112,174,Bou283_T,"-37.81380668, 144.96516718"
301120240918,30,2024-09-18,11,239,321,560,Lon189_T,"-37.8112185, 144.96656806"
791520231203,79,2023-12-03,15,756,561,1317,FliSS_T,"-37.81794046, 144.96616678"
231320240516,23,2024-05-16,13,326,609,935,Col623_T,"-37.81909256, 144.95452748"
461720250502,46,2025-05-02,17,83,150,233,Pel147_T,"-37.80240719, 144.9615673"
25120231026,25,2023-10-26,1,32,19,51,MCEC_T,"-37.82401776, 144.95604426"
25020241118,25,2024-11-18,0,16,24,40,MCEC_T,"-37.82401776, 144.95604426"
136520250320,136,2025-03-20,5,3,0,3,BirFed1120_T,"-37.8184141, 144.97357915"
1301920241206,130,2024-12-06,19,13,8,21,Bou892T,"-37.8204637, 144.94126826"
1641120240927,164,2024-09-27,11,128,45,173,Lat526_T,"-37.813005, 144.95160411"
1381020250226,138,2025-02-26,10,5,8,13,EntPark1671_T,"-37.81996544, 144.95981454"
161820240617,161,2024-06-17,8,112,186,298,BirArt1109_T,"-37.81851276, 144.97131336"
1231920241012,123,2024-10-12,19,6,0,6,BirBridge_T,"-37.81753741, 144.97329734"
123920250914,123,2025-09-14,9,42,20,62,BirBridge_T,"-37.81753741, 144.97329734"
1371920250511,137,2025-05-11,19,1,5,6,BouHbr2353_T,"-37.81894815, 144.94612292"
84820250608,84,2025-06-08,8,217,160,377,ElFi_T,"-37.81798049, 144.96503383"
841620250625,84,2025-06-25,16,720,1414,2134,ElFi_T,"-37.81798049, 144.96503383"
702020250131,70,2025-01-31,20,138,150,288,Errol20_T,"-37.80456984, 144.94946228"
41120240422,4,2024-04-22,11,1244,822,2066,Swa123_T,"-37.81487988, 144.9660878"
70720250522,70,2025-05-22,7,39,17,56,Errol20_T,"-37.80456984, 144.94946228"
3320240103,3,2024-01-03,3,33,26,59,Swa295_T,"-37.81101524, 144.96429485"
751920231128,75,2023-11-28,19,35,77,112,SprFli_T,"-37.81515276, 144.97467661"
81520250816,8,2025-08-16,15,203,229,432,WebBN_T,"-37.82293543, 144.9471751"
781520240409,78,2024-04-09,15,31,67,98,HarEsB_T,"-37.81471642, 144.9446508"
42920251003,42,2025-10-03,9,74,34,108,UM1_T,"-37.80008566, 144.96386412"
282320240608,28,2024-06-08,23,88,44,132,VAC_T,"-37.82129925, 144.96879309"
291320250417,29,2025-04-17,13,310,339,649,AG_T,"-37.8199817, 144.96872865"
311720240728,31,2024-07-28,17,205,132,337,Lyg161_T,"-37.80169681, 144.96658911"
541220231211,54,2023-12-11,12,63,128,191,Swa607_T,"-37.804024, 144.96308399"
281720250816,28,2025-08-16,17,1028,909,1937,VAC_T,"-37.82129925, 144.96879309"
40520250920,40,2025-09-20,5,5,6,11,Spr201_T,"-37.80999341, 144.97227587"
5220240515,5,2024-05-15,2,6,7,13,PriNW_T,"-37.81874249, 144.96787656"
44720250109,44,2025-01-09,7,11,13,24,UM3_T,"-37.79698741, 144.96441306"
502220231124,50,2023-11-24,22,137,77,214,Lyg309_T,"-37.79808192, 144.96721013"
43120240821,43,2024-08-21,1,1,2,3,UM2_T,"-37.79844526, 144.96411782"
1351120250812,135,2025-08-12,11,286,325,611,Spen161_T,"-37.8172861, 144.95319102"
1311720240124,131,2024-01-24,17,99,194,293,King2_T,"-37.82009057, 144.95758725"
131020250103,131,2025-01-03,0,39,23,62,King2_T,"-37.82009057, 144.95758725"
1331320240120,133,2024-01-20,13,423,484,907,Spen229_T,"-37.81531435, 144.95227769"
1081520250211,108,2025-02-11,15,540,215,755,261Will_T,"-37.81295822, 144.95678789"
1081620250105,108,2025-01-05,16,72,51,123,261Will_T,"-37.81295822, 144.95678789"
141520250829,14,2025-08-29,15,350,104,454,SanBri_T,"-37.82011242, 144.96291897"
14520241122,14,2024-11-22,5,48,42,90,SanBri_T,"-37.82011242, 144.96291897"
40120250623,40,2025-06-23,1,7,0,7,Spr201_T,"-37.80999341, 144.97227587"
47520241114,47,2024-11-14,5,19,59,78,Eli250_T,"-37.81258467, 144.9625775"
361320231222,36,2023-12-22,13,225,244,469,Que85_T,"-37.81652527, 144.96121062"
107720231105,107,2023-11-05,7,9,18,27,280Will_T,"-37.81246271, 144.95690188"
1071220241204,107,2024-12-04,12,195,197,392,280Will_T,"-37.81246271, 144.95690188"
61620240413,61,2024-04-13,6,9,51,60,RMIT14_T,"-37.80767455, 144.96309114"
182520250707,182,2025-07-07,5,19,31,50,King163_T,"-37.81627451, 144.95550503"
1311620250209,131,2025-02-09,16,165,65,230,King2_T,"-37.82009057, 144.95758725"
1341420241116,134,2024-11-16,14,515,426,941,Spen201_T,"-37.81694221, 144.95303935"
1342220250109,134,2025-01-09,22,37,34,71,Spen201_T,"-37.81694221, 144.95303935"
134720250419,134,2025-04-19,7,173,163,336,Spen201_T,"-37.81694221, 144.95303935"
135920241103,135,2024-11-03,9,276,253,529,Spen161_T,"-37.8172861, 144.95319102"
1352120250107,135,2025-01-07,21,182,203,385,Spen161_T,"-37.8172861, 144.95319102"
1331920250105,133,2025-01-05,19,388,357,745,Spen229_T,"-37.81531435, 144.95227769"
672320240404,67,2024-04-04,23,40,71,111,FLDegS_T,"-37.81688755, 144.96562569"
671120250519,67,2025-05-19,11,342,471,813,FLDegS_T,"-37.81688755, 144.96562569"
852220231115,85,2023-11-15,22,2,8,10,488Mac_T,"-37.79432415, 144.92973378"
1920250206,1,2025-02-06,9,249,325,574,Bou292_T,"-37.81349441, 144.96515323"
63020240711,63,2024-07-11,0,33,58,91,Bou231_T,"-37.81333081, 144.96675571"
622020240225,62,2024-02-25,20,262,121,383,Lat224_T,"-37.80996494, 144.96216521"
621720250410,62,2025-04-10,17,369,331,700,Lat224_T,"-37.80996494, 144.96216521"
121620240502,12,2024-05-02,16,143,139,282,NewQ_T,"-37.81457988, 144.94292398"
24020250107,24,2025-01-07,0,89,56,145,Col620_T,"-37.81887963, 144.95449198"
242020240626,24,2024-06-26,20,285,402,687,Col620_T,"-37.81887963, 144.95449198"
72420240329,72,2024-03-29,4,7,11,18,ACMI_T,"-37.81726338, 144.96872809"
72420241010,72,2024-10-10,4,3,3,6,ACMI_T,"-37.81726338, 144.96872809"
791920231031,79,2023-10-31,19,318,254,572,FliSS_T,"-37.81794046, 144.96616678"
91820240808,9,2024-08-08,18,947,113,1060,Col700_T,"-37.81982992, 144.95102555"
53120231229,53,2023-12-29,1,21,9,30,Col254_T,"-37.81564191, 144.965499"
23020231102,23,2023-11-02,0,7,24,31,Col623_T,"-37.81909256, 144.95452748"
252220231222,25,2023-12-22,22,620,401,1021,MCEC_T,"-37.82401776, 144.95604426"
19320250807,19,2025-08-07,3,10,12,22,LtB210_T,"-37.81237202, 144.96550671"
492220250831,49,2025-08-31,22,69,53,122,Eli501_T,"-37.80730068, 144.95956055"
48520240709,48,2024-07-09,5,12,9,21,QVMQ_T,"-37.80631581, 144.95866697"
48920231113,48,2023-11-13,9,99,68,167,QVMQ_T,"-37.80631581, 144.95866697"
1371920240916,137,2024-09-16,19,3,6,9,BouHbr2353_T,"-37.81894815, 144.94612292"
1361920250122,136,2025-01-22,19,143,141,284,BirFed1120_T,"-37.8184141, 144.97357915"
1611420240615,161,2024-06-15,14,1291,142,1433,BirArt1109_T,"-37.81851276, 144.97131336"
161620250129,161,2025-01-29,6,81,53,134,BirArt1109_T,"-37.81851276, 144.97131336"
69820250325,69,2025-03-25,8,223,37,260,FLDegC_T,"-37.81687226, 144.96559144"
69720250411,69,2025-04-11,7,90,32,122,FLDegC_T,"-37.81687226, 144.96559144"
4120241125,4,2024-11-25,1,29,26,55,Swa123_T,"-37.81487988, 144.9660878"
701320240427,70,2024-04-27,13,165,162,327,Errol20_T,"-37.80456984, 144.94946228"
701420250323,70,2025-03-23,14,143,163,306,Errol20_T,"-37.80456984, 144.94946228"
3720250727,3,2025-07-27,7,35,42,77,Swa295_T,"-37.81101524, 144.96429485"
81420240629,8,2024-06-29,14,145,195,340,WebBN_T,"-37.82293543, 144.9471751"
751120250409,75,2025-04-09,11,41,34,75,SprFli_T,"-37.81515276, 144.97467661"
1652320241130,165,2024-11-30,23,32,39,71,Spen475_T,"-37.80953359, 144.94939004"
165720250430,165,2025-04-30,7,10,44,54,Spen475_T,"-37.80953359, 144.94939004"
143620240714,143,2024-07-14,6,8,12,20,Spencer_T,"-37.821728, 144.95557015"
1341420231102,134,2023-11-02,14,299,295,594,Spen201_T,"-37.81694221, 144.95303935"
134420240307,134,2024-03-07,4,23,22,45,Spen201_T,"-37.81694221, 144.95303935"
1342120240505,134,2024-05-05,21,186,175,361,Spen201_T,"-37.81694221, 144.95303935"
852320231228,85,2023-12-28,23,0,3,3,488Mac_T,"-37.79432415, 144.92973378"
852020241217,85,2024-12-17,20,33,38,71,488Mac_T,"-37.79432415, 144.92973378"
851120251015,85,2025-10-15,11,82,49,131,488Mac_T,"-37.79432415, 144.92973378"
862320240304,86,2024-03-04,23,1,2,3,574Qub_T,"-37.80309992, 144.94908064"
112120241031,11,2024-10-31,21,37,41,78,WatCit_T,"-37.81564989, 144.93970694"
67620250114,67,2025-01-14,6,109,58,167,FLDegS_T,"-37.81688755, 144.96562569"
561020241015,56,2024-10-15,10,286,180,466,Lon364_T,"-37.81234775, 144.96153311"
24120231121,24,2023-11-21,1,31,31,62,Col620_T,"-37.81887963, 144.95449198"
72520240508,72,2024-05-08,5,16,24,40,ACMI_T,"-37.81726338, 144.96872809"
721920250802,72,2025-08-02,19,106,212,318,ACMI_T,"-37.81726338, 144.96872809"
22320240301,2,2024-03-01,23,65,119,184,Bou283_T,"-37.81380668, 144.96516718"
562320250628,56,2025-06-28,23,129,170,299,Lon364_T,"-37.81234775, 144.96153311"
27220240705,27,2024-07-05,2,8,2,10,Vic_T,"-37.80606888, 144.95644692"
272320241117,27,2024-11-17,23,40,15,55,Vic_T,"-37.80606888, 144.95644692"
532320250820,53,2025-08-20,23,29,83,112,Col254_T,"-37.81564191, 144.965499"
23920240518,23,2024-05-18,9,166,157,323,Col623_T,"-37.81909256, 144.95452748"
46920240405,46,2024-04-05,9,54,107,161,Pel147_T,"-37.80240719, 144.9615673"
1361620250716,136,2025-07-16,16,144,84,228,BirFed1120_T,"-37.8184141, 144.97357915"
1361920250813,136,2025-08-13,19,3,1,4,BirFed1120_T,"-37.8184141, 144.97357915"
1422220240112,142,2024-01-12,22,374,212,586,Hammer1584_T,"-37.81970749, 144.96795734"
1301920250723,130,2025-07-23,19,21,17,38,Bou892T,"-37.8204637, 144.94126826"
1301320240623,130,2024-06-23,13,18,15,33,Bou892T,"-37.8204637, 144.94126826"
141220250909,141,2025-09-09,2,1,4,5,474Fl_T,"-37.81997273, 144.95834911"
1381020251013,138,2025-10-13,10,25,9,34,EntPark1671_T,"-37.81996544, 144.95981454"
1171820250716,117,2025-07-16,18,155,333,488,Fli114F_T,"-37.81629332, 144.97090877"
1411920250403,141,2025-04-03,19,88,109,197,474Fl_T,"-37.81997273, 144.95834911"
117620240214,117,2024-02-14,6,49,24,73,Fli114F_T,"-37.81629332, 144.97090877"
19120250822,19,2025-08-22,1,42,82,124,LtB210_T,"-37.81237202, 144.96550671"
1371120240121,137,2024-01-21,11,9,16,25,BouHbr2353_T,"-37.81894815, 144.94612292"
1392220250130,139,2025-01-30,22,16,13,29,Signal1647_T,"-37.81959923, 144.9632832"
6620250110,6,2025-01-10,6,148,173,321,FliS_T,"-37.81911705, 144.96558255"
4920240301,4,2024-03-01,9,696,407,1103,Swa123_T,"-37.81487988, 144.9660878"
31220250808,3,2025-08-08,12,1129,1336,2465,Swa295_T,"-37.81101524, 144.96429485"
391620250919,39,2025-09-19,16,117,76,193,AlfPl_T,"-37.81379749, 144.96995745"
751420250429,75,2025-04-29,14,66,43,109,SprFli_T,"-37.81515276, 144.97467661"
78920241028,78,2024-10-28,9,54,31,85,HarEsB_T,"-37.81471642, 144.9446508"
411820240919,41,2024-09-19,18,268,242,510,Swa31,"-37.81668634, 144.96689733"
422320250701,42,2025-07-01,23,9,4,13,UM1_T,"-37.80008566, 144.96386412"
591520250906,59,2025-09-06,15,708,560,1268,RMIT_T,"-37.80825648, 144.96304859"
28120240824,28,2024-08-24,1,22,6,28,VAC_T,"-37.82129925, 144.96879309"
292020240207,29,2024-02-07,20,166,315,481,AG_T,"-37.8199817, 144.96872865"
54920240805,54,2024-08-05,9,241,98,339,Swa607_T,"-37.804024, 144.96308399"
471920250804,47,2025-08-04,19,731,547,1278,Eli250_T,"-37.81258467, 144.9625775"
401920250108,40,2025-01-08,19,93,123,216,Spr201_T,"-37.80999341, 144.97227587"
5220241230,5,2024-12-30,2,12,15,27,PriNW_T,"-37.81874249, 144.96787656"
78820231123,78,2023-11-23,8,154,82,236,HarEsB_T,"-37.81471642, 144.9446508"
71520240818,71,2024-08-18,5,3,1,4,WestWP_T,"-37.81235775, 144.97136962"
711520240820,71,2024-08-20,15,8,8,16,WestWP_T,"-37.81235775, 144.97136962"
59520240304,59,2024-03-04,5,24,16,40,RMIT_T,"-37.80825648, 144.96304859"
65920240530,65,2024-05-30,9,418,235,653,SwaCs_T,"-37.81569416, 144.9668064"
28620231218,28,2023-12-18,6,121,52,173,VAC_T,"-37.82129925, 144.96879309"
311020240312,31,2024-03-12,10,109,121,230,Lyg161_T,"-37.80169681, 144.96658911"
281020250331,28,2025-03-31,10,816,293,1109,VAC_T,"-37.82129925, 144.96879309"
472020250813,47,2025-08-13,20,621,612,1233,Eli250_T,"-37.81258467, 144.9625775"
471620250222,47,2025-02-22,16,767,891,1658,Eli250_T,"-37.81258467, 144.9625775"
311020250611,31,2025-06-11,10,71,74,145,Lyg161_T,"-37.80169681, 144.96658911"
441820241003,44,2024-10-03,18,101,143,244,UM3_T,"-37.79698741, 144.96441306"
21320240306,21,2024-03-06,3,13,31,44,Bourke155_T,"-37.81267313, 144.96788288"
212020240816,21,2024-08-16,20,386,536,922,Bourke155_T,"-37.81267313, 144.96788288"
1181420240205,118,2024-02-05,14,12,15,27,Fli114C_T,"-37.81632783, 144.97090512"
108820240418,108,2024-04-18,8,97,2141,2238,261Will_T,"-37.81295822, 144.95678789"
1081020231202,108,2023-12-02,10,51,45,96,261Will_T,"-37.81295822, 144.95678789"
501220250323,50,2025-03-23,12,220,298,518,Lyg309_T,"-37.79808192, 144.96721013"
441520250401,44,2025-04-01,15,125,103,228,UM3_T,"-37.79698741, 144.96441306"
184820250814,184,2025-08-14,8,345,406,751,Eli124_T,"-37.81512416, 144.96371988"
1311020241207,131,2024-12-07,10,61,103,164,King2_T,"-37.82009057, 144.95758725"
1401520240911,140,2024-09-11,15,60,74,134,Boyd2837_T,"-37.82590962, 144.96185972"
1401620240926,140,2024-09-26,16,90,88,178,Boyd2837_T,"-37.82590962, 144.96185972"
1321120240504,132,2024-05-04,11,164,124,288,King335_T,"-37.81267639, 144.95386444"
1341920250729,134,2025-07-29,19,316,267,583,Spen201_T,"-37.81694221, 144.95303935"
131720231106,131,2023-11-06,7,57,62,119,King2_T,"-37.82009057, 144.95758725"
118720231116,118,2023-11-16,7,9,0,9,Fli114C_T,"-37.81632783, 144.97090512"
85620251015,85,2025-10-15,6,22,12,34,488Mac_T,"-37.79432415, 144.92973378"
172320241108,17,2024-11-08,23,48,34,82,Col15_T,"-37.81362543, 144.97323591"
631320240812,63,2024-08-12,13,342,481,823,Bou231_T,"-37.81333081, 144.96675571"
621920231025,62,2023-10-25,19,214,174,388,Lat224_T,"-37.80996494, 144.96216521"
562220240213,56,2024-02-13,22,69,161,230,Lon364_T,"-37.81234775, 144.96153311"
241920250527,24,2025-05-27,19,319,543,862,Col620_T,"-37.81887963, 144.95449198"
12820250518,12,2025-05-18,8,89,60,149,NewQ_T,"-37.81457988, 144.94292398"
76720250429,76,2025-04-29,7,42,21,63,KenMac_T,"-37.79453803, 144.93036194"
351320250325,35,2025-03-25,13,1222,1413,2635,SouthB_T,"-37.82018685, 144.96508508"
272120250121,27,2025-01-21,21,78,44,122,Vic_T,"-37.80606888, 144.95644692"
91420240902,9,2024-09-02,14,335,145,480,Col700_T,"-37.81982992, 144.95102555"
9820250813,9,2025-08-13,8,129,3246,3375,Col700_T,"-37.81982992, 144.95102555"
9520231125,9,2023-11-25,5,9,7,16,Col700_T,"-37.81982992, 144.95102555"
53220241123,53,2024-11-23,2,11,23,34,Col254_T,"-37.81564191, 144.965499"
531220240812,53,2024-08-12,12,804,722,1526,Col254_T,"-37.81564191, 144.965499"
51220250806,51,2025-08-06,2,6,6,12,Fra118_T,"-37.80841815, 144.95906316"
1171820240127,117,2024-01-27,18,289,210,499,Fli114F_T,"-37.81629332, 144.97090877"
1171720250419,117,2025-04-19,17,236,245,481,Fli114F_T,"-37.81629332, 144.97090877"
117620250904,117,2025-09-04,6,73,16,89,Fli114F_T,"-37.81629332, 144.97090877"
1091520240317,109,2024-03-17,15,90,122,212,LatWill_T,"-37.81193681, 144.95621105"
30020240623,30,2024-06-23,0,275,283,558,Lon189_T,"-37.8112185, 144.96656806"
251620250628,25,2025-06-28,16,1255,830,2085,MCEC_T,"-37.82401776, 144.95604426"
20020241112,20,2024-11-12,0,9,19,28,LtB170_T,"-37.81172914, 144.9682466"
25020241222,25,2024-12-22,0,87,223,310,MCEC_T,"-37.82401776, 144.95604426"
461720250329,46,2025-03-29,17,41,79,120,Pel147_T,"-37.80240719, 144.9615673"
1361520240923,136,2024-09-23,15,61,52,113,BirFed1120_T,"-37.8184141, 144.97357915"
130720250119,130,2025-01-19,7,6,5,11,Bou892T,"-37.8204637, 144.94126826"
1421620240124,142,2024-01-24,16,408,268,676,Hammer1584_T,"-37.81970749, 144.96795734"
1381120250204,138,2025-02-04,11,6,1,7,EntPark1671_T,"-37.81996544, 144.95981454"
1231920240331,123,2024-03-31,19,52,11,63,BirBridge_T,"-37.81753741, 144.97329734"
49320240126,49,2024-01-26,3,20,24,44,Eli501_T,"-37.80730068, 144.95956055"
109520231231,109,2023-12-31,5,2,6,8,LatWill_T,"-37.81193681, 144.95621105"
661720241021,66,2024-10-21,17,1394,1434,2828,QVN_T,"-37.81057846, 144.96444294"
691220240602,69,2024-06-02,12,253,152,405,FLDegC_T,"-37.81687226, 144.96559144"
84720240906,84,2024-09-06,7,482,196,678,ElFi_T,"-37.81798049, 144.96503383"
662120240506,66,2024-05-06,21,592,376,968,QVN_T,"-37.81057846, 144.96444294"
84020241115,84,2024-11-15,0,83,81,164,ElFi_T,"-37.81798049, 144.96503383"
41820251008,4,2025-10-08,18,1513,1356,2869,Swa123_T,"-37.81487988, 144.9660878"
3620250503,3,2025-05-03,6,25,26,51,Swa295_T,"-37.81101524, 144.96429485"
8220250322,8,2025-03-22,2,1,4,5,WebBN_T,"-37.82293543, 144.9471751"
752320240907,75,2024-09-07,23,12,5,17,SprFli_T,"-37.81515276, 144.97467661"
751520241125,75,2024-11-25,15,36,28,64,SprFli_T,"-37.81515276, 144.97467661"
411720240703,41,2024-07-03,17,292,313,605,Swa31,"-37.81668634, 144.96689733"
411820231223,41,2023-12-23,18,2101,1843,3944,Swa31,"-37.81668634, 144.96689733"
592220250719,59,2025-07-19,22,299,208,507,RMIT_T,"-37.80825648, 144.96304859"
592220241029,59,2024-10-29,22,123,88,211,RMIT_T,"-37.80825648, 144.96304859"
281620240609,28,2024-06-09,16,526,890,1416,VAC_T,"-37.82129925, 144.96879309"
47520240820,47,2024-08-20,5,11,50,61,Eli250_T,"-37.81258467, 144.9625775"
40020240718,40,2024-07-18,0,6,7,13,Spr201_T,"-37.80999341, 144.97227587"
401820240429,40,2024-04-29,18,98,109,207,Spr201_T,"-37.80999341, 144.97227587"
37020250806,37,2025-08-06,0,8,10,18,Lyg260_T,"-37.80107122, 144.96704554"
61520241103,61,2024-11-03,5,28,24,52,RMIT14_T,"-37.80767455, 144.96309114"
451320250220,45,2025-02-20,13,497,924,1421,Swa148_T,"-37.81414075, 144.96609379"
140920241205,140,2024-12-05,9,87,31,118,Boyd2837_T,"-37.82590962, 144.96185972"
140820250331,140,2025-03-31,8,176,28,204,Boyd2837_T,"-37.82590962, 144.96185972"
1322020231215,132,2023-12-15,20,175,141,316,King335_T,"-37.81267639, 144.95386444"
1341220231226,134,2023-12-26,12,315,409,724,Spen201_T,"-37.81694221, 144.95303935"
131120250105,131,2025-01-05,1,109,97,206,King2_T,"-37.82009057, 144.95758725"
135320240501,135,2024-05-01,3,17,9,26,Spen161_T,"-37.8172861, 144.95319102"
133320250112,133,2025-01-12,3,24,18,42,Spen229_T,"-37.81531435, 144.95227769"
1241920231124,124,2023-11-24,19,1,3,4,BirBridge_T,"-37.81757416, 144.97329934"
107920240918,107,2024-09-18,9,63,191,254,280Will_T,"-37.81246271, 144.95690188"
12220231102,1,2023-11-02,22,133,159,292,Bou292_T,"-37.81349441, 144.96515323"
1920240405,1,2024-04-05,9,290,347,637,Bou292_T,"-37.81349441, 144.96515323"
631920250318,63,2025-03-18,19,221,295,516,Bou231_T,"-37.81333081, 144.96675571"
1801420250719,180,2025-07-19,14,38,27,65,Mac330_T,"-37.79497059, 144.93530329"
136220241113,136,2024-11-13,2,0,2,2,BirFed1120_T,"-37.8184141, 144.97357915"
1301420250723,130,2025-07-23,14,67,52,119,Bou892T,"-37.8204637, 144.94126826"
1381520250525,138,2025-05-25,15,13,27,40,EntPark1671_T,"-37.81996544, 144.95981454"
61520240214,6,2024-02-14,15,1156,905,2061,FliS_T,"-37.81911705, 144.96558255"
62320240410,6,2024-04-10,23,245,194,439,FliS_T,"-37.81911705, 144.96558255"
61120240419,6,2024-04-19,11,641,581,1222,FliS_T,"-37.81911705, 144.96558255"
841520250319,84,2025-03-19,15,891,1312,2203,ElFi_T,"-37.81798049, 144.96503383"
81620250926,8,2025-09-26,16,196,277,473,WebBN_T,"-37.82293543, 144.9471751"
81520250530,8,2025-05-30,15,136,310,446,WebBN_T,"-37.82293543, 144.9471751"
412220250421,41,2025-04-21,22,270,316,586,Swa31,"-37.81668634, 144.96689733"
77520250410,77,2025-04-10,5,10,16,26,HarEsP_T,"-37.81441438, 144.94433026"
772320250726,77,2025-07-26,23,204,27,231,HarEsP_T,"-37.81441438, 144.94433026"
591120240329,59,2024-03-29,11,229,302,531,RMIT_T,"-37.80825648, 144.96304859"
591320241214,59,2024-12-14,13,159,285,444,RMIT_T,"-37.80825648, 144.96304859"
31120240415,31,2024-04-15,1,3,2,5,Lyg161_T,"-37.80169681, 144.96658911"
372320231109,37,2023-11-09,23,69,40,109,Lyg260_T,"-37.80107122, 144.96704554"
371720240320,37,2024-03-20,17,126,112,238,Lyg260_T,"-37.80107122, 144.96704554"
47820240827,47,2024-08-27,8,318,665,983,Eli250_T,"-37.81258467, 144.9625775"
47320240717,47,2024-07-17,3,35,15,50,Eli250_T,"-37.81258467, 144.9625775"
1181020231201,118,2023-12-01,10,25,13,38,Fli114C_T,"-37.81632783, 144.97090512"
612020250322,61,2025-03-22,20,488,405,893,RMIT14_T,"-37.80767455, 144.96309114"
431520250124,43,2025-01-24,15,91,92,183,UM2_T,"-37.79844526, 144.96411782"
167820250622,167,2025-06-22,8,11,30,41,Lat526_T,"-37.81304149, 144.95155955"
1811220250524,181,2025-05-24,12,644,1292,1936,Eli368_T,"-37.81009465, 144.96143149"
1621920250222,162,2025-02-22,19,303,339,642,Eli489_T,"-37.80740397, 144.95987909"
1321220250925,132,2025-09-25,12,201,167,368,King335_T,"-37.81267639, 144.95386444"
1341120240511,134,2024-05-11,11,328,354,682,Spen201_T,"-37.81694221, 144.95303935"
171420231104,17,2023-11-04,14,195,112,307,Col15_T,"-37.81362543, 144.97323591"
172120240119,17,2024-01-19,21,134,139,273,Col15_T,"-37.81362543, 144.97323591"
181520240404,18,2024-04-04,15,326,149,475,Col12_T,"-37.81344862, 144.97305353"
682020250513,68,2025-05-13,20,101,79,180,FLDegN_T,"-37.8168479, 144.96559789"
11820250519,1,2025-05-19,18,801,510,1311,Bou292_T,"-37.81349441, 144.96515323"
111720250717,11,2025-07-17,17,112,85,197,WatCit_T,"-37.81564989, 144.93970694"
861820240108,86,2024-01-08,18,17,14,31,574Qub_T,"-37.80309992, 144.94908064"
121420231024,12,2023-10-24,14,126,141,267,NewQ_T,"-37.81457988, 144.94292398"
351320240428,35,2024-04-28,13,1459,1519,2978,SouthB_T,"-37.82018685, 144.96508508"
2020240704,2,2024-07-04,0,5,27,32,Bou283_T,"-37.81380668, 144.96516718"
581220250629,58,2025-06-29,12,579,216,795,Bou688_T,"-37.81686075, 144.95358075"
271220240920,27,2024-09-20,12,184,151,335,Vic_T,"-37.80606888, 144.95644692"
58020250723,58,2025-07-23,0,105,158,263,Bou688_T,"-37.81686075, 144.95358075"
232220231111,23,2023-11-11,22,85,134,219,Col623_T,"-37.81909256, 144.95452748"
211720240814,21,2024-08-14,17,405,383,788,Bourke155_T,"-37.81267313, 144.96788288"
37320240213,37,2024-02-13,3,2,4,6,Lyg260_T,"-37.80107122, 144.96704554"
502120251010,50,2025-10-10,21,273,184,457,Lyg309_T,"-37.79808192, 144.96721013"
502120240922,50,2024-09-22,21,137,52,189,Lyg309_T,"-37.79808192, 144.96721013"
44220240623,44,2024-06-23,2,7,3,10,UM3_T,"-37.79698741, 144.96441306"
501420240129,50,2024-01-29,14,212,213,425,Lyg309_T,"-37.79808192, 144.96721013"
43120250407,43,2025-04-07,1,7,3,10,UM2_T,"-37.79844526, 144.96411782"
452320250913,45,2025-09-13,23,191,360,551,Swa148_T,"-37.81414075, 144.96609379"
451620241217,45,2024-12-17,16,576,845,1421,Swa148_T,"-37.81414075, 144.96609379"
45720241110,45,2024-11-10,7,29,58,87,Swa148_T,"-37.81414075, 144.96609379"
1322220250326,132,2025-03-26,22,71,89,160,King335_T,"-37.81267639, 144.95386444"
1081620250505,108,2025-05-05,16,997,262,1259,261Will_T,"-37.81295822, 144.95678789"
1081620231230,108,2023-12-30,16,143,138,281,261Will_T,"-37.81295822, 144.95678789"
872320240717,87,2024-07-17,23,8,9,17,Errol23_T,"-37.80454949, 144.94921863"
1811820251011,181,2025-10-11,18,1240,1203,2443,Eli368_T,"-37.81009465, 144.96143149"
1651820240911,165,2024-09-11,18,41,21,62,Spen475_T,"-37.80953359, 144.94939004"
162120250616,162,2025-06-16,1,25,21,46,Eli489_T,"-37.80740397, 144.95987909"
162720251002,162,2025-10-02,7,153,106,259,Eli489_T,"-37.80740397, 144.95987909"
143420250316,143,2025-03-16,4,24,19,43,Spencer_T,"-37.821728, 144.95557015"
1322220231224,132,2023-12-24,22,16,19,35,King335_T,"-37.81267639, 144.95386444"
851320250207,85,2025-02-07,13,87,84,171,488Mac_T,"-37.79432415, 144.92973378"
171520250404,17,2025-04-04,15,256,291,547,Col15_T,"-37.81362543, 144.97323591"
12320231018,1,2023-10-18,23,62,66,128,Bou292_T,"-37.81349441, 144.96515323"
631420240311,63,2024-03-11,14,191,250,441,Bou231_T,"-37.81333081, 144.96675571"
68820240628,68,2024-06-28,8,116,69,185,FLDegN_T,"-37.8168479, 144.96559789"
861320241002,86,2024-10-02,13,66,91,157,574Qub_T,"-37.80309992, 144.94908064"
681320240619,68,2024-06-19,13,267,160,427,FLDegN_T,"-37.8168479, 144.96559789"
62920250608,62,2025-06-08,9,52,58,110,Lat224_T,"-37.80996494, 144.96216521"
561320240715,56,2024-07-15,13,357,290,647,Lon364_T,"-37.81234775, 144.96153311"
24720241023,24,2024-10-23,7,958,193,1151,Col620_T,"-37.81887963, 144.95449198"
721820241129,72,2024-11-29,18,383,522,905,ACMI_T,"-37.81726338, 144.96872809"
581320250202,58,2025-02-02,13,351,192,543,Bou688_T,"-37.81686075, 144.95358075"
351320250317,35,2025-03-17,13,1338,1634,2972,SouthB_T,"-37.82018685, 144.96508508"
76720240819,76,2024-08-19,7,40,19,59,KenMac_T,"-37.79453803, 144.93036194"
561020250601,56,2025-06-01,10,241,177,418,Lon364_T,"-37.81234775, 144.96153311"
561320251016,56,2025-10-16,13,428,413,841,Lon364_T,"-37.81234775, 144.96153311"
92120241127,9,2024-11-27,21,67,47,114,Col700_T,"-37.81982992, 144.95102555"
79120250801,79,2025-08-01,1,19,36,55,FliSS_T,"-37.81794046, 144.96616678"
25020250601,25,2025-06-01,0,97,59,156,MCEC_T,"-37.82401776, 144.95604426"
25320240715,25,2024-07-15,3,3,4,7,MCEC_T,"-37.82401776, 144.95604426"
511720250523,51,2025-05-23,17,103,120,223,Fra118_T,"-37.80841815, 144.95906316"
136720241023,136,2024-10-23,7,84,115,199,BirFed1120_T,"-37.8184141, 144.97357915"
1422020250118,142,2025-01-18,20,813,727,1540,Hammer1584_T,"-37.81970749, 144.96795734"
1611620250626,161,2025-06-26,16,132,107,239,BirArt1109_T,"-37.81851276, 144.97131336"
1381820240329,138,2024-03-29,18,3,11,14,EntPark1671_T,"-37.81996544, 144.95981454"
49420241027,49,2024-10-27,4,36,27,63,Eli501_T,"-37.80730068, 144.95956055"
1372220250226,137,2025-02-26,22,1,9,10,BouHbr2353_T,"-37.81894815, 144.94612292"
702120241201,70,2024-12-01,21,83,81,164,Errol20_T,"-37.80456984, 144.94946228"
391720240722,39,2024-07-22,17,97,59,156,AlfPl_T,"-37.81379749, 144.96995745"
82120250508,8,2025-05-08,21,16,13,29,WebBN_T,"-37.82293543, 144.9471751"
62720250128,62,2025-01-28,7,25,49,74,Lat224_T,"-37.80996494, 144.96216521"
101220241201,10,2024-12-01,12,53,36,89,BouHbr_T,"-37.81876474, 144.94710545"
102020241213,10,2024-12-13,20,90,60,150,BouHbr_T,"-37.81876474, 144.94710545"
721820250604,72,2025-06-04,18,118,369,487,ACMI_T,"-37.81726338, 144.96872809"
581220241025,58,2024-10-25,12,755,421,1176,Bou688_T,"-37.81686075, 144.95358075"
762320241105,76,2024-11-05,23,1,2,3,KenMac_T,"-37.79453803, 144.93036194"
2820241214,2,2024-12-14,8,58,107,165,Bou283_T,"-37.81380668, 144.96516718"
91020231130,9,2023-11-30,10,197,520,717,Col700_T,"-37.81982992, 144.95102555"
92220240517,9,2024-05-17,22,48,32,80,Col700_T,"-37.81982992, 144.95102555"
53420240308,53,2024-03-08,4,4,6,10,Col254_T,"-37.81564191, 144.965499"
231620240923,23,2024-09-23,16,174,519,693,Col623_T,"-37.81909256, 144.95452748"
30420250825,30,2025-08-25,4,6,33,39,Lon189_T,"-37.8112185, 144.96656806"
20720240501,20,2024-05-01,7,31,42,73,LtB170_T,"-37.81172914, 144.9682466"
521120240211,52,2024-02-11,11,266,221,487,Eli263_T,"-37.81252157, 144.9619401"
491420251010,49,2025-10-10,14,343,470,813,Eli501_T,"-37.80730068, 144.95956055"
191120250824,19,2025-08-24,11,432,318,750,LtB210_T,"-37.81237202, 144.96550671"
1411220240331,141,2024-03-31,12,206,157,363,474Fl_T,"-37.81997273, 144.95834911"
139020240807,139,2024-08-07,0,4,1,5,Signal1647_T,"-37.81959923, 144.9632832"
142920250909,142,2025-09-09,9,98,108,206,Hammer1584_T,"-37.81970749, 144.96795734"
136620240907,136,2024-09-07,6,15,18,33,BirFed1120_T,"-37.8184141, 144.97357915"
1611620240817,161,2024-08-17,16,1352,150,1502,BirArt1109_T,"-37.81851276, 144.97131336"
1302020240605,130,2024-06-05,20,1,0,1,Bou892T,"-37.8204637, 144.94126826"
1171820240518,117,2024-05-18,18,236,288,524,Fli114F_T,"-37.81629332, 144.97090877"
109520240713,109,2024-07-13,5,1,7,8,LatWill_T,"-37.81193681, 144.95621105"
661920240228,66,2024-02-28,19,1108,931,2039,QVN_T,"-37.81057846, 144.96444294"
751520240410,75,2024-04-10,15,47,80,127,SprFli_T,"-37.81515276, 144.97467661"
41420240601,41,2024-06-01,4,39,93,132,Swa31,"-37.81668634, 144.96689733"
711720250221,71,2025-02-21,17,25,17,42,WestWP_T,"-37.81235775, 144.97136962"
712120240121,71,2024-01-21,21,2,5,7,WestWP_T,"-37.81235775, 144.97136962"
71620240122,71,2024-01-22,6,10,7,17,WestWP_T,"-37.81235775, 144.97136962"
59220231027,59,2023-10-27,2,29,9,38,RMIT_T,"-37.80825648, 144.96304859"
54520240306,54,2024-03-06,5,10,3,13,Swa607_T,"-37.804024, 144.96308399"
402120241017,40,2024-10-17,21,87,42,129,Spr201_T,"-37.80999341, 144.97227587"
401320250104,40,2025-01-04,13,95,232,327,Spr201_T,"-37.80999341, 144.97227587"
50520250731,50,2025-07-31,5,2,2,4,Lyg309_T,"-37.79808192, 144.96721013"
431920250323,43,2025-03-23,19,76,49,125,UM2_T,"-37.79844526, 144.96411782"
442220250404,44,2025-04-04,22,9,8,17,UM3_T,"-37.79698741, 144.96441306"
43120231124,43,2023-11-24,1,7,3,10,UM2_T,"-37.79844526, 144.96411782"
431020240110,43,2024-01-10,10,54,39,93,UM2_T,"-37.79844526, 144.96411782"
211620250606,21,2025-06-06,16,320,284,604,Bourke155_T,"-37.81267313, 144.96788288"
1401620240402,140,2024-04-02,16,86,88,174,Boyd2837_T,"-37.82590962, 144.96185972"
140720250709,140,2025-07-09,7,53,12,65,Boyd2837_T,"-37.82590962, 144.96185972"
1622120250302,162,2025-03-02,21,225,98,323,Eli489_T,"-37.80740397, 144.95987909"
1621920250913,162,2025-09-13,19,224,243,467,Eli489_T,"-37.80740397, 144.95987909"
131520250910,131,2025-09-10,5,6,6,12,King2_T,"-37.82009057, 144.95758725"
1321420250309,132,2025-03-09,14,140,116,256,King335_T,"-37.81267639, 144.95386444"
1321520240116,132,2024-01-16,15,111,85,196,King335_T,"-37.81267639, 144.95386444"
1311220240529,131,2024-05-29,12,154,180,334,King2_T,"-37.82009057, 144.95758725"
131520241221,131,2024-12-21,5,15,71,86,King2_T,"-37.82009057, 144.95758725"
1181120241023,118,2024-10-23,11,19,16,35,Fli114C_T,"-37.81632783, 144.97090512"
1241620250517,124,2025-05-17,16,5,4,9,BirBridge_T,"-37.81757416, 144.97329934"
791520241021,79,2024-10-21,15,409,397,806,FliSS_T,"-37.81794046, 144.96616678"
202220241129,20,2024-11-29,22,422,658,1080,LtB170_T,"-37.81172914, 144.9682466"
20420250625,20,2025-06-25,4,3,11,14,LtB170_T,"-37.81172914, 144.9682466"
522220250502,52,2025-05-02,22,213,221,434,Eli263_T,"-37.81252157, 144.9619401"
52520250918,52,2025-09-18,5,5,7,12,Eli263_T,"-37.81252157, 144.9619401"
23020240825,23,2024-08-25,0,53,49,102,Col623_T,"-37.81909256, 144.95452748"
1171620240219,117,2024-02-19,16,163,296,459,Fli114F_T,"-37.81629332, 144.97090877"
117420241008,117,2024-10-08,4,3,4,7,Fli114F_T,"-37.81629332, 144.97090877"
1171120250724,117,2025-07-24,11,131,160,291,Fli114F_T,"-37.81629332, 144.97090877"
192020240406,19,2024-04-06,20,729,817,1546,LtB210_T,"-37.81237202, 144.96550671"
482220250625,48,2025-06-25,22,59,41,100,QVMQ_T,"-37.80631581, 144.95866697"
1802220250315,180,2025-03-15,22,1,12,13,Mac330_T,"-37.79497059, 144.93530329"
141920240409,141,2024-04-09,9,87,108,195,474Fl_T,"-37.81997273, 144.95834911"
137220250604,137,2025-06-04,2,0,1,1,BouHbr2353_T,"-37.81894815, 144.94612292"
1641820250617,164,2025-06-17,18,112,103,215,Lat526_T,"-37.813005, 144.95160411"
138920240808,138,2024-08-08,9,1,1,2,EntPark1671_T,"-37.81996544, 144.95981454"
66920240123,66,2024-01-23,9,223,475,698,QVN_T,"-37.81057846, 144.96444294"
66020240312,66,2024-03-12,0,77,31,108,QVN_T,"-37.81057846, 144.96444294"
661020240204,66,2024-02-04,10,415,422,837,QVN_T,"-37.81057846, 144.96444294"
751020250519,75,2025-05-19,10,29,27,56,SprFli_T,"-37.81515276, 144.97467661"
77920241217,77,2024-12-17,9,87,118,205,HarEsP_T,"-37.81441438, 144.94433026"
592020240625,59,2024-06-25,20,330,253,583,RMIT_T,"-37.80825648, 144.96304859"
651720231211,65,2023-12-11,17,548,787,1335,SwaCs_T,"-37.81569416, 144.9668064"
29620240627,29,2024-06-27,6,39,51,90,AG_T,"-37.8199817, 144.96872865"
141820250509,14,2025-05-09,18,636,148,784,SanBri_T,"-37.82011242, 144.96291897"
31920240401,31,2024-04-01,9,36,34,70,Lyg161_T,"-37.80169681, 144.96658911"
54320240401,54,2024-04-01,3,10,6,16,Swa607_T,"-37.804024, 144.96308399"
281020251010,28,2025-10-10,10,642,303,945,VAC_T,"-37.82129925, 144.96879309"
28220231230,28,2023-12-30,2,23,10,33,VAC_T,"-37.82129925, 144.96879309"
361020241211,36,2024-12-11,10,160,143,303,Que85_T,"-37.81652527, 144.96121062"
36520250509,36,2025-05-09,5,6,8,14,Que85_T,"-37.81652527, 144.96121062"
361420250806,36,2025-08-06,14,194,213,407,Que85_T,"-37.81652527, 144.96121062"
37220250930,37,2025-09-30,2,2,1,3,Lyg260_T,"-37.80107122, 144.96704554"
37920231206,37,2023-12-06,9,44,45,89,Lyg260_T,"-37.80107122, 144.96704554"
51420250718,5,2025-07-18,14,1130,1327,2457,PriNW_T,"-37.81874249, 144.96787656"
5520240731,5,2024-07-31,5,15,27,42,PriNW_T,"-37.81874249, 144.96787656"
212120241022,21,2024-10-22,21,148,229,377,Bourke155_T,"-37.81267313, 144.96788288"
21220250312,21,2025-03-12,2,13,20,33,Bourke155_T,"-37.81267313, 144.96788288"
118720240527,118,2024-05-27,7,9,4,13,Fli114C_T,"-37.81632783, 144.97090512"
1082020240207,108,2024-02-07,20,216,178,394,261Will_T,"-37.81295822, 144.95678789"
61620250312,61,2025-03-12,6,43,67,110,RMIT14_T,"-37.80767455, 144.96309114"
501220250831,50,2025-08-31,12,206,236,442,Lyg309_T,"-37.79808192, 144.96721013"
50320250826,50,2025-08-26,3,7,0,7,Lyg309_T,"-37.79808192, 144.96721013"
1671220241201,167,2024-12-01,12,31,88,119,Lat526_T,"-37.81304149, 144.95155955"
1401520250913,140,2025-09-13,15,103,90,193,Boyd2837_T,"-37.82590962, 144.96185972"
1431520240825,143,2024-08-25,15,382,269,651,Spencer_T,"-37.821728, 144.95557015"
1432320240916,143,2024-09-16,23,33,30,63,Spencer_T,"-37.821728, 144.95557015"
1322220250102,132,2025-01-02,22,96,73,169,King335_T,"-37.81267639, 144.95386444"
1321120231024,132,2023-10-24,11,121,67,188,King335_T,"-37.81267639, 144.95386444"
1081020251009,108,2025-10-09,10,310,476,786,261Will_T,"-37.81295822, 144.95678789"
87820250104,87,2025-01-04,8,42,23,65,Errol23_T,"-37.80454949, 144.94921863"
1811620250827,181,2025-08-27,16,900,1241,2141,Eli368_T,"-37.81009465, 144.96143149"
179820250405,179,2025-04-05,8,44,18,62,Pow61_T,"-37.82392385, 144.96299677"
165920250728,165,2025-07-28,9,17,32,49,Spen475_T,"-37.80953359, 144.94939004"
167120251009,167,2025-10-09,1,1,4,5,Lat526_T,"-37.81304149, 144.95155955"
851920240705,85,2024-07-05,19,37,44,81,488Mac_T,"-37.79432415, 144.92973378"
182120250310,18,2025-03-10,21,12,9,21,Col12_T,"-37.81344862, 144.97305353"
622320250909,62,2025-09-09,23,84,87,171,Lat224_T,"-37.80996494, 144.96216521"
67220250820,67,2025-08-20,2,0,1,1,FLDegS_T,"-37.81688755, 144.96562569"
62720241003,62,2024-10-03,7,49,59,108,Lat224_T,"-37.80996494, 144.96216521"
111220231106,11,2023-11-06,12,105,103,208,WatCit_T,"-37.81564989, 144.93970694"
121720250406,12,2025-04-06,17,225,203,428,NewQ_T,"-37.81457988, 144.94292398"
10520240615,10,2024-06-15,5,1,1,2,BouHbr_T,"-37.81876474, 144.94710545"
101020250723,10,2025-07-23,10,82,77,159,BouHbr_T,"-37.81876474, 144.94710545"
72620240502,72,2024-05-02,6,66,60,126,ACMI_T,"-37.81726338, 144.96872809"
76620250825,76,2025-08-25,6,15,10,25,KenMac_T,"-37.79453803, 144.93036194"
271620231215,27,2023-12-15,16,124,93,217,Vic_T,"-37.80606888, 144.95644692"
21120240415,2,2024-04-15,11,450,509,959,Bou283_T,"-37.81380668, 144.96516718"
9620231215,9,2023-12-15,6,19,236,255,Col700_T,"-37.81982992, 144.95102555"
231820250624,23,2025-06-24,18,189,365,554,Col623_T,"-37.81909256, 144.95452748"
482320231128,48,2023-11-28,23,28,42,70,QVMQ_T,"-37.80631581, 144.95866697"
251720240717,25,2024-07-17,17,865,301,1166,MCEC_T,"-37.82401776, 144.95604426"
521020231227,52,2023-12-27,10,261,129,390,Eli263_T,"-37.81252157, 144.9619401"
137620241217,137,2024-12-17,6,24,4,28,BouHbr2353_T,"-37.81894815, 144.94612292"
1231420231109,123,2023-11-09,14,37,32,69,BirBridge_T,"-37.81753741, 144.97329734"
1231320240206,123,2024-02-06,13,22,17,39,BirBridge_T,"-37.81753741, 144.97329734"
117420250827,117,2025-08-27,4,3,3,6,Fli114F_T,"-37.81629332, 144.97090877"
1171220240315,117,2024-03-15,12,183,279,462,Fli114F_T,"-37.81629332, 144.97090877"
1171120240602,117,2024-06-02,11,74,126,200,Fli114F_T,"-37.81629332, 144.97090877"
661820240711,66,2024-07-11,18,1202,1064,2266,QVN_T,"-37.81057846, 144.96444294"
841020241019,84,2024-10-19,10,691,527,1218,ElFi_T,"-37.81798049, 144.96503383"
4420240104,4,2024-01-04,4,12,8,20,Swa123_T,"-37.81487988, 144.9660878"
702320250919,70,2025-09-19,23,6,16,22,Errol20_T,"-37.80456984, 144.94946228"
8320240427,8,2024-04-27,3,1,0,1,WebBN_T,"-37.82293543, 144.9471751"
75520240108,75,2024-01-08,5,0,4,4,SprFli_T,"-37.81515276, 144.97467661"
411020251002,41,2025-10-02,10,1277,842,2119,Swa31,"-37.81668634, 144.96689733"
77020231122,77,2023-11-22,0,16,18,34,HarEsP_T,"-37.81441438, 144.94433026"
71520250603,71,2025-06-03,5,2,1,3,WestWP_T,"-37.81235775, 144.97136962"
65220240607,65,2024-06-07,2,4,3,7,SwaCs_T,"-37.81569416, 144.9668064"
542220231216,54,2023-12-16,22,68,44,112,Swa607_T,"-37.804024, 144.96308399"
29020241029,29,2024-10-29,0,2,11,13,AG_T,"-37.8199817, 144.96872865"
312220250508,31,2025-05-08,22,94,175,269,Lyg161_T,"-37.80169681, 144.96658911"
311120240227,31,2024-02-27,11,114,108,222,Lyg161_T,"-37.80169681, 144.96658911"
31120240330,31,2024-03-30,1,17,27,44,Lyg161_T,"-37.80169681, 144.96658911"
541720250225,54,2025-02-25,17,138,317,455,Swa607_T,"-37.804024, 144.96308399"
472120250907,47,2025-09-07,21,306,215,521,Eli250_T,"-37.81258467, 144.9625775"
1311120240229,131,2024-02-29,11,88,145,233,King2_T,"-37.82009057, 144.95758725"
682120250427,68,2025-04-27,21,69,60,129,FLDegN_T,"-37.8168479, 144.96559789"
851820241126,85,2024-11-26,18,64,103,167,488Mac_T,"-37.79432415, 144.92973378"
85220250323,85,2025-03-23,2,2,2,4,488Mac_T,"-37.79432415, 144.92973378"
171920250405,17,2025-04-05,19,313,180,493,Col15_T,"-37.81362543, 144.97323591"
631120240608,63,2024-06-08,11,253,284,537,Bou231_T,"-37.81333081, 144.96675571"
631720240823,63,2024-08-23,17,402,338,740,Bou231_T,"-37.81333081, 144.96675571"
631720240315,63,2024-03-15,17,435,451,886,Bou231_T,"-37.81333081, 144.96675571"
12220250411,1,2025-04-11,22,242,261,503,Bou292_T,"-37.81349441, 144.96515323"
561120231227,56,2023-12-27,11,279,169,448,Lon364_T,"-37.81234775, 144.96153311"
24220240222,24,2024-02-22,2,30,19,49,Col620_T,"-37.81887963, 144.95449198"
241020250524,24,2025-05-24,10,704,517,1221,Col620_T,"-37.81887963, 144.95449198"
72520250629,72,2025-06-29,5,3,5,8,ACMI_T,"-37.81726338, 144.96872809"
35520241121,35,2024-11-21,5,90,72,162,SouthB_T,"-37.82018685, 144.96508508"
2820241230,2,2024-12-30,8,69,70,139,Bou283_T,"-37.81380668, 144.96516718"
531920240202,53,2024-02-02,19,332,213,545,Col254_T,"-37.81564191, 144.965499"
25320250516,25,2025-05-16,3,4,4,8,MCEC_T,"-37.82401776, 144.95604426"
52320241213,52,2024-12-13,3,1,11,12,Eli263_T,"-37.81252157, 144.9619401"
52120231023,52,2023-10-23,1,8,32,40,Eli263_T,"-37.81252157, 144.9619401"
51720250604,51,2025-06-04,7,32,25,57,Fra118_T,"-37.80841815, 144.95906316"
51020240321,51,2024-03-21,0,18,14,32,Fra118_T,"-37.80841815, 144.95906316"
51120241117,51,2024-11-17,1,18,11,29,Fra118_T,"-37.80841815, 144.95906316"
232220240731,23,2024-07-31,22,43,86,129,Col623_T,"-37.81909256, 144.95452748"
232120240822,23,2024-08-22,21,102,192,294,Col623_T,"-37.81909256, 144.95452748"
1171820240706,117,2024-07-06,18,190,184,374,Fli114F_T,"-37.81629332, 144.97090877"
1172120250913,117,2025-09-13,21,132,93,225,Fli114F_T,"-37.81629332, 144.97090877"
191920250815,19,2025-08-15,19,725,626,1351,LtB210_T,"-37.81237202, 144.96550671"
49020231110,49,2023-11-10,0,54,55,109,Eli501_T,"-37.80730068, 144.95956055"
109120250521,109,2025-05-21,1,8,12,20,LatWill_T,"-37.81193681, 144.95621105"
1411020251009,141,2025-10-09,10,179,96,275,474Fl_T,"-37.81997273, 144.95834911"
1422320250122,142,2025-01-22,23,3,6,9,Hammer1584_T,"-37.81970749, 144.96795734"
1361620240510,136,2024-05-10,16,65,43,108,BirFed1120_T,"-37.8184141, 144.97357915"
123620240209,123,2024-02-09,6,7,3,10,BirBridge_T,"-37.81753741, 144.97329734"
1301120240706,130,2024-07-06,11,21,36,57,Bou892T,"-37.8204637, 144.94126826"
661720231115,66,2023-11-15,17,1480,1320,2800,QVN_T,"-37.81057846, 144.96444294"
691520250224,69,2025-02-24,15,102,111,213,FLDegC_T,"-37.81687226, 144.96559144"
84120250105,84,2025-01-05,1,155,145,300,ElFi_T,"-37.81798049, 144.96503383"
70120240921,70,2024-09-21,1,4,5,9,Errol20_T,"-37.80456984, 144.94946228"
3020250909,3,2025-09-09,0,71,55,126,Swa295_T,"-37.81101524, 144.96429485"
391220231031,39,2023-10-31,12,266,194,460,AlfPl_T,"-37.81379749, 144.96995745"
752120240526,75,2024-05-26,21,10,10,20,SprFli_T,"-37.81515276, 144.97467661"
781320250914,78,2025-09-14,13,76,90,166,HarEsB_T,"-37.81471642, 144.9446508"
592020240901,59,2024-09-01,20,340,150,490,RMIT_T,"-37.80825648, 144.96304859"
652020231027,65,2023-10-27,20,296,587,883,SwaCs_T,"-37.81569416, 144.9668064"
29120250710,29,2025-07-10,1,2,7,9,AG_T,"-37.8199817, 144.96872865"
291320240210,29,2024-02-10,13,383,730,1113,AG_T,"-37.8199817, 144.96872865"
142320250309,14,2025-03-09,23,417,81,498,SanBri_T,"-37.82011242, 144.96291897"
312320240305,31,2024-03-05,23,27,37,64,Lyg161_T,"-37.80169681, 144.96658911"
54420241203,54,2024-12-03,4,0,1,1,Swa607_T,"-37.804024, 144.96308399"
28820250225,28,2025-02-25,8,657,345,1002,VAC_T,"-37.82129925, 144.96879309"
401920250603,40,2025-06-03,19,63,51,114,Spr201_T,"-37.80999341, 144.97227587"
312020241129,31,2024-11-29,20,312,301,613,Lyg161_T,"-37.80169681, 144.96658911"
442020240301,44,2024-03-01,20,14,19,33,UM3_T,"-37.79698741, 144.96441306"
451820241220,45,2024-12-20,18,722,844,1566,Swa148_T,"-37.81414075, 144.96609379"
501020240908,50,2024-09-08,10,123,157,280,Lyg309_T,"-37.79808192, 144.96721013"
43020241103,43,2024-11-03,0,24,10,34,UM2_T,"-37.79844526, 144.96411782"
441020240913,44,2024-09-13,10,65,96,161,UM3_T,"-37.79698741, 144.96441306"
45520231228,45,2023-12-28,5,17,25,42,Swa148_T,"-37.81414075, 144.96609379"
1621020250216,162,2025-02-16,10,412,465,877,Eli489_T,"-37.80740397, 144.95987909"
1431020240905,143,2024-09-05,10,76,301,377,Spencer_T,"-37.821728, 144.95557015"
1321020241225,132,2024-12-25,10,47,37,84,King335_T,"-37.81267639, 144.95386444"
131120241124,131,2024-11-24,1,126,151,277,King2_T,"-37.82009057, 144.95758725"
135420241228,135,2024-12-28,4,28,12,40,Spen161_T,"-37.8172861, 144.95319102"
1181420250810,118,2025-08-10,14,36,48,84,Fli114C_T,"-37.81632783, 144.97090512"
1241120250130,124,2025-01-30,11,6,5,11,BirBridge_T,"-37.81757416, 144.97329934"
1241520240106,124,2024-01-06,15,0,1,1,BirBridge_T,"-37.81757416, 144.97329934"
166720241111,166,2024-11-11,7,22,14,36,Spen484_T,"-37.80896733, 144.94931703"
1671620250613,167,2025-06-13,16,67,88,155,Lat526_T,"-37.81304149, 144.95155955"
171220231101,17,2023-11-01,12,697,596,1293,Col15_T,"-37.81362543, 144.97323591"
17720240224,17,2024-02-24,7,38,26,64,Col15_T,"-37.81362543, 144.97323591"
171820250309,17,2025-03-09,18,135,118,253,Col15_T,"-37.81362543, 144.97323591"
63320250217,63,2025-02-17,3,0,4,4,Bou231_T,"-37.81333081, 144.96675571"
24520231202,24,2023-12-02,5,24,40,64,Col620_T,"-37.81887963, 144.95449198"
101620240907,10,2024-09-07,16,29,21,50,BouHbr_T,"-37.81876474, 144.94710545"
101220250112,10,2025-01-12,12,10,14,24,BouHbr_T,"-37.81876474, 144.94710545"
76320250831,76,2025-08-31,3,1,0,1,KenMac_T,"-37.79453803, 144.93036194"
762320240216,76,2024-02-16,23,4,12,16,KenMac_T,"-37.79453803, 144.93036194"
11320250407,11,2025-04-07,3,1,0,1,WatCit_T,"-37.81564989, 144.93970694"
21920250623,2,2025-06-23,19,143,138,281,Bou283_T,"-37.81380668, 144.96516718"
581920250312,58,2025-03-12,19,265,282,547,Bou688_T,"-37.81686075, 144.95358075"
21520250320,2,2025-03-20,15,468,592,1060,Bou283_T,"-37.81380668, 144.96516718"
79320231123,79,2023-11-23,3,11,7,18,FliSS_T,"-37.81794046, 144.96616678"
301920250202,30,2025-02-02,19,302,618,920,Lon189_T,"-37.8112185, 144.96656806"
482220231221,48,2023-12-21,22,44,99,143,QVMQ_T,"-37.80631581, 144.95866697"
251020241117,25,2024-11-17,10,312,828,1140,MCEC_T,"-37.82401776, 144.95604426"
522020250509,52,2025-05-09,20,382,337,719,Eli263_T,"-37.81252157, 144.9619401"
521920240903,52,2024-09-03,19,218,261,479,Eli263_T,"-37.81252157, 144.9619401"
511720250618,51,2025-06-18,17,89,183,272,Fra118_T,"-37.80841815, 144.95906316"
137920250405,137,2025-04-05,9,8,15,23,BouHbr2353_T,"-37.81894815, 144.94612292"
161620250709,161,2025-07-09,6,10,0,10,BirArt1109_T,"-37.81851276, 144.97131336"
1381120250921,138,2025-09-21,11,5,7,12,EntPark1671_T,"-37.81996544, 144.95981454"
49320250101,49,2025-01-01,3,65,58,123,Eli501_T,"-37.80730068, 144.95956055"
1171920250921,117,2025-09-21,19,70,49,119,Fli114F_T,"-37.81629332, 144.97090877"
1172320250209,117,2025-02-09,23,79,178,257,Fli114F_T,"-37.81629332, 144.97090877"
1171120250228,117,2025-02-28,11,139,159,298,Fli114F_T,"-37.81629332, 144.97090877"
661820240814,66,2024-08-14,18,1406,1487,2893,QVN_T,"-37.81057846, 144.96444294"
31920231115,3,2023-11-15,19,1108,1095,2203,Swa295_T,"-37.81101524, 144.96429485"
41620240912,4,2024-09-12,16,1248,1108,2356,Swa123_T,"-37.81487988, 144.9660878"
751220240313,75,2024-03-13,12,108,72,180,SprFli_T,"-37.81515276, 144.97467661"
751820240516,75,2024-05-16,18,55,34,89,SprFli_T,"-37.81515276, 144.97467661"
31520250913,3,2025-09-13,15,1310,1385,2695,Swa295_T,"-37.81101524, 144.96429485"
81020250811,8,2025-08-11,10,139,156,295,WebBN_T,"-37.82293543, 144.9471751"
1081820250704,108,2025-07-04,18,401,209,610,261Will_T,"-37.81295822, 144.95678789"
1081620241014,108,2024-10-14,16,711,214,925,261Will_T,"-37.81295822, 144.95678789"
611320240402,61,2024-04-02,13,293,430,723,RMIT14_T,"-37.80767455, 144.96309114"
50520250808,50,2025-08-08,5,1,3,4,Lyg309_T,"-37.79808192, 144.96721013"
431920240515,43,2024-05-15,19,101,305,406,UM2_T,"-37.79844526, 144.96411782"
1821520250709,182,2025-07-09,15,234,156,390,King163_T,"-37.81627451, 144.95550503"
1791020250517,179,2025-05-17,10,65,61,126,Pow61_T,"-37.82392385, 144.96299677"
162920251005,162,2025-10-05,9,265,209,474,Eli489_T,"-37.80740397, 144.95987909"
167420241006,167,2024-10-06,4,0,1,1,Lat526_T,"-37.81304149, 144.95155955"
140720240613,140,2024-06-13,7,66,11,77,Boyd2837_T,"-37.82590962, 144.96185972"
1431520241228,143,2024-12-28,15,194,247,441,Spencer_T,"-37.821728, 144.95557015"
1321220250105,132,2025-01-05,12,130,65,195,King335_T,"-37.81267639, 144.95386444"
1612220241004,161,2024-10-04,22,1,1,2,BirArt1109_T,"-37.81851276, 144.97131336"
67520231115,67,2023-11-15,5,16,15,31,FLDegS_T,"-37.81688755, 144.96562569"
681120250111,68,2025-01-11,11,215,190,405,FLDegN_T,"-37.8168479, 144.96559789"
851220250322,85,2025-03-22,12,117,105,222,488Mac_T,"-37.79432415, 144.92973378"
171620250306,17,2025-03-06,16,211,385,596,Col15_T,"-37.81362543, 144.97323591"
12320231113,1,2023-11-13,23,61,62,123,Bou292_T,"-37.81349441, 144.96515323"
11720250416,1,2025-04-16,17,1744,1209,2953,Bou292_T,"-37.81349441, 144.96515323"
56020231128,56,2023-11-28,0,16,44,60,Lon364_T,"-37.81234775, 144.96153311"
86920240617,86,2024-06-17,9,7,2,9,574Qub_T,"-37.80309992, 144.94908064"
241920250803,24,2025-08-03,19,357,410,767,Col620_T,"-37.81887963, 144.95449198"
76620240202,76,2024-02-02,6,11,18,29,KenMac_T,"-37.79453803, 144.93036194"
53020241216,53,2024-12-16,0,16,31,47,Col254_T,"-37.81564191, 144.965499"
79420250924,79,2025-09-24,4,6,8,14,FliSS_T,"-37.81794046, 144.96616678"
791020250324,79,2025-03-24,10,355,281,636,FliSS_T,"-37.81794046, 144.96616678"
201120231022,20,2023-10-22,11,208,163,371,LtB170_T,"-37.81172914, 144.9682466"
201820250530,20,2025-05-30,18,687,552,1239,LtB170_T,"-37.81172914, 144.9682466"
51020250829,51,2025-08-29,0,8,16,24,Fra118_T,"-37.80841815, 144.95906316"
511220240402,51,2024-04-02,12,153,165,318,Fra118_T,"-37.80841815, 144.95906316"
51120240910,51,2024-09-10,1,10,5,15,Fra118_T,"-37.80841815, 144.95906316"
1091820250226,109,2025-02-26,18,222,103,325,LatWill_T,"-37.81193681, 144.95621105"
481920240804,48,2024-08-04,19,69,98,167,QVMQ_T,"-37.80631581, 144.95866697"
48320240206,48,2024-02-06,3,11,6,17,QVMQ_T,"-37.80631581, 144.95866697"
141820240813,141,2024-08-13,8,106,126,232,474Fl_T,"-37.81997273, 144.95834911"
139820250426,139,2025-04-26,8,6,15,21,Signal1647_T,"-37.81959923, 144.9632832"
1421320250105,142,2025-01-05,13,267,273,540,Hammer1584_T,"-37.81970749, 144.96795734"
1232020240219,123,2024-02-19,20,11,15,26,BirBridge_T,"-37.81753741, 144.97329734"
123920241129,123,2024-11-29,9,3,1,4,BirBridge_T,"-37.81753741, 144.97329734"
134720241008,134,2024-10-08,7,397,294,691,Spen201_T,"-37.81694221, 144.95303935"
1342120250515,134,2025-05-15,21,299,284,583,Spen201_T,"-37.81694221, 144.95303935"
134020250819,134,2025-08-19,0,30,30,60,Spen201_T,"-37.81694221, 144.95303935"
1351520250314,135,2025-03-14,15,590,629,1219,Spen161_T,"-37.8172861, 144.95319102"
852220241207,85,2024-12-07,22,26,12,38,488Mac_T,"-37.79432415, 144.92973378"
17220240204,17,2024-02-04,2,10,8,18,Col15_T,"-37.81362543, 144.97323591"
17520240517,17,2024-05-17,5,65,19,84,Col15_T,"-37.81362543, 144.97323591"
671020240308,67,2024-03-08,10,268,271,539,FLDegS_T,"-37.81688755, 144.96562569"
68520241217,68,2024-12-17,5,1,1,2,FLDegN_T,"-37.8168479, 144.96559789"
18120241125,18,2024-11-25,1,0,1,1,Col12_T,"-37.81344862, 144.97305353"
681020231101,68,2023-11-01,10,237,142,379,FLDegN_T,"-37.8168479, 144.96559789"
861020240319,86,2024-03-19,10,39,34,73,574Qub_T,"-37.80309992, 144.94908064"
81820240903,8,2024-09-03,18,163,226,389,WebBN_T,"-37.82293543, 144.9471751"
752320240623,75,2024-06-23,23,0,5,5,SprFli_T,"-37.81515276, 144.97467661"
772220240508,77,2024-05-08,22,2,2,4,HarEsP_T,"-37.81441438, 144.94433026"
291020240924,29,2024-09-24,10,118,202,320,AG_T,"-37.8199817, 144.96872865"
59120250912,59,2025-09-12,1,77,29,106,RMIT_T,"-37.80825648, 144.96304859"
14220241112,14,2024-11-12,2,9,0,9,SanBri_T,"-37.82011242, 144.96291897"
141520241113,14,2024-11-13,15,423,138,561,SanBri_T,"-37.82011242, 144.96291897"
71520241128,71,2024-11-28,5,7,1,8,WestWP_T,"-37.81235775, 144.97136962"
282120250221,28,2025-02-21,21,398,992,1390,VAC_T,"-37.82129925, 144.96879309"
541820250402,54,2025-04-02,18,212,464,676,Swa607_T,"-37.804024, 144.96308399"
281920240603,28,2024-06-03,19,148,137,285,VAC_T,"-37.82129925, 144.96879309"
402120240905,40,2024-09-05,21,109,52,161,Spr201_T,"-37.80999341, 144.97227587"
401220240608,40,2024-06-08,12,127,181,308,Spr201_T,"-37.80999341, 144.97227587"
311020240112,31,2024-01-12,10,86,103,189,Lyg161_T,"-37.80169681, 144.96658911"
31620241024,31,2024-10-24,6,6,13,19,Lyg161_T,"-37.80169681, 144.96658911"
54820250313,54,2025-03-13,8,297,47,344,Swa607_T,"-37.804024, 144.96308399"
361320250116,36,2025-01-16,13,270,289,559,Que85_T,"-37.81652527, 144.96121062"
37020241108,37,2024-11-08,0,11,8,19,Lyg260_T,"-37.80107122, 144.96704554"
47320250914,47,2025-09-14,3,77,41,118,Eli250_T,"-37.81258467, 144.9625775"
47720250712,47,2025-07-12,7,46,82,128,Eli250_T,"-37.81258467, 144.9625775"
611120240128,61,2024-01-28,11,170,287,457,RMIT14_T,"-37.80767455, 144.96309114"
50320240826,50,2024-08-26,3,8,0,8,Lyg309_T,"-37.79808192, 144.96721013"
452320250905,45,2025-09-05,23,271,354,625,Swa148_T,"-37.81414075, 144.96609379"
1401320240315,140,2024-03-15,13,85,46,131,Boyd2837_T,"-37.82590962, 144.96185972"
162020240729,162,2024-07-29,0,41,30,71,Eli489_T,"-37.80740397, 144.95987909"
1321920250902,132,2025-09-02,19,92,119,211,King335_T,"-37.81267639, 144.95386444"
1351020240402,135,2024-04-02,10,305,318,623,Spen161_T,"-37.8172861, 144.95319102"
135520240416,135,2024-04-16,5,18,15,33,Spen161_T,"-37.8172861, 144.95319102"
1331320250312,133,2025-03-12,13,581,518,1099,Spen229_T,"-37.81531435, 144.95227769"
1332120231214,133,2023-12-14,21,373,301,674,Spen229_T,"-37.81531435, 144.95227769"
1181820250525,118,2025-05-25,18,37,18,55,Fli114C_T,"-37.81632783, 144.97090512"
1791620241226,179,2024-12-26,16,39,37,76,Pow61_T,"-37.82392385, 144.96299677"
1671420241212,167,2024-12-12,14,10,9,19,Lat526_T,"-37.81304149, 144.95155955"
1412320231125,141,2023-11-25,23,176,160,336,474Fl_T,"-37.81997273, 144.95834911"
1392320240807,139,2024-08-07,23,0,1,1,Signal1647_T,"-37.81959923, 144.9632832"
1361720240312,136,2024-03-12,17,357,108,465,BirFed1120_T,"-37.8184141, 144.97357915"
1421520231118,142,2023-11-18,15,794,863,1657,Hammer1584_T,"-37.81970749, 144.96795734"
49920250809,49,2025-08-09,9,276,285,561,Eli501_T,"-37.80730068, 144.95956055"
1172020240416,117,2024-04-16,20,108,90,198,Fli114F_T,"-37.81629332, 144.97090877"
852020231027,85,2023-10-27,20,32,31,63,488Mac_T,"-37.79432415, 144.92973378"
851020250907,85,2025-09-07,10,102,85,187,488Mac_T,"-37.79432415, 144.92973378"
63020251010,63,2025-10-10,0,22,60,82,Bou231_T,"-37.81333081, 144.96675571"
11720250829,1,2025-08-29,17,1151,1041,2192,Bou292_T,"-37.81349441, 144.96515323"
621320240521,62,2024-05-21,13,200,156,356,Lat224_T,"-37.80996494, 144.96216521"
561820231204,56,2023-12-04,18,321,307,628,Lon364_T,"-37.81234775, 144.96153311"
561020250420,56,2025-04-20,10,342,150,492,Lon364_T,"-37.81234775, 144.96153311"
122320241102,12,2024-11-02,23,170,1261,1431,NewQ_T,"-37.81457988, 144.94292398"
101120250121,10,2025-01-21,11,120,73,193,BouHbr_T,"-37.81876474, 144.94710545"
721420240630,72,2024-06-30,14,292,325,617,ACMI_T,"-37.81726338, 144.96872809"
762120240801,76,2024-08-01,21,6,6,12,KenMac_T,"-37.79453803, 144.93036194"
22220250514,2,2025-05-14,22,17,115,132,Bou283_T,"-37.81380668, 144.96516718"
86020241001,86,2024-10-01,0,0,2,2,574Qub_T,"-37.80309992, 144.94908064"
101120250224,10,2025-02-24,11,123,65,188,BouHbr_T,"-37.81876474, 144.94710545"
58020240824,58,2024-08-24,0,87,118,205,Bou688_T,"-37.81686075, 144.95358075"
58920241121,58,2024-11-21,9,1220,163,1383,Bou688_T,"-37.81686075, 144.95358075"
581020231204,58,2023-12-04,10,692,207,899,Bou688_T,"-37.81686075, 144.95358075"
272020251012,27,2025-10-12,20,108,72,180,Vic_T,"-37.80606888, 144.95644692"
91420240222,9,2024-02-22,14,642,274,916,Col700_T,"-37.81982992, 144.95102555"
23320240105,23,2024-01-05,3,5,8,13,Col623_T,"-37.81909256, 144.95452748"
30620250116,30,2025-01-16,6,10,28,38,Lon189_T,"-37.8112185, 144.96656806"
191820250729,19,2025-07-29,18,721,412,1133,LtB210_T,"-37.81237202, 144.96550671"
19920250916,19,2025-09-16,9,115,91,206,LtB210_T,"-37.81237202, 144.96550671"
491820231129,49,2023-11-29,18,311,222,533,Eli501_T,"-37.80730068, 144.95956055"
109320240410,109,2024-04-10,3,4,4,8,LatWill_T,"-37.81193681, 144.95621105"
141520250824,141,2025-08-24,5,21,14,35,474Fl_T,"-37.81997273, 144.95834911"
1381020251005,138,2025-10-05,10,5,4,9,EntPark1671_T,"-37.81996544, 144.95981454"
1611220251007,161,2025-10-07,12,155,184,339,BirArt1109_T,"-37.81851276, 144.97131336"
1231020231225,123,2023-12-25,10,16,14,30,BirBridge_T,"-37.81753741, 144.97329734"
61420250312,6,2025-03-12,14,846,709,1555,FliS_T,"-37.81911705, 144.96558255"
84120240325,84,2024-03-25,1,83,72,155,ElFi_T,"-37.81798049, 144.96503383"
41520250828,4,2025-08-28,15,1484,1301,2785,Swa123_T,"-37.81487988, 144.9660878"
6920250808,6,2025-08-08,9,645,705,1350,FliS_T,"-37.81911705, 144.96558255"
701020231212,70,2023-12-12,10,114,115,229,Errol20_T,"-37.80456984, 144.94946228"
391720240902,39,2024-09-02,17,109,57,166,AlfPl_T,"-37.81379749, 144.96995745"
771120240727,77,2024-07-27,11,172,95,267,HarEsP_T,"-37.81441438, 144.94433026"
711920231210,71,2023-12-10,19,10,4,14,WestWP_T,"-37.81235775, 144.97136962"
282020240501,28,2024-05-01,20,75,92,167,VAC_T,"-37.82129925, 144.96879309"
28420240826,28,2024-08-26,4,3,30,33,VAC_T,"-37.82129925, 144.96879309"
54620240729,54,2024-07-29,6,18,3,21,Swa607_T,"-37.804024, 144.96308399"
471820250604,47,2025-06-04,18,1134,988,2122,Eli250_T,"-37.81258467, 144.9625775"
401620250609,40,2025-06-09,16,69,46,115,Spr201_T,"-37.80999341, 144.97227587"
31020250405,31,2025-04-05,0,68,70,138,Lyg161_T,"-37.80169681, 144.96658911"
361320241117,36,2024-11-17,13,99,119,218,Que85_T,"-37.81652527, 144.96121062"
451420241211,45,2024-12-11,14,513,827,1340,Swa148_T,"-37.81414075, 144.96609379"
212120250505,21,2025-05-05,21,138,152,290,Bourke155_T,"-37.81267313, 144.96788288"
211920250925,21,2025-09-25,19,416,445,861,Bourke155_T,"-37.81267313, 144.96788288"
108720250110,108,2025-01-10,7,54,297,351,261Will_T,"-37.81295822, 144.95678789"
872020250802,87,2025-08-02,20,66,53,119,Errol23_T,"-37.80454949, 144.94921863"
87020240526,87,2024-05-26,0,7,6,13,Errol23_T,"-37.80454949, 144.94921863"
43920250329,43,2025-03-29,9,45,51,96,UM2_T,"-37.79844526, 144.96411782"
441820250830,44,2025-08-30,18,47,45,92,UM3_T,"-37.79698741, 144.96441306"
1652120250603,165,2025-06-03,21,7,0,7,Spen475_T,"-37.80953359, 144.94939004"
131420250824,131,2025-08-24,4,32,41,73,King2_T,"-37.82009057, 144.95758725"
23020250904,23,2025-09-04,0,14,24,38,Col623_T,"-37.81909256, 144.95452748"
79320240709,79,2024-07-09,3,2,6,8,FliSS_T,"-37.81794046, 144.96616678"
251420250924,25,2025-09-24,14,573,682,1255,MCEC_T,"-37.82401776, 144.95604426"
46020240310,46,2024-03-10,0,16,16,32,Pel147_T,"-37.80240719, 144.9615673"
1801920250504,180,2025-05-04,19,3,3,6,Mac330_T,"-37.79497059, 144.93530329"
78720231215,78,2023-12-15,7,30,33,63,HarEsB_T,"-37.81471642, 144.9446508"
141520240329,14,2024-03-29,15,488,173,661,SanBri_T,"-37.82011242, 144.96291897"
14720240728,14,2024-07-28,7,63,16,79,SanBri_T,"-37.82011242, 144.96291897"
40820241228,40,2024-12-28,8,39,47,86,Spr201_T,"-37.80999341, 144.97227587"
402020250519,40,2025-05-19,20,51,18,69,Spr201_T,"-37.80999341, 144.97227587"
361320250902,36,2025-09-02,13,264,288,552,Que85_T,"-37.81652527, 144.96121062"
36120250921,36,2025-09-21,1,148,118,266,Que85_T,"-37.81652527, 144.96121062"
37220240327,37,2024-03-27,2,6,6,12,Lyg260_T,"-37.80107122, 144.96704554"
50120240228,50,2024-02-28,1,6,4,10,Lyg309_T,"-37.79808192, 144.96721013"
501120240309,50,2024-03-09,11,168,181,349,Lyg309_T,"-37.79808192, 144.96721013"
1322320250907,132,2025-09-07,23,49,39,88,King335_T,"-37.81267639, 144.95386444"
1321220240804,132,2024-08-04,12,169,123,292,King335_T,"-37.81267639, 144.95386444"
132720241112,132,2024-11-12,7,72,50,122,King335_T,"-37.81267639, 144.95386444"
1352220240202,135,2024-02-02,22,132,129,261,Spen161_T,"-37.8172861, 144.95319102"
107320241212,107,2024-12-12,3,3,8,11,280Will_T,"-37.81246271, 144.95690188"
1071420250518,107,2025-05-18,14,74,120,194,280Will_T,"-37.81246271, 144.95690188"
1331920240306,133,2024-03-06,19,700,435,1135,Spen229_T,"-37.81531435, 144.95227769"
108920240513,108,2024-05-13,9,93,802,895,261Will_T,"-37.81295822, 144.95678789"
87420240903,87,2024-09-03,4,2,0,2,Errol23_T,"-37.80454949, 144.94921863"
1821820250528,182,2025-05-28,18,253,222,475,King163_T,"-37.81627451, 144.95550503"
1661620241218,166,2024-12-18,16,57,32,89,Spen484_T,"-37.80896733, 144.94931703"
1791620250812,179,2025-08-12,16,35,35,70,Pow61_T,"-37.82392385, 144.96299677"
165520241220,165,2024-12-20,5,2,6,8,Spen475_T,"-37.80953359, 144.94939004"
662120250807,66,2025-08-07,21,926,559,1485,QVN_T,"-37.81057846, 144.96444294"
61320241021,6,2024-10-21,13,953,841,1794,FliS_T,"-37.81911705, 144.96558255"
61220250314,6,2025-03-14,12,779,784,1563,FliS_T,"-37.81911705, 144.96558255"
842120240811,84,2024-08-11,21,466,589,1055,ElFi_T,"-37.81798049, 144.96503383"
841320240814,84,2024-08-14,13,1021,1192,2213,ElFi_T,"-37.81798049, 144.96503383"
701120250213,70,2025-02-13,11,153,143,296,Errol20_T,"-37.80456984, 144.94946228"
701320250714,70,2025-07-14,13,135,158,293,Errol20_T,"-37.80456984, 144.94946228"
32220250106,3,2025-01-06,22,370,348,718,Swa295_T,"-37.81101524, 144.96429485"
70520240708,70,2024-07-08,5,2,1,3,Errol20_T,"-37.80456984, 144.94946228"
3520250612,3,2025-06-12,5,11,18,29,Swa295_T,"-37.81101524, 144.96429485"
851820231025,85,2023-10-25,18,43,67,110,488Mac_T,"-37.79432415, 144.92973378"
17520250101,17,2025-01-01,5,7,9,16,Col15_T,"-37.81362543, 144.97323591"
1420240323,1,2024-03-23,4,22,14,36,Bou292_T,"-37.81349441, 144.96515323"
62820240514,62,2024-05-14,8,76,124,200,Lat224_T,"-37.80996494, 144.96216521"
56820240205,56,2024-02-05,8,79,169,248,Lon364_T,"-37.81234775, 144.96153311"
561820240831,56,2024-08-31,18,448,398,846,Lon364_T,"-37.81234775, 144.96153311"
111520240720,11,2024-07-20,15,46,36,82,WatCit_T,"-37.81564989, 144.93970694"
12220241105,12,2024-11-05,2,2,6,8,NewQ_T,"-37.81457988, 144.94292398"
12020241214,12,2024-12-14,0,108,39,147,NewQ_T,"-37.81457988, 144.94292398"
12120250301,12,2025-03-01,1,18,9,27,NewQ_T,"-37.81457988, 144.94292398"
12520241012,12,2024-10-12,5,7,1,8,NewQ_T,"-37.81457988, 144.94292398"
101120240606,10,2024-06-06,11,87,66,153,BouHbr_T,"-37.81876474, 144.94710545"
351320231207,35,2023-12-07,13,1191,1528,2719,SouthB_T,"-37.82018685, 144.96508508"
581820231219,58,2023-12-19,18,609,507,1116,Bou688_T,"-37.81686075, 144.95358075"
581720240518,58,2024-05-18,17,804,516,1320,Bou688_T,"-37.81686075, 144.95358075"
143420250115,143,2025-01-15,4,22,12,34,Spencer_T,"-37.821728, 144.95557015"
143720250723,143,2025-07-23,7,81,113,194,Spencer_T,"-37.821728, 144.95557015"
132120240106,132,2024-01-06,1,39,11,50,King335_T,"-37.81267639, 144.95386444"
1351820250915,135,2025-09-15,18,232,318,550,Spen161_T,"-37.8172861, 144.95319102"
1311320240224,131,2024-02-24,13,156,157,313,King2_T,"-37.82009057, 144.95758725"
1351220240630,135,2024-06-30,12,622,417,1039,Spen161_T,"-37.8172861, 144.95319102"
1351420240917,135,2024-09-17,14,340,349,689,Spen161_T,"-37.8172861, 144.95319102"
133420250219,133,2025-02-19,4,11,27,38,Spen229_T,"-37.81531435, 144.95227769"
1331520241227,133,2024-12-27,15,428,565,993,Spen229_T,"-37.81531435, 144.95227769"
631420250708,63,2025-07-08,14,314,397,711,Bou231_T,"-37.81333081, 144.96675571"
111220250415,11,2025-04-15,12,172,180,352,WatCit_T,"-37.81564989, 144.93970694"
561520240511,56,2024-05-11,15,297,376,673,Lon364_T,"-37.81234775, 144.96153311"
561220240724,56,2024-07-24,12,396,341,737,Lon364_T,"-37.81234775, 144.96153311"
24520250710,24,2025-07-10,5,112,46,158,Col620_T,"-37.81887963, 144.95449198"
721220240420,72,2024-04-20,12,259,378,637,ACMI_T,"-37.81726338, 144.96872809"
722120240821,72,2024-08-21,21,95,138,233,ACMI_T,"-37.81726338, 144.96872809"
21120231202,2,2023-12-02,11,690,674,1364,Bou283_T,"-37.81380668, 144.96516718"
27720250304,27,2025-03-04,7,60,42,102,Vic_T,"-37.80606888, 144.95644692"
27020231220,27,2023-12-20,0,35,10,45,Vic_T,"-37.80606888, 144.95644692"
581420250821,58,2025-08-21,14,617,476,1093,Bou688_T,"-37.81686075, 144.95358075"
79220240208,79,2024-02-08,2,13,13,26,FliSS_T,"-37.81794046, 144.96616678"
92020240905,9,2024-09-05,20,134,43,177,Col700_T,"-37.81982992, 144.95102555"
791820250726,79,2025-07-26,18,1029,372,1401,FliSS_T,"-37.81794046, 144.96616678"
30420250523,30,2025-05-23,4,44,50,94,Lon189_T,"-37.8112185, 144.96656806"
302220240519,30,2024-05-19,22,129,157,286,Lon189_T,"-37.8112185, 144.96656806"
25020231109,25,2023-11-09,0,18,33,51,MCEC_T,"-37.82401776, 144.95604426"
20020250810,20,2025-08-10,0,352,539,891,LtB170_T,"-37.81172914, 144.9682466"
52620250827,52,2025-08-27,6,37,14,51,Eli263_T,"-37.81252157, 144.9619401"
461120231122,46,2023-11-22,11,45,67,112,Pel147_T,"-37.80240719, 144.9615673"
462120250606,46,2025-06-06,21,1,0,1,Pel147_T,"-37.80240719, 144.9615673"
511620240201,51,2024-02-01,16,101,57,158,Fra118_T,"-37.80841815, 144.95906316"
231520250103,23,2025-01-03,15,151,216,367,Col623_T,"-37.81909256, 144.95452748"
23020240722,23,2024-07-22,0,14,24,38,Col623_T,"-37.81909256, 144.95452748"
109520251004,109,2025-10-04,5,3,6,9,LatWill_T,"-37.81193681, 144.95621105"
1091520250211,109,2025-02-11,15,211,116,327,LatWill_T,"-37.81193681, 144.95621105"
482120240923,48,2024-09-23,21,50,42,92,QVMQ_T,"-37.80631581, 144.95866697"
48320241129,48,2024-11-29,3,3,6,9,QVMQ_T,"-37.80631581, 144.95866697"
481920250213,48,2025-02-13,19,99,94,193,QVMQ_T,"-37.80631581, 144.95866697"
481320240307,48,2024-03-07,13,456,240,696,QVMQ_T,"-37.80631581, 144.95866697"
180720250901,180,2025-09-01,7,57,13,70,Mac330_T,"-37.79497059, 144.93530329"
1421320240209,142,2024-02-09,13,456,522,978,Hammer1584_T,"-37.81970749, 144.96795734"
1301420250320,130,2025-03-20,14,59,48,107,Bou892T,"-37.8204637, 144.94126826"
1611320240720,161,2024-07-20,13,186,97,283,BirArt1109_T,"-37.81851276, 144.97131336"
1382120241012,138,2024-10-12,21,0,3,3,EntPark1671_T,"-37.81996544, 144.95981454"
691420231211,69,2023-12-11,14,209,218,427,FLDegC_T,"-37.81687226, 144.96559144"
6820250113,6,2025-01-13,8,738,2002,2740,FliS_T,"-37.81911705, 144.96558255"
841220241107,84,2024-11-07,12,1046,1192,2238,ElFi_T,"-37.81798049, 144.96503383"
8920240307,8,2024-03-07,9,205,115,320,WebBN_T,"-37.82293543, 144.9471751"
81920240815,8,2024-08-15,19,36,40,76,WebBN_T,"-37.82293543, 144.9471751"
772120240221,77,2024-02-21,21,176,138,314,HarEsP_T,"-37.81441438, 144.94433026"
772120241214,77,2024-12-14,21,187,219,406,HarEsP_T,"-37.81441438, 144.94433026"
782220240910,78,2024-09-10,22,2,11,13,HarEsB_T,"-37.81471642, 144.9446508"
781020251008,78,2025-10-08,10,22,29,51,HarEsB_T,"-37.81471642, 144.9446508"
591220250221,59,2025-02-21,12,309,403,712,RMIT_T,"-37.80825648, 144.96304859"
14020250317,14,2025-03-17,0,68,18,86,SanBri_T,"-37.82011242, 144.96291897"
14320240204,14,2024-02-04,3,36,15,51,SanBri_T,"-37.82011242, 144.96291897"
311420240724,31,2024-07-24,14,101,144,245,Lyg161_T,"-37.80169681, 144.96658911"
282220250130,28,2025-01-30,22,755,108,863,VAC_T,"-37.82129925, 144.96879309"
47520240225,47,2024-02-25,5,31,52,83,Eli250_T,"-37.81258467, 144.9625775"
472320240715,47,2024-07-15,23,23,31,54,Eli250_T,"-37.81258467, 144.9625775"
402120251001,40,2025-10-01,21,269,44,313,Spr201_T,"-37.80999341, 144.97227587"
311120250523,31,2025-05-23,11,114,84,198,Lyg161_T,"-37.80169681, 144.96658911"
36820250402,36,2025-04-02,8,305,138,443,Que85_T,"-37.81652527, 144.96121062"
451420231119,45,2023-11-19,14,1146,1700,2846,Swa148_T,"-37.81414075, 144.96609379"
51020240614,5,2024-06-14,10,327,678,1005,PriNW_T,"-37.81874249, 144.96787656"
211520231205,21,2023-12-05,15,414,404,818,Bourke155_T,"-37.81267313, 144.96788288"
21620241118,21,2024-11-18,6,14,25,39,Bourke155_T,"-37.81267313, 144.96788288"
108820240821,108,2024-08-21,8,73,2012,2085,261Will_T,"-37.81295822, 144.95678789"
50720240711,50,2024-07-11,7,17,27,44,Lyg309_T,"-37.79808192, 144.96721013"
165020250224,165,2025-02-24,0,5,2,7,Spen475_T,"-37.80953359, 144.94939004"
1652120250327,165,2025-03-27,21,40,16,56,Spen475_T,"-37.80953359, 144.94939004"
131420241204,131,2024-12-04,4,0,6,6,King2_T,"-37.82009057, 144.95758725"
143020251017,143,2025-10-17,0,70,18,88,Spencer_T,"-37.821728, 144.95557015"
143020240716,143,2024-07-16,0,2,0,2,Spencer_T,"-37.821728, 144.95557015"
1352220250720,135,2025-07-20,22,64,90,154,Spen161_T,"-37.8172861, 144.95319102"
135420250226,135,2025-02-26,4,31,13,44,Spen161_T,"-37.8172861, 144.95319102"
133820231027,133,2023-10-27,8,458,464,922,Spen229_T,"-37.81531435, 144.95227769"
124920250829,124,2025-08-29,9,2,4,6,BirBridge_T,"-37.81757416, 144.97329934"
67920240813,67,2024-08-13,9,566,371,937,FLDegS_T,"-37.81688755, 144.96562569"
68920240407,68,2024-04-07,9,135,127,262,FLDegN_T,"-37.8168479, 144.96559789"
182120250220,18,2025-02-20,21,40,10,50,Col12_T,"-37.81344862, 144.97305353"
63020241113,63,2024-11-13,0,12,47,59,Bou231_T,"-37.81333081, 144.96675571"
11920240518,11,2024-05-18,9,54,59,113,WatCit_T,"-37.81564989, 144.93970694"
562120240917,56,2024-09-17,21,148,224,372,Lon364_T,"-37.81234775, 144.96153311"
861620240131,86,2024-01-31,16,42,49,91,574Qub_T,"-37.80309992, 144.94908064"
762320240623,76,2024-06-23,23,0,1,1,KenMac_T,"-37.79453803, 144.93036194"
351020250418,35,2025-04-18,10,901,879,1780,SouthB_T,"-37.82018685, 144.96508508"
271820231114,27,2023-11-14,18,135,90,225,Vic_T,"-37.80606888, 144.95644692"
53620250212,53,2025-02-12,6,25,47,72,Col254_T,"-37.81564191, 144.965499"
25320231103,25,2023-11-03,3,9,13,22,MCEC_T,"-37.82401776, 144.95604426"
251920250119,25,2025-01-19,19,310,300,610,MCEC_T,"-37.82401776, 144.95604426"
20620250729,20,2025-07-29,6,13,13,26,LtB170_T,"-37.81172914, 144.9682466"
511720250203,51,2025-02-03,17,75,58,133,Fra118_T,"-37.80841815, 144.95906316"
351620250508,35,2025-05-08,16,1318,967,2285,SouthB_T,"-37.82018685, 144.96508508"
58020250428,58,2025-04-28,0,79,81,160,Bou688_T,"-37.81686075, 144.95358075"
791120240615,79,2024-06-15,11,468,306,774,FliSS_T,"-37.81794046, 144.96616678"
531820250919,53,2025-09-19,18,611,404,1015,Col254_T,"-37.81564191, 144.965499"
23620231116,23,2023-11-16,6,106,76,182,Col623_T,"-37.81909256, 144.95452748"
51820240805,51,2024-08-05,8,75,39,114,Fra118_T,"-37.80841815, 144.95906316"
481820240509,48,2024-05-09,18,131,211,342,QVMQ_T,"-37.80631581, 144.95866697"
20520231214,20,2023-12-14,5,5,10,15,LtB170_T,"-37.81172914, 144.9682466"
1391420231227,139,2023-12-27,14,93,109,202,Signal1647_T,"-37.81959923, 144.9632832"
1301220241004,130,2024-10-04,12,88,38,126,Bou892T,"-37.8204637, 144.94126826"
1301620241204,130,2024-12-04,16,38,34,72,Bou892T,"-37.8204637, 144.94126826"
161920241119,161,2024-11-19,9,74,127,201,BirArt1109_T,"-37.81851276, 144.97131336"
130220240927,130,2024-09-27,2,1,0,1,Bou892T,"-37.8204637, 144.94126826"
49920241223,49,2024-12-23,9,95,136,231,Eli501_T,"-37.80730068, 144.95956055"
49320250318,49,2025-03-18,3,24,22,46,Eli501_T,"-37.80730068, 144.95956055"
49720240917,49,2024-09-17,7,79,102,181,Eli501_T,"-37.80730068, 144.95956055"
109720241121,109,2024-11-21,7,46,244,290,LatWill_T,"-37.81193681, 144.95621105"
662120241221,66,2024-12-21,21,1129,944,2073,QVN_T,"-37.81057846, 144.96444294"
41720231225,4,2023-12-25,17,1068,832,1900,Swa123_T,"-37.81487988, 144.9660878"
4120250219,4,2025-02-19,1,24,34,58,Swa123_T,"-37.81487988, 144.9660878"
781720241011,78,2024-10-11,17,34,144,178,HarEsB_T,"-37.81471642, 144.9446508"
781420241015,78,2024-10-15,14,60,175,235,HarEsB_T,"-37.81471642, 144.9446508"
42820241201,42,2024-12-01,8,18,22,40,UM1_T,"-37.80008566, 144.96386412"
14320240319,14,2024-03-19,3,5,1,6,SanBri_T,"-37.82011242, 144.96291897"
14120240515,14,2024-05-15,1,18,4,22,SanBri_T,"-37.82011242, 144.96291897"
652120231223,65,2023-12-23,21,1051,1920,2971,SwaCs_T,"-37.81569416, 144.9668064"
541420240109,54,2024-01-09,14,162,172,334,Swa607_T,"-37.804024, 144.96308399"
40420250302,40,2025-03-02,4,4,2,6,Spr201_T,"-37.80999341, 144.97227587"
372120240623,37,2024-06-23,21,114,156,270,Lyg260_T,"-37.80107122, 144.96704554"
472320250203,47,2025-02-03,23,88,92,180,Eli250_T,"-37.81258467, 144.9625775"
611220250218,61,2025-02-18,12,822,1053,1875,RMIT14_T,"-37.80767455, 144.96309114"
501920250517,50,2025-05-17,19,281,300,581,Lyg309_T,"-37.79808192, 144.96721013"
43820240726,43,2024-07-26,8,232,69,301,UM2_T,"-37.79844526, 144.96411782"
51520250714,5,2025-07-14,15,1123,860,1983,PriNW_T,"-37.81874249, 144.96787656"
143120241122,143,2024-11-22,1,54,29,83,Spencer_T,"-37.821728, 144.95557015"
1351220240405,135,2024-04-05,12,489,448,937,Spen161_T,"-37.8172861, 144.95319102"
1352020250411,135,2025-04-11,20,191,246,437,Spen161_T,"-37.8172861, 144.95319102"
1351320250930,135,2025-09-30,13,447,490,937,Spen161_T,"-37.8172861, 144.95319102"
1332120240902,133,2024-09-02,21,252,166,418,Spen229_T,"-37.81531435, 144.95227769"
87720250518,87,2025-05-18,7,10,10,20,Errol23_T,"-37.80454949, 144.94921863"
1662020250317,166,2025-03-17,20,5,5,10,Spen484_T,"-37.80896733, 144.94931703"
1791220250827,179,2025-08-27,12,55,53,108,Pow61_T,"-37.82392385, 144.96299677"
165020241122,165,2024-11-22,0,3,2,5,Spen475_T,"-37.80953359, 144.94939004"
1651420250211,165,2025-02-11,14,34,24,58,Spen475_T,"-37.80953359, 144.94939004"
1671320240828,167,2024-08-28,13,15,53,68,Lat526_T,"-37.81304149, 144.95155955"
672320250526,67,2025-05-26,23,16,34,50,FLDegS_T,"-37.81688755, 144.96562569"
85920250426,85,2025-04-26,9,92,83,175,488Mac_T,"-37.79432415, 144.92973378"
68220241001,68,2024-10-01,2,1,0,1,FLDegN_T,"-37.8168479, 144.96559789"
622120250930,62,2025-09-30,21,193,509,702,Lat224_T,"-37.80996494, 144.96216521"
632120250525,63,2025-05-25,21,21,104,125,Bou231_T,"-37.81333081, 144.96675571"
78620240531,78,2024-05-31,6,2,2,4,HarEsB_T,"-37.81471642, 144.9446508"
41320250814,41,2025-08-14,3,19,20,39,Swa31,"-37.81668634, 144.96689733"
59920250903,59,2025-09-03,9,419,245,664,RMIT_T,"-37.80825648, 144.96304859"
14720240115,14,2024-01-15,7,148,150,298,SanBri_T,"-37.82011242, 144.96291897"
291420240327,29,2024-03-27,14,41,37,78,AG_T,"-37.8199817, 144.96872865"
31120250812,31,2025-08-12,1,14,2,16,Lyg161_T,"-37.80169681, 144.96658911"
541920250401,54,2025-04-01,19,154,288,442,Swa607_T,"-37.804024, 144.96308399"
471820250104,47,2025-01-04,18,587,612,1199,Eli250_T,"-37.81258467, 144.9625775"
471420251003,47,2025-10-03,14,1065,1084,2149,Eli250_T,"-37.81258467, 144.9625775"
451420231024,45,2023-10-24,14,420,616,1036,Swa148_T,"-37.81414075, 144.96609379"
5920231128,5,2023-11-28,9,364,553,917,PriNW_T,"-37.81874249, 144.96787656"
51820240119,5,2024-01-19,18,1257,1858,3115,PriNW_T,"-37.81874249, 144.96787656"
211520231109,21,2023-11-09,15,331,429,760,Bourke155_T,"-37.81267313, 144.96788288"
501420240914,50,2024-09-14,14,262,251,513,Lyg309_T,"-37.79808192, 144.96721013"
502120250509,50,2025-05-09,21,283,176,459,Lyg309_T,"-37.79808192, 144.96721013"
45720240903,45,2024-09-03,7,201,172,373,Swa148_T,"-37.81414075, 144.96609379"
131820241114,131,2024-11-14,8,159,39,198,King2_T,"-37.82009057, 144.95758725"
133820241002,133,2024-10-02,8,484,502,986,Spen229_T,"-37.81531435, 144.95227769"
1182020240113,118,2024-01-13,20,26,12,38,Fli114C_T,"-37.81632783, 144.97090512"
107420241017,107,2024-10-17,4,1,3,4,280Will_T,"-37.81246271, 144.95690188"
61920241221,61,2024-12-21,9,66,170,236,RMIT14_T,"-37.80767455, 144.96309114"
87020231105,87,2023-11-05,0,13,14,27,Errol23_T,"-37.80454949, 144.94921863"
61620240509,61,2024-05-09,6,27,70,97,RMIT14_T,"-37.80767455, 144.96309114"
611720240628,61,2024-06-28,17,336,458,794,RMIT14_T,"-37.80767455, 144.96309114"
611820240223,61,2024-02-23,18,384,513,897,RMIT14_T,"-37.80767455, 144.96309114"
1811320251016,181,2025-10-16,13,828,1024,1852,Eli368_T,"-37.81009465, 144.96143149"
661820250122,66,2025-01-22,18,1096,1055,2151,QVN_T,"-37.81057846, 144.96444294"
692020240417,69,2024-04-17,20,46,33,79,FLDegC_T,"-37.81687226, 144.96559144"
692020240529,69,2024-05-29,20,39,30,69,FLDegC_T,"-37.81687226, 144.96559144"
841320240830,84,2024-08-30,13,1001,1267,2268,ElFi_T,"-37.81798049, 144.96503383"
61220250624,6,2025-06-24,12,754,572,1326,FliS_T,"-37.81911705, 144.96558255"
842020250811,84,2025-08-11,20,535,768,1303,ElFi_T,"-37.81798049, 144.96503383"
701320250817,70,2025-08-17,13,135,139,274,Errol20_T,"-37.80456984, 144.94946228"
31920250827,3,2025-08-27,19,1006,998,2004,Swa295_T,"-37.81101524, 144.96429485"
39720240908,39,2024-09-08,7,21,8,29,AlfPl_T,"-37.81379749, 144.96995745"
391220250616,39,2025-06-16,12,202,147,349,AlfPl_T,"-37.81379749, 144.96995745"
3420250526,3,2025-05-26,4,15,8,23,Swa295_T,"-37.81101524, 144.96429485"
3320240129,3,2024-01-29,3,53,24,77,Swa295_T,"-37.81101524, 144.96429485"
75320240615,75,2024-06-15,3,2,0,2,SprFli_T,"-37.81515276, 144.97467661"
751120250116,75,2025-01-16,11,35,101,136,SprFli_T,"-37.81515276, 144.97467661"
411320250320,41,2025-03-20,13,1511,2069,3580,Swa31,"-37.81668634, 144.96689733"
411220250416,41,2025-04-16,12,2214,1810,4024,Swa31,"-37.81668634, 144.96689733"
78320240104,78,2024-01-04,3,1,2,3,HarEsB_T,"-37.81471642, 144.9446508"
591520250329,59,2025-03-29,15,216,362,578,RMIT_T,"-37.80825648, 144.96304859"
281820250119,28,2025-01-19,18,289,513,802,VAC_T,"-37.82129925, 144.96879309"
282120240611,28,2024-06-11,21,69,195,264,VAC_T,"-37.82129925, 144.96879309"
292120250510,29,2025-05-10,21,55,105,160,AG_T,"-37.8199817, 144.96872865"
40220240426,40,2024-04-26,2,3,0,3,Spr201_T,"-37.80999341, 144.97227587"
311620241220,31,2024-12-20,16,109,115,224,Lyg161_T,"-37.80169681, 144.96658911"
36420240215,36,2024-02-15,4,7,4,11,Que85_T,"-37.81652527, 144.96121062"
36720240626,36,2024-06-26,7,68,84,152,Que85_T,"-37.81652527, 144.96121062"
37920250403,37,2025-04-03,9,32,43,75,Lyg260_T,"-37.80107122, 144.96704554"
611620241030,61,2024-10-30,16,556,854,1410,RMIT14_T,"-37.80767455, 144.96309114"
441320240915,44,2024-09-15,13,28,26,54,UM3_T,"-37.79698741, 144.96441306"
432120250824,43,2025-08-24,21,43,38,81,UM2_T,"-37.79844526, 144.96411782"
44320240415,44,2024-04-15,3,3,0,3,UM3_T,"-37.79698741, 144.96441306"
135720250403,135,2025-04-03,7,209,182,391,Spen161_T,"-37.8172861, 144.95319102"
1331920240513,133,2024-05-13,19,333,307,640,Spen229_T,"-37.81531435, 144.95227769"
133120240520,133,2024-05-20,1,16,4,20,Spen229_T,"-37.81531435, 144.95227769"
872220250326,87,2025-03-26,22,7,5,12,Errol23_T,"-37.80454949, 144.94921863"
181120240204,18,2024-02-04,11,55,61,116,Col12_T,"-37.81344862, 144.97305353"
181720241101,18,2024-11-01,17,494,120,614,Col12_T,"-37.81344862, 144.97305353"
181020241112,18,2024-11-12,10,660,535,1195,Col12_T,"-37.81344862, 144.97305353"
621620240624,62,2024-06-24,16,159,102,261,Lat224_T,"-37.80996494, 144.96216521"
24820250629,24,2025-06-29,8,302,191,493,Col620_T,"-37.81887963, 144.95449198"
72920240927,72,2024-09-27,9,132,214,346,ACMI_T,"-37.81726338, 144.96872809"
21720250204,2,2025-02-04,17,491,408,899,Bou283_T,"-37.81380668, 144.96516718"
35420250923,35,2025-09-23,4,11,2,13,SouthB_T,"-37.82018685, 144.96508508"
21620241104,2,2024-11-04,16,884,784,1668,Bou283_T,"-37.81380668, 144.96516718"
27120250729,27,2025-07-29,1,6,2,8,Vic_T,"-37.80606888, 144.95644692"
272220250303,27,2025-03-03,22,35,17,52,Vic_T,"-37.80606888, 144.95644692"
301420240129,30,2024-01-29,14,180,355,535,Lon189_T,"-37.8112185, 144.96656806"
79020250629,79,2025-06-29,0,127,146,273,FliSS_T,"-37.81794046, 144.96616678"
302120250102,30,2025-01-02,21,264,346,610,Lon189_T,"-37.8112185, 144.96656806"
231120250820,23,2025-08-20,11,226,303,529,Col623_T,"-37.81909256, 144.95452748"
49320240403,49,2024-04-03,3,24,24,48,Eli501_T,"-37.80730068, 144.95956055"
491520241208,49,2024-12-08,15,391,586,977,Eli501_T,"-37.80730068, 144.95956055"
19320240521,19,2024-05-21,3,6,17,23,LtB210_T,"-37.81237202, 144.96550671"
19820250409,19,2025-04-09,8,72,51,123,LtB210_T,"-37.81237202, 144.96550671"
481220241204,48,2024-12-04,12,227,179,406,QVMQ_T,"-37.80631581, 144.95866697"
301020250614,30,2025-06-14,10,77,185,262,Lon189_T,"-37.8112185, 144.96656806"
20320241003,20,2024-10-03,3,7,7,14,LtB170_T,"-37.81172914, 144.9682466"
20020231029,20,2023-10-29,0,365,472,837,LtB170_T,"-37.81172914, 144.9682466"
52220250816,52,2025-08-16,2,82,79,161,Eli263_T,"-37.81252157, 144.9619401"
1411220250122,141,2025-01-22,12,209,170,379,474Fl_T,"-37.81997273, 144.95834911"
1391020240701,139,2024-07-01,10,27,41,68,Signal1647_T,"-37.81959923, 144.9632832"
1301820250202,130,2025-02-02,18,30,15,45,Bou892T,"-37.8204637, 144.94126826"
1381620231231,138,2023-12-31,16,14,4,18,EntPark1671_T,"-37.81996544, 144.95981454"
109820240805,109,2024-08-05,8,83,622,705,LatWill_T,"-37.81193681, 144.95621105"
19320250531,19,2025-05-31,3,24,55,79,LtB210_T,"-37.81237202, 144.96550671"
481620231121,48,2023-11-21,16,144,134,278,QVMQ_T,"-37.80631581, 144.95866697"
1411120250427,141,2025-04-27,11,165,143,308,474Fl_T,"-37.81997273, 144.95834911"
1392320240220,139,2024-02-20,23,11,11,22,Signal1647_T,"-37.81959923, 144.9632832"
139320250525,139,2025-05-25,3,5,0,5,Signal1647_T,"-37.81959923, 144.9632832"
1361420240512,136,2024-05-12,14,123,84,207,BirFed1120_T,"-37.8184141, 144.97357915"
1302320250217,130,2025-02-17,23,1,0,1,Bou892T,"-37.8204637, 144.94126826"
164920241115,164,2024-11-15,9,86,50,136,Lat526_T,"-37.813005, 144.95160411"
661720241013,66,2024-10-13,17,1247,1486,2733,QVN_T,"-37.81057846, 144.96444294"
66820250110,66,2025-01-10,8,116,243,359,QVN_T,"-37.81057846, 144.96444294"
69820231223,69,2023-12-23,8,73,34,107,FLDegC_T,"-37.81687226, 144.96559144"
69420241130,69,2024-11-30,4,3,1,4,FLDegC_T,"-37.81687226, 144.96559144"
841620240403,84,2024-04-03,16,957,1670,2627,ElFi_T,"-37.81798049, 144.96503383"
41220250307,4,2025-03-07,12,2182,1365,3547,Swa123_T,"-37.81487988, 144.9660878"
701320231118,70,2023-11-18,13,158,157,315,Errol20_T,"-37.80456984, 144.94946228"
31620250722,3,2025-07-22,16,968,1164,2132,Swa295_T,"-37.81101524, 144.96429485"
31020231127,3,2023-11-27,10,296,311,607,Swa295_T,"-37.81101524, 144.96429485"
82020250516,8,2025-05-16,20,29,12,41,WebBN_T,"-37.82293543, 144.9471751"
75420250301,75,2025-03-01,4,5,0,5,SprFli_T,"-37.81515276, 144.97467661"
42920250121,42,2025-01-21,9,118,71,189,UM1_T,"-37.80008566, 144.96386412"
591920231217,59,2023-12-17,19,457,326,783,RMIT_T,"-37.80825648, 144.96304859"
29020240306,29,2024-03-06,0,17,9,26,AG_T,"-37.8199817, 144.96872865"
40420240229,40,2024-02-29,4,0,2,2,Spr201_T,"-37.80999341, 144.97227587"
36720250316,36,2025-03-16,7,25,19,44,Que85_T,"-37.81652527, 144.96121062"
371020240805,37,2024-08-05,10,45,56,101,Lyg260_T,"-37.80107122, 144.96704554"
45220250207,45,2025-02-07,2,18,41,59,Swa148_T,"-37.81414075, 144.96609379"
45120250301,45,2025-03-01,1,62,215,277,Swa148_T,"-37.81414075, 144.96609379"
21420240323,21,2024-03-23,4,42,36,78,Bourke155_T,"-37.81267313, 144.96788288"
51220250823,5,2025-08-23,12,1096,1327,2423,PriNW_T,"-37.81874249, 144.96787656"
451620241209,45,2024-12-09,16,436,733,1169,Swa148_T,"-37.81414075, 144.96609379"
1072020240614,107,2024-06-14,20,69,70,139,280Will_T,"-37.81246271, 144.95690188"
611120241224,61,2024-12-24,11,197,337,534,RMIT14_T,"-37.80767455, 144.96309114"
1662320250701,166,2025-07-01,23,2,2,4,Spen484_T,"-37.80896733, 144.94931703"
179020250714,179,2025-07-14,0,3,4,7,Pow61_T,"-37.82392385, 144.96299677"
1671820241014,167,2024-10-14,18,47,72,119,Lat526_T,"-37.81304149, 144.95155955"
1621220240911,162,2024-09-11,12,478,545,1023,Eli489_T,"-37.80740397, 144.95987909"
143320250330,143,2025-03-30,3,71,40,111,Spencer_T,"-37.821728, 144.95557015"
1432020250612,143,2025-06-12,20,108,105,213,Spencer_T,"-37.821728, 144.95557015"
143220250924,143,2025-09-24,2,26,8,34,Spencer_T,"-37.821728, 144.95557015"
1321220240417,132,2024-04-17,12,136,160,296,King335_T,"-37.81267639, 144.95386444"
852020240424,85,2024-04-24,20,21,17,38,488Mac_T,"-37.79432415, 144.92973378"
85420240610,85,2024-06-10,4,1,2,3,488Mac_T,"-37.79432415, 144.92973378"
852320240718,85,2024-07-18,23,0,5,5,488Mac_T,"-37.79432415, 144.92973378"
17520240724,17,2024-07-24,5,72,20,92,Col15_T,"-37.81362543, 144.97323591"
63020250120,63,2025-01-20,0,3,24,27,Bou231_T,"-37.81333081, 144.96675571"
56420240322,56,2024-03-22,4,6,11,17,Lon364_T,"-37.81234775, 144.96153311"
561620240907,56,2024-09-07,16,378,442,820,Lon364_T,"-37.81234775, 144.96153311"
86720240810,86,2024-08-10,7,12,4,16,574Qub_T,"-37.80309992, 144.94908064"
69920240127,69,2024-01-27,9,134,90,224,FLDegC_T,"-37.81687226, 144.96559144"
6720231228,6,2023-12-28,7,189,165,354,FliS_T,"-37.81911705, 144.96558255"
61020241001,6,2024-10-01,10,534,465,999,FliS_T,"-37.81911705, 144.96558255"
842120250726,84,2025-07-26,21,503,602,1105,ElFi_T,"-37.81798049, 144.96503383"
66320240417,66,2024-04-17,3,30,4,34,QVN_T,"-37.81057846, 144.96444294"
31820250905,3,2025-09-05,18,1168,1445,2613,Swa295_T,"-37.81101524, 144.96429485"
81620231202,8,2023-12-02,16,155,182,337,WebBN_T,"-37.82293543, 144.9471751"
751220240216,75,2024-02-16,12,87,85,172,SprFli_T,"-37.81515276, 144.97467661"
411820241025,41,2024-10-25,18,1562,1144,2706,Swa31,"-37.81668634, 144.96689733"
41620250428,41,2025-04-28,6,471,134,605,Swa31,"-37.81668634, 144.96689733"
421320240710,42,2024-07-10,13,190,226,416,UM1_T,"-37.80008566, 144.96386412"
78920241201,78,2024-12-01,9,32,78,110,HarEsB_T,"-37.81471642, 144.9446508"
65720231111,65,2023-11-11,7,45,34,79,SwaCs_T,"-37.81569416, 144.9668064"
541420231214,54,2023-12-14,14,106,73,179,Swa607_T,"-37.804024, 144.96308399"
401720240912,40,2024-09-12,17,209,442,651,Spr201_T,"-37.80999341, 144.97227587"
54820241225,54,2024-12-25,8,10,19,29,Swa607_T,"-37.804024, 144.96308399"
471720250525,47,2025-05-25,17,1042,882,1924,Eli250_T,"-37.81258467, 144.9625775"
47720231212,47,2023-12-12,7,101,293,394,Eli250_T,"-37.81258467, 144.9625775"
471420250224,47,2025-02-24,14,798,847,1645,Eli250_T,"-37.81258467, 144.9625775"
612320250626,61,2025-06-26,23,58,46,104,RMIT14_T,"-37.80767455, 144.96309114"
61720231123,61,2023-11-23,7,86,155,241,RMIT14_T,"-37.80767455, 144.96309114"
502220251009,50,2025-10-09,22,90,26,116,Lyg309_T,"-37.79808192, 144.96721013"
441120250226,44,2025-02-26,11,48,86,134,UM3_T,"-37.79698741, 144.96441306"
45320241208,45,2024-12-08,3,15,105,120,Swa148_T,"-37.81414075, 144.96609379"
132320241116,132,2024-11-16,3,23,9,32,King335_T,"-37.81267639, 144.95386444"
1321620240105,132,2024-01-05,16,109,101,210,King335_T,"-37.81267639, 144.95386444"
132620240721,132,2024-07-21,6,15,12,27,King335_T,"-37.81267639, 144.95386444"
1311920240918,131,2024-09-18,19,80,59,139,King2_T,"-37.82009057, 144.95758725"
1351120250822,135,2025-08-22,11,390,496,886,Spen161_T,"-37.8172861, 144.95319102"
1071120240929,107,2024-09-29,11,28,31,59,280Will_T,"-37.81246271, 144.95690188"
107820241005,107,2024-10-05,8,39,48,87,280Will_T,"-37.81246271, 144.95690188"
1071820241224,107,2024-12-24,18,61,98,159,280Will_T,"-37.81246271, 144.95690188"
1181620250808,118,2025-08-08,16,18,23,41,Fli114C_T,"-37.81632783, 144.97090512"
118220250903,118,2025-09-03,2,1,5,6,Fli114C_T,"-37.81632783, 144.97090512"
182620250510,182,2025-05-10,6,25,40,65,King163_T,"-37.81627451, 144.95550503"
165020241218,165,2024-12-18,0,4,3,7,Spen475_T,"-37.80953359, 144.94939004"
1651320250908,165,2025-09-08,13,28,25,53,Spen475_T,"-37.80953359, 144.94939004"
12120240402,1,2024-04-02,21,200,175,375,Bou292_T,"-37.81349441, 144.96515323"
67520250226,67,2025-02-26,5,19,15,34,FLDegS_T,"-37.81688755, 144.96562569"
181320240701,18,2024-07-01,13,215,198,413,Col12_T,"-37.81344862, 144.97305353"
62320250911,62,2025-09-11,3,5,3,8,Lat224_T,"-37.80996494, 144.96216521"
63320250506,63,2025-05-06,3,1,1,2,Bou231_T,"-37.81333081, 144.96675571"
11520250209,11,2025-02-09,5,4,1,5,WatCit_T,"-37.81564989, 144.93970694"
56820240413,56,2024-04-13,8,97,62,159,Lon364_T,"-37.81234775, 144.96153311"
112020250602,11,2025-06-02,20,78,87,165,WatCit_T,"-37.81564989, 144.93970694"
112120250607,11,2025-06-07,21,25,20,45,WatCit_T,"-37.81564989, 144.93970694"
352020250124,35,2025-01-24,20,1352,1747,3099,SouthB_T,"-37.82018685, 144.96508508"
351620231129,35,2023-11-29,16,1022,842,1864,SouthB_T,"-37.82018685, 144.96508508"
58120250526,58,2025-05-26,1,16,24,40,Bou688_T,"-37.81686075, 144.95358075"
27320240722,27,2024-07-22,3,2,6,8,Vic_T,"-37.80606888, 144.95644692"
53820250502,53,2025-05-02,8,272,208,480,Col254_T,"-37.81564191, 144.965499"
532220240920,53,2024-09-20,22,129,134,263,Col254_T,"-37.81564191, 144.965499"
531320231226,53,2023-12-26,13,940,731,1671,Col254_T,"-37.81564191, 144.965499"
24920250406,24,2025-04-06,9,564,575,1139,Col620_T,"-37.81887963, 144.95449198"
24820240524,24,2024-05-24,8,1638,389,2027,Col620_T,"-37.81887963, 144.95449198"
722020231218,72,2023-12-18,20,106,277,383,ACMI_T,"-37.81726338, 144.96872809"
582020240419,58,2024-04-19,20,335,301,636,Bou688_T,"-37.81686075, 144.95358075"
58720231119,58,2023-11-19,7,120,63,183,Bou688_T,"-37.81686075, 144.95358075"
531620250926,53,2025-09-26,16,608,435,1043,Col254_T,"-37.81564191, 144.965499"
23720240324,23,2024-03-24,7,64,71,135,Col623_T,"-37.81909256, 144.95452748"
30820240614,30,2024-06-14,8,58,102,160,Lon189_T,"-37.8112185, 144.96656806"
30120231202,30,2023-12-02,1,303,287,590,Lon189_T,"-37.8112185, 144.96656806"
20120240925,20,2024-09-25,1,18,23,41,LtB170_T,"-37.81172914, 144.9682466"
20720240929,20,2024-09-29,7,28,26,54,LtB170_T,"-37.81172914, 144.9682466"
52720240509,52,2024-05-09,7,89,124,213,Eli263_T,"-37.81252157, 144.9619401"
46220240113,46,2024-01-13,2,1,1,2,Pel147_T,"-37.80240719, 144.9615673"
191920241102,19,2024-11-02,19,822,664,1486,LtB210_T,"-37.81237202, 144.96550671"
139420240622,139,2024-06-22,4,2,2,4,Signal1647_T,"-37.81959923, 144.9632832"
1392220240224,139,2024-02-24,22,13,24,37,Signal1647_T,"-37.81959923, 144.9632832"
66020241025,66,2024-10-25,0,72,65,137,QVN_T,"-37.81057846, 144.96444294"
841520240422,84,2024-04-22,15,842,1335,2177,ElFi_T,"-37.81798049, 144.96503383"
391820231025,39,2023-10-25,18,122,108,230,AlfPl_T,"-37.81379749, 144.96995745"
712120240630,71,2024-06-30,21,8,11,19,WestWP_T,"-37.81235775, 144.97136962"
592020250625,59,2025-06-25,20,154,125,279,RMIT_T,"-37.80825648, 144.96304859"
28520240825,28,2024-08-25,5,12,17,29,VAC_T,"-37.82129925, 144.96879309"
28120240203,28,2024-02-03,1,20,22,42,VAC_T,"-37.82129925, 144.96879309"
14420240408,14,2024-04-08,4,21,1,22,SanBri_T,"-37.82011242, 144.96291897"
541720250625,54,2025-06-25,17,128,145,273,Swa607_T,"-37.804024, 144.96308399"
471320250109,47,2025-01-09,13,780,925,1705,Eli250_T,"-37.81258467, 144.9625775"
40720250905,40,2025-09-05,7,91,73,164,Spr201_T,"-37.80999341, 144.97227587"
361720250206,36,2025-02-06,17,339,280,619,Que85_T,"-37.81652527, 144.96121062"
52120240612,5,2024-06-12,21,224,195,419,PriNW_T,"-37.81874249, 144.96787656"
21820250612,21,2025-06-12,8,73,72,145,Bourke155_T,"-37.81267313, 144.96788288"
1181620240426,118,2024-04-26,16,16,21,37,Fli114C_T,"-37.81632783, 144.97090512"
1082020250404,108,2025-04-04,20,225,131,356,261Will_T,"-37.81295822, 144.95678789"
87720240404,87,2024-04-04,7,31,29,60,Errol23_T,"-37.80454949, 144.94921863"
61620250715,61,2025-07-15,6,10,39,49,RMIT14_T,"-37.80767455, 144.96309114"
50720250120,50,2025-01-20,7,12,30,42,Lyg309_T,"-37.79808192, 144.96721013"
431920250816,43,2025-08-16,19,34,42,76,UM2_T,"-37.79844526, 144.96411782"
1672120250123,167,2025-01-23,21,10,30,40,Lat526_T,"-37.81304149, 144.95155955"
162320250619,162,2025-06-19,3,15,7,22,Eli489_T,"-37.80740397, 144.95987909"
1432320241123,143,2024-11-23,23,238,172,410,Spencer_T,"-37.821728, 144.95557015"
1431420250428,143,2025-04-28,14,91,126,217,Spencer_T,"-37.821728, 144.95557015"
1431320240414,143,2024-04-14,13,207,256,463,Spencer_T,"-37.821728, 144.95557015"
134220240717,134,2024-07-17,2,20,16,36,Spen201_T,"-37.81694221, 144.95303935"
1312020240318,131,2024-03-18,20,87,70,157,King2_T,"-37.82009057, 144.95758725"
1182320250224,118,2025-02-24,23,1,6,7,Fli114C_T,"-37.81632783, 144.97090512"
512120240525,51,2024-05-25,21,56,76,132,Fra118_T,"-37.80841815, 144.95906316"
511220241115,51,2024-11-15,12,119,50,169,Fra118_T,"-37.80841815, 144.95906316"
62620241025,62,2024-10-25,6,93,28,121,Lat224_T,"-37.80996494, 144.96216521"
621520250516,62,2025-05-16,15,429,267,696,Lat224_T,"-37.80996494, 144.96216521"
561720240614,56,2024-06-14,17,365,330,695,Lon364_T,"-37.81234775, 144.96153311"
11620240815,11,2024-08-15,6,21,20,41,WatCit_T,"-37.81564989, 144.93970694"
111020250317,11,2025-03-17,10,61,44,105,WatCit_T,"-37.81564989, 144.93970694"
352120250131,35,2025-01-31,21,981,1418,2399,SouthB_T,"-37.82018685, 144.96508508"
22320250920,2,2025-09-20,23,83,116,199,Bou283_T,"-37.81380668, 144.96516718"
21520240803,2,2024-08-03,15,944,843,1787,Bou283_T,"-37.81380668, 144.96516718"
271820241018,27,2024-10-18,18,121,69,190,Vic_T,"-37.80606888, 144.95644692"
92020240611,9,2024-06-11,20,79,50,129,Col700_T,"-37.81982992, 144.95102555"
30220250427,30,2025-04-27,2,131,255,386,Lon189_T,"-37.8112185, 144.96656806"
252320250808,25,2025-08-08,23,251,105,356,MCEC_T,"-37.82401776, 144.95604426"
461520240528,46,2024-05-28,15,107,80,187,Pel147_T,"-37.80240719, 144.9615673"
201320240811,20,2024-08-11,13,363,383,746,LtB170_T,"-37.81172914, 144.9682466"
25420250424,25,2025-04-24,4,2,3,5,MCEC_T,"-37.82401776, 144.95604426"
46620231107,46,2023-11-07,6,5,8,13,Pel147_T,"-37.80240719, 144.9615673"
1302320250407,130,2025-04-07,23,1,0,1,Bou892T,"-37.8204637, 144.94126826"
161020250729,161,2025-07-29,0,1,0,1,BirArt1109_T,"-37.81851276, 144.97131336"
1642120250629,164,2025-06-29,21,12,23,35,Lat526_T,"-37.813005, 144.95160411"
1381520250413,138,2025-04-13,15,7,2,9,EntPark1671_T,"-37.81996544, 144.95981454"
1231820240227,123,2024-02-27,18,32,18,50,BirBridge_T,"-37.81753741, 144.97329734"
492220250916,49,2025-09-16,22,101,129,230,Eli501_T,"-37.80730068, 144.95956055"
1171820250922,117,2025-09-22,18,110,136,246,Fli114F_T,"-37.81629332, 144.97090877"
117620250406,117,2025-04-06,6,11,20,31,Fli114F_T,"-37.81629332, 144.97090877"
49320240517,49,2024-05-17,3,26,27,53,Eli501_T,"-37.80730068, 144.95956055"
492320241204,49,2024-12-04,23,83,76,159,Eli501_T,"-37.80730068, 144.95956055"
691620250213,69,2025-02-13,16,176,165,341,FLDegC_T,"-37.81687226, 144.96559144"
41320250523,4,2025-05-23,13,1414,1457,2871,Swa123_T,"-37.81487988, 144.9660878"
701620241008,70,2024-10-08,16,160,145,305,Errol20_T,"-37.80456984, 144.94946228"
31420250416,3,2025-04-16,14,1296,1403,2699,Swa295_T,"-37.81101524, 144.96429485"
42820250718,42,2025-07-18,8,117,138,255,UM1_T,"-37.80008566, 144.96386412"
771020240707,77,2024-07-07,10,192,164,356,HarEsP_T,"-37.81441438, 144.94433026"
78920250622,78,2025-06-22,9,61,82,143,HarEsB_T,"-37.81471642, 144.9446508"
541120240331,54,2024-03-31,11,49,57,106,Swa607_T,"-37.804024, 144.96308399"
21720240913,21,2024-09-13,7,29,45,74,Bourke155_T,"-37.81267313, 144.96788288"
372220250425,37,2025-04-25,22,79,91,170,Lyg260_T,"-37.80107122, 144.96704554"
36120231215,36,2023-12-15,1,29,20,49,Que85_T,"-37.81652527, 144.96121062"
50920240920,50,2024-09-20,9,77,127,204,Lyg309_T,"-37.79808192, 144.96721013"
452120250106,45,2025-01-06,21,171,412,583,Swa148_T,"-37.81414075, 144.96609379"
451620240321,45,2024-03-21,16,591,928,1519,Swa148_T,"-37.81414075, 144.96609379"
211120240426,21,2024-04-26,11,341,295,636,Bourke155_T,"-37.81267313, 144.96788288"
21820250811,21,2025-08-11,8,63,84,147,Bourke155_T,"-37.81267313, 144.96788288"
1621820250102,162,2025-01-02,18,260,327,587,Eli489_T,"-37.80740397, 144.95987909"
1322220250220,132,2025-02-20,22,81,80,161,King335_T,"-37.81267639, 144.95386444"
134620250227,134,2025-02-27,6,176,168,344,Spen201_T,"-37.81694221, 144.95303935"
134820250302,134,2025-03-02,8,245,270,515,Spen201_T,"-37.81694221, 144.95303935"
117620240502,117,2024-05-02,6,41,30,71,Fli114F_T,"-37.81629332, 144.97090877"
1091220240530,109,2024-05-30,12,165,215,380,LatWill_T,"-37.81193681, 144.95621105"
141820250503,141,2025-05-03,8,55,51,106,474Fl_T,"-37.81997273, 144.95834911"
136720240530,136,2024-05-30,7,73,76,149,BirFed1120_T,"-37.8184141, 144.97357915"
1362120240625,136,2024-06-25,21,1,4,5,BirFed1120_T,"-37.8184141, 144.97357915"
1362220240831,136,2024-08-31,22,6,1,7,BirFed1120_T,"-37.8184141, 144.97357915"
1231320240127,123,2024-01-27,13,55,37,92,BirBridge_T,"-37.81753741, 144.97329734"
123820250923,123,2025-09-23,8,75,14,89,BirBridge_T,"-37.81753741, 144.97329734"
138720250503,138,2025-05-03,7,2,0,2,EntPark1671_T,"-37.81996544, 144.95981454"
1611420250512,161,2025-05-12,14,94,85,179,BirArt1109_T,"-37.81851276, 144.97131336"
17720250305,17,2025-03-05,7,394,83,477,Col15_T,"-37.81362543, 144.97323591"
11320240716,1,2024-07-16,13,1290,1120,2410,Bou292_T,"-37.81349441, 144.96515323"
12320240802,1,2024-08-02,23,119,82,201,Bou292_T,"-37.81349441, 144.96515323"
11320241224,1,2024-12-24,13,1615,1908,3523,Bou292_T,"-37.81349441, 144.96515323"
631120250714,63,2025-07-14,11,258,334,592,Bou231_T,"-37.81333081, 144.96675571"
622120250628,62,2025-06-28,21,180,228,408,Lat224_T,"-37.80996494, 144.96216521"
12920240111,12,2024-01-11,9,81,78,159,NewQ_T,"-37.81457988, 144.94292398"
242220240831,24,2024-08-31,22,230,332,562,Col620_T,"-37.81887963, 144.95449198"
10020240904,10,2024-09-04,0,3,1,4,BouHbr_T,"-37.81876474, 144.94710545"
242320250919,24,2025-09-19,23,198,618,816,Col620_T,"-37.81887963, 144.95449198"
22320241006,2,2024-10-06,23,120,49,169,Bou283_T,"-37.81380668, 144.96516718"
271120240118,27,2024-01-18,11,143,119,262,Vic_T,"-37.80606888, 144.95644692"
21720250413,2,2025-04-13,17,454,506,960,Bou283_T,"-37.81380668, 144.96516718"
791920240107,79,2024-01-07,19,193,214,407,FliSS_T,"-37.81794046, 144.96616678"
53920250106,53,2025-01-06,9,120,89,209,Col254_T,"-37.81564191, 144.965499"
792220250403,79,2025-04-03,22,220,845,1065,FliSS_T,"-37.81794046, 144.96616678"
301020240718,30,2024-07-18,10,98,186,284,Lon189_T,"-37.8112185, 144.96656806"
302120241026,30,2024-10-26,21,345,600,945,Lon189_T,"-37.8112185, 144.96656806"
301320250925,30,2025-09-25,13,374,522,896,Lon189_T,"-37.8112185, 144.96656806"
312120240620,31,2024-06-20,21,114,126,240,Lyg161_T,"-37.80169681, 144.96658911"
40620240922,40,2024-09-22,6,8,10,18,Spr201_T,"-37.80999341, 144.97227587"
36820250609,36,2025-06-09,8,34,31,65,Que85_T,"-37.81652527, 144.96121062"
5720241113,5,2024-11-13,7,187,390,577,PriNW_T,"-37.81874249, 144.96787656"
1181020240820,118,2024-08-20,10,14,14,28,Fli114C_T,"-37.81632783, 144.97090512"
87420241007,87,2024-10-07,4,3,4,7,Errol23_T,"-37.80454949, 144.94921863"
501920240129,50,2024-01-29,19,162,174,336,Lyg309_T,"-37.79808192, 144.96721013"
50420231028,50,2023-10-28,4,4,2,6,Lyg309_T,"-37.79808192, 144.96721013"
431120250830,43,2025-08-30,11,70,55,125,UM2_T,"-37.79844526, 144.96411782"
44420250316,44,2025-03-16,4,1,0,1,UM3_T,"-37.79698741, 144.96441306"
166320250215,166,2025-02-15,3,0,2,2,Spen484_T,"-37.80896733, 144.94931703"
167720250202,167,2025-02-02,7,12,32,44,Lat526_T,"-37.81304149, 144.95155955"
181120250420,181,2025-04-20,1,208,208,416,Eli368_T,"-37.81009465, 144.96143149"
1311820251007,131,2025-10-07,18,91,133,224,King2_T,"-37.82009057, 144.95758725"
143120240417,143,2024-04-17,1,22,11,33,Spencer_T,"-37.821728, 144.95557015"
143920240806,143,2024-08-06,9,127,319,446,Spencer_T,"-37.821728, 144.95557015"
1342120250917,134,2025-09-17,21,318,236,554,Spen201_T,"-37.81694221, 144.95303935"
1351520240415,135,2024-04-15,15,457,383,840,Spen161_T,"-37.8172861, 144.95319102"
1181020250925,118,2025-09-25,10,20,20,40,Fli114C_T,"-37.81632783, 144.97090512"
6820241106,6,2024-11-06,8,1028,2327,3355,FliS_T,"-37.81911705, 144.96558255"
841320240427,84,2024-04-27,13,1124,1377,2501,ElFi_T,"-37.81798049, 144.96503383"
841220240831,84,2024-08-31,12,1115,979,2094,ElFi_T,"-37.81798049, 144.96503383"
391520250930,39,2025-09-30,15,81,72,153,AlfPl_T,"-37.81379749, 144.96995745"
41520241024,41,2024-10-24,5,21,22,43,Swa31,"-37.81668634, 144.96689733"
781320240406,78,2024-04-06,13,60,66,126,HarEsB_T,"-37.81471642, 144.9446508"
41920240228,41,2024-02-28,9,1568,461,2029,Swa31,"-37.81668634, 144.96689733"
77020240224,77,2024-02-24,0,24,16,40,HarEsP_T,"-37.81441438, 144.94433026"
771020240905,77,2024-09-05,10,126,43,169,HarEsP_T,"-37.81441438, 144.94433026"
771220241020,77,2024-10-20,12,1298,1153,2451,HarEsP_T,"-37.81441438, 144.94433026"
77820250121,77,2025-01-21,8,148,176,324,HarEsP_T,"-37.81441438, 144.94433026"
78520250407,78,2025-04-07,5,0,4,4,HarEsB_T,"-37.81471642, 144.9446508"
711320231221,71,2023-12-21,13,15,18,33,WestWP_T,"-37.81235775, 144.97136962"
28820241204,28,2024-12-04,8,570,274,844,VAC_T,"-37.82129925, 144.96879309"
292120240510,29,2024-05-10,21,62,184,246,AG_T,"-37.8199817, 144.96872865"
292120250303,29,2025-03-03,21,45,62,107,AG_T,"-37.8199817, 144.96872865"
142120241004,14,2024-10-04,21,328,114,442,SanBri_T,"-37.82011242, 144.96291897"
85720241216,85,2024-12-16,7,61,22,83,488Mac_T,"-37.79432415, 144.92973378"
17720240406,17,2024-04-06,7,19,15,34,Col15_T,"-37.81362543, 144.97323591"
63820240821,63,2024-08-21,8,132,152,284,Bou231_T,"-37.81333081, 144.96675571"
631120240204,63,2024-02-04,11,172,214,386,Bou231_T,"-37.81333081, 144.96675571"
11720250421,11,2025-04-21,7,29,34,63,WatCit_T,"-37.81564989, 144.93970694"
681120240215,68,2024-02-15,11,169,125,294,FLDegN_T,"-37.8168479, 144.96559789"
62420241112,62,2024-11-12,4,16,19,35,Lat224_T,"-37.80996494, 144.96216521"
562020250226,56,2025-02-26,20,376,322,698,Lon364_T,"-37.81234775, 144.96153311"
24120231111,24,2023-11-11,1,79,107,186,Col620_T,"-37.81887963, 144.95449198"
761820241101,76,2024-11-01,18,69,73,142,KenMac_T,"-37.79453803, 144.93036194"
35520241225,35,2024-12-25,5,28,18,46,SouthB_T,"-37.82018685, 144.96508508"
351120240916,35,2024-09-16,11,597,509,1106,SouthB_T,"-37.82018685, 144.96508508"
2120240229,2,2024-02-29,1,2,9,11,Bou283_T,"-37.81380668, 144.96516718"
58420240329,58,2024-03-29,4,14,22,36,Bou688_T,"-37.81686075, 144.95358075"
58720240530,58,2024-05-30,7,739,123,862,Bou688_T,"-37.81686075, 144.95358075"
35620250614,35,2025-06-14,6,51,20,71,SouthB_T,"-37.82018685, 144.96508508"
9520250504,9,2025-05-04,5,7,6,13,Col700_T,"-37.81982992, 144.95102555"
532220240406,53,2024-04-06,22,190,459,649,Col254_T,"-37.81564191, 144.965499"
30120250304,30,2025-03-04,1,24,28,52,Lon189_T,"-37.8112185, 144.96656806"
301520250712,30,2025-07-12,15,344,566,910,Lon189_T,"-37.8112185, 144.96656806"
201820241118,20,2024-11-18,18,311,247,558,LtB170_T,"-37.81172914, 144.9682466"
202320231124,20,2023-11-24,23,246,360,606,LtB170_T,"-37.81172914, 144.9682466"
251220250603,25,2025-06-03,12,310,236,546,MCEC_T,"-37.82401776, 144.95604426"
522120240731,52,2024-07-31,21,190,134,324,Eli263_T,"-37.81252157, 144.9619401"
1172220231201,117,2023-12-01,22,247,228,475,Fli114F_T,"-37.81629332, 144.97090877"
117520240731,117,2024-07-31,5,7,7,14,Fli114F_T,"-37.81629332, 144.97090877"
117920241108,117,2024-11-08,9,133,119,252,Fli114F_T,"-37.81629332, 144.97090877"
491820240519,49,2024-05-19,18,188,182,370,Eli501_T,"-37.80730068, 144.95956055"
49820231215,49,2023-12-15,8,70,143,213,Eli501_T,"-37.80730068, 144.95956055"
49620240128,49,2024-01-28,6,28,29,57,Eli501_T,"-37.80730068, 144.95956055"
231020240713,23,2024-07-13,10,228,244,472,Col623_T,"-37.81909256, 144.95452748"
52220240927,52,2024-09-27,2,33,28,61,Eli263_T,"-37.81252157, 144.9619401"
46920250726,46,2025-07-26,9,30,29,59,Pel147_T,"-37.80240719, 144.9615673"
25320250404,25,2025-04-04,3,5,19,24,MCEC_T,"-37.82401776, 144.95604426"
20720250619,20,2025-06-19,7,20,24,44,LtB170_T,"-37.81172914, 144.9682466"
1801720250905,180,2025-09-05,17,75,66,141,Mac330_T,"-37.79497059, 144.93530329"
191720250515,19,2025-05-15,17,709,477,1186,LtB210_T,"-37.81237202, 144.96550671"
1371120241209,137,2024-12-09,11,15,58,73,BouHbr2353_T,"-37.81894815, 144.94612292"
136920240406,136,2024-04-06,9,49,56,105,BirFed1120_T,"-37.8184141, 144.97357915"
1361020250928,136,2025-09-28,10,91,61,152,BirFed1120_T,"-37.8184141, 144.97357915"
1642320250915,164,2025-09-15,23,7,24,31,Lat526_T,"-37.813005, 144.95160411"
1611120250714,161,2025-07-14,11,86,80,166,BirArt1109_T,"-37.81851276, 144.97131336"
1171220250420,117,2025-04-20,12,135,133,268,Fli114F_T,"-37.81629332, 144.97090877"
1092020240613,109,2024-06-13,20,90,89,179,LatWill_T,"-37.81193681, 144.95621105"
66120250416,66,2025-04-16,1,49,40,89,QVN_T,"-37.81057846, 144.96444294"
691720250415,69,2025-04-15,17,159,232,391,FLDegC_T,"-37.81687226, 144.96559144"
391920240619,39,2024-06-19,19,37,37,74,AlfPl_T,"-37.81379749, 144.96995745"
391620241015,39,2024-10-15,16,128,85,213,AlfPl_T,"-37.81379749, 144.96995745"
8720250709,8,2025-07-09,7,145,68,213,WebBN_T,"-37.82293543, 144.9471751"
75320240504,75,2024-05-04,3,0,3,3,SprFli_T,"-37.81515276, 144.97467661"
39120231214,39,2023-12-14,1,3,5,8,AlfPl_T,"-37.81379749, 144.96995745"
42020250424,42,2025-04-24,0,1,4,5,UM1_T,"-37.80008566, 144.96386412"
77820251011,77,2025-10-11,8,61,69,130,HarEsP_T,"-37.81441438, 144.94433026"
29620240903,29,2024-09-03,6,47,72,119,AG_T,"-37.8199817, 144.96872865"
14520241011,14,2024-10-11,5,41,41,82,SanBri_T,"-37.82011242, 144.96291897"
71220241118,71,2024-11-18,2,2,4,6,WestWP_T,"-37.81235775, 144.97136962"
71020240226,71,2024-02-26,0,3,5,8,WestWP_T,"-37.81235775, 144.97136962"
711720240802,71,2024-08-02,17,18,16,34,WestWP_T,"-37.81235775, 144.97136962"
54320231115,54,2023-11-15,3,8,3,11,Swa607_T,"-37.804024, 144.96308399"
28820250408,28,2025-04-08,8,567,312,879,VAC_T,"-37.82129925, 144.96879309"
29820231109,29,2023-11-09,8,137,118,255,AG_T,"-37.8199817, 144.96872865"
371220240824,37,2024-08-24,12,102,126,228,Lyg260_T,"-37.80107122, 144.96704554"
47920241102,47,2024-11-02,9,352,418,770,Eli250_T,"-37.81258467, 144.9625775"
611520250127,61,2025-01-27,15,232,223,455,RMIT14_T,"-37.80767455, 144.96309114"
61420250818,61,2025-08-18,4,6,6,12,RMIT14_T,"-37.80767455, 144.96309114"
502320240512,50,2024-05-12,23,8,12,20,Lyg309_T,"-37.79808192, 144.96721013"
501420250924,50,2025-09-24,14,206,175,381,Lyg309_T,"-37.79808192, 144.96721013"
43520231205,43,2023-12-05,5,2,1,3,UM2_T,"-37.79844526, 144.96411782"
45420231030,45,2023-10-30,4,2,23,25,Swa148_T,"-37.81414075, 144.96609379"
21320250120,21,2025-01-20,3,10,6,16,Bourke155_T,"-37.81267313, 144.96788288"
143320250121,143,2025-01-21,3,14,7,21,Spencer_T,"-37.821728, 144.95557015"
1431720250419,143,2025-04-19,17,298,282,580,Spencer_T,"-37.821728, 144.95557015"
1312020250929,131,2025-09-29,20,58,73,131,King2_T,"-37.82009057, 144.95758725"
871720231022,87,2023-10-22,17,48,48,96,Errol23_T,"-37.80454949, 144.94921863"
871520241118,87,2024-11-18,15,77,118,195,Errol23_T,"-37.80454949, 144.94921863"
1792120250626,179,2025-06-26,21,54,46,100,Pow61_T,"-37.82392385, 144.96299677"
162520241216,162,2024-12-16,5,18,9,27,Eli489_T,"-37.80740397, 144.95987909"
851720231025,85,2023-10-25,17,64,113,177,488Mac_T,"-37.79432415, 144.92973378"
17920240608,17,2024-06-08,9,121,84,205,Col15_T,"-37.81362543, 144.97323591"
1220231202,1,2023-12-02,2,32,43,75,Bou292_T,"-37.81349441, 144.96515323"
492120250819,49,2025-08-19,21,193,160,353,Eli501_T,"-37.80730068, 144.95956055"
25020251007,25,2025-10-07,0,27,32,59,MCEC_T,"-37.82401776, 144.95604426"
251920251009,25,2025-10-09,19,885,530,1415,MCEC_T,"-37.82401776, 144.95604426"
1391220240714,139,2024-07-14,12,10,31,41,Signal1647_T,"-37.81959923, 144.9632832"
1391520240914,139,2024-09-14,15,13,24,37,Signal1647_T,"-37.81959923, 144.9632832"
1361520251003,136,2025-10-03,15,77,45,122,BirFed1120_T,"-37.8184141, 144.97357915"
139220240102,139,2024-01-02,2,6,3,9,Signal1647_T,"-37.81959923, 144.9632832"
142720250726,142,2025-07-26,7,131,80,211,Hammer1584_T,"-37.81970749, 144.96795734"
1231120250502,123,2025-05-02,11,46,12,58,BirBridge_T,"-37.81753741, 144.97329734"
130920240607,130,2024-06-07,9,9,12,21,Bou892T,"-37.8204637, 144.94126826"
3120231024,3,2023-10-24,1,97,62,159,Swa295_T,"-37.81101524, 144.96429485"
70520241002,70,2024-10-02,5,4,2,6,Errol20_T,"-37.80456984, 144.94946228"
3920240526,3,2024-05-26,9,202,245,447,Swa295_T,"-37.81101524, 144.96429485"
3320250501,3,2025-05-01,3,14,16,30,Swa295_T,"-37.81101524, 144.96429485"
8820250223,8,2025-02-23,8,42,125,167,WebBN_T,"-37.82293543, 144.9471751"
81420240905,8,2024-09-05,14,80,133,213,WebBN_T,"-37.82293543, 144.9471751"
411220250528,41,2025-05-28,12,419,432,851,Swa31,"-37.81668634, 144.96689733"
711120231224,71,2023-12-24,11,6,2,8,WestWP_T,"-37.81235775, 144.97136962"
541620250521,54,2025-05-21,16,166,416,582,Swa607_T,"-37.804024, 144.96308399"
281820250302,28,2025-03-02,18,316,705,1021,VAC_T,"-37.82129925, 144.96879309"
401420250404,40,2025-04-04,14,240,177,417,Spr201_T,"-37.80999341, 144.97227587"
40820231107,40,2023-11-07,8,42,31,73,Spr201_T,"-37.80999341, 144.97227587"
361720240726,36,2024-07-26,17,439,257,696,Que85_T,"-37.81652527, 144.96121062"
37820240929,37,2024-09-29,8,21,20,41,Lyg260_T,"-37.80107122, 144.96704554"
451120240329,45,2024-03-29,11,284,388,672,Swa148_T,"-37.81414075, 144.96609379"
451520240513,45,2024-05-13,15,418,626,1044,Swa148_T,"-37.81414075, 144.96609379"
51120240825,5,2024-08-25,11,623,1022,1645,PriNW_T,"-37.81874249, 144.96787656"
871920240817,87,2024-08-17,19,56,59,115,Errol23_T,"-37.80454949, 144.94921863"
87720240301,87,2024-03-01,7,35,30,65,Errol23_T,"-37.80454949, 144.94921863"
61520240311,61,2024-03-11,5,4,21,25,RMIT14_T,"-37.80767455, 144.96309114"
501520250317,50,2025-03-17,15,206,196,402,Lyg309_T,"-37.79808192, 144.96721013"
43120250710,43,2025-07-10,1,1,1,2,UM2_T,"-37.79844526, 144.96411782"
50320240318,50,2024-03-18,3,5,0,5,Lyg309_T,"-37.79808192, 144.96721013"
1792220250721,179,2025-07-21,22,20,30,50,Pow61_T,"-37.82392385, 144.96299677"
166820241227,166,2024-12-27,8,21,26,47,Spen484_T,"-37.80896733, 144.94931703"
1651820241214,165,2024-12-14,18,46,48,94,Spen475_T,"-37.80953359, 144.94939004"
131020241208,131,2024-12-08,0,188,157,345,King2_T,"-37.82009057, 144.95758725"
167620241004,167,2024-10-04,6,2,21,23,Lat526_T,"-37.81304149, 144.95155955"
1401220240308,140,2024-03-08,12,92,41,133,Boyd2837_T,"-37.82590962, 144.96185972"
1401220241230,140,2024-12-30,12,84,45,129,Boyd2837_T,"-37.82590962, 144.96185972"
134020240518,134,2024-05-18,0,72,83,155,Spen201_T,"-37.81694221, 144.95303935"
1352020250722,135,2025-07-22,20,97,117,214,Spen161_T,"-37.8172861, 144.95319102"
131120231115,131,2023-11-15,1,14,34,48,King2_T,"-37.82009057, 144.95758725"
681620250923,68,2025-09-23,16,236,232,468,FLDegN_T,"-37.8168479, 144.96559789"
851920250325,85,2025-03-25,19,39,40,79,488Mac_T,"-37.79432415, 144.92973378"
171520250707,17,2025-07-07,15,524,322,846,Col15_T,"-37.81362543, 144.97323591"
172320250901,17,2025-09-01,23,22,26,48,Col15_T,"-37.81362543, 144.97323591"
1341520250425,134,2025-04-25,15,275,311,586,Spen201_T,"-37.81694221, 144.95303935"
1341320231129,134,2023-11-29,13,258,229,487,Spen201_T,"-37.81694221, 144.95303935"
1312120240818,131,2024-08-18,21,45,41,86,King2_T,"-37.82009057, 144.95758725"
1311920240228,131,2024-02-28,19,71,127,198,King2_T,"-37.82009057, 144.95758725"
135520241020,135,2024-10-20,5,61,35,96,Spen161_T,"-37.8172861, 144.95319102"
107720250907,107,2025-09-07,7,18,31,49,280Will_T,"-37.81246271, 144.95690188"
1182220250510,118,2025-05-10,22,26,19,45,Fli114C_T,"-37.81632783, 144.97090512"
1661720250122,166,2025-01-22,17,82,79,161,Spen484_T,"-37.80896733, 144.94931703"
1791820250926,179,2025-09-26,18,102,66,168,Pow61_T,"-37.82392385, 144.96299677"
165220250712,165,2025-07-12,2,3,0,3,Spen475_T,"-37.80953359, 144.94939004"
1671720240916,167,2024-09-16,17,46,86,132,Lat526_T,"-37.81304149, 144.95155955"
851020240717,85,2024-07-17,10,72,58,130,488Mac_T,"-37.79432415, 144.92973378"
63520241118,63,2024-11-18,5,3,8,11,Bou231_T,"-37.81333081, 144.96675571"
681720240924,68,2024-09-24,17,295,154,449,FLDegN_T,"-37.8168479, 144.96559789"
181020250725,18,2025-07-25,10,129,222,351,Col12_T,"-37.81344862, 144.97305353"
621120250203,62,2025-02-03,11,159,154,313,Lat224_T,"-37.80996494, 144.96216521"
621520250524,62,2025-05-24,15,296,160,456,Lat224_T,"-37.80996494, 144.96216521"
621920250724,62,2025-07-24,19,298,302,600,Lat224_T,"-37.80996494, 144.96216521"
86520241109,86,2024-11-09,5,1,1,2,574Qub_T,"-37.80309992, 144.94908064"
111620250914,11,2025-09-14,16,147,133,280,WatCit_T,"-37.81564989, 144.93970694"
121620240819,12,2024-08-19,16,162,169,331,NewQ_T,"-37.81457988, 144.94292398"
12220250906,12,2025-09-06,2,1,3,4,NewQ_T,"-37.81457988, 144.94292398"
10520231030,10,2023-10-30,5,8,2,10,BouHbr_T,"-37.81876474, 144.94710545"
721720241024,72,2024-10-24,17,270,960,1230,ACMI_T,"-37.81726338, 144.96872809"
35220250725,35,2025-07-25,2,9,16,25,SouthB_T,"-37.82018685, 144.96508508"
351220241207,35,2024-12-07,12,1174,1273,2447,SouthB_T,"-37.82018685, 144.96508508"
22020250106,2,2025-01-06,20,136,164,300,Bou283_T,"-37.81380668, 144.96516718"
21920240322,2,2024-03-22,19,441,395,836,Bou283_T,"-37.81380668, 144.96516718"
91920240704,9,2024-07-04,19,261,60,321,Col700_T,"-37.81982992, 144.95102555"
271420250828,27,2025-08-28,14,140,132,272,Vic_T,"-37.80606888, 144.95644692"
792320231129,79,2023-11-29,23,121,194,315,FliSS_T,"-37.81794046, 144.96616678"
51620231224,51,2023-12-24,6,15,33,48,Fra118_T,"-37.80841815, 144.95906316"
302120240610,30,2024-06-10,21,147,198,345,Lon189_T,"-37.8112185, 144.96656806"
48920241017,48,2024-10-17,9,213,150,363,QVMQ_T,"-37.80631581, 144.95866697"
462320231225,46,2023-12-25,23,10,11,21,Pel147_T,"-37.80240719, 144.9615673"
201020241111,20,2024-11-11,10,111,94,205,LtB170_T,"-37.81172914, 144.9682466"
251620240111,25,2024-01-11,16,896,632,1528,MCEC_T,"-37.82401776, 144.95604426"
251120241129,25,2024-11-29,11,1286,1191,2477,MCEC_T,"-37.82401776, 144.95604426"
180420250417,180,2025-04-17,4,1,0,1,Mac330_T,"-37.79497059, 144.93530329"
19020250214,19,2025-02-14,0,99,111,210,LtB210_T,"-37.81237202, 144.96550671"
1412320240711,141,2024-07-11,23,31,40,71,474Fl_T,"-37.81997273, 144.95834911"
1411420240827,141,2024-08-27,14,106,75,181,474Fl_T,"-37.81997273, 144.95834911"
1371720250922,137,2025-09-22,17,17,121,138,BouHbr2353_T,"-37.81894815, 144.94612292"
1362020241204,136,2024-12-04,20,49,40,89,BirFed1120_T,"-37.8184141, 144.97357915"
130020241105,130,2024-11-05,0,1,0,1,Bou892T,"-37.8204637, 144.94126826"
1421720231222,142,2023-12-22,17,732,915,1647,Hammer1584_T,"-37.81970749, 144.96795734"
1381520240827,138,2024-08-27,15,3,4,7,EntPark1671_T,"-37.81996544, 144.95981454"
691920240121,69,2024-01-21,19,67,56,123,FLDegC_T,"-37.81687226, 144.96559144"
691020240126,69,2024-01-26,10,279,189,468,FLDegC_T,"-37.81687226, 144.96559144"
18920240201,18,2024-02-01,9,159,695,854,Col12_T,"-37.81344862, 144.97305353"
632320231125,63,2023-11-25,23,281,422,703,Bou231_T,"-37.81333081, 144.96675571"
63420241205,63,2024-12-05,4,1,2,3,Bou231_T,"-37.81333081, 144.96675571"
1320250701,1,2025-07-01,3,10,8,18,Bou292_T,"-37.81349441, 144.96515323"
86820240709,86,2024-07-09,8,18,24,42,574Qub_T,"-37.80309992, 144.94908064"
11020240819,11,2024-08-19,0,3,8,11,WatCit_T,"-37.81564989, 144.93970694"
62120250122,62,2025-01-22,1,33,25,58,Lat224_T,"-37.80996494, 144.96216521"
11020250509,11,2025-05-09,0,9,6,15,WatCit_T,"-37.81564989, 144.93970694"
24820250810,24,2025-08-10,8,250,190,440,Col620_T,"-37.81887963, 144.95449198"
242220241107,24,2024-11-07,22,204,356,560,Col620_T,"-37.81887963, 144.95449198"
101320250915,10,2025-09-15,13,106,95,201,BouHbr_T,"-37.81876474, 144.94710545"
76120240415,76,2024-04-15,1,2,1,3,KenMac_T,"-37.79453803, 144.93036194"
35220250103,35,2025-01-03,2,23,13,36,SouthB_T,"-37.82018685, 144.96508508"
352120240815,35,2024-08-15,21,484,793,1277,SouthB_T,"-37.82018685, 144.96508508"
72120250909,72,2025-09-09,1,6,4,10,ACMI_T,"-37.81726338, 144.96872809"
22120250812,2,2025-08-12,21,51,81,132,Bou283_T,"-37.81380668, 144.96516718"
272320241221,27,2024-12-21,23,62,38,100,Vic_T,"-37.80606888, 144.95644692"
791520240201,79,2024-02-01,15,448,334,782,FliSS_T,"-37.81794046, 144.96616678"
23320240509,23,2024-05-09,3,6,9,15,Col623_T,"-37.81909256, 144.95452748"
231020240514,23,2024-05-14,10,189,227,416,Col623_T,"-37.81909256, 144.95452748"
251720250912,25,2025-09-12,17,1048,954,2002,MCEC_T,"-37.82401776, 144.95604426"
20320250528,20,2025-05-28,3,2,8,10,LtB170_T,"-37.81172914, 144.9682466"
141720240830,141,2024-08-30,7,44,43,87,474Fl_T,"-37.81997273, 144.95834911"
1391420241210,139,2024-12-10,14,45,53,98,Signal1647_T,"-37.81959923, 144.9632832"
1362220240317,136,2024-03-17,22,5,141,146,BirFed1120_T,"-37.8184141, 144.97357915"
1361620240801,136,2024-08-01,16,102,73,175,BirFed1120_T,"-37.8184141, 144.97357915"
142920240531,142,2024-05-31,9,140,122,262,Hammer1584_T,"-37.81970749, 144.96795734"
1611720250905,161,2025-09-05,17,1172,261,1433,BirArt1109_T,"-37.81851276, 144.97131336"
164020250828,164,2025-08-28,0,4,4,8,Lat526_T,"-37.813005, 144.95160411"
1231820250424,123,2025-04-24,18,35,0,35,BirBridge_T,"-37.81753741, 144.97329734"
1231220250304,123,2025-03-04,12,92,111,203,BirBridge_T,"-37.81753741, 144.97329734"
1301520240127,130,2024-01-27,15,16,38,54,Bou892T,"-37.8204637, 144.94126826"
117220250421,117,2025-04-21,2,8,0,8,Fli114F_T,"-37.81629332, 144.97090877"
66320250510,66,2025-05-10,3,61,51,112,QVN_T,"-37.81057846, 144.96444294"
84720240408,84,2024-04-08,7,636,224,860,ElFi_T,"-37.81798049, 144.96503383"
412220250212,41,2025-02-12,22,523,897,1420,Swa31,"-37.81668634, 144.96689733"
782320231207,78,2023-12-07,23,6,22,28,HarEsB_T,"-37.81471642, 144.9446508"
782320250723,78,2025-07-23,23,4,2,6,HarEsB_T,"-37.81471642, 144.9446508"
141020231102,14,2023-11-02,10,282,396,678,SanBri_T,"-37.82011242, 144.96291897"
71020250225,71,2025-02-25,0,3,2,5,WestWP_T,"-37.81235775, 144.97136962"
36120250302,36,2025-03-02,1,130,145,275,Que85_T,"-37.81652527, 144.96121062"
47820241103,47,2024-11-03,8,127,184,311,Eli250_T,"-37.81258467, 144.9625775"
61620250921,61,2025-09-21,6,18,31,49,RMIT14_T,"-37.80767455, 144.96309114"
70520250222,70,2025-02-22,5,2,6,8,Errol20_T,"-37.80456984, 144.94946228"
701720240112,70,2024-01-12,17,116,123,239,Errol20_T,"-37.80456984, 144.94946228"
751620240513,75,2024-05-13,16,55,45,100,SprFli_T,"-37.81515276, 144.97467661"
81620241012,8,2024-10-12,16,252,241,493,WebBN_T,"-37.82293543, 144.9471751"
77120241104,77,2024-11-04,1,16,1,17,HarEsP_T,"-37.81441438, 144.94433026"
77820250129,77,2025-01-29,8,124,173,297,HarEsP_T,"-37.81441438, 144.94433026"
42320240607,42,2024-06-07,3,0,4,4,UM1_T,"-37.80008566, 144.96386412"
78520241030,78,2024-10-30,5,0,1,1,HarEsB_T,"-37.81471642, 144.9446508"
291520240713,29,2024-07-13,15,450,564,1014,AG_T,"-37.8199817, 144.96872865"
651920240705,65,2024-07-05,19,776,597,1373,SwaCs_T,"-37.81569416, 144.9668064"
291920231216,29,2023-12-16,19,470,1290,1760,AG_T,"-37.8199817, 144.96872865"
31720240612,31,2024-06-12,7,32,18,50,Lyg161_T,"-37.80169681, 144.96658911"
50520240213,50,2024-02-13,5,6,2,8,Lyg309_T,"-37.79808192, 144.96721013"
431720241030,43,2024-10-30,17,245,200,445,UM2_T,"-37.79844526, 144.96411782"
51520241231,5,2024-12-31,15,1334,1581,2915,PriNW_T,"-37.81874249, 144.96787656"
131220251004,131,2025-10-04,2,35,91,126,King2_T,"-37.82009057, 144.95758725"
1331020250405,133,2025-04-05,10,430,426,856,Spen229_T,"-37.81531435, 144.95227769"
1181820240111,118,2024-01-11,18,21,63,84,Fli114C_T,"-37.81632783, 144.97090512"
87520240704,87,2024-07-04,5,4,3,7,Errol23_T,"-37.80454949, 144.94921863"
182620250727,182,2025-07-27,6,31,38,69,King163_T,"-37.81627451, 144.95550503"
70120240619,70,2024-06-19,1,0,2,2,Errol20_T,"-37.80456984, 144.94946228"
166420241117,166,2024-11-17,4,2,1,3,Spen484_T,"-37.80896733, 144.94931703"
1662320250303,166,2025-03-03,23,3,2,5,Spen484_T,"-37.80896733, 144.94931703"
11920231108,1,2023-11-08,19,736,378,1114,Bou292_T,"-37.81349441, 144.96515323"
631820241205,63,2024-12-05,18,376,431,807,Bou231_T,"-37.81333081, 144.96675571"
631220250122,63,2025-01-22,12,532,634,1166,Bou231_T,"-37.81333081, 144.96675571"
86920250702,86,2025-07-02,9,44,22,66,574Qub_T,"-37.80309992, 144.94908064"
11720240403,11,2024-04-03,7,53,40,93,WatCit_T,"-37.81564989, 144.93970694"
121820240925,12,2024-09-25,18,114,133,247,NewQ_T,"-37.81457988, 144.94292398"
72020250209,72,2025-02-09,0,40,62,102,ACMI_T,"-37.81726338, 144.96872809"
352220231101,35,2023-11-01,22,325,503,828,SouthB_T,"-37.82018685, 144.96508508"
35620240115,35,2024-01-15,6,238,245,483,SouthB_T,"-37.82018685, 144.96508508"
2020250203,2,2025-02-03,0,13,10,23,Bou283_T,"-37.81380668, 144.96516718"
792220240523,79,2024-05-23,22,139,54,193,FliSS_T,"-37.81794046, 144.96616678"
531120251004,53,2025-10-04,11,789,567,1356,Col254_T,"-37.81564191, 144.965499"
53020250312,53,2025-03-12,0,10,23,33,Col254_T,"-37.81564191, 144.965499"
63720250321,63,2025-03-21,7,44,58,102,Bou231_T,"-37.81333081, 144.96675571"
862020240421,86,2024-04-21,20,23,45,68,574Qub_T,"-37.80309992, 144.94908064"
101220231122,10,2023-11-22,12,176,162,338,BouHbr_T,"-37.81876474, 144.94710545"
10120231124,10,2023-11-24,1,0,5,5,BouHbr_T,"-37.81876474, 144.94710545"
101420250729,10,2025-07-29,14,107,67,174,BouHbr_T,"-37.81876474, 144.94710545"
581920240423,58,2024-04-23,19,322,318,640,Bou688_T,"-37.81686075, 144.95358075"
79020240302,79,2024-03-02,0,150,207,357,FliSS_T,"-37.81794046, 144.96616678"
53420250617,53,2025-06-17,4,7,6,13,Col254_T,"-37.81564191, 144.965499"
53520250409,53,2025-04-09,5,5,8,13,Col254_T,"-37.81564191, 144.965499"
232120240209,23,2024-02-09,21,73,166,239,Col623_T,"-37.81909256, 144.95452748"
791220250301,79,2025-03-01,12,722,554,1276,FliSS_T,"-37.81794046, 144.96616678"
202120250227,20,2025-02-27,21,257,423,680,LtB170_T,"-37.81172914, 144.9682466"
25620240314,25,2024-03-14,6,0,0,0,MCEC_T,"-37.82401776, 144.95604426"
461820240121,46,2024-01-21,18,47,39,86,Pel147_T,"-37.80240719, 144.9615673"
522020240121,52,2024-01-21,20,193,176,369,Eli263_T,"-37.81252157, 144.9619401"
511120240127,51,2024-01-27,11,157,116,273,Fra118_T,"-37.80841815, 144.95906316"
491120241009,49,2024-10-09,11,32,40,72,Eli501_T,"-37.80730068, 144.95956055"
1171320250210,117,2025-02-10,13,237,193,430,Fli114F_T,"-37.81629332, 144.97090877"
109020250716,109,2025-07-16,0,25,19,44,LatWill_T,"-37.81193681, 144.95621105"
25720250908,25,2025-09-08,7,209,320,529,MCEC_T,"-37.82401776, 144.95604426"
1371420250407,137,2025-04-07,14,10,44,54,BouHbr2353_T,"-37.81894815, 144.94612292"
136920240224,136,2024-02-24,9,43,57,100,BirFed1120_T,"-37.8184141, 144.97357915"
142420240902,142,2024-09-02,4,2,0,2,Hammer1584_T,"-37.81970749, 144.96795734"
1302220250915,130,2025-09-15,22,15,5,20,Bou892T,"-37.8204637, 144.94126826"
1642120250119,164,2025-01-19,21,37,73,110,Lat526_T,"-37.813005, 144.95160411"
1231820250701,123,2025-07-01,18,2,0,2,BirBridge_T,"-37.81753741, 144.97329734"
661420250516,66,2025-05-16,14,1211,1319,2530,QVN_T,"-37.81057846, 144.96444294"
691120240503,69,2024-05-03,11,172,139,311,FLDegC_T,"-37.81687226, 144.96559144"
41020250918,4,2025-09-18,10,1081,626,1707,Swa123_T,"-37.81487988, 144.9660878"
66720240302,66,2024-03-02,7,33,44,77,QVN_T,"-37.81057846, 144.96444294"
3520240321,3,2024-03-21,5,13,41,54,Swa295_T,"-37.81101524, 144.96429485"
75920250830,75,2025-08-30,9,18,15,33,SprFli_T,"-37.81515276, 144.97467661"
8620240525,8,2024-05-25,6,23,8,31,WebBN_T,"-37.82293543, 144.9471751"
751520250420,75,2025-04-20,15,29,39,68,SprFli_T,"-37.81515276, 144.97467661"
42220250401,42,2025-04-01,2,3,2,5,UM1_T,"-37.80008566, 144.96386412"
781520250701,78,2025-07-01,15,53,94,147,HarEsB_T,"-37.81471642, 144.9446508"
712020250112,71,2025-01-12,20,4,0,4,WestWP_T,"-37.81235775, 144.97136962"
28020231023,28,2023-10-23,0,35,5,40,VAC_T,"-37.82129925, 144.96879309"
14420240131,14,2024-01-31,4,21,2,23,SanBri_T,"-37.82011242, 144.96291897"
54120240512,54,2024-05-12,1,48,35,83,Swa607_T,"-37.804024, 144.96308399"
47120250724,47,2025-07-24,1,30,14,44,Eli250_T,"-37.81258467, 144.9625775"
312120250713,31,2025-07-13,21,128,177,305,Lyg161_T,"-37.80169681, 144.96658911"
36520240716,36,2024-07-16,5,12,4,16,Que85_T,"-37.81652527, 144.96121062"
212320240407,21,2024-04-07,23,92,90,182,Bourke155_T,"-37.81267313, 144.96788288"
52120251002,5,2025-10-02,21,973,513,1486,PriNW_T,"-37.81874249, 144.96787656"
52120241209,5,2024-12-09,21,899,1228,2127,PriNW_T,"-37.81874249, 144.96787656"
107320241222,107,2024-12-22,3,18,7,25,280Will_T,"-37.81246271, 144.95690188"
107420240501,107,2024-05-01,4,0,4,4,280Will_T,"-37.81246271, 144.95690188"
871420241109,87,2024-11-09,14,108,110,218,Errol23_T,"-37.80454949, 144.94921863"
431620240209,43,2024-02-09,16,124,57,181,UM2_T,"-37.79844526, 144.96411782"
45820250717,45,2025-07-17,8,221,305,526,Swa148_T,"-37.81414075, 144.96609379"
212220241103,21,2024-11-03,22,129,175,304,Bourke155_T,"-37.81267313, 144.96788288"
21820241129,21,2024-11-29,8,66,72,138,Bourke155_T,"-37.81267313, 144.96788288"
21420240126,21,2024-01-26,4,40,32,72,Bourke155_T,"-37.81267313, 144.96788288"
1431120250408,143,2025-04-08,11,101,169,270,Spencer_T,"-37.821728, 144.95557015"
1352020250515,135,2025-05-15,20,185,137,322,Spen161_T,"-37.8172861, 144.95319102"
1331420240815,133,2024-08-15,14,440,481,921,Spen229_T,"-37.81531435, 144.95227769"
1331820241004,133,2024-10-04,18,506,417,923,Spen229_T,"-37.81531435, 144.95227769"
107020240505,107,2024-05-05,0,41,42,83,280Will_T,"-37.81246271, 144.95690188"
871220240306,87,2024-03-06,12,164,148,312,Errol23_T,"-37.80454949, 144.94921863"
87920240614,87,2024-06-14,9,60,51,111,Errol23_T,"-37.80454949, 144.94921863"
852220250118,85,2025-01-18,22,18,8,26,488Mac_T,"-37.79432415, 144.92973378"
85720250222,85,2025-02-22,7,26,21,47,488Mac_T,"-37.79432415, 144.92973378"
11620240622,1,2024-06-22,16,1818,1524,3342,Bou292_T,"-37.81349441, 144.96515323"
67320250102,67,2025-01-02,3,4,6,10,FLDegS_T,"-37.81688755, 144.96562569"
672320240611,67,2024-06-11,23,13,39,52,FLDegS_T,"-37.81688755, 144.96562569"
63820231202,63,2023-12-02,8,50,60,110,Bou231_T,"-37.81333081, 144.96675571"
632320241013,63,2024-10-13,23,2,25,27,Bou231_T,"-37.81333081, 144.96675571"
11820250829,1,2025-08-29,18,1183,845,2028,Bou292_T,"-37.81349441, 144.96515323"
121220231129,12,2023-11-29,12,34,72,106,NewQ_T,"-37.81457988, 144.94292398"
121020240228,12,2024-02-28,10,80,97,177,NewQ_T,"-37.81457988, 144.94292398"
112320240906,11,2024-09-06,23,13,28,41,WatCit_T,"-37.81564989, 144.93970694"
622320250218,62,2025-02-18,23,93,66,159,Lat224_T,"-37.80996494, 144.96216521"
63320250325,63,2025-03-25,3,0,17,17,Bou231_T,"-37.81333081, 144.96675571"
10020240127,10,2024-01-27,0,3,4,7,BouHbr_T,"-37.81876474, 144.94710545"
721820231226,72,2023-12-26,18,118,181,299,ACMI_T,"-37.81726338, 144.96872809"
35820241214,35,2024-12-14,8,421,406,827,SouthB_T,"-37.82018685, 144.96508508"
721220250920,72,2025-09-20,12,226,336,562,ACMI_T,"-37.81726338, 144.96872809"
581520250319,58,2025-03-19,15,604,632,1236,Bou688_T,"-37.81686075, 144.95358075"
2120231027,2,2023-10-27,1,15,22,37,Bou283_T,"-37.81380668, 144.96516718"
30720240801,30,2024-08-01,7,51,57,108,Lon189_T,"-37.8112185, 144.96656806"
91020250318,9,2025-03-18,10,205,721,926,Col700_T,"-37.81982992, 144.95102555"
531320231114,53,2023-11-14,13,1006,851,1857,Col254_T,"-37.81564191, 144.965499"
30520241222,30,2024-12-22,5,77,88,165,Lon189_T,"-37.8112185, 144.96656806"
521820240411,52,2024-04-11,18,430,391,821,Eli263_T,"-37.81252157, 144.9619401"
491920250128,49,2025-01-28,19,178,135,313,Eli501_T,"-37.80730068, 144.95956055"
1391620240307,139,2024-03-07,16,156,54,210,Signal1647_T,"-37.81959923, 144.9632832"
1642320241030,164,2024-10-30,23,578,66,644,Lat526_T,"-37.813005, 144.95160411"
1381420250820,138,2025-08-20,14,6,8,14,EntPark1671_T,"-37.81996544, 144.95981454"
138920241015,138,2024-10-15,9,3,7,10,EntPark1671_T,"-37.81996544, 144.95981454"
117920250617,117,2025-06-17,9,212,88,300,Fli114F_T,"-37.81629332, 144.97090877"
109920240114,109,2024-01-14,9,45,39,84,LatWill_T,"-37.81193681, 144.95621105"
662220240904,66,2024-09-04,22,328,267,595,QVN_T,"-37.81057846, 144.96444294"
691220240819,69,2024-08-19,12,228,199,427,FLDegC_T,"-37.81687226, 144.96559144"
66620240411,66,2024-04-11,6,31,76,107,QVN_T,"-37.81057846, 144.96444294"
661820231022,66,2023-10-22,18,1066,977,2043,QVN_T,"-37.81057846, 144.96444294"
3720240523,3,2024-05-23,7,123,200,323,Swa295_T,"-37.81101524, 144.96429485"
751420240311,75,2024-03-11,14,28,13,41,SprFli_T,"-37.81515276, 144.97467661"
392020240103,39,2024-01-03,20,25,55,80,AlfPl_T,"-37.81379749, 144.96995745"
1391920250205,139,2025-02-05,19,60,34,94,Signal1647_T,"-37.81959923, 144.9632832"
1611620250618,161,2025-06-18,16,147,108,255,BirArt1109_T,"-37.81851276, 144.97131336"
1381720241111,138,2024-11-11,17,11,3,14,EntPark1671_T,"-37.81996544, 144.95981454"
1381620250619,138,2025-06-19,16,6,9,15,EntPark1671_T,"-37.81996544, 144.95981454"
1091820240910,109,2024-09-10,18,216,140,356,LatWill_T,"-37.81193681, 144.95621105"
692020240704,69,2024-07-04,20,33,35,68,FLDegC_T,"-37.81687226, 144.96559144"
3920240204,3,2024-02-04,9,234,255,489,Swa295_T,"-37.81101524, 144.96429485"
701020250918,70,2025-09-18,10,76,103,179,Errol20_T,"-37.80456984, 144.94946228"
661420240705,66,2024-07-05,14,1282,1345,2627,QVN_T,"-37.81057846, 144.96444294"
42220250521,4,2025-05-21,22,190,236,426,Swa123_T,"-37.81487988, 144.9660878"
392120240527,39,2024-05-27,21,7,12,19,AlfPl_T,"-37.81379749, 144.96995745"
391420240726,39,2024-07-26,14,91,107,198,AlfPl_T,"-37.81379749, 144.96995745"
751420241024,75,2024-10-24,14,41,60,101,SprFli_T,"-37.81515276, 144.97467661"
751820250317,75,2025-03-17,18,41,90,131,SprFli_T,"-37.81515276, 144.97467661"
41120231221,41,2023-12-21,1,106,89,195,Swa31,"-37.81668634, 144.96689733"
781420250601,78,2025-06-01,14,35,63,98,HarEsB_T,"-37.81471642, 144.9446508"
771120240217,77,2024-02-17,11,238,144,382,HarEsP_T,"-37.81441438, 144.94433026"
59220240509,59,2024-05-09,2,22,7,29,RMIT_T,"-37.80825648, 144.96304859"
291920250602,29,2025-06-02,19,86,88,174,AG_T,"-37.8199817, 144.96872865"
29220250902,29,2025-09-02,2,1,1,2,AG_T,"-37.8199817, 144.96872865"
40520241127,40,2024-11-27,5,7,10,17,Spr201_T,"-37.80999341, 144.97227587"
402120240120,40,2024-01-20,21,129,76,205,Spr201_T,"-37.80999341, 144.97227587"
372120240520,37,2024-05-20,21,69,100,169,Lyg260_T,"-37.80107122, 144.96704554"
371520250802,37,2025-08-02,15,151,186,337,Lyg260_T,"-37.80107122, 144.96704554"
611220240523,61,2024-05-23,12,549,727,1276,RMIT14_T,"-37.80767455, 144.96309114"
612220241105,61,2024-11-05,22,212,106,318,RMIT14_T,"-37.80767455, 144.96309114"
61920241213,61,2024-12-13,9,231,403,634,RMIT14_T,"-37.80767455, 144.96309114"
431620240709,43,2024-07-09,16,45,70,115,UM2_T,"-37.79844526, 144.96411782"
432320251002,43,2025-10-02,23,5,5,10,UM2_T,"-37.79844526, 144.96411782"
45920250509,45,2025-05-09,9,238,260,498,Swa148_T,"-37.81414075, 144.96609379"
451320250102,45,2025-01-02,13,719,952,1671,Swa148_T,"-37.81414075, 144.96609379"
451120250321,45,2025-03-21,11,242,589,831,Swa148_T,"-37.81414075, 144.96609379"
451620231027,45,2023-10-27,16,508,719,1227,Swa148_T,"-37.81414075, 144.96609379"
108920250314,108,2025-03-14,9,319,955,1274,261Will_T,"-37.81295822, 144.95678789"
107820231109,107,2023-11-09,8,76,232,308,280Will_T,"-37.81246271, 144.95690188"
143820251003,143,2025-10-03,8,113,136,249,Spencer_T,"-37.821728, 144.95557015"
134820231019,134,2023-10-19,8,302,425,727,Spen201_T,"-37.81694221, 144.95303935"
133520241124,133,2024-11-24,5,29,48,77,Spen229_T,"-37.81531435, 144.95227769"
1181820240827,118,2024-08-27,18,7,15,22,Fli114C_T,"-37.81632783, 144.97090512"
87220231212,87,2023-12-12,2,0,1,1,Errol23_T,"-37.80454949, 144.94921863"
87920240702,87,2024-07-02,9,73,58,131,Errol23_T,"-37.80454949, 144.94921863"
871920250618,87,2025-06-18,19,71,68,139,Errol23_T,"-37.80454949, 144.94921863"
871120250815,87,2025-08-15,11,84,92,176,Errol23_T,"-37.80454949, 144.94921863"
1811820251003,181,2025-10-03,18,1143,1209,2352,Eli368_T,"-37.81009465, 144.96143149"
1651020241018,165,2024-10-18,10,5,11,16,Spen475_T,"-37.80953359, 144.94939004"
167320241123,167,2024-11-23,3,3,4,7,Lat526_T,"-37.81304149, 144.95155955"
191520240730,19,2024-07-30,15,384,429,813,LtB210_T,"-37.81237202, 144.96550671"
681920240528,68,2024-05-28,19,57,9,66,FLDegN_T,"-37.8168479, 144.96559789"
672320240828,67,2024-08-28,23,14,45,59,FLDegS_T,"-37.81688755, 144.96562569"
671920250226,67,2025-02-26,19,238,354,592,FLDegS_T,"-37.81688755, 144.96562569"
68820250318,68,2025-03-18,8,206,187,393,FLDegN_T,"-37.8168479, 144.96559789"
621720240506,62,2024-05-06,17,284,160,444,Lat224_T,"-37.80996494, 144.96216521"
62420250526,62,2025-05-26,4,7,5,12,Lat224_T,"-37.80996494, 144.96216521"
101320240112,10,2024-01-12,13,95,84,179,BouHbr_T,"-37.81876474, 144.94710545"
10520250625,10,2025-06-25,5,1,5,6,BouHbr_T,"-37.81876474, 144.94710545"
102320250819,10,2025-08-19,23,3,9,12,BouHbr_T,"-37.81876474, 144.94710545"
722320241229,72,2024-12-29,23,36,42,78,ACMI_T,"-37.81726338, 144.96872809"
241720250820,24,2025-08-20,17,621,2692,3313,Col620_T,"-37.81887963, 144.95449198"
1092020250817,109,2025-08-17,20,61,87,148,LatWill_T,"-37.81193681, 144.95621105"
672220240219,67,2024-02-19,22,85,79,164,FLDegS_T,"-37.81688755, 144.96562569"
17120240323,17,2024-03-23,1,14,40,54,Col15_T,"-37.81362543, 144.97323591"
172320240901,17,2024-09-01,23,12,10,22,Col15_T,"-37.81362543, 144.97323591"
171720250309,17,2025-03-09,17,146,121,267,Col15_T,"-37.81362543, 144.97323591"
67420240305,67,2024-03-05,4,8,3,11,FLDegS_T,"-37.81688755, 144.96562569"
181420250708,18,2025-07-08,14,197,132,329,Col12_T,"-37.81344862, 144.97305353"
621620250925,62,2025-09-25,16,334,285,619,Lat224_T,"-37.80996494, 144.96216521"
632220250923,63,2025-09-23,22,33,106,139,Bou231_T,"-37.81333081, 144.96675571"
86020240207,86,2024-02-07,0,2,10,12,574Qub_T,"-37.80309992, 144.94908064"
62520240724,62,2024-07-24,5,23,10,33,Lat224_T,"-37.80996494, 144.96216521"
621520241224,62,2024-12-24,15,165,115,280,Lat224_T,"-37.80996494, 144.96216521"
581520241114,58,2024-11-14,15,600,603,1203,Bou688_T,"-37.81686075, 144.95358075"
21720231104,2,2023-11-04,17,862,734,1596,Bou283_T,"-37.81380668, 144.96516718"
21520241201,2,2024-12-01,15,833,930,1763,Bou283_T,"-37.81380668, 144.96516718"
23820250826,23,2025-08-26,8,1022,416,1438,Col623_T,"-37.81909256, 144.95452748"
511820250618,51,2025-06-18,18,124,128,252,Fra118_T,"-37.80841815, 144.95906316"
251620241103,25,2024-11-03,16,1182,852,2034,MCEC_T,"-37.82401776, 144.95604426"
201720240219,20,2024-02-19,17,272,202,474,LtB170_T,"-37.81172914, 144.9682466"
1412220240829,141,2024-08-29,22,44,56,100,474Fl_T,"-37.81997273, 144.95834911"
1411020250423,141,2025-04-23,10,204,100,304,474Fl_T,"-37.81997273, 144.95834911"
1391120241216,139,2024-12-16,11,29,35,64,Signal1647_T,"-37.81959923, 144.9632832"
1372320250516,137,2025-05-16,23,0,2,2,BouHbr2353_T,"-37.81894815, 144.94612292"
1421120231128,142,2023-11-28,11,296,290,586,Hammer1584_T,"-37.81970749, 144.96795734"
1611920250212,161,2025-02-12,19,418,113,531,BirArt1109_T,"-37.81851276, 144.97131336"
142320250920,14,2025-09-20,23,186,36,222,SanBri_T,"-37.82011242, 144.96291897"
142320240619,14,2024-06-19,23,118,20,138,SanBri_T,"-37.82011242, 144.96291897"
651820240227,65,2024-02-27,18,318,683,1001,SwaCs_T,"-37.81569416, 144.9668064"
281820250731,28,2025-07-31,18,543,383,926,VAC_T,"-37.82129925, 144.96879309"
28820231125,28,2023-11-25,8,100,123,223,VAC_T,"-37.82129925, 144.96879309"
312020250610,31,2025-06-10,20,99,115,214,Lyg161_T,"-37.80169681, 144.96658911"
471020250814,47,2025-08-14,10,413,583,996,Eli250_T,"-37.81258467, 144.9625775"
611220250909,61,2025-09-09,12,579,796,1375,RMIT14_T,"-37.80767455, 144.96309114"
611520231027,61,2023-10-27,15,388,615,1003,RMIT14_T,"-37.80767455, 144.96309114"
50820240609,50,2024-06-09,8,18,25,43,Lyg309_T,"-37.79808192, 144.96721013"
44120241017,44,2024-10-17,1,1,0,1,UM3_T,"-37.79698741, 144.96441306"
45920250726,45,2025-07-26,9,194,243,437,Swa148_T,"-37.81414075, 144.96609379"
451320250811,45,2025-08-11,13,562,1044,1606,Swa148_T,"-37.81414075, 144.96609379"
5220250901,5,2025-09-01,2,11,7,18,PriNW_T,"-37.81874249, 144.96787656"
1431020240810,143,2024-08-10,10,249,362,611,Spencer_T,"-37.821728, 144.95557015"
132220240614,132,2024-06-14,2,4,1,5,King335_T,"-37.81267639, 144.95386444"
1321920240918,132,2024-09-18,19,128,163,291,King335_T,"-37.81267639, 144.95386444"
131020240320,131,2024-03-20,0,33,25,58,King2_T,"-37.82009057, 144.95758725"
1331120231021,133,2023-10-21,11,491,495,986,Spen229_T,"-37.81531435, 144.95227769"
133820231208,133,2023-12-08,8,480,473,953,Spen229_T,"-37.81531435, 144.95227769"
87820240512,87,2024-05-12,8,39,28,67,Errol23_T,"-37.80454949, 144.94921863"
182420250416,182,2025-04-16,4,9,25,34,King163_T,"-37.81627451, 144.95550503"
1661620241122,166,2024-11-22,16,37,38,75,Spen484_T,"-37.80896733, 144.94931703"
162220250210,162,2025-02-10,2,18,4,22,Eli489_T,"-37.80740397, 144.95987909"
162820250314,162,2025-03-14,8,360,199,559,Eli489_T,"-37.80740397, 144.95987909"
179120250622,179,2025-06-22,1,4,12,16,Pow61_T,"-37.82392385, 144.96299677"
165720250820,165,2025-08-20,7,9,36,45,Spen475_T,"-37.80953359, 144.94939004"
143020250614,143,2025-06-14,0,142,43,185,Spencer_T,"-37.821728, 144.95557015"
1341320240508,134,2024-05-08,13,262,220,482,Spen201_T,"-37.81694221, 144.95303935"
1341620250121,134,2025-01-21,16,485,481,966,Spen201_T,"-37.81694221, 144.95303935"
135520250225,135,2025-02-25,5,22,35,57,Spen161_T,"-37.8172861, 144.95319102"
118820250427,118,2025-04-27,8,1,2,3,Fli114C_T,"-37.81632783, 144.97090512"
1241820250223,124,2025-02-23,18,4,4,8,BirBridge_T,"-37.81757416, 144.97329934"
17720250128,17,2025-01-28,7,386,73,459,Col15_T,"-37.81362543, 144.97323591"
172020250528,17,2025-05-28,20,64,68,132,Col15_T,"-37.81362543, 144.97323591"
181220250710,18,2025-07-10,12,258,203,461,Col12_T,"-37.81344862, 144.97305353"
631720231111,63,2023-11-11,17,367,339,706,Bou231_T,"-37.81333081, 144.96675571"
632020240130,63,2024-01-30,20,138,233,371,Bou231_T,"-37.81333081, 144.96675571"
67320240719,67,2024-07-19,3,0,2,2,FLDegS_T,"-37.81688755, 144.96562569"
111920240901,11,2024-09-01,19,71,81,152,WatCit_T,"-37.81564989, 144.93970694"
86420240203,86,2024-02-03,4,0,1,1,574Qub_T,"-37.80309992, 144.94908064"
10520240408,10,2024-04-08,5,5,5,10,BouHbr_T,"-37.81876474, 144.94710545"
761020250320,76,2025-03-20,10,35,35,70,KenMac_T,"-37.79453803, 144.93036194"
721520240706,72,2024-07-06,15,292,430,722,ACMI_T,"-37.81726338, 144.96872809"
58920240914,58,2024-09-14,9,371,115,486,Bou688_T,"-37.81686075, 144.95358075"
27520250311,27,2025-03-11,5,2,5,7,Vic_T,"-37.80606888, 144.95644692"
531520241116,53,2024-11-16,15,795,587,1382,Col254_T,"-37.81564191, 144.965499"
532120240325,53,2024-03-25,21,139,241,380,Col254_T,"-37.81564191, 144.965499"
30520231213,30,2023-12-13,5,19,6,25,Lon189_T,"-37.8112185, 144.96656806"
30820240115,30,2024-01-15,8,104,130,234,Lon189_T,"-37.8112185, 144.96656806"
30720240214,30,2024-02-14,7,27,84,111,Lon189_T,"-37.8112185, 144.96656806"
252320240617,25,2024-06-17,23,34,25,59,MCEC_T,"-37.82401776, 144.95604426"
52820250528,52,2025-05-28,8,137,337,474,Eli263_T,"-37.81252157, 144.9619401"
51720240305,51,2024-03-05,7,43,29,72,Fra118_T,"-37.80841815, 144.95906316"
23820250328,23,2025-03-28,8,585,311,896,Col623_T,"-37.81909256, 144.95452748"
51420250610,51,2025-06-10,4,0,1,1,Fra118_T,"-37.80841815, 144.95906316"
1171820250205,117,2025-02-05,18,142,279,421,Fli114F_T,"-37.81629332, 144.97090877"
25820251016,25,2025-10-16,8,436,1234,1670,MCEC_T,"-37.82401776, 144.95604426"
482120250717,48,2025-07-17,21,71,89,160,QVMQ_T,"-37.80631581, 144.95866697"
48720251003,48,2025-10-03,7,79,73,152,QVMQ_T,"-37.80631581, 144.95866697"
48220240802,48,2024-08-02,2,10,9,19,QVMQ_T,"-37.80631581, 144.95866697"
481920231115,48,2023-11-15,19,146,228,374,QVMQ_T,"-37.80631581, 144.95866697"
1801620251008,180,2025-10-08,16,30,34,64,Mac330_T,"-37.79497059, 144.93530329"
1372320240826,137,2024-08-26,23,4,5,9,BouHbr2353_T,"-37.81894815, 144.94612292"
1392320231214,139,2023-12-14,23,32,34,66,Signal1647_T,"-37.81959923, 144.9632832"
139020240228,139,2024-02-28,0,9,2,11,Signal1647_T,"-37.81959923, 144.9632832"
1362320250101,136,2025-01-01,23,0,1,1,BirFed1120_T,"-37.8184141, 144.97357915"
1641320241002,164,2024-10-02,13,112,80,192,Lat526_T,"-37.813005, 144.95160411"
1642020250101,164,2025-01-01,20,71,91,162,Lat526_T,"-37.813005, 144.95160411"
1231020231018,123,2023-10-18,10,37,9,46,BirBridge_T,"-37.81753741, 144.97329734"
692020250704,69,2025-07-04,20,20,30,50,FLDegC_T,"-37.81687226, 144.96559144"
691520250725,69,2025-07-25,15,272,294,566,FLDegC_T,"-37.81687226, 144.96559144"
62120241025,6,2024-10-25,21,816,721,1537,FliS_T,"-37.81911705, 144.96558255"
4020240814,4,2024-08-14,0,39,15,54,Swa123_T,"-37.81487988, 144.9660878"
4320241224,4,2024-12-24,3,16,20,36,Swa123_T,"-37.81487988, 144.9660878"
701520250319,70,2025-03-19,15,169,143,312,Errol20_T,"-37.80456984, 144.94946228"
39220250522,39,2025-05-22,2,1,1,2,AlfPl_T,"-37.81379749, 144.96995745"
8620231024,8,2023-10-24,6,58,69,127,WebBN_T,"-37.82293543, 144.9471751"
82120240212,8,2024-02-12,21,45,45,90,WebBN_T,"-37.82293543, 144.9471751"
35920240112,35,2024-01-12,9,607,619,1226,SouthB_T,"-37.82018685, 144.96508508"
56620250616,56,2025-06-16,6,17,22,39,Lon364_T,"-37.81234775, 144.96153311"
351320250309,35,2025-03-09,13,1427,1962,3389,SouthB_T,"-37.82018685, 144.96508508"
272020240131,27,2024-01-31,20,176,94,270,Vic_T,"-37.80606888, 144.95644692"
2220250430,2,2025-04-30,2,4,13,17,Bou283_T,"-37.81380668, 144.96516718"
27420250328,27,2025-03-28,4,2,1,3,Vic_T,"-37.80606888, 144.95644692"
271220250825,27,2025-08-25,12,137,118,255,Vic_T,"-37.80606888, 144.95644692"
91320250206,9,2025-02-06,13,530,476,1006,Col700_T,"-37.81982992, 144.95102555"
532020250101,53,2025-01-01,20,171,178,349,Col254_T,"-37.81564191, 144.965499"
23920241122,23,2024-11-22,9,308,176,484,Col623_T,"-37.81909256, 144.95452748"
51320240420,51,2024-04-20,3,11,7,18,Fra118_T,"-37.80841815, 144.95906316"
79520250105,79,2025-01-05,5,19,23,42,FliSS_T,"-37.81794046, 144.96616678"
46320240526,46,2024-05-26,3,3,1,4,Pel147_T,"-37.80240719, 144.9615673"
201720241108,20,2024-11-08,17,376,212,588,LtB170_T,"-37.81172914, 144.9682466"
20020240215,20,2024-02-15,0,39,67,106,LtB170_T,"-37.81172914, 144.9682466"
461020250507,46,2025-05-07,10,118,68,186,Pel147_T,"-37.80240719, 144.9615673"
1801620250621,180,2025-06-21,16,31,52,83,Mac330_T,"-37.79497059, 144.93530329"
1411020241002,141,2024-10-02,10,138,131,269,474Fl_T,"-37.81997273, 144.95834911"
1371020231214,137,2023-12-14,10,30,49,79,BouHbr2353_T,"-37.81894815, 144.94612292"
842020241018,84,2024-10-18,20,473,584,1057,ElFi_T,"-37.81798049, 144.96503383"
702020250814,70,2025-08-14,20,91,87,178,Errol20_T,"-37.80456984, 144.94946228"
41420240424,4,2024-04-24,14,1511,1375,2886,Swa123_T,"-37.81487988, 144.9660878"
702320250911,70,2025-09-11,23,4,15,19,Errol20_T,"-37.80456984, 144.94946228"
70520231122,70,2023-11-22,5,3,1,4,Errol20_T,"-37.80456984, 144.94946228"
70620240529,70,2024-05-29,6,8,8,16,Errol20_T,"-37.80456984, 144.94946228"
701520240725,70,2024-07-25,15,143,110,253,Errol20_T,"-37.80456984, 144.94946228"
752020231113,75,2023-11-13,20,14,20,34,SprFli_T,"-37.81515276, 144.97467661"
77920250313,77,2025-03-13,9,134,217,351,HarEsP_T,"-37.81441438, 144.94433026"
782020250824,78,2025-08-24,20,11,16,27,HarEsB_T,"-37.81471642, 144.9446508"
142220231229,14,2023-12-29,22,521,130,651,SanBri_T,"-37.82011242, 144.96291897"
591920241104,59,2024-11-04,19,347,336,683,RMIT_T,"-37.80825648, 144.96304859"
281920250904,28,2025-09-04,19,419,190,609,VAC_T,"-37.82129925, 144.96879309"
402020240612,40,2024-06-12,20,101,61,162,Spr201_T,"-37.80999341, 144.97227587"
36320240612,36,2024-06-12,3,4,2,6,Que85_T,"-37.81652527, 144.96121062"
441920250307,44,2025-03-07,19,57,97,154,UM3_T,"-37.79698741, 144.96441306"
441520250925,44,2025-09-25,15,110,128,238,UM3_T,"-37.79698741, 144.96441306"
43020240214,43,2024-02-14,0,2,1,3,UM2_T,"-37.79844526, 144.96411782"
45320241001,45,2024-10-01,3,3,6,9,Swa148_T,"-37.81414075, 144.96609379"
51620250308,5,2025-03-08,16,1827,1547,3374,PriNW_T,"-37.81874249, 144.96787656"
131820250623,131,2025-06-23,8,120,32,152,King2_T,"-37.82009057, 144.95758725"
1321220231219,132,2023-12-19,12,122,114,236,King335_T,"-37.81267639, 144.95386444"
1321920250226,132,2025-02-26,19,177,148,325,King335_T,"-37.81267639, 144.95386444"
134820240604,134,2024-06-04,8,260,314,574,Spen201_T,"-37.81694221, 144.95303935"
135820240128,135,2024-01-28,8,122,158,280,Spen161_T,"-37.8172861, 144.95319102"
133520250711,133,2025-07-11,5,61,80,141,Spen229_T,"-37.81531435, 144.95227769"
781520250226,78,2025-02-26,15,23,70,93,HarEsB_T,"-37.81471642, 144.9446508"
142020250315,14,2025-03-15,20,631,178,809,SanBri_T,"-37.82011242, 144.96291897"
14420241227,14,2024-12-27,4,26,7,33,SanBri_T,"-37.82011242, 144.96291897"
471020250202,47,2025-02-02,10,326,477,803,Eli250_T,"-37.81258467, 144.9625775"
40920241107,40,2024-11-07,9,189,240,429,Spr201_T,"-37.80999341, 144.97227587"
371420240711,37,2024-07-11,14,116,111,227,Lyg260_T,"-37.80107122, 144.96704554"
372320241005,37,2024-10-05,23,163,192,355,Lyg260_T,"-37.80107122, 144.96704554"
45320250330,45,2025-03-30,3,19,115,134,Swa148_T,"-37.81414075, 144.96609379"
451920241203,45,2024-12-03,19,277,649,926,Swa148_T,"-37.81414075, 144.96609379"
5020240305,5,2024-03-05,0,86,53,139,PriNW_T,"-37.81874249, 144.96787656"
21420231119,21,2023-11-19,4,46,68,114,Bourke155_T,"-37.81267313, 144.96788288"
21920250702,21,2025-07-02,9,118,77,195,Bourke155_T,"-37.81267313, 144.96788288"
212020240102,21,2024-01-02,20,308,356,664,Bourke155_T,"-37.81267313, 144.96788288"
1071520250204,107,2025-02-04,15,100,90,190,280Will_T,"-37.81246271, 144.95690188"
871420251008,87,2025-10-08,14,87,116,203,Errol23_T,"-37.80454949, 144.94921863"
61920241125,61,2024-11-25,9,116,151,267,RMIT14_T,"-37.80767455, 144.96309114"
501520250825,50,2025-08-25,15,172,160,332,Lyg309_T,"-37.79808192, 144.96721013"
43920231020,43,2023-10-20,9,265,82,347,UM2_T,"-37.79844526, 144.96411782"
182220250604,182,2025-06-04,2,17,18,35,King163_T,"-37.81627451, 144.95550503"
167520250418,167,2025-04-18,5,0,5,5,Lat526_T,"-37.81304149, 144.95155955"
182920251015,182,2025-10-15,9,94,197,291,King163_T,"-37.81627451, 144.95550503"
143720250320,143,2025-03-20,7,87,120,207,Spencer_T,"-37.821728, 144.95557015"
1342020231222,134,2023-12-22,20,333,291,624,Spen201_T,"-37.81694221, 144.95303935"
1341620240122,134,2024-01-22,16,545,545,1090,Spen201_T,"-37.81694221, 144.95303935"
1341220240424,134,2024-04-24,12,378,451,829,Spen201_T,"-37.81694221, 144.95303935"
1342320250914,134,2025-09-14,23,60,78,138,Spen201_T,"-37.81694221, 144.95303935"
1331020241026,133,2024-10-26,10,473,466,939,Spen229_T,"-37.81531435, 144.95227769"
124720240118,124,2024-01-18,7,0,1,1,BirBridge_T,"-37.81757416, 144.97329934"
1352320250716,135,2025-07-16,23,20,36,56,Spen161_T,"-37.8172861, 144.95319102"
1331020240326,133,2024-03-26,10,371,423,794,Spen229_T,"-37.81531435, 144.95227769"
124920231104,124,2023-11-04,9,0,2,2,BirBridge_T,"-37.81757416, 144.97329934"
67820240224,67,2024-02-24,8,145,98,243,FLDegS_T,"-37.81688755, 144.96562569"
85520240818,85,2024-08-18,5,1,0,1,488Mac_T,"-37.79432415, 144.92973378"
12020241211,1,2024-12-11,20,844,708,1552,Bou292_T,"-37.81349441, 144.96515323"
62520250413,62,2025-04-13,5,14,12,26,Lat224_T,"-37.80996494, 144.96216521"
56220240414,56,2024-04-14,2,76,89,165,Lon364_T,"-37.81234775, 144.96153311"
56520250112,56,2025-01-12,5,17,11,28,Lon364_T,"-37.81234775, 144.96153311"
63120250106,63,2025-01-06,1,0,3,3,Bou231_T,"-37.81333081, 144.96675571"
72920240721,72,2024-07-21,9,84,456,540,ACMI_T,"-37.81726338, 144.96872809"
2720250131,2,2025-01-31,7,37,65,102,Bou283_T,"-37.81380668, 144.96516718"
58520240501,58,2024-05-01,5,94,12,106,Bou688_T,"-37.81686075, 144.95358075"
582120240105,58,2024-01-05,21,279,236,515,Bou688_T,"-37.81686075, 144.95358075"
231920240321,23,2024-03-21,19,185,302,487,Col623_T,"-37.81909256, 144.95452748"
79120250303,79,2025-03-03,1,16,7,23,FliSS_T,"-37.81794046, 144.96616678"
46920241128,46,2024-11-28,9,102,34,136,Pel147_T,"-37.80240719, 144.9615673"
1181820250413,118,2025-04-13,18,46,8,54,Fli114C_T,"-37.81632783, 144.97090512"
107520231216,107,2023-12-16,5,10,8,18,280Will_T,"-37.81246271, 144.95690188"
87120231030,87,2023-10-30,1,2,1,3,Errol23_T,"-37.80454949, 144.94921863"
671220250102,67,2025-01-02,12,414,636,1050,FLDegS_T,"-37.81688755, 144.96562569"
112220250902,11,2025-09-02,22,27,12,39,WatCit_T,"-37.81564989, 144.93970694"
111020231103,11,2023-11-03,10,39,57,96,WatCit_T,"-37.81564989, 144.93970694"
24820240110,24,2024-01-10,8,1591,246,1837,Col620_T,"-37.81887963, 144.95449198"
102020240317,10,2024-03-17,20,50,26,76,BouHbr_T,"-37.81876474, 144.94710545"
721520240809,72,2024-08-09,15,193,433,626,ACMI_T,"-37.81726338, 144.96872809"
72520240715,72,2024-07-15,5,21,30,51,ACMI_T,"-37.81726338, 144.96872809"
271220240531,27,2024-05-31,12,180,154,334,Vic_T,"-37.80606888, 144.95644692"
21720250423,2,2025-04-23,17,603,471,1074,Bou283_T,"-37.81380668, 144.96516718"
302320231107,30,2023-11-07,23,138,149,287,Lon189_T,"-37.8112185, 144.96656806"
92020250412,9,2025-04-12,20,44,51,95,Col700_T,"-37.81982992, 144.95102555"
511420240612,51,2024-06-12,14,95,72,167,Fra118_T,"-37.80841815, 144.95906316"
30720250102,30,2025-01-02,7,16,29,45,Lon189_T,"-37.8112185, 144.96656806"
302120250801,30,2025-08-01,21,356,595,951,Lon189_T,"-37.8112185, 144.96656806"
191520231214,19,2023-12-14,15,453,584,1037,LtB210_T,"-37.81237202, 144.96550671"
20820250605,20,2025-06-05,8,58,64,122,LtB170_T,"-37.81172914, 144.9682466"
251620240827,25,2024-08-27,16,764,398,1162,MCEC_T,"-37.82401776, 144.95604426"
521820231224,52,2023-12-24,18,265,253,518,Eli263_T,"-37.81252157, 144.9619401"
1371420250718,137,2025-07-18,14,20,57,77,BouHbr2353_T,"-37.81894815, 144.94612292"
1642320250330,164,2025-03-30,23,8,29,37,Lat526_T,"-37.813005, 144.95160411"
164520250531,164,2025-05-31,5,7,2,9,Lat526_T,"-37.813005, 144.95160411"
1612120241018,161,2024-10-18,21,0,3,3,BirArt1109_T,"-37.81851276, 144.97131336"
161620241122,161,2024-11-22,6,81,77,158,BirArt1109_T,"-37.81851276, 144.97131336"
109220240124,109,2024-01-24,2,3,7,10,LatWill_T,"-37.81193681, 144.95621105"
62220240907,6,2024-09-07,22,774,523,1297,FliS_T,"-37.81911705, 144.96558255"
841420240726,84,2024-07-26,14,904,1187,2091,ElFi_T,"-37.81798049, 144.96503383"
84920241031,84,2024-10-31,9,1159,457,1616,ElFi_T,"-37.81798049, 144.96503383"
84120250807,84,2025-08-07,1,19,12,31,ElFi_T,"-37.81798049, 144.96503383"
841220250926,84,2025-09-26,12,994,929,1923,ElFi_T,"-37.81798049, 144.96503383"
70520251009,70,2025-10-09,5,1,1,2,Errol20_T,"-37.80456984, 144.94946228"
70620250113,70,2025-01-13,6,13,14,27,Errol20_T,"-37.80456984, 144.94946228"
32220250926,3,2025-09-26,22,700,643,1343,Swa295_T,"-37.81101524, 144.96429485"
392220240812,39,2024-08-12,22,12,15,27,AlfPl_T,"-37.81379749, 144.96995745"
77320250322,77,2025-03-22,3,12,5,17,HarEsP_T,"-37.81441438, 144.94433026"
421920241108,42,2024-11-08,19,73,118,191,UM1_T,"-37.80008566, 144.96386412"
781420250106,78,2025-01-06,14,9,22,31,HarEsB_T,"-37.81471642, 144.9446508"
291720240816,29,2024-08-16,17,204,290,494,AG_T,"-37.8199817, 144.96872865"
591120250527,59,2025-05-27,11,614,761,1375,RMIT_T,"-37.80825648, 144.96304859"
541820240816,54,2024-08-16,18,166,279,445,Swa607_T,"-37.804024, 144.96308399"
291420250801,29,2025-08-01,14,193,237,430,AG_T,"-37.8199817, 144.96872865"
47520240709,47,2024-07-09,5,11,51,62,Eli250_T,"-37.81258467, 144.9625775"
431520240926,43,2024-09-26,15,126,104,230,UM2_T,"-37.79844526, 144.96411782"
431620241202,43,2024-12-02,16,82,93,175,UM2_T,"-37.79844526, 144.96411782"
51320250226,5,2025-02-26,13,656,970,1626,PriNW_T,"-37.81874249, 144.96787656"
1401520240731,140,2024-07-31,15,90,115,205,Boyd2837_T,"-37.82590962, 144.96185972"
1312220250628,131,2025-06-28,22,199,127,326,King2_T,"-37.82009057, 144.95758725"
511920240405,51,2024-04-05,19,92,75,167,Fra118_T,"-37.80841815, 144.95906316"
231520250312,23,2025-03-12,15,137,377,514,Col623_T,"-37.81909256, 144.95452748"
232120250927,23,2025-09-27,21,84,162,246,Col623_T,"-37.81909256, 144.95452748"
1171620250729,117,2025-07-29,16,110,297,407,Fli114F_T,"-37.81629332, 144.97090877"
192020250429,19,2025-04-29,20,323,374,697,LtB210_T,"-37.81237202, 144.96550671"
19720240622,19,2024-06-22,7,13,13,26,LtB210_T,"-37.81237202, 144.96550671"
482020240315,48,2024-03-15,20,118,122,240,QVMQ_T,"-37.80631581, 144.95866697"
1391820240421,139,2024-04-21,18,28,31,59,Signal1647_T,"-37.81959923, 144.9632832"
1392220240502,139,2024-05-02,22,14,18,32,Signal1647_T,"-37.81959923, 144.9632832"
1372120240218,137,2024-02-18,21,2,3,5,BouHbr2353_T,"-37.81894815, 144.94612292"
1381920240913,138,2024-09-13,19,1,0,1,EntPark1671_T,"-37.81996544, 144.95981454"
1381420241130,138,2024-11-30,14,5,3,8,EntPark1671_T,"-37.81996544, 144.95981454"
1611120240621,161,2024-06-21,11,58,78,136,BirArt1109_T,"-37.81851276, 144.97131336"
161820250106,161,2025-01-06,8,81,79,160,BirArt1109_T,"-37.81851276, 144.97131336"
123820231026,123,2023-10-26,8,40,6,46,BirBridge_T,"-37.81753741, 144.97329734"
661320250921,66,2025-09-21,13,1045,1450,2495,QVN_T,"-37.81057846, 144.96444294"
691920240822,69,2024-08-22,19,42,30,72,FLDegC_T,"-37.81687226, 144.96559144"
70320250516,70,2025-05-16,3,2,1,3,Errol20_T,"-37.80456984, 144.94946228"
31020241219,3,2024-12-19,10,357,441,798,Swa295_T,"-37.81101524, 144.96429485"
392320240805,39,2024-08-05,23,8,9,17,AlfPl_T,"-37.81379749, 144.96995745"
81520240403,8,2024-04-03,15,137,246,383,WebBN_T,"-37.82293543, 144.9471751"
81720250713,8,2025-07-13,17,107,80,187,WebBN_T,"-37.82293543, 144.9471751"
751920240427,75,2024-04-27,19,444,37,481,SprFli_T,"-37.81515276, 144.97467661"
77020250527,77,2025-05-27,0,12,2,14,HarEsP_T,"-37.81441438, 144.94433026"
781220240614,78,2024-06-14,12,24,47,71,HarEsB_T,"-37.81471642, 144.9446508"
71220250919,71,2025-09-19,2,1,2,3,WestWP_T,"-37.81235775, 144.97136962"
652020240229,65,2024-02-29,20,275,623,898,SwaCs_T,"-37.81569416, 144.9668064"
14620231218,14,2023-12-18,6,86,89,175,SanBri_T,"-37.82011242, 144.96291897"
54320250424,54,2025-04-24,3,8,7,15,Swa607_T,"-37.804024, 144.96308399"
281720250318,28,2025-03-18,17,995,1266,2261,VAC_T,"-37.82129925, 144.96879309"
37820250201,37,2025-02-01,8,19,24,43,Lyg260_T,"-37.80107122, 144.96704554"
371520250327,37,2025-03-27,15,96,99,195,Lyg260_T,"-37.80107122, 144.96704554"
45020250405,45,2025-04-05,0,118,312,430,Swa148_T,"-37.81414075, 144.96609379"
211520240824,21,2024-08-24,15,385,418,803,Bourke155_T,"-37.81267313, 144.96788288"
211020250507,21,2025-05-07,10,154,112,266,Bourke155_T,"-37.81267313, 144.96788288"
1071220250824,107,2025-08-24,12,146,185,331,280Will_T,"-37.81246271, 144.95690188"
1182220240414,118,2024-04-14,22,6,4,10,Fli114C_T,"-37.81632783, 144.97090512"
1082220250312,108,2025-03-12,22,128,85,213,261Will_T,"-37.81295822, 144.95678789"
612020250725,61,2025-07-25,20,178,161,339,RMIT14_T,"-37.80767455, 144.96309114"
1661020241018,166,2024-10-18,10,9,11,20,Spen484_T,"-37.80896733, 144.94931703"
167620250219,167,2025-02-19,6,5,31,36,Lat526_T,"-37.81304149, 144.95155955"
1651020250223,165,2025-02-23,10,20,57,77,Spen475_T,"-37.80953359, 144.94939004"
165920250330,165,2025-03-30,9,25,34,59,Spen475_T,"-37.80953359, 144.94939004"
1621920250501,162,2025-05-01,19,212,170,382,Eli489_T,"-37.80740397, 144.95987909"
1401220240618,140,2024-06-18,12,62,46,108,Boyd2837_T,"-37.82590962, 144.96185972"
140620241102,140,2024-11-02,6,12,4,16,Boyd2837_T,"-37.82590962, 144.96185972"
1321820250601,132,2025-06-01,18,127,97,224,King335_T,"-37.81267639, 144.95386444"
56120250818,56,2025-08-18,1,12,5,17,Lon364_T,"-37.81234775, 144.96153311"
2620240218,2,2024-02-18,6,7,9,16,Bou283_T,"-37.81380668, 144.96516718"
581220231111,58,2023-11-11,12,720,207,927,Bou688_T,"-37.81686075, 144.95358075"
35820250612,35,2025-06-12,8,655,2131,2786,SouthB_T,"-37.82018685, 144.96508508"
35320250829,35,2025-08-29,3,1,8,9,SouthB_T,"-37.82018685, 144.96508508"
531020250628,53,2025-06-28,10,451,284,735,Col254_T,"-37.81564191, 144.965499"
531920250712,53,2025-07-12,19,307,248,555,Col254_T,"-37.81564191, 144.965499"
1321720250522,132,2025-05-22,17,179,171,350,King335_T,"-37.81267639, 144.95386444"
1352320240930,135,2024-09-30,23,35,55,90,Spen161_T,"-37.8172861, 144.95319102"
1071520250627,107,2025-06-27,15,146,112,258,280Will_T,"-37.81246271, 144.95690188"
133420250910,133,2025-09-10,4,9,20,29,Spen229_T,"-37.81531435, 144.95227769"
1331020240922,133,2024-09-22,10,357,381,738,Spen229_T,"-37.81531435, 144.95227769"
1332020250516,133,2025-05-16,20,421,303,724,Spen229_T,"-37.81531435, 144.95227769"
1181920240921,118,2024-09-21,19,12,10,22,Fli114C_T,"-37.81632783, 144.97090512"
1181020250701,118,2025-07-01,10,14,18,32,Fli114C_T,"-37.81632783, 144.97090512"
1081320240407,108,2024-04-07,13,124,124,248,261Will_T,"-37.81295822, 144.95678789"
1651520241118,165,2024-11-18,15,53,53,106,Spen475_T,"-37.80953359, 144.94939004"
1652320241122,165,2024-11-22,23,44,47,91,Spen475_T,"-37.80953359, 144.94939004"
68520240701,68,2024-07-01,5,1,0,1,FLDegN_T,"-37.8168479, 144.96559789"
171420240329,17,2024-03-29,14,160,137,297,Col15_T,"-37.81362543, 144.97323591"
17520240525,17,2024-05-25,5,17,12,29,Col15_T,"-37.81362543, 144.97323591"
63520241007,63,2024-10-07,5,0,4,4,Bou231_T,"-37.81333081, 144.96675571"
672020240731,67,2024-07-31,20,119,223,342,FLDegS_T,"-37.81688755, 144.96562569"
181120240714,18,2024-07-14,11,70,50,120,Col12_T,"-37.81344862, 144.97305353"
671920250409,67,2025-04-09,19,312,376,688,FLDegS_T,"-37.81688755, 144.96562569"
561620240828,56,2024-08-28,16,231,288,519,Lon364_T,"-37.81234775, 144.96153311"
101920240227,10,2024-02-27,19,9,16,25,BouHbr_T,"-37.81876474, 144.94710545"
102020241101,10,2024-11-01,20,49,63,112,BouHbr_T,"-37.81876474, 144.94710545"
121520250727,12,2025-07-27,15,228,213,441,NewQ_T,"-37.81457988, 144.94292398"
241220241102,24,2024-11-02,12,720,669,1389,Col620_T,"-37.81887963, 144.95449198"
72020250106,72,2025-01-06,0,9,14,23,ACMI_T,"-37.81726338, 144.96872809"
351320250524,35,2025-05-24,13,1301,1389,2690,SouthB_T,"-37.82018685, 144.96508508"
762120250318,76,2025-03-18,21,5,8,13,KenMac_T,"-37.79453803, 144.93036194"
9620240731,9,2024-07-31,6,20,346,366,Col700_T,"-37.81982992, 144.95102555"
9420241221,9,2024-12-21,4,3,7,10,Col700_T,"-37.81982992, 144.95102555"
53720250707,53,2025-07-07,7,118,68,186,Col254_T,"-37.81564191, 144.965499"
791120250916,79,2025-09-16,11,312,284,596,FliSS_T,"-37.81794046, 144.96616678"
48620250606,48,2025-06-06,6,18,38,56,QVMQ_T,"-37.80631581, 144.95866697"
25320250905,25,2025-09-05,3,6,8,14,MCEC_T,"-37.82401776, 144.95604426"
461020240204,46,2024-02-04,10,23,30,53,Pel147_T,"-37.80240719, 144.9615673"
201420231129,20,2023-11-29,14,114,145,259,LtB170_T,"-37.81172914, 144.9682466"
141520241023,141,2024-10-23,5,11,5,16,474Fl_T,"-37.81997273, 144.95834911"
1391520240318,139,2024-03-18,15,57,32,89,Signal1647_T,"-37.81959923, 144.9632832"
1362220241006,136,2024-10-06,22,2,0,2,BirFed1120_T,"-37.8184141, 144.97357915"
1611320250704,161,2025-07-04,13,142,197,339,BirArt1109_T,"-37.81851276, 144.97131336"
1611820250725,161,2025-07-25,18,12,12,24,BirArt1109_T,"-37.81851276, 144.97131336"
1381720240103,138,2024-01-03,17,11,3,14,EntPark1671_T,"-37.81996544, 144.95981454"
1381420240718,138,2024-07-18,14,2,6,8,EntPark1671_T,"-37.81996544, 144.95981454"
1171120250220,117,2025-02-20,11,103,144,247,Fli114F_T,"-37.81629332, 144.97090877"
492320240411,49,2024-04-11,23,114,82,196,Eli501_T,"-37.80730068, 144.95956055"
109720250811,109,2025-08-11,7,34,234,268,LatWill_T,"-37.81193681, 144.95621105"
6620250819,6,2025-08-19,6,196,359,555,FliS_T,"-37.81911705, 144.96558255"
70620250406,70,2025-04-06,6,1,4,5,Errol20_T,"-37.80456984, 144.94946228"
70520240811,70,2024-08-11,5,3,0,3,Errol20_T,"-37.80456984, 144.94946228"
9020240907,9,2024-09-07,0,14,14,28,Col700_T,"-37.81982992, 144.95102555"
91920250515,9,2025-05-15,19,224,76,300,Col700_T,"-37.81982992, 144.95102555"
411920240414,41,2024-04-14,19,890,1309,2199,Swa31,"-37.81668634, 144.96689733"
81320240919,8,2024-09-19,13,267,210,477,WebBN_T,"-37.82293543, 144.9471751"
78020250405,78,2025-04-05,0,1,22,23,HarEsB_T,"-37.81471642, 144.9446508"
591320240528,59,2024-05-28,13,1288,1228,2516,RMIT_T,"-37.80825648, 144.96304859"
651220240410,65,2024-04-10,12,802,675,1477,SwaCs_T,"-37.81569416, 144.9668064"
281220240329,28,2024-03-29,12,880,904,1784,VAC_T,"-37.82129925, 144.96879309"
141020250811,14,2025-08-11,10,190,142,332,SanBri_T,"-37.82011242, 144.96291897"
14020231029,14,2023-10-29,0,246,47,293,SanBri_T,"-37.82011242, 144.96291897"
542220250711,54,2025-07-11,22,49,85,134,Swa607_T,"-37.804024, 144.96308399"
281420250822,28,2025-08-22,14,568,767,1335,VAC_T,"-37.82129925, 144.96879309"
471820240403,47,2024-04-03,18,1059,837,1896,Eli250_T,"-37.81258467, 144.9625775"
472220250329,47,2025-03-29,22,499,486,985,Eli250_T,"-37.81258467, 144.9625775"
471620231114,47,2023-11-14,16,1187,919,2106,Eli250_T,"-37.81258467, 144.9625775"
52120250716,5,2025-07-16,21,634,518,1152,PriNW_T,"-37.81874249, 144.96787656"
36420240712,36,2024-07-12,4,7,1,8,Que85_T,"-37.81652527, 144.96121062"
87820250416,87,2025-04-16,8,69,69,138,Errol23_T,"-37.80454949, 144.94921863"
871320250826,87,2025-08-26,13,96,116,212,Errol23_T,"-37.80454949, 144.94921863"
1081920240427,108,2024-04-27,19,36,96,132,261Will_T,"-37.81295822, 144.95678789"
872120241119,87,2024-11-19,21,20,34,54,Errol23_T,"-37.80454949, 144.94921863"
611720250723,61,2025-07-23,17,580,551,1131,RMIT14_T,"-37.80767455, 144.96309114"
43920250531,43,2025-05-31,9,33,30,63,UM2_T,"-37.79844526, 144.96411782"
452320240614,45,2024-06-14,23,187,376,563,Swa148_T,"-37.81414075, 144.96609379"
112020250914,11,2025-09-14,20,114,87,201,WatCit_T,"-37.81564989, 144.93970694"
76820240619,76,2024-06-19,8,86,43,129,KenMac_T,"-37.79453803, 144.93036194"
581920250813,58,2025-08-13,19,335,356,691,Bou688_T,"-37.81686075, 144.95358075"
22220240721,2,2024-07-21,22,31,59,90,Bou283_T,"-37.81380668, 144.96516718"
52020241227,52,2024-12-27,0,55,57,112,Eli263_T,"-37.81252157, 144.9619401"
46720240202,46,2024-02-02,7,21,32,53,Pel147_T,"-37.80240719, 144.9615673"
23420241127,23,2024-11-27,4,0,3,3,Col623_T,"-37.81909256, 144.95452748"
25420240316,25,2024-03-16,4,5,9,14,MCEC_T,"-37.82401776, 144.95604426"
251420240726,25,2024-07-26,14,1028,691,1719,MCEC_T,"-37.82401776, 144.95604426"
191820240116,19,2024-01-16,18,526,452,978,LtB210_T,"-37.81237202, 144.96550671"
481520240705,48,2024-07-05,15,385,183,568,QVMQ_T,"-37.80631581, 144.95866697"
462220240515,46,2024-05-15,22,26,39,65,Pel147_T,"-37.80240719, 144.9615673"
49020251010,49,2025-10-10,0,71,71,142,Eli501_T,"-37.80730068, 144.95956055"
1411620240707,141,2024-07-07,16,244,210,454,474Fl_T,"-37.81997273, 144.95834911"
1391620240604,139,2024-06-04,16,115,24,139,Signal1647_T,"-37.81959923, 144.9632832"
1361620250318,136,2025-03-18,16,195,96,291,BirFed1120_T,"-37.8184141, 144.97357915"
1421620250727,142,2025-07-27,16,260,498,758,Hammer1584_T,"-37.81970749, 144.96795734"
1422220241014,142,2024-10-14,22,1,9,10,Hammer1584_T,"-37.81970749, 144.96795734"
164820250804,164,2025-08-04,8,128,45,173,Lat526_T,"-37.813005, 144.95160411"
1171720240626,117,2024-06-26,17,495,546,1041,Fli114F_T,"-37.81629332, 144.97090877"
77320231106,77,2023-11-06,3,5,3,8,HarEsP_T,"-37.81441438, 144.94433026"
71220240208,71,2024-02-08,2,5,7,12,WestWP_T,"-37.81235775, 144.97136962"
591920250407,59,2025-04-07,19,240,556,796,RMIT_T,"-37.80825648, 144.96304859"
65620240920,65,2024-09-20,6,135,76,211,SwaCs_T,"-37.81569416, 144.9668064"
47920250629,47,2025-06-29,9,211,269,480,Eli250_T,"-37.81258467, 144.9625775"
401920240928,40,2024-09-28,19,123,179,302,Spr201_T,"-37.80999341, 144.97227587"
40120250727,40,2025-07-27,1,36,8,44,Spr201_T,"-37.80999341, 144.97227587"
36620240110,36,2024-01-10,6,40,17,57,Que85_T,"-37.81652527, 144.96121062"
50620231212,50,2023-12-12,6,12,14,26,Lyg309_T,"-37.79808192, 144.96721013"
452020240914,45,2024-09-14,20,366,724,1090,Swa148_T,"-37.81414075, 144.96609379"
451520250724,45,2025-07-24,15,537,795,1332,Swa148_T,"-37.81414075, 144.96609379"
51420240909,5,2024-09-09,14,1159,826,1985,PriNW_T,"-37.81874249, 144.96787656"
5620250128,5,2025-01-28,6,75,226,301,PriNW_T,"-37.81874249, 144.96787656"
50620251008,50,2025-10-08,6,3,9,12,Lyg309_T,"-37.79808192, 144.96721013"
1822120251002,182,2025-10-02,21,169,145,314,King163_T,"-37.81627451, 144.95550503"
181920250326,181,2025-03-26,9,262,340,602,Eli368_T,"-37.81009465, 144.96143149"
1621720251006,162,2025-10-06,17,345,411,756,Eli489_T,"-37.80740397, 144.95987909"
1672020241215,167,2024-12-15,20,25,53,78,Lat526_T,"-37.81304149, 144.95155955"
1401520240716,140,2024-07-16,15,79,107,186,Boyd2837_T,"-37.82590962, 144.96185972"
1312020250908,131,2025-09-08,20,64,52,116,King2_T,"-37.82009057, 144.95758725"
132620241102,132,2024-11-02,6,20,12,32,King335_T,"-37.81267639, 144.95386444"
6920231223,6,2023-12-23,9,446,361,807,FliS_T,"-37.81911705, 144.96558255"
1401020241204,140,2024-12-04,10,102,51,153,Boyd2837_T,"-37.82590962, 144.96185972"
140720241231,140,2024-12-31,7,38,11,49,Boyd2837_T,"-37.82590962, 144.96185972"
1622020240801,162,2024-08-01,20,234,171,405,Eli489_T,"-37.80740397, 144.95987909"
143120250725,143,2025-07-25,1,51,22,73,Spencer_T,"-37.821728, 144.95557015"
1321220240214,132,2024-02-14,12,172,147,319,King335_T,"-37.81267639, 144.95386444"
1081220250705,108,2025-07-05,12,186,157,343,261Will_T,"-37.81295822, 144.95678789"
1082320251015,108,2025-10-15,23,72,50,122,261Will_T,"-37.81295822, 144.95678789"
1081120240723,108,2024-07-23,11,106,258,364,261Will_T,"-37.81295822, 144.95678789"
70320240524,70,2024-05-24,3,0,1,1,Errol20_T,"-37.80456984, 144.94946228"
1820240825,1,2024-08-25,8,96,75,171,Bou292_T,"-37.81349441, 144.96515323"
181120241223,18,2024-12-23,11,174,201,375,Col12_T,"-37.81344862, 144.97305353"
622320240422,62,2024-04-22,23,76,54,130,Lat224_T,"-37.80996494, 144.96216521"
56920241122,56,2024-11-22,9,212,172,384,Lon364_T,"-37.81234775, 144.96153311"
10920231018,10,2023-10-18,9,81,151,232,BouHbr_T,"-37.81876474, 144.94710545"
10620241203,10,2024-12-03,6,4,30,34,BouHbr_T,"-37.81876474, 144.94710545"
10820250206,10,2025-02-06,8,55,184,239,BouHbr_T,"-37.81876474, 144.94710545"
76120250710,76,2025-07-10,1,2,0,2,KenMac_T,"-37.79453803, 144.93036194"
791320240424,79,2024-04-24,13,433,336,769,FliSS_T,"-37.81794046, 144.96616678"
79620241116,79,2024-11-16,6,54,31,85,FliSS_T,"-37.81794046, 144.96616678"
792120231119,79,2023-11-19,21,182,261,443,FliSS_T,"-37.81794046, 144.96616678"
9120241005,9,2024-10-05,1,7,10,17,Col700_T,"-37.81982992, 144.95102555"
53120250408,53,2025-04-08,1,2,7,9,Col254_T,"-37.81564191, 144.965499"
531020240417,53,2024-04-17,10,531,513,1044,Col254_T,"-37.81564191, 144.965499"
792020250331,79,2025-03-31,20,190,228,418,FliSS_T,"-37.81794046, 144.96616678"
791420250621,79,2025-06-21,14,673,493,1166,FliSS_T,"-37.81794046, 144.96616678"
79920250905,79,2025-09-05,9,339,278,617,FliSS_T,"-37.81794046, 144.96616678"
52820240709,52,2024-07-09,8,139,209,348,Eli263_T,"-37.81252157, 144.9619401"
46620241105,46,2024-11-05,6,1,1,2,Pel147_T,"-37.80240719, 144.9615673"
511020241229,51,2024-12-29,10,128,99,227,Fra118_T,"-37.80841815, 144.95906316"
511020250221,51,2025-02-21,10,91,88,179,Fra118_T,"-37.80841815, 144.95906316"
252320240218,25,2024-02-18,23,73,219,292,MCEC_T,"-37.82401776, 144.95604426"
191120231213,19,2023-12-13,11,545,379,924,LtB210_T,"-37.81237202, 144.96550671"
481420240804,48,2024-08-04,14,732,468,1200,QVMQ_T,"-37.80631581, 144.95866697"
1412320250329,141,2025-03-29,23,80,132,212,474Fl_T,"-37.81997273, 144.95834911"
1371420231231,137,2023-12-31,14,31,46,77,BouHbr2353_T,"-37.81894815, 144.94612292"
1611920250914,161,2025-09-14,19,2,10,12,BirArt1109_T,"-37.81851276, 144.97131336"
109820240823,109,2024-08-23,8,109,549,658,LatWill_T,"-37.81193681, 144.95621105"
1091820240422,109,2024-04-22,18,158,120,278,LatWill_T,"-37.81193681, 144.95621105"
66720250608,66,2025-06-08,7,18,37,55,QVN_T,"-37.81057846, 144.96444294"
69620231220,69,2023-12-20,6,24,6,30,FLDegC_T,"-37.81687226, 144.96559144"
69120240307,69,2024-03-07,1,1,1,2,FLDegC_T,"-37.81687226, 144.96559144"
692120240825,69,2024-08-25,21,8,6,14,FLDegC_T,"-37.81687226, 144.96559144"
701520240430,70,2024-04-30,15,170,149,319,Errol20_T,"-37.80456984, 144.94946228"
1352320250109,135,2025-01-09,23,107,99,206,Spen161_T,"-37.8172861, 144.95319102"
1331420250303,133,2025-03-03,14,477,524,1001,Spen229_T,"-37.81531435, 144.95227769"
118120250817,118,2025-08-17,1,0,4,4,Fli114C_T,"-37.81632783, 144.97090512"
682320240419,68,2024-04-19,23,46,17,63,FLDegN_T,"-37.8168479, 144.96559789"
852220250628,85,2025-06-28,22,16,23,39,488Mac_T,"-37.79432415, 144.92973378"
851420250923,85,2025-09-23,14,50,79,129,488Mac_T,"-37.79432415, 144.92973378"
671420240913,67,2024-09-13,14,395,689,1084,FLDegS_T,"-37.81688755, 144.96562569"
181420241204,18,2024-12-04,14,280,187,467,Col12_T,"-37.81344862, 144.97305353"
86520250928,86,2025-09-28,5,0,1,1,574Qub_T,"-37.80309992, 144.94908064"
121620240523,12,2024-05-23,16,241,247,488,NewQ_T,"-37.81457988, 144.94292398"
10720240812,10,2024-08-12,7,16,32,48,BouHbr_T,"-37.81876474, 144.94710545"
101520241128,10,2024-11-28,15,140,39,179,BouHbr_T,"-37.81876474, 144.94710545"
721320231019,72,2023-10-19,13,322,301,623,ACMI_T,"-37.81726338, 144.96872809"
722220241103,72,2024-11-03,22,39,245,284,ACMI_T,"-37.81726338, 144.96872809"
761220240806,76,2024-08-06,12,86,70,156,KenMac_T,"-37.79453803, 144.93036194"
352220250408,35,2025-04-08,22,261,461,722,SouthB_T,"-37.82018685, 144.96508508"
21920251016,2,2025-10-16,19,483,508,991,Bou283_T,"-37.81380668, 144.96516718"
27520250430,27,2025-04-30,5,8,2,10,Vic_T,"-37.80606888, 144.95644692"
27320250403,27,2025-04-03,3,7,0,7,Vic_T,"-37.80606888, 144.95644692"
30920250223,30,2025-02-23,9,29,46,75,Lon189_T,"-37.8112185, 144.96656806"
792320240315,79,2024-03-15,23,297,457,754,FliSS_T,"-37.81794046, 144.96616678"
251820240820,25,2024-08-20,18,727,350,1077,MCEC_T,"-37.82401776, 144.95604426"
461220240621,46,2024-06-21,12,98,87,185,Pel147_T,"-37.80240719, 144.9615673"
521820250829,52,2025-08-29,18,374,387,761,Eli263_T,"-37.81252157, 144.9619401"
251520240319,25,2024-03-19,15,503,421,924,MCEC_T,"-37.82401776, 144.95604426"
1391820250407,139,2025-04-07,18,56,21,77,Signal1647_T,"-37.81959923, 144.9632832"
1391520231221,139,2023-12-21,15,110,69,179,Signal1647_T,"-37.81959923, 144.9632832"
1391120240210,139,2024-02-10,11,45,50,95,Signal1647_T,"-37.81959923, 144.9632832"
1371920250404,137,2025-04-04,19,0,5,5,BouHbr2353_T,"-37.81894815, 144.94612292"
1361420240213,136,2024-02-13,14,32,7,39,BirFed1120_T,"-37.8184141, 144.97357915"
142420240910,142,2024-09-10,4,1,3,4,Hammer1584_T,"-37.81970749, 144.96795734"
1301620241103,130,2024-11-03,16,38,37,75,Bou892T,"-37.8204637, 144.94126826"
1642020241128,164,2024-11-28,20,68,104,172,Lat526_T,"-37.813005, 144.95160411"
164820241210,164,2024-12-10,8,86,91,177,Lat526_T,"-37.813005, 144.95160411"
123820240725,123,2024-07-25,8,14,0,14,BirBridge_T,"-37.81753741, 144.97329734"
138920240326,138,2024-03-26,9,0,1,1,EntPark1671_T,"-37.81996544, 144.95981454"
1381820250813,138,2025-08-13,18,1,0,1,EntPark1671_T,"-37.81996544, 144.95981454"
109320240307,109,2024-03-07,3,3,3,6,LatWill_T,"-37.81193681, 144.95621105"
661520240927,66,2024-09-27,15,1557,1510,3067,QVN_T,"-37.81057846, 144.96444294"
6320240402,6,2024-04-02,3,11,4,15,FliS_T,"-37.81911705, 144.96558255"
6820250108,6,2025-01-08,8,866,1617,2483,FliS_T,"-37.81911705, 144.96558255"
84620241225,84,2024-12-25,6,47,47,94,ElFi_T,"-37.81798049, 144.96503383"
662120240112,66,2024-01-12,21,869,735,1604,QVN_T,"-37.81057846, 144.96444294"
3120240718,3,2024-07-18,1,67,43,110,Swa295_T,"-37.81101524, 144.96429485"
32020250317,3,2025-03-17,20,793,685,1478,Swa295_T,"-37.81101524, 144.96429485"
751120240603,75,2024-06-03,11,41,33,74,SprFli_T,"-37.81515276, 144.97467661"
81120240421,8,2024-04-21,11,136,295,431,WebBN_T,"-37.82293543, 144.9471751"
751620250211,75,2025-02-11,16,70,75,145,SprFli_T,"-37.81515276, 144.97467661"
751220250916,75,2025-09-16,12,94,66,160,SprFli_T,"-37.81515276, 144.97467661"
41620240302,41,2024-03-02,6,180,153,333,Swa31,"-37.81668634, 144.96689733"
771620240531,77,2024-05-31,16,229,128,357,HarEsP_T,"-37.81441438, 144.94433026"
42320241110,42,2024-11-10,3,5,4,9,UM1_T,"-37.80008566, 144.96386412"
771620231022,77,2023-10-22,16,64,72,136,HarEsP_T,"-37.81441438, 144.94433026"
782020231205,78,2023-12-05,20,20,36,56,HarEsB_T,"-37.81471642, 144.9446508"
142220250207,14,2025-02-07,22,536,106,642,SanBri_T,"-37.82011242, 144.96291897"
652120240519,65,2024-05-19,21,65,320,385,SwaCs_T,"-37.81569416, 144.9668064"
281620250928,28,2025-09-28,16,392,1359,1751,VAC_T,"-37.82129925, 144.96879309"
28820250403,28,2025-04-03,8,670,328,998,VAC_T,"-37.82129925, 144.96879309"
84920250903,84,2025-09-03,9,915,432,1347,ElFi_T,"-37.81798049, 144.96503383"
4220231227,4,2023-12-27,2,42,33,75,Swa123_T,"-37.81487988, 144.9660878"
42020250812,4,2025-08-12,20,507,510,1017,Swa123_T,"-37.81487988, 144.9660878"
31520240524,3,2024-05-24,15,1006,1226,2232,Swa295_T,"-37.81101524, 144.96429485"
41120240530,41,2024-05-30,1,40,53,93,Swa31,"-37.81668634, 144.96689733"
67420231021,67,2023-10-21,4,16,23,39,FLDegS_T,"-37.81688755, 144.96562569"
671620241022,67,2024-10-22,16,321,687,1008,FLDegS_T,"-37.81688755, 144.96562569"
1420231117,1,2023-11-17,4,8,15,23,Bou292_T,"-37.81349441, 144.96515323"
11620240504,1,2024-05-04,16,1852,1495,3347,Bou292_T,"-37.81349441, 144.96515323"
18920250816,18,2025-08-16,9,59,50,109,Col12_T,"-37.81344862, 144.97305353"
632320250609,63,2025-06-09,23,2,38,40,Bou231_T,"-37.81333081, 144.96675571"
62920231217,62,2023-12-17,9,78,84,162,Lat224_T,"-37.80996494, 144.96216521"
561020240908,56,2024-09-08,10,320,135,455,Lon364_T,"-37.81234775, 144.96153311"
121220240617,12,2024-06-17,12,145,143,288,NewQ_T,"-37.81457988, 144.94292398"
12220241002,12,2024-10-02,2,3,2,5,NewQ_T,"-37.81457988, 144.94292398"
12720250201,12,2025-02-01,7,58,38,96,NewQ_T,"-37.81457988, 144.94292398"
11820250216,11,2025-02-16,8,45,21,66,WatCit_T,"-37.81564989, 144.93970694"
722020241123,72,2024-11-23,20,165,239,404,ACMI_T,"-37.81726338, 144.96872809"
351620240826,35,2024-08-26,16,973,902,1875,SouthB_T,"-37.82018685, 144.96508508"
11220250207,11,2025-02-07,2,2,1,3,WatCit_T,"-37.81564989, 144.93970694"
58220241225,58,2024-12-25,2,28,45,73,Bou688_T,"-37.81686075, 144.95358075"
561520250928,56,2025-09-28,15,392,364,756,Lon364_T,"-37.81234775, 144.96153311"
92220250220,9,2025-02-20,22,54,34,88,Col700_T,"-37.81982992, 144.95102555"
531020250927,53,2025-09-27,10,658,443,1101,Col254_T,"-37.81564191, 144.965499"
252120250331,25,2025-03-31,21,191,208,399,MCEC_T,"-37.82401776, 144.95604426"
139520250901,139,2025-09-01,5,4,4,8,Signal1647_T,"-37.81959923, 144.9632832"
1361920250617,136,2025-06-17,19,5,1,6,BirFed1120_T,"-37.8184141, 144.97357915"
142520240813,142,2024-08-13,5,13,3,16,Hammer1584_T,"-37.81970749, 144.96795734"
1381020240725,138,2024-07-25,10,3,3,6,EntPark1671_T,"-37.81996544, 144.95981454"
1091220240205,109,2024-02-05,12,205,164,369,LatWill_T,"-37.81193681, 144.95621105"
61320240512,6,2024-05-12,13,911,797,1708,FliS_T,"-37.81911705, 144.96558255"
84520240426,84,2024-04-26,5,42,38,80,ElFi_T,"-37.81798049, 144.96503383"
842320240729,84,2024-07-29,23,70,107,177,ElFi_T,"-37.81798049, 144.96503383"
69120250731,69,2025-07-31,1,0,1,1,FLDegC_T,"-37.81687226, 144.96559144"
42320241021,4,2024-10-21,23,66,57,123,Swa123_T,"-37.81487988, 144.9660878"
701720250206,70,2025-02-06,17,162,143,305,Errol20_T,"-37.80456984, 144.94946228"
70920250714,70,2025-07-14,9,57,63,120,Errol20_T,"-37.80456984, 144.94946228"
702020250806,70,2025-08-06,20,65,94,159,Errol20_T,"-37.80456984, 144.94946228"
392220240828,39,2024-08-28,22,21,10,31,AlfPl_T,"-37.81379749, 144.96995745"
39120250730,39,2025-07-30,1,1,0,1,AlfPl_T,"-37.81379749, 144.96995745"
752120240111,75,2024-01-11,21,16,4,20,SprFli_T,"-37.81515276, 144.97467661"
751620241104,75,2024-11-04,16,36,43,79,SprFli_T,"-37.81515276, 144.97467661"
14320231107,14,2023-11-07,3,17,1,18,SanBri_T,"-37.82011242, 144.96291897"
711020231021,71,2023-10-21,10,11,19,30,WestWP_T,"-37.81235775, 144.97136962"
40120240717,40,2024-07-17,1,4,3,7,Spr201_T,"-37.80999341, 144.97227587"
40220241017,40,2024-10-17,2,1,0,1,Spr201_T,"-37.80999341, 144.97227587"
311020250216,31,2025-02-16,10,107,65,172,Lyg161_T,"-37.80169681, 144.96658911"
39520250905,39,2025-09-05,5,6,2,8,AlfPl_T,"-37.81379749, 144.96995745"
39920240424,39,2024-04-24,9,124,177,301,AlfPl_T,"-37.81379749, 144.96995745"
75420241006,75,2024-10-06,4,0,2,2,SprFli_T,"-37.81515276, 144.97467661"
411420250822,41,2025-08-22,14,1501,1666,3167,Swa31,"-37.81668634, 144.96689733"
78720231205,78,2023-12-05,7,53,45,98,HarEsB_T,"-37.81471642, 144.9446508"
78820240613,78,2024-06-13,8,83,47,130,HarEsB_T,"-37.81471642, 144.9446508"
59220250604,59,2025-06-04,2,9,9,18,RMIT_T,"-37.80825648, 144.96304859"
541120250330,54,2025-03-30,11,86,87,173,Swa607_T,"-37.804024, 144.96308399"
541020240203,54,2024-02-03,10,87,85,172,Swa607_T,"-37.804024, 144.96308399"
54120240311,54,2024-03-11,1,17,11,28,Swa607_T,"-37.804024, 144.96308399"
281620231228,28,2023-12-28,16,658,1508,2166,VAC_T,"-37.82129925, 144.96879309"
401120240713,40,2024-07-13,11,190,192,382,Spr201_T,"-37.80999341, 144.97227587"
21820231211,21,2023-12-11,8,80,95,175,Bourke155_T,"-37.81267313, 144.96788288"
372320241002,37,2024-10-02,23,51,33,84,Lyg260_T,"-37.80107122, 144.96704554"
37320241125,37,2024-11-25,3,5,10,15,Lyg260_T,"-37.80107122, 144.96704554"
371320250812,37,2025-08-12,13,106,101,207,Lyg260_T,"-37.80107122, 144.96704554"
871720250101,87,2025-01-01,17,31,25,56,Errol23_T,"-37.80454949, 144.94921863"
50120250526,50,2025-05-26,1,1,2,3,Lyg309_T,"-37.79808192, 144.96721013"
431520240110,43,2024-01-10,15,65,65,130,UM2_T,"-37.79844526, 144.96411782"
45020241107,45,2024-11-07,0,27,48,75,Swa148_T,"-37.81414075, 144.96609379"
166920251014,166,2025-10-14,9,23,26,49,Spen484_T,"-37.80896733, 144.94931703"
166820250127,166,2025-01-27,8,16,10,26,Spen484_T,"-37.80896733, 144.94931703"
1071420231031,107,2023-10-31,14,108,185,293,280Will_T,"-37.81246271, 144.95690188"
143920240811,143,2024-08-11,9,104,259,363,Spencer_T,"-37.821728, 144.95557015"
132320240109,132,2024-01-09,3,9,2,11,King335_T,"-37.81267639, 144.95386444"
1341920240613,134,2024-06-13,19,202,243,445,Spen201_T,"-37.81694221, 144.95303935"
1351020250101,135,2025-01-01,10,252,379,631,Spen161_T,"-37.8172861, 144.95319102"
1331020250914,133,2025-09-14,10,350,433,783,Spen229_T,"-37.81531435, 144.95227769"
133020250218,133,2025-02-18,0,40,17,57,Spen229_T,"-37.81531435, 144.95227769"
118820250819,118,2025-08-19,8,37,12,49,Fli114C_T,"-37.81632783, 144.97090512"
1081920250814,108,2025-08-14,19,370,139,509,261Will_T,"-37.81295822, 144.95678789"
108820241229,108,2024-12-29,8,41,36,77,261Will_T,"-37.81295822, 144.95678789"
108720250226,108,2025-02-26,7,92,826,918,261Will_T,"-37.81295822, 144.95678789"
791420240405,79,2024-04-05,14,604,491,1095,FliSS_T,"-37.81794046, 144.96616678"
79320240510,79,2024-05-10,3,10,12,22,FliSS_T,"-37.81794046, 144.96616678"
91020250716,9,2025-07-16,10,190,558,748,Col700_T,"-37.81982992, 144.95102555"
53420240310,53,2024-03-10,4,8,11,19,Col254_T,"-37.81564191, 144.965499"
462020250601,46,2025-06-01,20,1,3,4,Pel147_T,"-37.80240719, 144.9615673"
20820240712,20,2024-07-12,8,40,42,82,LtB170_T,"-37.81172914, 144.9682466"
491120250722,49,2025-07-22,11,148,257,405,Eli501_T,"-37.80730068, 144.95956055"
1372020241225,137,2024-12-25,20,8,17,25,BouHbr2353_T,"-37.81894815, 144.94612292"
1392020240413,139,2024-04-13,20,43,36,79,Signal1647_T,"-37.81959923, 144.9632832"
1362220250720,136,2025-07-20,22,1,0,1,BirFed1120_T,"-37.8184141, 144.97357915"
1381620240302,138,2024-03-02,16,8,4,12,EntPark1671_T,"-37.81996544, 144.95981454"
1171220231228,117,2023-12-28,12,126,172,298,Fli114F_T,"-37.81629332, 144.97090877"
1172320250219,117,2025-02-19,23,34,31,65,Fli114F_T,"-37.81629332, 144.97090877"
492020240913,49,2024-09-13,20,177,139,316,Eli501_T,"-37.80730068, 144.95956055"
49420240921,49,2024-09-21,4,29,37,66,Eli501_T,"-37.80730068, 144.95956055"
49920241213,49,2024-12-13,9,183,237,420,Eli501_T,"-37.80730068, 144.95956055"
109020240229,109,2024-02-29,0,10,24,34,LatWill_T,"-37.81193681, 144.95621105"
66620250609,66,2025-06-09,6,15,25,40,QVN_T,"-37.81057846, 144.96444294"
661820250731,66,2025-07-31,18,1249,1411,2660,QVN_T,"-37.81057846, 144.96444294"
61920241022,6,2024-10-22,19,860,612,1472,FliS_T,"-37.81911705, 144.96558255"
41020231114,4,2023-11-14,10,984,588,1572,Swa123_T,"-37.81487988, 144.9660878"
311420240719,31,2024-07-19,14,113,113,226,Lyg161_T,"-37.80169681, 144.96658911"
31820240315,31,2024-03-15,8,58,77,135,Lyg161_T,"-37.80169681, 144.96658911"
361520250322,36,2025-03-22,15,133,118,251,Que85_T,"-37.81652527, 144.96121062"
371320241109,37,2024-11-09,13,102,119,221,Lyg260_T,"-37.80107122, 144.96704554"
471920240312,47,2024-03-12,19,633,445,1078,Eli250_T,"-37.81258467, 144.9625775"
21820250104,21,2025-01-04,8,26,20,46,Bourke155_T,"-37.81267313, 144.96788288"
871020240701,87,2024-07-01,10,107,90,197,Errol23_T,"-37.80454949, 144.94921863"
87420231127,87,2023-11-27,4,3,2,5,Errol23_T,"-37.80454949, 144.94921863"
61420251004,61,2025-10-04,4,13,1,14,RMIT14_T,"-37.80767455, 144.96309114"
612120240920,61,2024-09-20,21,264,192,456,RMIT14_T,"-37.80767455, 144.96309114"
501620241114,50,2024-11-14,16,198,155,353,Lyg309_T,"-37.79808192, 144.96721013"
43920241008,43,2024-10-08,9,242,96,338,UM2_T,"-37.79844526, 144.96411782"
1661420250115,166,2025-01-15,14,49,52,101,Spen484_T,"-37.80896733, 144.94931703"
1401020240105,140,2024-01-05,10,101,43,144,Boyd2837_T,"-37.82590962, 144.96185972"
1321420240128,132,2024-01-28,14,155,136,291,King335_T,"-37.81267639, 144.95386444"
1072120251011,107,2025-10-11,21,72,41,113,280Will_T,"-37.81246271, 144.95690188"
133920250823,133,2025-08-23,9,341,407,748,Spen229_T,"-37.81531435, 144.95227769"
1351320240611,135,2024-06-11,13,371,362,733,Spen161_T,"-37.8172861, 144.95319102"
1181320241219,118,2024-12-19,13,16,14,30,Fli114C_T,"-37.81632783, 144.97090512"
124820250329,124,2025-03-29,8,1,1,2,BirBridge_T,"-37.81757416, 144.97329934"
85620240319,85,2024-03-19,6,18,9,27,488Mac_T,"-37.79432415, 144.92973378"
11820240129,1,2024-01-29,18,896,566,1462,Bou292_T,"-37.81349441, 144.96515323"
681020250824,68,2025-08-24,10,256,276,532,FLDegN_T,"-37.8168479, 144.96559789"
181720250523,18,2025-05-23,17,243,107,350,Col12_T,"-37.81344862, 144.97305353"
1320250817,1,2025-08-17,3,19,45,64,Bou292_T,"-37.81349441, 144.96515323"
622120250607,62,2025-06-07,21,133,142,275,Lat224_T,"-37.80996494, 144.96216521"
861620231231,86,2023-12-31,16,21,31,52,574Qub_T,"-37.80309992, 144.94908064"
11020240408,11,2024-04-08,0,2,5,7,WatCit_T,"-37.81564989, 144.93970694"
111020240810,11,2024-08-10,10,99,95,194,WatCit_T,"-37.81564989, 144.93970694"
761620240227,76,2024-02-27,16,55,77,132,KenMac_T,"-37.79453803, 144.93036194"
27820241230,27,2024-12-30,8,36,44,80,Vic_T,"-37.80606888, 144.95644692"
791520250509,79,2025-05-09,15,491,478,969,FliSS_T,"-37.81794046, 144.96616678"
79120250716,79,2025-07-16,1,21,9,30,FliSS_T,"-37.81794046, 144.96616678"
30220231120,30,2023-11-20,2,28,48,76,Lon189_T,"-37.8112185, 144.96656806"
531220250928,53,2025-09-28,12,677,497,1174,Col254_T,"-37.81564191, 144.965499"
53220250304,53,2025-03-04,2,2,2,4,Col254_T,"-37.81564191, 144.965499"
91020250423,9,2025-04-23,10,116,354,470,Col700_T,"-37.81982992, 144.95102555"
20320241109,20,2024-11-09,3,25,30,55,LtB170_T,"-37.81172914, 144.9682466"
1371120250128,137,2025-01-28,11,19,52,71,BouHbr2353_T,"-37.81894815, 144.94612292"
1412320240319,141,2024-03-19,23,29,43,72,474Fl_T,"-37.81997273, 144.95834911"
1391420240511,139,2024-05-11,14,71,66,137,Signal1647_T,"-37.81959923, 144.9632832"
164620241116,164,2024-11-16,6,11,13,24,Lat526_T,"-37.813005, 144.95160411"
1231920231207,123,2023-12-07,19,33,27,60,BirBridge_T,"-37.81753741, 144.97329734"
1231320240217,123,2024-02-17,13,21,14,35,BirBridge_T,"-37.81753741, 144.97329734"
1381120240922,138,2024-09-22,11,5,1,6,EntPark1671_T,"-37.81996544, 144.95981454"
1381720250123,138,2025-01-23,17,5,5,10,EntPark1671_T,"-37.81996544, 144.95981454"
481620250728,48,2025-07-28,16,115,108,223,QVMQ_T,"-37.80631581, 144.95866697"
66020231228,66,2023-12-28,0,109,69,178,QVN_T,"-37.81057846, 144.96444294"
751020240416,75,2024-04-16,10,42,33,75,SprFli_T,"-37.81515276, 144.97467661"
752320241106,75,2024-11-06,23,0,1,1,SprFli_T,"-37.81515276, 144.97467661"
41120250901,41,2025-09-01,1,38,57,95,Swa31,"-37.81668634, 144.96689733"
781920231026,78,2023-10-26,19,40,98,138,HarEsB_T,"-37.81471642, 144.9446508"
421120250214,42,2025-02-14,11,104,165,269,UM1_T,"-37.80008566, 144.96386412"
31220241209,31,2024-12-09,2,5,4,9,Lyg161_T,"-37.80169681, 144.96658911"
311220250705,31,2025-07-05,12,175,165,340,Lyg161_T,"-37.80169681, 144.96658911"
311420231127,31,2023-11-27,14,126,149,275,Lyg161_T,"-37.80169681, 144.96658911"
542320240407,54,2024-04-07,23,27,62,89,Swa607_T,"-37.804024, 144.96308399"
281820250916,28,2025-09-16,18,312,299,611,VAC_T,"-37.82129925, 144.96879309"
472120250626,47,2025-06-26,21,514,342,856,Eli250_T,"-37.81258467, 144.9625775"
5920241222,5,2024-12-22,9,252,370,622,PriNW_T,"-37.81874249, 144.96787656"
21020231118,21,2023-11-18,0,261,249,510,Bourke155_T,"-37.81267313, 144.96788288"
212320231110,21,2023-11-10,23,361,411,772,Bourke155_T,"-37.81267313, 144.96788288"
21720241125,21,2024-11-25,7,30,43,73,Bourke155_T,"-37.81267313, 144.96788288"
21320241204,21,2024-12-04,3,2,2,4,Bourke155_T,"-37.81267313, 144.96788288"
362220240729,36,2024-07-29,22,23,15,38,Que85_T,"-37.81652527, 144.96121062"
361120241127,36,2024-11-27,11,191,157,348,Que85_T,"-37.81652527, 144.96121062"
37020250225,37,2025-02-25,0,8,4,12,Lyg260_T,"-37.80107122, 144.96704554"
871520241113,87,2024-11-13,15,103,118,221,Errol23_T,"-37.80454949, 144.94921863"
43220231107,43,2023-11-07,2,2,0,2,UM2_T,"-37.79844526, 144.96411782"
45320240616,45,2024-06-16,3,23,99,122,Swa148_T,"-37.81414075, 144.96609379"
451520241006,45,2024-10-06,15,1819,1366,3185,Swa148_T,"-37.81414075, 144.96609379"
45620241011,45,2024-10-11,6,47,70,117,Swa148_T,"-37.81414075, 144.96609379"
179320250210,179,2025-02-10,3,3,6,9,Pow61_T,"-37.82392385, 144.96299677"
1671920250115,167,2025-01-15,19,24,31,55,Lat526_T,"-37.81304149, 144.95155955"
1621520250917,162,2025-09-17,15,285,349,634,Eli489_T,"-37.80740397, 144.95987909"
143020250816,143,2025-08-16,0,130,55,185,Spencer_T,"-37.821728, 144.95557015"
134120240315,134,2024-03-15,1,35,40,75,Spen201_T,"-37.81694221, 144.95303935"
1351020250521,135,2025-05-21,10,251,283,534,Spen161_T,"-37.8172861, 144.95319102"
1352220250725,135,2025-07-25,22,145,760,905,Spen161_T,"-37.8172861, 144.95319102"
133720250203,133,2025-02-03,7,606,324,930,Spen229_T,"-37.81531435, 144.95227769"
1332220240803,133,2024-08-03,22,256,199,455,Spen229_T,"-37.81531435, 144.95227769"
124920250824,124,2025-08-24,9,3,4,7,BirBridge_T,"-37.81757416, 144.97329934"
67420240919,67,2024-09-19,4,3,5,8,FLDegS_T,"-37.81688755, 144.96562569"
17120250114,17,2025-01-14,1,5,6,11,Col15_T,"-37.81362543, 144.97323591"
631720240304,63,2024-03-04,17,313,356,669,Bou231_T,"-37.81333081, 144.96675571"
62320231208,62,2023-12-08,3,32,25,57,Lat224_T,"-37.80996494, 144.96216521"
12620231118,12,2023-11-18,6,17,13,30,NewQ_T,"-37.81457988, 144.94292398"
10920250621,10,2025-06-21,9,28,20,48,BouHbr_T,"-37.81876474, 144.94710545"
761420250212,76,2025-02-12,14,51,52,103,KenMac_T,"-37.79453803, 144.93036194"
67220250926,67,2025-09-26,2,9,13,22,FLDegS_T,"-37.81688755, 144.96562569"
851020250717,85,2025-07-17,10,71,58,129,488Mac_T,"-37.79432415, 144.92973378"
17920250221,17,2025-02-21,9,487,154,641,Col15_T,"-37.81362543, 144.97323591"
182020250213,18,2025-02-13,20,68,20,88,Col12_T,"-37.81344862, 144.97305353"
21220240405,21,2024-04-05,2,38,29,67,Bourke155_T,"-37.81267313, 144.96788288"
211620250410,21,2025-04-10,16,333,364,697,Bourke155_T,"-37.81267313, 144.96788288"
432220251006,43,2025-10-06,22,50,29,79,UM2_T,"-37.79844526, 144.96411782"
5420231203,5,2023-12-03,4,23,41,64,PriNW_T,"-37.81874249, 144.96787656"
51820240508,5,2024-05-08,18,672,806,1478,PriNW_T,"-37.81874249, 144.96787656"
1072020250511,107,2025-05-11,20,66,27,93,280Will_T,"-37.81246271, 144.95690188"
1181020250208,118,2025-02-08,10,17,21,38,Fli114C_T,"-37.81632783, 144.97090512"
501720240611,50,2024-06-11,17,208,137,345,Lyg309_T,"-37.79808192, 144.96721013"
179920241229,179,2024-12-29,9,56,37,93,Pow61_T,"-37.82392385, 144.96299677"
1791520250823,179,2025-08-23,15,78,78,156,Pow61_T,"-37.82392385, 144.96299677"
181120250915,181,2025-09-15,1,73,78,151,Eli368_T,"-37.81009465, 144.96143149"
1311220250129,131,2025-01-29,12,152,206,358,King2_T,"-37.82009057, 144.95758725"
1401620250709,140,2025-07-09,16,92,108,200,Boyd2837_T,"-37.82590962, 144.96185972"
1321720240326,132,2024-03-26,17,230,171,401,King335_T,"-37.81267639, 144.95386444"
1351020250813,135,2025-08-13,10,356,376,732,Spen161_T,"-37.8172861, 144.95319102"
68120240226,68,2024-02-26,1,1,1,2,FLDegN_T,"-37.8168479, 144.96559789"
171620241218,17,2024-12-18,16,234,413,647,Col15_T,"-37.81362543, 144.97323591"
171320250218,17,2025-02-18,13,802,754,1556,Col15_T,"-37.81362543, 144.97323591"
63720240229,63,2024-02-29,7,111,111,222,Bou231_T,"-37.81333081, 144.96675571"
63920240820,63,2024-08-20,9,145,168,313,Bou231_T,"-37.81333081, 144.96675571"
181320240206,18,2024-02-06,13,299,276,575,Col12_T,"-37.81344862, 144.97305353"
181320241013,18,2024-10-13,13,74,75,149,Col12_T,"-37.81344862, 144.97305353"
182020250421,18,2025-04-21,20,11,8,19,Col12_T,"-37.81344862, 144.97305353"
621320250918,62,2025-09-18,13,301,261,562,Lat224_T,"-37.80996494, 144.96216521"
621920240319,62,2024-03-19,19,297,187,484,Lat224_T,"-37.80996494, 144.96216521"
622320250324,62,2025-03-24,23,91,68,159,Lat224_T,"-37.80996494, 144.96216521"
86720250208,86,2025-02-08,7,13,10,23,574Qub_T,"-37.80309992, 144.94908064"
101620250719,10,2025-07-19,16,52,30,82,BouHbr_T,"-37.81876474, 144.94710545"
721720240928,72,2024-09-28,17,210,726,936,ACMI_T,"-37.81726338, 144.96872809"
721620241007,72,2024-10-07,16,89,496,585,ACMI_T,"-37.81726338, 144.96872809"
301920231218,30,2023-12-18,19,279,366,645,Lon189_T,"-37.8112185, 144.96656806"
91120240916,9,2024-09-16,11,199,284,483,Col700_T,"-37.81982992, 144.95102555"
91620250208,9,2025-02-08,16,158,229,387,Col700_T,"-37.81982992, 144.95102555"
792120250710,79,2025-07-10,21,146,240,386,FliSS_T,"-37.81794046, 144.96616678"
301020250315,30,2025-03-15,10,97,213,310,Lon189_T,"-37.8112185, 144.96656806"
791420250415,79,2025-04-15,14,567,529,1096,FliSS_T,"-37.81794046, 144.96616678"
462220241101,46,2024-11-01,22,5,1,6,Pel147_T,"-37.80240719, 144.9615673"
251820241210,25,2024-12-10,18,894,324,1218,MCEC_T,"-37.82401776, 144.95604426"
201220250502,20,2025-05-02,12,337,235,572,LtB170_T,"-37.81172914, 144.9682466"
191720250827,19,2025-08-27,17,547,342,889,LtB210_T,"-37.81237202, 144.96550671"
1372020250821,137,2025-08-21,20,4,3,7,BouHbr2353_T,"-37.81894815, 144.94612292"
1391420250727,139,2025-07-27,14,35,43,78,Signal1647_T,"-37.81959923, 144.9632832"
180920250915,180,2025-09-15,9,59,18,77,Mac330_T,"-37.79497059, 144.93530329"
161620250804,161,2025-08-04,6,4,4,8,BirArt1109_T,"-37.81851276, 144.97131336"
1232320240525,123,2024-05-25,23,3,0,3,BirBridge_T,"-37.81753741, 144.97329734"
1381220241016,138,2024-10-16,12,10,19,29,EntPark1671_T,"-37.81996544, 144.95981454"
1091020251004,109,2025-10-04,10,87,67,154,LatWill_T,"-37.81193681, 144.95621105"
1091020231024,109,2023-10-24,10,122,193,315,LatWill_T,"-37.81193681, 144.95621105"
66420240814,66,2024-08-14,4,6,13,19,QVN_T,"-37.81057846, 144.96444294"
61420240919,6,2024-09-19,14,818,590,1408,FliS_T,"-37.81911705, 144.96558255"
842320240423,84,2024-04-23,23,77,106,183,ElFi_T,"-37.81798049, 144.96503383"
41420250602,4,2025-06-02,14,933,814,1747,Swa123_T,"-37.81487988, 144.9660878"
70220240615,70,2024-06-15,2,2,2,4,Errol20_T,"-37.80456984, 144.94946228"
392320240604,39,2024-06-04,23,8,5,13,AlfPl_T,"-37.81379749, 144.96995745"
81020240222,8,2024-02-22,10,91,148,239,WebBN_T,"-37.82293543, 144.9471751"
8320240329,8,2024-03-29,3,2,2,4,WebBN_T,"-37.82293543, 144.9471751"
81120250122,8,2025-01-22,11,122,197,319,WebBN_T,"-37.82293543, 144.9471751"
117220240708,117,2024-07-08,2,1,0,1,Fli114F_T,"-37.81629332, 144.97090877"
491420240204,49,2024-02-04,14,222,268,490,Eli501_T,"-37.80730068, 144.95956055"
1091320250909,109,2025-09-09,13,227,201,428,LatWill_T,"-37.81193681, 144.95621105"
1641220250822,164,2025-08-22,12,154,142,296,Lat526_T,"-37.813005, 144.95160411"
691620241111,69,2024-11-11,16,149,183,332,FLDegC_T,"-37.81687226, 144.96559144"
61520250914,6,2025-09-14,15,943,752,1695,FliS_T,"-37.81911705, 144.96558255"
39420240716,39,2024-07-16,4,0,4,4,AlfPl_T,"-37.81379749, 144.96995745"
8220240323,8,2024-03-23,2,8,2,10,WebBN_T,"-37.82293543, 144.9471751"
82020240402,8,2024-04-02,20,14,10,24,WebBN_T,"-37.82293543, 144.9471751"
781320231224,78,2023-12-24,13,51,53,104,HarEsB_T,"-37.81471642, 144.9446508"
141020250824,14,2025-08-24,10,240,113,353,SanBri_T,"-37.82011242, 144.96291897"
711720250218,71,2025-02-18,17,25,32,57,WestWP_T,"-37.81235775, 144.97136962"
28020241202,28,2024-12-02,0,20,14,34,VAC_T,"-37.82129925, 144.96879309"
542020240829,54,2024-08-29,20,259,269,528,Swa607_T,"-37.804024, 144.96308399"
54320250625,54,2025-06-25,3,9,3,12,Swa607_T,"-37.804024, 144.96308399"
361220250315,36,2025-03-15,12,132,142,274,Que85_T,"-37.81652527, 144.96121062"
372220231202,37,2023-12-02,22,132,206,338,Lyg260_T,"-37.80107122, 144.96704554"
47920250129,47,2025-01-29,9,227,500,727,Eli250_T,"-37.81258467, 144.9625775"
47320250605,47,2025-06-05,3,14,18,32,Eli250_T,"-37.81258467, 144.9625775"
471220240923,47,2024-09-23,12,890,862,1752,Eli250_T,"-37.81258467, 144.9625775"
451220250606,45,2025-06-06,12,424,508,932,Swa148_T,"-37.81414075, 144.96609379"
45920251012,45,2025-10-12,9,214,569,783,Swa148_T,"-37.81414075, 144.96609379"
451920240721,45,2024-07-21,19,312,557,869,Swa148_T,"-37.81414075, 144.96609379"
51720240831,5,2024-08-31,17,1293,1487,2780,PriNW_T,"-37.81874249, 144.96787656"
212320250727,21,2025-07-27,23,51,50,101,Bourke155_T,"-37.81267313, 144.96788288"
108520250416,108,2025-04-16,5,14,59,73,261Will_T,"-37.81295822, 144.95678789"
501820231108,50,2023-11-08,18,146,142,288,Lyg309_T,"-37.79808192, 144.96721013"
166620250815,166,2025-08-15,6,2,6,8,Spen484_T,"-37.80896733, 144.94931703"
1661120250831,166,2025-08-31,11,55,55,110,Spen484_T,"-37.80896733, 144.94931703"
162820240826,162,2024-08-26,8,264,168,432,Eli489_T,"-37.80740397, 144.95987909"
131420231019,131,2023-10-19,4,7,8,15,King2_T,"-37.82009057, 144.95758725"
135220240902,135,2024-09-02,2,4,4,8,Spen161_T,"-37.8172861, 144.95319102"
1620250101,1,2025-01-01,6,28,21,49,Bou292_T,"-37.81349441, 144.96515323"
681620250319,68,2025-03-19,16,250,241,491,FLDegN_T,"-37.8168479, 144.96559789"
68320251012,68,2025-10-12,3,0,1,1,FLDegN_T,"-37.8168479, 144.96559789"
622020240805,62,2024-08-05,20,219,130,349,Lat224_T,"-37.80996494, 144.96216521"
111520231214,11,2023-12-14,15,78,68,146,WatCit_T,"-37.81564989, 144.93970694"
12620240419,12,2024-04-19,6,20,17,37,NewQ_T,"-37.81457988, 144.94292398"
721620231024,72,2023-10-24,16,206,656,862,ACMI_T,"-37.81726338, 144.96872809"
721720241013,72,2024-10-13,17,172,326,498,ACMI_T,"-37.81726338, 144.96872809"
12620240406,12,2024-04-06,6,11,9,20,NewQ_T,"-37.81457988, 144.94292398"
11520240901,11,2024-09-01,5,2,1,3,WatCit_T,"-37.81564989, 144.93970694"
121620250128,12,2025-01-28,16,124,130,254,NewQ_T,"-37.81457988, 144.94292398"
122220250311,12,2025-03-11,22,120,129,249,NewQ_T,"-37.81457988, 144.94292398"
101820250221,10,2025-02-21,18,108,87,195,BouHbr_T,"-37.81876474, 144.94710545"
351320231024,35,2023-10-24,13,1095,1192,2287,SouthB_T,"-37.82018685, 144.96508508"
30920250208,30,2025-02-08,9,50,185,235,Lon189_T,"-37.8112185, 144.96656806"
522320250211,52,2025-02-11,23,46,60,106,Eli263_T,"-37.81252157, 144.9619401"
511720240730,51,2024-07-30,17,80,83,163,Fra118_T,"-37.80841815, 144.95906316"
51920240901,51,2024-09-01,9,95,77,172,Fra118_T,"-37.80841815, 144.95906316"
51220250115,51,2025-01-15,2,5,5,10,Fra118_T,"-37.80841815, 144.95906316"
511820240225,51,2024-02-25,18,142,109,251,Fra118_T,"-37.80841815, 144.95906316"
23320241018,23,2024-10-18,3,4,16,20,Col623_T,"-37.81909256, 144.95452748"
191020250629,19,2025-06-29,10,181,110,291,LtB210_T,"-37.81237202, 144.96550671"
25120240526,25,2024-05-26,1,63,95,158,MCEC_T,"-37.82401776, 144.95604426"
48920250920,48,2025-09-20,9,255,178,433,QVMQ_T,"-37.80631581, 144.95866697"
48920240130,48,2024-01-30,9,155,121,276,QVMQ_T,"-37.80631581, 144.95866697"
1371020240420,137,2024-04-20,10,6,16,22,BouHbr2353_T,"-37.81894815, 144.94612292"
139620240609,139,2024-06-09,6,1,1,2,Signal1647_T,"-37.81959923, 144.9632832"
136420250228,136,2025-02-28,4,2,1,3,BirFed1120_T,"-37.8184141, 144.97357915"
1611420250509,161,2025-05-09,14,113,189,302,BirArt1109_T,"-37.81851276, 144.97131336"
1381620250810,138,2025-08-10,16,7,7,14,EntPark1671_T,"-37.81996544, 144.95981454"
66620250107,66,2025-01-07,6,17,49,66,QVN_T,"-37.81057846, 144.96444294"
661220240422,66,2024-04-22,12,995,1164,2159,QVN_T,"-37.81057846, 144.96444294"
42320240326,4,2024-03-26,23,489,150,639,Swa123_T,"-37.81487988, 144.9660878"
392220250922,39,2025-09-22,22,4,4,8,AlfPl_T,"-37.81379749, 144.96995745"
81020250104,8,2025-01-04,10,77,209,286,WebBN_T,"-37.82293543, 144.9471751"
75020250107,75,2025-01-07,0,0,1,1,SprFli_T,"-37.81515276, 144.97467661"
41220231018,41,2023-10-18,2,35,24,59,Swa31,"-37.81668634, 144.96689733"
77820241019,77,2024-10-19,8,47,80,127,HarEsP_T,"-37.81441438, 144.94433026"
781020250419,78,2025-04-19,10,48,102,150,HarEsB_T,"-37.81471642, 144.9446508"
311320250319,31,2025-03-19,13,177,163,340,Lyg161_T,"-37.80169681, 144.96658911"
47820240806,47,2024-08-06,8,233,670,903,Eli250_T,"-37.81258467, 144.9625775"
5120241114,5,2024-11-14,1,18,37,55,PriNW_T,"-37.81874249, 144.96787656"
5020250421,5,2025-04-21,0,142,100,242,PriNW_T,"-37.81874249, 144.96787656"
21520240412,21,2024-04-12,5,6,12,18,Bourke155_T,"-37.81267313, 144.96788288"
36720231028,36,2023-10-28,7,47,31,78,Que85_T,"-37.81652527, 144.96121062"
501120241027,50,2024-10-27,11,170,197,367,Lyg309_T,"-37.79808192, 144.96721013"
432020240920,43,2024-09-20,20,24,67,91,UM2_T,"-37.79844526, 144.96411782"
45820250419,45,2025-04-19,8,76,104,180,Swa148_T,"-37.81414075, 144.96609379"
451920240428,45,2024-04-28,19,327,545,872,Swa148_T,"-37.81414075, 144.96609379"
45920250217,45,2025-02-17,9,177,316,493,Swa148_T,"-37.81414075, 144.96609379"
1401220250424,140,2025-04-24,12,78,50,128,Boyd2837_T,"-37.82590962, 144.96185972"
1311320231019,131,2023-10-19,13,167,168,335,King2_T,"-37.82009057, 144.95758725"
351220250218,35,2025-02-18,12,1402,1270,2672,SouthB_T,"-37.82018685, 144.96508508"
91520240826,9,2024-08-26,15,946,172,1118,Col700_T,"-37.81982992, 144.95102555"
79820240124,79,2024-01-24,8,606,338,944,FliSS_T,"-37.81794046, 144.96616678"
531320240726,53,2024-07-26,13,841,637,1478,Col254_T,"-37.81564191, 144.965499"
51720231024,51,2023-10-24,7,24,30,54,Fra118_T,"-37.80841815, 144.95906316"
481220240518,48,2024-05-18,12,626,395,1021,QVMQ_T,"-37.80631581, 144.95866697"
521320241201,52,2024-12-01,13,428,371,799,Eli263_T,"-37.81252157, 144.9619401"
462320240418,46,2024-04-18,23,7,18,25,Pel147_T,"-37.80240719, 144.9615673"
1372320241219,137,2024-12-19,23,1,0,1,BouHbr2353_T,"-37.81894815, 144.94612292"
1411220240924,141,2024-09-24,12,213,190,403,474Fl_T,"-37.81997273, 144.95834911"
130520241115,130,2024-11-15,5,1,1,2,Bou892T,"-37.8204637, 144.94126826"
1231820240725,123,2024-07-25,18,1,0,1,BirBridge_T,"-37.81753741, 144.97329734"
49720240706,49,2024-07-06,7,59,49,108,Eli501_T,"-37.80730068, 144.95956055"
1091920250921,109,2025-09-21,19,92,87,179,LatWill_T,"-37.81193681, 144.95621105"
66520250809,66,2025-08-09,5,13,11,24,QVN_T,"-37.81057846, 144.96444294"
691620240709,69,2024-07-09,16,92,101,193,FLDegC_T,"-37.81687226, 144.96559144"
691120250129,69,2025-01-29,11,246,163,409,FLDegC_T,"-37.81687226, 144.96559144"
6720241214,6,2024-12-14,7,153,157,310,FliS_T,"-37.81911705, 144.96558255"
41720231228,4,2023-12-28,17,2003,1546,3549,Swa123_T,"-37.81487988, 144.9660878"
4020240804,4,2024-08-04,0,252,137,389,Swa123_T,"-37.81487988, 144.9660878"
41120250610,4,2025-06-10,11,1241,704,1945,Swa123_T,"-37.81487988, 144.9660878"
751520231114,75,2023-11-14,15,51,44,95,SprFli_T,"-37.81515276, 144.97467661"
411620231119,41,2023-11-19,16,1589,1697,3286,Swa31,"-37.81668634, 144.96689733"
8020231116,8,2023-11-16,0,2,2,4,WebBN_T,"-37.82293543, 144.9471751"
41620240525,41,2024-05-25,6,148,138,286,Swa31,"-37.81668634, 144.96689733"
77120250219,77,2025-02-19,1,4,3,7,HarEsP_T,"-37.81441438, 144.94433026"
71120250224,71,2025-02-24,1,5,5,10,WestWP_T,"-37.81235775, 144.97136962"
712220250616,71,2025-06-16,22,2,2,4,WestWP_T,"-37.81235775, 144.97136962"
711620231027,71,2023-10-27,16,17,16,33,WestWP_T,"-37.81235775, 144.97136962"
591520250502,59,2025-05-02,15,705,1348,2053,RMIT_T,"-37.80825648, 144.96304859"
28620250728,28,2025-07-28,6,128,33,161,VAC_T,"-37.82129925, 144.96879309"
31920250305,31,2025-03-05,9,70,47,117,Lyg161_T,"-37.80169681, 144.96658911"
311020250619,31,2025-06-19,10,74,72,146,Lyg161_T,"-37.80169681, 144.96658911"
311720250802,31,2025-08-02,17,284,223,507,Lyg161_T,"-37.80169681, 144.96658911"
312020240928,31,2024-09-28,20,392,413,805,Lyg161_T,"-37.80169681, 144.96658911"
541120240627,54,2024-06-27,11,78,80,158,Swa607_T,"-37.804024, 144.96308399"
5320241128,5,2024-11-28,3,24,22,46,PriNW_T,"-37.81874249, 144.96787656"
21120240203,21,2024-02-03,1,153,216,369,Bourke155_T,"-37.81267313, 144.96788288"
212120240223,21,2024-02-23,21,388,552,940,Bourke155_T,"-37.81267313, 144.96788288"
1381020240917,138,2024-09-17,10,4,2,6,EntPark1671_T,"-37.81996544, 144.95981454"
491020240609,49,2024-06-09,10,267,351,618,Eli501_T,"-37.80730068, 144.95956055"
109720250808,109,2025-08-08,7,39,163,202,LatWill_T,"-37.81193681, 144.95621105"
109020250323,109,2025-03-23,0,19,62,81,LatWill_T,"-37.81193681, 144.95621105"
19220240816,19,2024-08-16,2,27,40,67,LtB210_T,"-37.81237202, 144.96550671"
671120251012,67,2025-10-12,11,326,474,800,FLDegS_T,"-37.81688755, 144.96562569"
172120241209,17,2024-12-09,21,54,63,117,Col15_T,"-37.81362543, 144.97323591"
171020250815,17,2025-08-15,10,281,189,470,Col15_T,"-37.81362543, 144.97323591"
11820240713,1,2024-07-13,18,945,561,1506,Bou292_T,"-37.81349441, 144.96515323"
62620240125,62,2024-01-25,6,69,28,97,Lat224_T,"-37.80996494, 144.96216521"
621520240413,62,2024-04-13,15,307,207,514,Lat224_T,"-37.80996494, 144.96216521"
58320251001,58,2025-10-01,3,8,4,12,Bou688_T,"-37.81686075, 144.95358075"
41920240527,41,2024-05-27,9,1436,382,1818,Swa31,"-37.81668634, 144.96689733"
771620240602,77,2024-06-02,16,132,123,255,HarEsP_T,"-37.81441438, 144.94433026"
77720250209,77,2025-02-09,7,36,41,77,HarEsP_T,"-37.81441438, 144.94433026"
781020250902,78,2025-09-02,10,32,39,71,HarEsB_T,"-37.81471642, 144.9446508"
292120240324,29,2024-03-24,21,73,199,272,AG_T,"-37.8199817, 144.96872865"
712320240216,71,2024-02-16,23,12,8,20,WestWP_T,"-37.81235775, 144.97136962"
711320240724,71,2024-07-24,13,6,29,35,WestWP_T,"-37.81235775, 144.97136962"
281620250915,28,2025-09-15,16,331,896,1227,VAC_T,"-37.82129925, 144.96879309"
47520250422,47,2025-04-22,5,10,47,57,Eli250_T,"-37.81258467, 144.9625775"
21520240427,21,2024-04-27,5,28,29,57,Bourke155_T,"-37.81267313, 144.96788288"
211220241225,21,2024-12-25,12,226,198,424,Bourke155_T,"-37.81267313, 144.96788288"
37420240414,37,2024-04-14,4,3,1,4,Lyg260_T,"-37.80107122, 144.96704554"
43620240614,43,2024-06-14,6,34,4,38,UM2_T,"-37.79844526, 144.96411782"
432020241213,43,2024-12-13,20,39,38,77,UM2_T,"-37.79844526, 144.96411782"
45920241129,45,2024-11-29,9,212,311,523,Swa148_T,"-37.81414075, 144.96609379"
1071220250316,107,2025-03-16,12,12,13,25,280Will_T,"-37.81246271, 144.95690188"
1071020240706,107,2024-07-06,10,74,89,163,280Will_T,"-37.81246271, 144.95690188"
1241720250429,124,2025-04-29,17,4,3,7,BirBridge_T,"-37.81757416, 144.97329934"
108120231122,108,2023-11-22,1,8,1,9,261Will_T,"-37.81295822, 144.95678789"
1081220240303,108,2024-03-03,12,150,124,274,261Will_T,"-37.81295822, 144.95678789"
108720240827,108,2024-08-27,7,47,742,789,261Will_T,"-37.81295822, 144.95678789"
87620240408,87,2024-04-08,6,24,16,40,Errol23_T,"-37.80454949, 144.94921863"
50020250102,50,2025-01-02,0,11,4,15,Lyg309_T,"-37.79808192, 144.96721013"
166420250121,166,2025-01-21,4,0,2,2,Spen484_T,"-37.80896733, 144.94931703"
1621920250617,162,2025-06-17,19,200,142,342,Eli489_T,"-37.80740397, 144.95987909"
1311420250616,131,2025-06-16,14,122,106,228,King2_T,"-37.82009057, 144.95758725"
162620240912,162,2024-09-12,6,84,50,134,Eli489_T,"-37.80740397, 144.95987909"
132720240423,132,2024-04-23,7,70,55,125,King335_T,"-37.81267639, 144.95386444"
1341420240528,134,2024-05-28,14,307,280,587,Spen201_T,"-37.81694221, 144.95303935"
135720251007,135,2025-10-07,7,172,204,376,Spen161_T,"-37.8172861, 144.95319102"
35820240623,35,2024-06-23,8,294,251,545,SouthB_T,"-37.82018685, 144.96508508"
35220231214,35,2023-12-14,2,20,41,61,SouthB_T,"-37.82018685, 144.96508508"
76820231026,76,2023-10-26,8,91,46,137,KenMac_T,"-37.79453803, 144.93036194"
761820231123,76,2023-11-23,18,59,64,123,KenMac_T,"-37.79453803, 144.93036194"
27420241209,27,2024-12-09,4,1,4,5,Vic_T,"-37.80606888, 144.95644692"
30220240419,30,2024-04-19,2,57,60,117,Lon189_T,"-37.8112185, 144.96656806"
9520240613,9,2024-06-13,5,11,51,62,Col700_T,"-37.81982992, 144.95102555"
791220240730,79,2024-07-30,12,427,350,777,FliSS_T,"-37.81794046, 144.96616678"
301920250903,30,2025-09-03,19,265,351,616,Lon189_T,"-37.8112185, 144.96656806"
51520250622,51,2025-06-22,5,4,5,9,Fra118_T,"-37.80841815, 144.95906316"
191220240707,19,2024-07-07,12,624,523,1147,LtB210_T,"-37.81237202, 144.96550671"
201120241206,20,2024-12-06,11,233,146,379,LtB170_T,"-37.81172914, 144.9682466"
201020240521,20,2024-05-21,10,157,97,254,LtB170_T,"-37.81172914, 144.9682466"
1361520241029,136,2024-10-29,15,70,49,119,BirFed1120_T,"-37.8184141, 144.97357915"
136620241205,136,2024-12-05,6,91,57,148,BirFed1120_T,"-37.8184141, 144.97357915"
1422320250504,142,2025-05-04,23,4,4,8,Hammer1584_T,"-37.81970749, 144.96795734"
1301020250701,130,2025-07-01,10,74,61,135,Bou892T,"-37.8204637, 144.94126826"
1612320250310,161,2025-03-10,23,1,0,1,BirArt1109_T,"-37.81851276, 144.97131336"
491720241017,49,2024-10-17,17,258,229,487,Eli501_T,"-37.80730068, 144.95956055"
1171820250324,117,2025-03-24,18,147,188,335,Fli114F_T,"-37.81629332, 144.97090877"
109620250419,109,2025-04-19,6,14,13,27,LatWill_T,"-37.81193681, 144.95621105"
301820250118,30,2025-01-18,18,420,517,937,Lon189_T,"-37.8112185, 144.96656806"
231620240127,23,2024-01-27,16,163,277,440,Col623_T,"-37.81909256, 144.95452748"
512220240710,51,2024-07-10,22,49,38,87,Fra118_T,"-37.80841815, 144.95906316"
482220240413,48,2024-04-13,22,61,96,157,QVMQ_T,"-37.80631581, 144.95866697"
201020240727,20,2024-07-27,10,123,110,233,LtB170_T,"-37.81172914, 144.9682466"
202120231121,20,2023-11-21,21,154,345,499,LtB170_T,"-37.81172914, 144.9682466"
521720241116,52,2024-11-16,17,344,380,724,Eli263_T,"-37.81252157, 144.9619401"
462220241225,46,2024-12-25,22,2,0,2,Pel147_T,"-37.80240719, 144.9615673"
461020250628,46,2025-06-28,10,28,31,59,Pel147_T,"-37.80240719, 144.9615673"
1371720250531,137,2025-05-31,17,2,7,9,BouHbr2353_T,"-37.81894815, 144.94612292"
1361920240718,136,2024-07-18,19,64,1,65,BirFed1120_T,"-37.8184141, 144.97357915"
142720250512,142,2025-05-12,7,169,220,389,Hammer1584_T,"-37.81970749, 144.96795734"
130420250528,130,2025-05-28,4,0,1,1,Bou892T,"-37.8204637, 144.94126826"
1301120250721,130,2025-07-21,11,47,28,75,Bou892T,"-37.8204637, 144.94126826"
130820250311,130,2025-03-11,8,21,21,42,Bou892T,"-37.8204637, 144.94126826"
1071620231207,107,2023-12-07,16,199,146,345,280Will_T,"-37.81246271, 144.95690188"
1082120240706,108,2024-07-06,21,16,98,114,261Will_T,"-37.81295822, 144.95678789"
61520240621,61,2024-06-21,5,13,25,38,RMIT14_T,"-37.80767455, 144.96309114"
501120250329,50,2025-03-29,11,215,335,550,Lyg309_T,"-37.79808192, 144.96721013"
1791320250513,179,2025-05-13,13,43,53,96,Pow61_T,"-37.82392385, 144.96299677"
179620250705,179,2025-07-05,6,5,3,8,Pow61_T,"-37.82392385, 144.96299677"
167320250415,167,2025-04-15,3,0,2,2,Lat526_T,"-37.81304149, 144.95155955"
1672020250809,167,2025-08-09,20,9,15,24,Lat526_T,"-37.81304149, 144.95155955"
131220250604,131,2025-06-04,2,3,6,9,King2_T,"-37.82009057, 144.95758725"
143720250104,143,2025-01-04,7,42,48,90,Spencer_T,"-37.821728, 144.95557015"
1322120240423,132,2024-04-23,21,85,71,156,King335_T,"-37.81267639, 144.95386444"
1321120241107,132,2024-11-07,11,166,110,276,King335_T,"-37.81267639, 144.95386444"
1321720231027,132,2023-10-27,17,214,151,365,King335_T,"-37.81267639, 144.95386444"
131020240509,131,2024-05-09,0,14,26,40,King2_T,"-37.82009057, 144.95758725"
1351520231207,135,2023-12-07,15,483,501,984,Spen161_T,"-37.8172861, 144.95319102"
1331020240113,133,2024-01-13,10,386,426,812,Spen229_T,"-37.81531435, 144.95227769"
124720251012,124,2025-10-12,7,5,5,10,BirBridge_T,"-37.81757416, 144.97329934"
1071520250728,107,2025-07-28,15,95,75,170,280Will_T,"-37.81246271, 144.95690188"
631720250314,63,2025-03-14,17,592,471,1063,Bou231_T,"-37.81333081, 144.96675571"
622020231129,62,2023-11-29,20,202,175,377,Lat224_T,"-37.80996494, 144.96216521"
621920250331,62,2025-03-31,19,253,210,463,Lat224_T,"-37.80996494, 144.96216521"
862020240216,86,2024-02-16,20,45,66,111,574Qub_T,"-37.80309992, 144.94908064"
11820231202,11,2023-12-02,8,5,8,13,WatCit_T,"-37.81564989, 144.93970694"
122320231124,12,2023-11-24,23,94,55,149,NewQ_T,"-37.81457988, 144.94292398"
102320240222,10,2024-02-22,23,3,5,8,BouHbr_T,"-37.81876474, 144.94710545"
721920240609,72,2024-06-09,19,158,274,432,ACMI_T,"-37.81726338, 144.96872809"
721820250223,72,2025-02-23,18,163,134,297,ACMI_T,"-37.81726338, 144.96872809"
102120250824,10,2025-08-24,21,27,39,66,BouHbr_T,"-37.81876474, 144.94710545"
761120240823,76,2024-08-23,11,57,52,109,KenMac_T,"-37.79453803, 144.93036194"
2220240410,2,2024-04-10,2,1,7,8,Bou283_T,"-37.81380668, 144.96516718"
9720240912,9,2024-09-12,7,73,1203,1276,Col700_T,"-37.81982992, 144.95102555"
108220231031,108,2023-10-31,2,10,8,18,261Will_T,"-37.81295822, 144.95678789"
661520250507,66,2025-05-07,15,1210,1273,2483,QVN_T,"-37.81057846, 144.96444294"
841420240501,84,2024-05-01,14,837,1088,1925,ElFi_T,"-37.81798049, 144.96503383"
41020241206,4,2024-12-06,10,1291,751,2042,Swa123_T,"-37.81487988, 144.9660878"
3120240705,3,2024-07-05,1,86,90,176,Swa295_T,"-37.81101524, 144.96429485"
751820240123,75,2024-01-23,18,71,179,250,SprFli_T,"-37.81515276, 144.97467661"
392320250921,39,2025-09-21,23,0,1,1,AlfPl_T,"-37.81379749, 144.96995745"
81520250729,8,2025-07-29,15,152,280,432,WebBN_T,"-37.82293543, 144.9471751"
41120240727,41,2024-07-27,1,65,56,121,Swa31,"-37.81668634, 144.96689733"
42720240603,42,2024-06-03,7,28,35,63,UM1_T,"-37.80008566, 144.96386412"
78620250727,78,2025-07-27,6,2,0,2,HarEsB_T,"-37.81471642, 144.9446508"
711520250602,71,2025-06-02,15,5,7,12,WestWP_T,"-37.81235775, 144.97136962"
282120240314,28,2024-03-14,21,903,233,1136,VAC_T,"-37.82129925, 144.96879309"
14320240629,14,2024-06-29,3,34,12,46,SanBri_T,"-37.82011242, 144.96291897"
541120241125,54,2024-11-25,11,52,52,104,Swa607_T,"-37.804024, 144.96308399"
54720240107,54,2024-01-07,7,14,17,31,Swa607_T,"-37.804024, 144.96308399"
5720241204,5,2024-12-04,7,223,456,679,PriNW_T,"-37.81874249, 144.96787656"
211620241022,21,2024-10-22,16,260,299,559,Bourke155_T,"-37.81267313, 144.96788288"
87120240530,87,2024-05-30,1,4,4,8,Errol23_T,"-37.80454949, 144.94921863"
61820250718,61,2025-07-18,8,281,258,539,RMIT14_T,"-37.80767455, 144.96309114"
441520240926,44,2024-09-26,15,88,50,138,UM3_T,"-37.79698741, 144.96441306"
1401020240911,140,2024-09-11,10,139,39,178,Boyd2837_T,"-37.82590962, 144.96185972"
1621520250712,162,2025-07-12,15,466,1077,1543,Eli489_T,"-37.80740397, 144.95987909"
162820250113,162,2025-01-13,8,158,166,324,Eli489_T,"-37.80740397, 144.95987909"
132720250208,132,2025-02-08,7,42,25,67,King335_T,"-37.81267639, 144.95386444"
134920241117,134,2024-11-17,9,360,428,788,Spen201_T,"-37.81694221, 144.95303935"
1351920250716,135,2025-07-16,19,140,173,313,Spen161_T,"-37.8172861, 144.95319102"
1181520240907,118,2024-09-07,15,17,15,32,Fli114C_T,"-37.81632783, 144.97090512"
671120240906,67,2024-09-06,11,429,514,943,FLDegS_T,"-37.81688755, 144.96562569"
671020240319,67,2024-03-19,10,314,428,742,FLDegS_T,"-37.81688755, 144.96562569"
181920240110,18,2024-01-10,19,89,30,119,Col12_T,"-37.81344862, 144.97305353"
562220240818,56,2024-08-18,22,96,118,214,Lon364_T,"-37.81234775, 144.96153311"
861720250507,86,2025-05-07,17,39,74,113,574Qub_T,"-37.80309992, 144.94908064"
12320240328,12,2024-03-28,3,3,3,6,NewQ_T,"-37.81457988, 144.94292398"
21420240407,2,2024-04-07,14,1002,917,1919,Bou283_T,"-37.81380668, 144.96516718"
532120250524,53,2025-05-24,21,146,205,351,Col254_T,"-37.81564191, 144.965499"
631120250123,63,2025-01-23,11,311,323,634,Bou231_T,"-37.81333081, 144.96675571"
861720240722,86,2024-07-22,17,37,78,115,574Qub_T,"-37.80309992, 144.94908064"
61720231224,6,2023-12-24,17,1063,1039,2102,FliS_T,"-37.81911705, 144.96558255"
84020251009,84,2025-10-09,0,55,73,128,ElFi_T,"-37.81798049, 144.96503383"
66420240226,66,2024-02-26,4,9,15,24,QVN_T,"-37.81057846, 144.96444294"
41620240910,4,2024-09-10,16,1134,1032,2166,Swa123_T,"-37.81487988, 144.9660878"
32120240515,3,2024-05-15,21,750,610,1360,Swa295_T,"-37.81101524, 144.96429485"
3020240930,3,2024-09-30,0,44,38,82,Swa295_T,"-37.81101524, 144.96429485"
3220241003,3,2024-10-03,2,6,11,17,Swa295_T,"-37.81101524, 144.96429485"
3620240125,3,2024-01-25,6,36,86,122,Swa295_T,"-37.81101524, 144.96429485"
32020240309,3,2024-03-09,20,1316,1379,2695,Swa295_T,"-37.81101524, 144.96429485"
39120241122,39,2024-11-22,1,0,2,2,AlfPl_T,"-37.81379749, 144.96995745"
8620231022,8,2023-10-22,6,4,16,20,WebBN_T,"-37.82293543, 144.9471751"
411420240606,41,2024-06-06,14,1182,1328,2510,Swa31,"-37.81668634, 144.96689733"
772020250419,77,2025-04-19,20,177,155,332,HarEsP_T,"-37.81441438, 144.94433026"
77820250810,77,2025-08-10,8,90,101,191,HarEsP_T,"-37.81441438, 144.94433026"
422120240616,42,2024-06-16,21,29,38,67,UM1_T,"-37.80008566, 144.96386412"
42920240621,42,2024-06-21,9,86,71,157,UM1_T,"-37.80008566, 144.96386412"
292020250626,29,2025-06-26,20,73,63,136,AG_T,"-37.8199817, 144.96872865"
29120240525,29,2024-05-25,1,16,23,39,AG_T,"-37.8199817, 144.96872865"
14620241217,14,2024-12-17,6,85,119,204,SanBri_T,"-37.82011242, 144.96291897"
71720251007,71,2025-10-07,7,9,7,16,WestWP_T,"-37.81235775, 144.97136962"
71120241024,71,2024-10-24,1,4,3,7,WestWP_T,"-37.81235775, 144.97136962"
54520240603,54,2024-06-03,5,8,12,20,Swa607_T,"-37.804024, 144.96308399"
21320240827,21,2024-08-27,3,6,0,6,Bourke155_T,"-37.81267313, 144.96788288"
371520240130,37,2024-01-30,15,76,108,184,Lyg260_T,"-37.80107122, 144.96704554"
43420240409,43,2024-04-09,4,0,1,1,UM2_T,"-37.79844526, 144.96411782"
43620250401,43,2025-04-01,6,16,18,34,UM2_T,"-37.79844526, 144.96411782"
45620241024,45,2024-10-24,6,53,49,102,Swa148_T,"-37.81414075, 144.96609379"
51320241223,5,2024-12-23,13,1241,1601,2842,PriNW_T,"-37.81874249, 144.96787656"
133720240420,133,2024-04-20,7,26,48,74,Spen229_T,"-37.81531435, 144.95227769"
1332120240516,133,2024-05-16,21,298,210,508,Spen229_T,"-37.81531435, 144.95227769"
1331020241028,133,2024-10-28,10,378,388,766,Spen229_T,"-37.81531435, 144.95227769"
108320250831,108,2025-08-31,3,24,14,38,261Will_T,"-37.81295822, 144.95678789"
108520231107,108,2023-11-07,5,9,13,22,261Will_T,"-37.81295822, 144.95678789"
871720240316,87,2024-03-16,17,141,92,233,Errol23_T,"-37.80454949, 144.94921863"
611120240426,61,2024-04-26,11,374,592,966,RMIT14_T,"-37.80767455, 144.96309114"
501520240309,50,2024-03-09,15,165,153,318,Lyg309_T,"-37.79808192, 144.96721013"
185120250927,185,2025-09-27,1,107,77,184,Eli197_T,"-37.81374643, 144.96276183"
1791120250428,179,2025-04-28,11,59,41,100,Pow61_T,"-37.82392385, 144.96299677"
179520250528,179,2025-05-28,5,1,2,3,Pow61_T,"-37.82392385, 144.96299677"
1672020241117,167,2024-11-17,20,14,43,57,Lat526_T,"-37.81304149, 144.95155955"
1431620241116,143,2024-11-16,16,268,356,624,Spencer_T,"-37.821728, 144.95557015"
1321020241018,132,2024-10-18,10,56,38,94,King335_T,"-37.81267639, 144.95386444"
134620250818,134,2025-08-18,6,153,119,272,Spen201_T,"-37.81694221, 144.95303935"
135320241030,135,2024-10-30,3,31,14,45,Spen161_T,"-37.8172861, 144.95319102"
1351820241228,135,2024-12-28,18,365,319,684,Spen161_T,"-37.8172861, 144.95319102"
85420231025,85,2023-10-25,4,4,4,8,488Mac_T,"-37.79432415, 144.92973378"
18720240911,18,2024-09-11,7,38,372,410,Col12_T,"-37.81344862, 144.97305353"
672320250712,67,2025-07-12,23,114,164,278,FLDegS_T,"-37.81688755, 144.96562569"
56120231127,56,2023-11-27,1,15,30,45,Lon364_T,"-37.81234775, 144.96153311"
56020231219,56,2023-12-19,0,12,32,44,Lon364_T,"-37.81234775, 144.96153311"
92320241212,9,2024-12-12,23,39,29,68,Col700_T,"-37.81982992, 144.95102555"
53620250217,53,2025-02-17,6,25,33,58,Col254_T,"-37.81564191, 144.965499"
91620250124,9,2025-01-24,16,1045,129,1174,Col700_T,"-37.81982992, 144.95102555"
91920250605,9,2025-06-05,19,240,235,475,Col700_T,"-37.81982992, 144.95102555"
23720250324,23,2025-03-24,7,271,167,438,Col623_T,"-37.81909256, 144.95452748"
51020250125,51,2025-01-25,0,13,14,27,Fra118_T,"-37.80841815, 144.95906316"
231720240831,23,2024-08-31,17,136,209,345,Col623_T,"-37.81909256, 144.95452748"
48720231020,48,2023-10-20,7,85,56,141,QVMQ_T,"-37.80631581, 144.95866697"
48420231026,48,2023-10-26,4,5,1,6,QVMQ_T,"-37.80631581, 144.95866697"
202120250710,20,2025-07-10,21,159,421,580,LtB170_T,"-37.81172914, 144.9682466"
201720250919,20,2025-09-19,17,487,302,789,LtB170_T,"-37.81172914, 144.9682466"
521120250726,52,2025-07-26,11,354,240,594,Eli263_T,"-37.81252157, 144.9619401"
52920241217,52,2024-12-17,9,142,200,342,Eli263_T,"-37.81252157, 144.9619401"
1411020250529,141,2025-05-29,10,142,105,247,474Fl_T,"-37.81997273, 144.95834911"
139820251005,139,2025-10-05,8,17,14,31,Signal1647_T,"-37.81959923, 144.9632832"
1171720250717,117,2025-07-17,17,214,525,739,Fli114F_T,"-37.81629332, 144.97090877"
109120231215,109,2023-12-15,1,10,11,21,LatWill_T,"-37.81193681, 144.95621105"
1801520250627,180,2025-06-27,15,30,41,71,Mac330_T,"-37.79497059, 144.93530329"
692120250822,69,2025-08-22,21,55,54,109,FLDegC_T,"-37.81687226, 144.96559144"
61020250419,6,2025-04-19,10,653,500,1153,FliS_T,"-37.81911705, 144.96558255"
6020250516,6,2025-05-16,0,86,55,141,FliS_T,"-37.81911705, 144.96558255"
842020231130,84,2023-11-30,20,637,1049,1686,ElFi_T,"-37.81798049, 144.96503383"
841220241128,84,2024-11-28,12,1175,1233,2408,ElFi_T,"-37.81798049, 144.96503383"
41520240425,4,2024-04-25,15,1616,1479,3095,Swa123_T,"-37.81487988, 144.9660878"
701820250329,70,2025-03-29,18,160,300,460,Errol20_T,"-37.80456984, 144.94946228"
4920231023,4,2023-10-23,9,727,357,1084,Swa123_T,"-37.81487988, 144.9660878"
3620240420,3,2024-04-20,6,33,54,87,Swa295_T,"-37.81101524, 144.96429485"
751120241229,75,2024-12-29,11,34,60,94,SprFli_T,"-37.81515276, 144.97467661"
391820240429,39,2024-04-29,18,58,42,100,AlfPl_T,"-37.81379749, 144.96995745"
781420250611,78,2025-06-11,14,22,51,73,HarEsB_T,"-37.81471642, 144.9446508"
78920240331,78,2024-03-31,9,72,57,129,HarEsB_T,"-37.81471642, 144.9446508"
14420250511,14,2025-05-11,4,24,6,30,SanBri_T,"-37.82011242, 144.96291897"
712120241209,71,2024-12-09,21,1,3,4,WestWP_T,"-37.81235775, 144.97136962"
711820250701,71,2025-07-01,18,10,10,20,WestWP_T,"-37.81235775, 144.97136962"
651620231101,65,2023-11-01,16,363,666,1029,SwaCs_T,"-37.81569416, 144.9668064"
651420240210,65,2024-02-10,14,581,961,1542,SwaCs_T,"-37.81569416, 144.9668064"
541720240610,54,2024-06-10,17,148,197,345,Swa607_T,"-37.804024, 144.96308399"
54220240611,54,2024-06-11,2,11,6,17,Swa607_T,"-37.804024, 144.96308399"
281320240318,28,2024-03-18,13,676,671,1347,VAC_T,"-37.82129925, 144.96879309"
401820231223,40,2023-12-23,18,84,128,212,Spr201_T,"-37.80999341, 144.97227587"
372320250302,37,2025-03-02,23,14,10,24,Lyg260_T,"-37.80107122, 144.96704554"
472320240428,47,2024-04-28,23,130,118,248,Eli250_T,"-37.81258467, 144.9625775"
45420241113,45,2024-11-13,4,1,16,17,Swa148_T,"-37.81414075, 144.96609379"
1081820250905,108,2025-09-05,18,429,206,635,261Will_T,"-37.81295822, 144.95678789"
108120240421,108,2024-04-21,1,5,22,27,261Will_T,"-37.81295822, 144.95678789"
1081420250714,108,2025-07-14,14,351,212,563,261Will_T,"-37.81295822, 144.95678789"
441220251012,44,2025-10-12,12,64,56,120,UM3_T,"-37.79698741, 144.96441306"
1791720250721,179,2025-07-21,17,93,85,178,Pow61_T,"-37.82392385, 144.96299677"
1651320250903,165,2025-09-03,13,46,34,80,Spen475_T,"-37.80953359, 144.94939004"
1661220250316,166,2025-03-16,12,14,9,23,Spen484_T,"-37.80896733, 144.94931703"
1671320241221,167,2024-12-21,13,9,12,21,Lat526_T,"-37.81304149, 144.95155955"
1401320240527,140,2024-05-27,13,90,68,158,Boyd2837_T,"-37.82590962, 144.96185972"
1401020251004,140,2025-10-04,10,164,68,232,Boyd2837_T,"-37.82590962, 144.96185972"
1321820231202,132,2023-12-02,18,114,119,233,King335_T,"-37.81267639, 144.95386444"
134120250823,134,2025-08-23,1,88,69,157,Spen201_T,"-37.81694221, 144.95303935"
134520240214,134,2024-02-14,5,35,48,83,Spen201_T,"-37.81694221, 144.95303935"
134520240729,134,2024-07-29,5,21,16,37,Spen201_T,"-37.81694221, 144.95303935"
1181720250311,118,2025-03-11,17,22,56,78,Fli114C_T,"-37.81632783, 144.97090512"
1072020240110,107,2024-01-10,20,107,115,222,280Will_T,"-37.81246271, 144.95690188"
67420240128,67,2024-01-28,4,11,5,16,FLDegS_T,"-37.81688755, 144.96562569"
511320241106,51,2024-11-06,13,67,78,145,Fra118_T,"-37.80841815, 144.95906316"
512020240409,51,2024-04-09,20,53,60,113,Fra118_T,"-37.80841815, 144.95906316"
251020241030,25,2024-10-30,10,192,597,789,MCEC_T,"-37.82401776, 144.95604426"
481720240310,48,2024-03-10,17,97,94,191,QVMQ_T,"-37.80631581, 144.95866697"
482220231030,48,2023-10-30,22,34,40,74,QVMQ_T,"-37.80631581, 144.95866697"
482020240112,48,2024-01-12,20,97,131,228,QVMQ_T,"-37.80631581, 144.95866697"
1411920250210,141,2025-02-10,19,85,94,179,474Fl_T,"-37.81997273, 144.95834911"
1372020250527,137,2025-05-27,20,2,4,6,BouHbr2353_T,"-37.81894815, 144.94612292"
137920240105,137,2024-01-05,9,17,10,27,BouHbr2353_T,"-37.81894815, 144.94612292"
1301320250803,130,2025-08-03,13,77,30,107,Bou892T,"-37.8204637, 144.94126826"
1381720240907,138,2024-09-07,17,9,4,13,EntPark1671_T,"-37.81996544, 144.95981454"
109320250609,109,2025-06-09,3,19,7,26,LatWill_T,"-37.81193681, 144.95621105"
661720250625,66,2025-06-25,17,824,836,1660,QVN_T,"-37.81057846, 144.96444294"
662020250829,66,2025-08-29,20,1220,989,2209,QVN_T,"-37.81057846, 144.96444294"
84320241218,84,2024-12-18,3,21,11,32,ElFi_T,"-37.81798049, 144.96503383"
391520250118,39,2025-01-18,15,48,55,103,AlfPl_T,"-37.81379749, 144.96995745"
391720231105,39,2023-11-05,17,55,41,96,AlfPl_T,"-37.81379749, 144.96995745"
411920250922,41,2025-09-22,19,494,953,1447,Swa31,"-37.81668634, 144.96689733"
78620240409,78,2024-04-09,6,2,11,13,HarEsB_T,"-37.81471642, 144.9446508"
42120250829,42,2025-08-29,1,4,5,9,UM1_T,"-37.80008566, 144.96386412"
771720240428,77,2024-04-28,17,349,261,610,HarEsP_T,"-37.81441438, 144.94433026"
77520241112,77,2024-11-12,5,5,12,17,HarEsP_T,"-37.81441438, 144.94433026"
781920250211,78,2025-02-11,19,27,52,79,HarEsB_T,"-37.81471642, 144.9446508"
141720250130,14,2025-01-30,17,1003,239,1242,SanBri_T,"-37.82011242, 144.96291897"
14020250407,14,2025-04-07,0,23,7,30,SanBri_T,"-37.82011242, 144.96291897"
14320250914,14,2025-09-14,3,18,9,27,SanBri_T,"-37.82011242, 144.96291897"
311020241122,31,2024-11-22,10,74,74,148,Lyg161_T,"-37.80169681, 144.96658911"
311820250922,31,2025-09-22,18,167,118,285,Lyg161_T,"-37.80169681, 144.96658911"
541220240430,54,2024-04-30,12,223,244,467,Swa607_T,"-37.804024, 144.96308399"
54220241109,54,2024-11-09,2,22,15,37,Swa607_T,"-37.804024, 144.96308399"
472220240901,47,2024-09-01,22,240,206,446,Eli250_T,"-37.81258467, 144.9625775"
40520240825,40,2024-08-25,5,5,5,10,Spr201_T,"-37.80999341, 144.97227587"
5220251007,5,2025-10-07,2,18,16,34,PriNW_T,"-37.81874249, 144.96787656"
361920241220,36,2024-12-20,19,201,171,372,Que85_T,"-37.81652527, 144.96121062"
872320250717,87,2025-07-17,23,9,9,18,Errol23_T,"-37.80454949, 144.94921863"
872220250914,87,2025-09-14,22,8,17,25,Errol23_T,"-37.80454949, 144.94921863"
1081720240221,108,2024-02-21,17,1878,223,2101,261Will_T,"-37.81295822, 144.95678789"
61220240921,61,2024-09-21,2,46,12,58,RMIT14_T,"-37.80767455, 144.96309114"
502220240726,50,2024-07-26,22,184,69,253,Lyg309_T,"-37.79808192, 144.96721013"
441020240624,44,2024-06-24,10,49,54,103,UM3_T,"-37.79698741, 144.96441306"
432120241005,43,2024-10-05,21,27,36,63,UM2_T,"-37.79844526, 144.96411782"
184220250815,184,2025-08-15,2,19,18,37,Eli124_T,"-37.81512416, 144.96371988"
166120250209,166,2025-02-09,1,4,1,5,Spen484_T,"-37.80896733, 144.94931703"
166720250825,166,2025-08-25,7,8,12,20,Spen484_T,"-37.80896733, 144.94931703"
1671620250526,167,2025-05-26,16,65,114,179,Lat526_T,"-37.81304149, 144.95155955"
162620250812,162,2025-08-12,6,40,36,76,Eli489_T,"-37.80740397, 144.95987909"
1431620250713,143,2025-07-13,16,137,197,334,Spencer_T,"-37.821728, 144.95557015"
143320240908,143,2024-09-08,3,58,17,75,Spencer_T,"-37.821728, 144.95557015"
132620250127,132,2025-01-27,6,8,12,20,King335_T,"-37.81267639, 144.95386444"
135420240529,135,2024-05-29,4,10,9,19,Spen161_T,"-37.8172861, 144.95319102"
171120240825,17,2024-08-25,11,113,72,185,Col15_T,"-37.81362543, 144.97323591"
12020231111,1,2023-11-11,20,614,441,1055,Bou292_T,"-37.81349441, 144.96515323"
172220250211,17,2025-02-11,22,59,48,107,Col15_T,"-37.81362543, 144.97323591"
631920231114,63,2023-11-14,19,184,267,451,Bou231_T,"-37.81333081, 144.96675571"
62220250513,62,2025-05-13,2,17,14,31,Lat224_T,"-37.80996494, 144.96216521"
561320231028,56,2023-10-28,13,299,221,520,Lon364_T,"-37.81234775, 144.96153311"
862320250414,86,2025-04-14,23,2,6,8,574Qub_T,"-37.80309992, 144.94908064"
10520240221,10,2024-02-21,5,5,1,6,BouHbr_T,"-37.81876474, 144.94710545"
76220250120,76,2025-01-20,2,0,1,1,KenMac_T,"-37.79453803, 144.93036194"
22120241130,2,2024-11-30,21,353,279,632,Bou283_T,"-37.81380668, 144.96516718"
53120240314,53,2024-03-14,1,9,11,20,Col254_T,"-37.81564191, 144.965499"
9020250812,9,2025-08-12,0,7,15,22,Col700_T,"-37.81982992, 144.95102555"
461220241024,46,2024-10-24,12,165,127,292,Pel147_T,"-37.80240719, 144.9615673"
461820240324,46,2024-03-24,18,60,66,126,Pel147_T,"-37.80240719, 144.9615673"
1392320240907,139,2024-09-07,23,19,36,55,Signal1647_T,"-37.81959923, 144.9632832"
1392220241021,139,2024-10-21,22,4,10,14,Signal1647_T,"-37.81959923, 144.9632832"
142320240107,142,2024-01-07,3,4,8,12,Hammer1584_T,"-37.81970749, 144.96795734"
142420240201,142,2024-02-01,4,3,1,4,Hammer1584_T,"-37.81970749, 144.96795734"
1422020240502,142,2024-05-02,20,122,86,208,Hammer1584_T,"-37.81970749, 144.96795734"
1422320241204,142,2024-12-04,23,8,3,11,Hammer1584_T,"-37.81970749, 144.96795734"
1421420250927,142,2025-09-27,14,817,441,1258,Hammer1584_T,"-37.81970749, 144.96795734"
130720251007,130,2025-10-07,7,16,5,21,Bou892T,"-37.8204637, 144.94126826"
164520250116,164,2025-01-16,5,3,5,8,Lat526_T,"-37.813005, 144.95160411"
1091820250930,109,2025-09-30,18,188,98,286,LatWill_T,"-37.81193681, 144.95621105"
1092120241105,109,2024-11-05,21,53,74,127,LatWill_T,"-37.81193681, 144.95621105"
49120250808,49,2025-08-08,1,45,40,85,Eli501_T,"-37.80730068, 144.95956055"
192220240531,19,2024-05-31,22,368,609,977,LtB210_T,"-37.81237202, 144.96550671"
6320240723,6,2024-07-23,3,11,8,19,FliS_T,"-37.81911705, 144.96558255"
84820240109,84,2024-01-09,8,1317,527,1844,ElFi_T,"-37.81798049, 144.96503383"
841520240414,84,2024-04-14,15,871,1417,2288,ElFi_T,"-37.81798049, 144.96503383"
841420250606,84,2025-06-06,14,828,1199,2027,ElFi_T,"-37.81798049, 144.96503383"
4420240518,4,2024-05-18,4,27,15,42,Swa123_T,"-37.81487988, 144.9660878"
31920231022,3,2023-10-22,19,809,981,1790,Swa295_T,"-37.81101524, 144.96429485"
42220240619,4,2024-06-19,22,158,189,347,Swa123_T,"-37.81487988, 144.9660878"
4120241104,4,2024-11-04,1,50,25,75,Swa123_T,"-37.81487988, 144.9660878"
70220250917,70,2025-09-17,2,0,2,2,Errol20_T,"-37.80456984, 144.94946228"
31020240821,3,2024-08-21,10,447,536,983,Swa295_T,"-37.81101524, 144.96429485"
31720241004,3,2024-10-04,17,1306,1313,2619,Swa295_T,"-37.81101524, 144.96429485"
75020250817,75,2025-08-17,0,0,5,5,SprFli_T,"-37.81515276, 144.97467661"
8720240402,8,2024-04-02,7,122,75,197,WebBN_T,"-37.82293543, 144.9471751"
771920240218,77,2024-02-18,19,208,149,357,HarEsP_T,"-37.81441438, 144.94433026"
78220240509,78,2024-05-09,2,0,1,1,HarEsB_T,"-37.81471642, 144.9446508"
141520250321,14,2025-03-21,15,560,132,692,SanBri_T,"-37.82011242, 144.96291897"
712320250726,71,2025-07-26,23,5,4,9,WestWP_T,"-37.81235775, 144.97136962"
711920240530,71,2024-05-30,19,14,13,27,WestWP_T,"-37.81235775, 144.97136962"
651020240101,65,2024-01-01,10,143,210,353,SwaCs_T,"-37.81569416, 144.9668064"
281020231027,28,2023-10-27,10,358,228,586,VAC_T,"-37.82129925, 144.96879309"
291620250523,29,2025-05-23,16,105,150,255,AG_T,"-37.8199817, 144.96872865"
402020240914,40,2024-09-14,20,82,86,168,Spr201_T,"-37.80999341, 144.97227587"
541620240713,54,2024-07-13,16,127,172,299,Swa607_T,"-37.804024, 144.96308399"
5320240905,5,2024-09-05,3,14,7,21,PriNW_T,"-37.81874249, 144.96787656"
21220231204,21,2023-12-04,2,22,27,49,Bourke155_T,"-37.81267313, 144.96788288"
108720240217,108,2024-02-17,7,35,43,78,261Will_T,"-37.81295822, 144.95678789"
871420240518,87,2024-05-18,14,134,108,242,Errol23_T,"-37.80454949, 144.94921863"
111820231217,11,2023-12-17,18,190,198,388,WatCit_T,"-37.81564989, 144.93970694"
72320240312,72,2024-03-12,3,3,6,9,ACMI_T,"-37.81726338, 144.96872809"
351720250524,35,2025-05-24,17,1163,1534,2697,SouthB_T,"-37.82018685, 144.96508508"
21520250606,2,2025-06-06,15,595,519,1114,Bou283_T,"-37.81380668, 144.96516718"
21620250621,2,2025-06-21,16,905,834,1739,Bou283_T,"-37.81380668, 144.96516718"
21120240913,2,2024-09-13,11,368,402,770,Bou283_T,"-37.81380668, 144.96516718"
53120241215,53,2024-12-15,1,31,59,90,Col254_T,"-37.81564191, 144.965499"
23120240102,23,2024-01-02,1,17,14,31,Col623_T,"-37.81909256, 144.95452748"
52320250508,52,2025-05-08,3,4,3,7,Eli263_T,"-37.81252157, 144.9619401"
521020240518,52,2024-05-18,10,194,129,323,Eli263_T,"-37.81252157, 144.9619401"
461520241016,46,2024-10-16,15,128,147,275,Pel147_T,"-37.80240719, 144.9615673"
511020240923,51,2024-09-23,10,107,83,190,Fra118_T,"-37.80841815, 144.95906316"
191620231019,19,2023-10-19,16,467,392,859,LtB210_T,"-37.81237202, 144.96550671"
491020250606,49,2025-06-06,10,319,357,676,Eli501_T,"-37.80730068, 144.95956055"
1412120241119,141,2024-11-19,21,52,103,155,474Fl_T,"-37.81997273, 144.95834911"
1411720250211,141,2025-02-11,17,173,150,323,474Fl_T,"-37.81997273, 144.95834911"
1371120250808,137,2025-08-08,11,32,51,83,BouHbr2353_T,"-37.81894815, 144.94612292"
1411520240310,141,2024-03-10,15,177,147,324,474Fl_T,"-37.81997273, 144.95834911"
1411120240314,141,2024-03-14,11,122,119,241,474Fl_T,"-37.81997273, 144.95834911"
139720240926,139,2024-09-26,7,17,114,131,Signal1647_T,"-37.81959923, 144.9632832"
1231620241207,123,2024-12-07,16,4,3,7,BirBridge_T,"-37.81753741, 144.97329734"
138820241121,138,2024-11-21,8,3,9,12,EntPark1671_T,"-37.81996544, 144.95981454"
109320250315,109,2025-03-15,3,10,14,24,LatWill_T,"-37.81193681, 144.95621105"
1181920240330,118,2024-03-30,19,17,13,30,Fli114C_T,"-37.81632783, 144.97090512"
61020240613,61,2024-06-13,0,52,26,78,RMIT14_T,"-37.80767455, 144.96309114"
50220241204,50,2024-12-04,2,3,2,5,Lyg309_T,"-37.79808192, 144.96721013"
50420250301,50,2025-03-01,4,4,1,5,Lyg309_T,"-37.79808192, 144.96721013"
179220250427,179,2025-04-27,2,5,19,24,Pow61_T,"-37.82392385, 144.96299677"
1671520241117,167,2024-11-17,15,15,48,63,Lat526_T,"-37.81304149, 144.95155955"
1321520240124,132,2024-01-24,15,118,90,208,King335_T,"-37.81267639, 144.95386444"
692320241029,69,2024-10-29,23,2,2,4,FLDegC_T,"-37.81687226, 144.96559144"
41520240923,4,2024-09-23,15,1231,1298,2529,Swa123_T,"-37.81487988, 144.9660878"
41820241202,4,2024-12-02,18,1289,1185,2474,Swa123_T,"-37.81487988, 144.9660878"
70220240101,70,2024-01-01,2,5,16,21,Errol20_T,"-37.80456984, 144.94946228"
3720250107,3,2025-01-07,7,63,110,173,Swa295_T,"-37.81101524, 144.96429485"
391320240906,39,2024-09-06,13,132,171,303,AlfPl_T,"-37.81379749, 144.96995745"
391820250520,39,2025-05-20,18,61,54,115,AlfPl_T,"-37.81379749, 144.96995745"
411920250717,41,2025-07-17,19,722,1042,1764,Swa31,"-37.81668634, 144.96689733"
65720240223,65,2024-02-23,7,194,78,272,SwaCs_T,"-37.81569416, 144.9668064"
29120231228,29,2023-12-28,1,11,12,23,AG_T,"-37.8199817, 144.96872865"
14120241113,14,2024-11-13,1,16,4,20,SanBri_T,"-37.82011242, 144.96291897"
54020240831,54,2024-08-31,0,59,48,107,Swa607_T,"-37.804024, 144.96308399"
542220231109,54,2023-11-09,22,129,150,279,Swa607_T,"-37.804024, 144.96308399"
542320250623,54,2025-06-23,23,21,38,59,Swa607_T,"-37.804024, 144.96308399"
18820231222,18,2023-12-22,8,57,436,493,Col12_T,"-37.81344862, 144.97305353"
63520240711,63,2024-07-11,5,7,10,17,Bou231_T,"-37.81333081, 144.96675571"
68820250612,68,2025-06-12,8,193,157,350,FLDegN_T,"-37.8168479, 144.96559789"
11320251009,1,2025-10-09,13,1462,1344,2806,Bou292_T,"-37.81349441, 144.96515323"
622320240717,62,2024-07-17,23,90,54,144,Lat224_T,"-37.80996494, 144.96216521"
862120231209,86,2023-12-09,21,1,10,11,574Qub_T,"-37.80309992, 144.94908064"
861820250627,86,2025-06-27,18,39,49,88,574Qub_T,"-37.80309992, 144.94908064"
121820240526,12,2024-05-26,18,186,191,377,NewQ_T,"-37.81457988, 144.94292398"
121720251013,12,2025-10-13,17,200,277,477,NewQ_T,"-37.81457988, 144.94292398"
762020240707,76,2024-07-07,20,5,7,12,KenMac_T,"-37.79453803, 144.93036194"
72320250515,72,2025-05-15,3,1,2,3,ACMI_T,"-37.81726338, 144.96872809"
22320240317,2,2024-03-17,23,23,80,103,Bou283_T,"-37.81380668, 144.96516718"
2920240412,2,2024-04-12,9,180,302,482,Bou283_T,"-37.81380668, 144.96516718"
35020250621,35,2025-06-21,0,142,148,290,SouthB_T,"-37.82018685, 144.96508508"
91220231102,9,2023-11-02,12,664,614,1278,Col700_T,"-37.81982992, 144.95102555"
791820240206,79,2024-02-06,18,614,393,1007,FliSS_T,"-37.81794046, 144.96616678"
91520241118,9,2024-11-18,15,866,184,1050,Col700_T,"-37.81982992, 144.95102555"
9320241214,9,2024-12-14,3,5,18,23,Col700_T,"-37.81982992, 144.95102555"
92020250730,9,2025-07-30,20,93,52,145,Col700_T,"-37.81982992, 144.95102555"
30420240825,30,2024-08-25,4,91,129,220,Lon189_T,"-37.8112185, 144.96656806"
301120231121,30,2023-11-21,11,146,224,370,Lon189_T,"-37.8112185, 144.96656806"
52920240426,52,2024-04-26,9,145,193,338,Eli263_T,"-37.81252157, 144.9619401"
19620250809,19,2025-08-09,6,8,7,15,LtB210_T,"-37.81237202, 144.96550671"
141020250125,141,2025-01-25,0,89,89,178,474Fl_T,"-37.81997273, 144.95834911"
1301920241015,130,2024-10-15,19,27,42,69,Bou892T,"-37.8204637, 144.94126826"
1612320241214,161,2024-12-14,23,0,22,22,BirArt1109_T,"-37.81851276, 144.97131336"
1612320240714,161,2024-07-14,23,0,10,10,BirArt1109_T,"-37.81851276, 144.97131336"
49920250515,49,2025-05-15,9,196,244,440,Eli501_T,"-37.80730068, 144.95956055"
84720231228,84,2023-12-28,7,261,142,403,ElFi_T,"-37.81798049, 144.96503383"
841720241003,84,2024-10-03,17,1291,2341,3632,ElFi_T,"-37.81798049, 144.96503383"
702320240816,70,2024-08-16,23,17,19,36,Errol20_T,"-37.80456984, 144.94946228"
701620250729,70,2025-07-29,16,135,120,255,Errol20_T,"-37.80456984, 144.94946228"
412220240809,41,2024-08-09,22,119,97,216,Swa31,"-37.81668634, 144.96689733"
8620240806,8,2024-08-06,6,16,20,36,WebBN_T,"-37.82293543, 144.9471751"
75220250820,75,2025-08-20,2,1,0,1,SprFli_T,"-37.81515276, 144.97467661"
782220231230,78,2023-12-30,22,9,17,26,HarEsB_T,"-37.81471642, 144.9446508"
782220240306,78,2024-03-06,22,2,6,8,HarEsB_T,"-37.81471642, 144.9446508"
78420250117,78,2025-01-17,4,0,3,3,HarEsB_T,"-37.81471642, 144.9446508"
71920250405,71,2025-04-05,9,17,13,30,WestWP_T,"-37.81235775, 144.97136962"
291420240809,29,2024-08-09,14,253,442,695,AG_T,"-37.8199817, 144.96872865"
291820241224,29,2024-12-24,18,801,1805,2606,AG_T,"-37.8199817, 144.96872865"
141620240919,14,2024-09-19,16,670,142,812,SanBri_T,"-37.82011242, 144.96291897"
14620241108,14,2024-11-08,6,99,139,238,SanBri_T,"-37.82011242, 144.96291897"
542020250923,54,2025-09-23,20,141,219,360,Swa607_T,"-37.804024, 144.96308399"
311520231110,31,2023-11-10,15,163,155,318,Lyg161_T,"-37.80169681, 144.96658911"
541820240716,54,2024-07-16,18,165,180,345,Swa607_T,"-37.804024, 144.96308399"
281920250602,28,2025-06-02,19,399,152,551,VAC_T,"-37.82129925, 144.96879309"
40620231101,40,2023-11-01,6,26,55,81,Spr201_T,"-37.80999341, 144.97227587"
5720250127,5,2025-01-27,7,92,108,200,PriNW_T,"-37.81874249, 144.96787656"
51220231212,5,2023-12-12,12,842,1186,2028,PriNW_T,"-37.81874249, 144.96787656"
36320250207,36,2025-02-07,3,13,10,23,Que85_T,"-37.81652527, 144.96121062"
371120240220,37,2024-02-20,11,79,132,211,Lyg260_T,"-37.80107122, 144.96704554"
872220240822,87,2024-08-22,22,15,30,45,Errol23_T,"-37.80454949, 144.94921863"
61720250915,61,2025-09-15,7,90,144,234,RMIT14_T,"-37.80767455, 144.96309114"
501920250908,50,2025-09-08,19,130,145,275,Lyg309_T,"-37.79808192, 144.96721013"
166120250612,166,2025-06-12,1,1,0,1,Spen484_T,"-37.80896733, 144.94931703"
162020250824,162,2025-08-24,0,81,56,137,Eli489_T,"-37.80740397, 144.95987909"
1321020231206,132,2023-12-06,10,111,99,210,King335_T,"-37.81267639, 144.95386444"
1322220240209,132,2024-02-09,22,93,113,206,King335_T,"-37.81267639, 144.95386444"
107620241028,107,2024-10-28,6,12,22,34,280Will_T,"-37.81246271, 144.95690188"
1241720250321,124,2025-03-21,17,3,18,21,BirBridge_T,"-37.81757416, 144.97329934"
1081720250731,108,2025-07-31,17,1692,279,1971,261Will_T,"-37.81295822, 144.95678789"
67120231025,67,2023-10-25,1,4,5,9,FLDegS_T,"-37.81688755, 144.96562569"
681620241030,68,2024-10-30,16,232,114,346,FLDegN_T,"-37.8168479, 144.96559789"
1820250125,1,2025-01-25,8,95,137,232,Bou292_T,"-37.81349441, 144.96515323"
671720231101,67,2023-11-01,17,403,655,1058,FLDegS_T,"-37.81688755, 144.96562569"
632020250409,63,2025-04-09,20,131,394,525,Bou231_T,"-37.81333081, 144.96675571"
862020240620,86,2024-06-20,20,6,8,14,574Qub_T,"-37.80309992, 144.94908064"
121620250602,12,2025-06-02,16,173,172,345,NewQ_T,"-37.81457988, 144.94292398"
242120250323,24,2025-03-23,21,240,299,539,Col620_T,"-37.81887963, 144.95449198"
721320240530,72,2024-05-30,13,245,337,582,ACMI_T,"-37.81726338, 144.96872809"
351520240620,35,2024-06-20,15,808,915,1723,SouthB_T,"-37.82018685, 144.96508508"
582320250516,58,2025-05-16,23,164,156,320,Bou688_T,"-37.81686075, 144.95358075"
58920250527,58,2025-05-27,9,1098,172,1270,Bou688_T,"-37.81686075, 144.95358075"
92320250722,9,2025-07-22,23,33,12,45,Col700_T,"-37.81982992, 144.95102555"
9320250916,9,2025-09-16,3,5,1,6,Col700_T,"-37.81982992, 144.95102555"
791320251002,79,2025-10-02,13,484,403,887,FliSS_T,"-37.81794046, 144.96616678"
231520240228,23,2024-02-28,15,159,334,493,Col623_T,"-37.81909256, 144.95452748"
23720240314,23,2024-03-14,7,386,154,540,Col623_T,"-37.81909256, 144.95452748"
301920240919,30,2024-09-19,19,258,427,685,Lon189_T,"-37.8112185, 144.96656806"
301120241215,30,2024-12-15,11,237,257,494,Lon189_T,"-37.8112185, 144.96656806"
301520240527,30,2024-05-27,15,208,368,576,Lon189_T,"-37.8112185, 144.96656806"
23820240716,23,2024-07-16,8,1015,418,1433,Col623_T,"-37.81909256, 144.95452748"
231720250826,23,2025-08-26,17,213,811,1024,Col623_T,"-37.81909256, 144.95452748"
252020240209,25,2024-02-09,20,648,323,971,MCEC_T,"-37.82401776, 144.95604426"
251720241213,25,2024-12-13,17,1204,875,2079,MCEC_T,"-37.82401776, 144.95604426"
25820250830,25,2025-08-30,8,98,186,284,MCEC_T,"-37.82401776, 144.95604426"
191920240105,19,2024-01-05,19,647,553,1200,LtB210_T,"-37.81237202, 144.96550671"
481320250725,48,2025-07-25,13,389,222,611,QVMQ_T,"-37.80631581, 144.95866697"
482020240918,48,2024-09-18,20,117,179,296,QVMQ_T,"-37.80631581, 144.95866697"
136620240605,136,2024-06-05,6,6,3,9,BirFed1120_T,"-37.8184141, 144.97357915"
1361820240809,136,2024-08-09,18,102,3,105,BirFed1120_T,"-37.8184141, 144.97357915"
1421320250531,142,2025-05-31,13,714,407,1121,Hammer1584_T,"-37.81970749, 144.96795734"
1421620250618,142,2025-06-18,16,277,241,518,Hammer1584_T,"-37.81970749, 144.96795734"
1232120240924,123,2024-09-24,21,1,0,1,BirBridge_T,"-37.81753741, 144.97329734"
1232220250802,123,2025-08-02,22,34,5,39,BirBridge_T,"-37.81753741, 144.97329734"
1381420250201,138,2025-02-01,14,10,10,20,EntPark1671_T,"-37.81996544, 144.95981454"
1091720240302,109,2024-03-02,17,95,136,231,LatWill_T,"-37.81193681, 144.95621105"
692020240810,69,2024-08-10,20,58,44,102,FLDegC_T,"-37.81687226, 144.96559144"
841520241109,84,2024-11-09,15,1026,1391,2417,ElFi_T,"-37.81798049, 144.96503383"
702020240404,70,2024-04-04,20,98,125,223,Errol20_T,"-37.80456984, 144.94946228"
701820240722,70,2024-07-22,18,132,169,301,Errol20_T,"-37.80456984, 144.94946228"
81620240702,8,2024-07-02,16,160,364,524,WebBN_T,"-37.82293543, 144.9471751"
781620240111,78,2024-01-11,16,39,106,145,HarEsB_T,"-37.81471642, 144.9446508"
71720240914,71,2024-09-14,7,4,1,5,WestWP_T,"-37.81235775, 144.97136962"
29020240225,29,2024-02-25,0,39,80,119,AG_T,"-37.8199817, 144.96872865"
31120240130,31,2024-01-30,1,15,3,18,Lyg161_T,"-37.80169681, 144.96658911"
312220231220,31,2023-12-20,22,72,105,177,Lyg161_T,"-37.80169681, 144.96658911"
28120250217,28,2025-02-17,1,15,6,21,VAC_T,"-37.82129925, 144.96879309"
51220250328,5,2025-03-28,12,868,1124,1992,PriNW_T,"-37.81874249, 144.96787656"
211520250313,21,2025-03-13,15,246,300,546,Bourke155_T,"-37.81267313, 144.96788288"
21720240430,21,2024-04-30,7,50,54,104,Bourke155_T,"-37.81267313, 144.96788288"
361520250309,36,2025-03-09,15,95,80,175,Que85_T,"-37.81652527, 144.96121062"
371220240914,37,2024-09-14,12,109,99,208,Lyg260_T,"-37.80107122, 144.96704554"
87620231124,87,2023-11-24,6,18,19,37,Errol23_T,"-37.80454949, 144.94921863"
61320240830,61,2024-08-30,3,9,1,10,RMIT14_T,"-37.80767455, 144.96309114"
501820240422,50,2024-04-22,18,198,240,438,Lyg309_T,"-37.79808192, 144.96721013"
44120240815,44,2024-08-15,1,20,0,20,UM3_T,"-37.79698741, 144.96441306"
432320240216,43,2024-02-16,23,14,9,23,UM2_T,"-37.79844526, 144.96411782"
452220250515,45,2025-05-15,22,198,359,557,Swa148_T,"-37.81414075, 144.96609379"
45720241023,45,2024-10-23,7,206,161,367,Swa148_T,"-37.81414075, 144.96609379"
1311920250422,131,2025-04-22,19,71,65,136,King2_T,"-37.82009057, 144.95758725"
1342120250105,134,2025-01-05,21,245,218,463,Spen201_T,"-37.81694221, 144.95303935"
135420250218,135,2025-02-18,4,20,14,34,Spen161_T,"-37.8172861, 144.95319102"
1072320240910,107,2024-09-10,23,30,15,45,280Will_T,"-37.81246271, 144.95690188"
682220240602,68,2024-06-02,22,18,8,26,FLDegN_T,"-37.8168479, 144.96559789"
851120240906,85,2024-09-06,11,102,93,195,488Mac_T,"-37.79432415, 144.92973378"
172120231117,17,2023-11-17,21,116,103,219,Col15_T,"-37.81362543, 144.97323591"
171820250103,17,2025-01-03,18,146,114,260,Col15_T,"-37.81362543, 144.97323591"
12120231126,1,2023-11-26,21,374,366,740,Bou292_T,"-37.81349441, 144.96515323"
181120240417,18,2024-04-17,11,167,242,409,Col12_T,"-37.81344862, 144.97305353"
18320240420,18,2024-04-20,3,0,2,2,Col12_T,"-37.81344862, 144.97305353"
622020251008,62,2025-10-08,20,273,279,552,Lat224_T,"-37.80996494, 144.96216521"
631620231107,63,2023-11-07,16,201,238,439,Bou231_T,"-37.81333081, 144.96675571"
68420250831,68,2025-08-31,4,3,2,5,FLDegN_T,"-37.8168479, 144.96559789"
56620250206,56,2025-02-06,6,35,27,62,Lon364_T,"-37.81234775, 144.96153311"
111920250307,11,2025-03-07,19,228,198,426,WatCit_T,"-37.81564989, 144.93970694"
241020240325,24,2024-03-25,10,594,459,1053,Col620_T,"-37.81887963, 144.95449198"
101620231020,10,2023-10-20,16,198,53,251,BouHbr_T,"-37.81876474, 144.94710545"
10320240808,10,2024-08-08,3,1,1,2,BouHbr_T,"-37.81876474, 144.94710545"
10020250517,10,2025-05-17,0,3,6,9,BouHbr_T,"-37.81876474, 144.94710545"
721820231109,72,2023-11-09,18,333,550,883,ACMI_T,"-37.81726338, 144.96872809"
76920241127,76,2024-11-27,9,55,36,91,KenMac_T,"-37.79453803, 144.93036194"
352320240104,35,2024-01-04,23,216,285,501,SouthB_T,"-37.82018685, 144.96508508"
2720240907,2,2024-09-07,7,27,59,86,Bou283_T,"-37.81380668, 144.96516718"
87920241025,87,2024-10-25,9,49,53,102,Errol23_T,"-37.80454949, 144.94921863"
1082220250821,108,2025-08-21,22,139,92,231,261Will_T,"-37.81295822, 144.95678789"
61620240115,61,2024-01-15,6,21,44,65,RMIT14_T,"-37.80767455, 144.96309114"
43120240428,43,2024-04-28,1,36,14,50,UM2_T,"-37.79844526, 144.96411782"
432020241016,43,2024-10-16,20,81,127,208,UM2_T,"-37.79844526, 144.96411782"
182820250427,182,2025-04-27,8,64,81,145,King163_T,"-37.81627451, 144.95550503"
1621820250628,162,2025-06-28,18,208,206,414,Eli489_T,"-37.80740397, 144.95987909"
162620250730,162,2025-07-30,6,38,26,64,Eli489_T,"-37.80740397, 144.95987909"
107420231121,107,2023-11-21,4,3,8,11,280Will_T,"-37.81246271, 144.95690188"
143120250809,143,2025-08-09,1,94,32,126,Spencer_T,"-37.821728, 144.95557015"
1342320250112,134,2025-01-12,23,241,148,389,Spen201_T,"-37.81694221, 144.95303935"
133420240202,133,2024-02-02,4,14,23,37,Spen229_T,"-37.81531435, 144.95227769"
1181520241031,118,2024-10-31,15,20,28,48,Fli114C_T,"-37.81632783, 144.97090512"
1241820250329,124,2025-03-29,18,18,28,46,BirBridge_T,"-37.81757416, 144.97329934"
67020250131,67,2025-01-31,0,14,32,46,FLDegS_T,"-37.81688755, 144.96562569"
851920250216,85,2025-02-16,19,45,33,78,488Mac_T,"-37.79432415, 144.92973378"
63420240613,63,2024-06-13,4,3,2,5,Bou231_T,"-37.81333081, 144.96675571"
181320231201,18,2023-12-01,13,235,178,413,Col12_T,"-37.81344862, 144.97305353"
18620241207,18,2024-12-07,6,2,3,5,Col12_T,"-37.81344862, 144.97305353"
671620240312,67,2024-03-12,16,265,529,794,FLDegS_T,"-37.81688755, 144.96562569"
62620240903,62,2024-09-03,6,144,32,176,Lat224_T,"-37.80996494, 144.96216521"
111120240412,11,2024-04-12,11,78,95,173,WatCit_T,"-37.81564989, 144.93970694"
121820250131,12,2025-01-31,18,209,318,527,NewQ_T,"-37.81457988, 144.94292398"
121720250430,12,2025-04-30,17,205,369,574,NewQ_T,"-37.81457988, 144.94292398"
721920231018,72,2023-10-18,19,295,268,563,ACMI_T,"-37.81726338, 144.96872809"
72720240524,72,2024-05-24,7,120,51,171,ACMI_T,"-37.81726338, 144.96872809"
58620240902,58,2024-09-02,6,143,42,185,Bou688_T,"-37.81686075, 144.95358075"
58320240130,58,2024-01-30,3,6,4,10,Bou688_T,"-37.81686075, 144.95358075"
58220250217,58,2025-02-17,2,8,13,21,Bou688_T,"-37.81686075, 144.95358075"
21120250211,2,2025-02-11,11,322,419,741,Bou283_T,"-37.81380668, 144.96516718"
21820250317,2,2025-03-17,18,384,338,722,Bou283_T,"-37.81380668, 144.96516718"
791520231128,79,2023-11-28,15,489,422,911,FliSS_T,"-37.81794046, 144.96616678"
231820251016,23,2025-10-16,18,215,387,602,Col623_T,"-37.81909256, 144.95452748"
511120231030,51,2023-10-30,11,84,97,181,Fra118_T,"-37.80841815, 144.95906316"
23120240601,23,2024-06-01,1,11,26,37,Col623_T,"-37.81909256, 144.95452748"
52320251006,52,2025-10-06,3,0,5,5,Eli263_T,"-37.81252157, 144.9619401"
1411320240704,141,2024-07-04,13,208,147,355,474Fl_T,"-37.81997273, 144.95834911"
1411920240716,141,2024-07-16,19,96,100,196,474Fl_T,"-37.81997273, 144.95834911"
139120250418,139,2025-04-18,1,10,7,17,Signal1647_T,"-37.81959923, 144.9632832"
1611120240920,161,2024-09-20,11,85,143,228,BirArt1109_T,"-37.81851276, 144.97131336"
1231720240202,123,2024-02-02,17,12,4,16,BirBridge_T,"-37.81753741, 144.97329734"
117720231111,117,2023-11-11,7,33,34,67,Fli114F_T,"-37.81629332, 144.97090877"
109120251011,109,2025-10-11,1,13,57,70,LatWill_T,"-37.81193681, 144.95621105"
109720240729,109,2024-07-29,7,21,152,173,LatWill_T,"-37.81193681, 144.95621105"
191020231123,19,2023-11-23,10,161,146,307,LtB210_T,"-37.81237202, 144.96550671"
41120240531,4,2024-05-31,11,1227,800,2027,Swa123_T,"-37.81487988, 144.9660878"
32320240301,3,2024-03-01,23,769,729,1498,Swa295_T,"-37.81101524, 144.96429485"
391620250101,39,2025-01-01,16,76,42,118,AlfPl_T,"-37.81379749, 144.96995745"
391020240529,39,2024-05-29,10,78,82,160,AlfPl_T,"-37.81379749, 144.96995745"
77220241220,77,2024-12-20,2,8,3,11,HarEsP_T,"-37.81441438, 144.94433026"
781920250712,78,2025-07-12,19,13,7,20,HarEsB_T,"-37.81471642, 144.9446508"
401420250314,40,2025-03-14,14,221,187,408,Spr201_T,"-37.80999341, 144.97227587"
31620251011,31,2025-10-11,6,0,3,3,Lyg161_T,"-37.80169681, 144.96658911"
361020250225,36,2025-02-25,10,163,179,342,Que85_T,"-37.81652527, 144.96121062"
36020250324,36,2025-03-24,0,7,4,11,Que85_T,"-37.81652527, 144.96121062"
45620250912,45,2025-09-12,6,37,61,98,Swa148_T,"-37.81414075, 144.96609379"
67720240402,67,2024-04-02,7,89,83,172,FLDegS_T,"-37.81688755, 144.96562569"
671120240921,67,2024-09-21,11,456,355,811,FLDegS_T,"-37.81688755, 144.96562569"
851520250419,85,2025-04-19,15,66,58,124,488Mac_T,"-37.79432415, 144.92973378"
11120240916,1,2024-09-16,11,630,610,1240,Bou292_T,"-37.81349441, 144.96515323"
11120250130,1,2025-01-30,11,778,707,1485,Bou292_T,"-37.81349441, 144.96515323"
63420240823,63,2024-08-23,4,5,8,13,Bou231_T,"-37.81333081, 144.96675571"
67320241202,67,2024-12-02,3,1,4,5,FLDegS_T,"-37.81688755, 144.96562569"
682220241211,68,2024-12-11,22,42,18,60,FLDegN_T,"-37.8168479, 144.96559789"
632020241122,63,2024-11-22,20,305,461,766,Bou231_T,"-37.81333081, 144.96675571"
672120240428,67,2024-04-28,21,93,176,269,FLDegS_T,"-37.81688755, 144.96562569"
351320241130,35,2024-11-30,13,657,817,1474,SouthB_T,"-37.82018685, 144.96508508"
35720250327,35,2025-03-27,7,568,828,1396,SouthB_T,"-37.82018685, 144.96508508"
35920240923,35,2024-09-23,9,552,805,1357,SouthB_T,"-37.82018685, 144.96508508"
21720240911,2,2024-09-11,17,440,365,805,Bou283_T,"-37.81380668, 144.96516718"
301520231126,30,2023-11-26,15,332,944,1276,Lon189_T,"-37.8112185, 144.96656806"
30820240413,30,2024-04-13,8,34,81,115,Lon189_T,"-37.8112185, 144.96656806"
53020241001,53,2024-10-01,0,13,16,29,Col254_T,"-37.81564191, 144.965499"
231720250412,23,2025-04-12,17,173,226,399,Col623_T,"-37.81909256, 144.95452748"
23520231218,23,2023-12-18,5,25,24,49,Col623_T,"-37.81909256, 144.95452748"
30920240523,30,2024-05-23,9,97,113,210,Lon189_T,"-37.8112185, 144.96656806"
522320231127,52,2023-11-27,23,51,39,90,Eli263_T,"-37.81252157, 144.9619401"
522020250514,52,2025-05-14,20,237,171,408,Eli263_T,"-37.81252157, 144.9619401"
51720240118,51,2024-01-18,7,32,21,53,Fra118_T,"-37.80841815, 144.95906316"
25020241005,25,2024-10-05,0,60,51,111,MCEC_T,"-37.82401776, 144.95604426"
25120250105,25,2025-01-05,1,27,45,72,MCEC_T,"-37.82401776, 144.95604426"
25520250629,25,2025-06-29,5,9,7,16,MCEC_T,"-37.82401776, 144.95604426"
20320250825,20,2025-08-25,3,9,11,20,LtB170_T,"-37.81172914, 144.9682466"
481020231203,48,2023-12-03,10,290,345,635,QVMQ_T,"-37.80631581, 144.95866697"
201420250417,20,2025-04-17,14,231,313,544,LtB170_T,"-37.81172914, 144.9682466"
141520241219,141,2024-12-19,5,13,7,20,474Fl_T,"-37.81997273, 144.95834911"
1411920250225,141,2025-02-25,19,103,104,207,474Fl_T,"-37.81997273, 144.95834911"
1422020240417,142,2024-04-17,20,146,77,223,Hammer1584_T,"-37.81970749, 144.96795734"
1421920250721,142,2025-07-21,19,4,0,4,Hammer1584_T,"-37.81970749, 144.96795734"
1641120250209,164,2025-02-09,11,117,79,196,Lat526_T,"-37.813005, 144.95160411"
1641420250723,164,2025-07-23,14,75,82,157,Lat526_T,"-37.813005, 144.95160411"
1801620250502,180,2025-05-02,16,40,54,94,Mac330_T,"-37.79497059, 144.93530329"
1802020250605,180,2025-06-05,20,4,1,5,Mac330_T,"-37.79497059, 144.93530329"
117820250515,117,2025-05-15,8,421,98,519,Fli114F_T,"-37.81629332, 144.97090877"
117520250608,117,2025-06-08,5,3,2,5,Fli114F_T,"-37.81629332, 144.97090877"
109020240714,109,2024-07-14,0,23,55,78,LatWill_T,"-37.81193681, 144.95621105"
6720250514,6,2025-05-14,7,548,862,1410,FliS_T,"-37.81911705, 144.96558255"
841620240414,84,2024-04-14,16,1009,1310,2319,ElFi_T,"-37.81798049, 144.96503383"
841120240827,84,2024-08-27,11,816,742,1558,ElFi_T,"-37.81798049, 144.96503383"
66820240608,66,2024-06-08,8,70,115,185,QVN_T,"-37.81057846, 144.96444294"
41120240112,4,2024-01-12,11,1285,690,1975,Swa123_T,"-37.81487988, 144.9660878"
4120240606,4,2024-06-06,1,24,37,61,Swa123_T,"-37.81487988, 144.9660878"
701720240117,70,2024-01-17,17,156,156,312,Errol20_T,"-37.80456984, 144.94946228"
702220250524,70,2025-05-24,22,196,103,299,Errol20_T,"-37.80456984, 144.94946228"
701220250611,70,2025-06-11,12,153,133,286,Errol20_T,"-37.80456984, 144.94946228"
392220250505,39,2025-05-05,22,14,10,24,AlfPl_T,"-37.81379749, 144.96995745"
8520241019,8,2024-10-19,5,1,3,4,WebBN_T,"-37.82293543, 144.9471751"
412120250213,41,2025-02-13,21,555,1106,1661,Swa31,"-37.81668634, 144.96689733"
771420250222,77,2025-02-22,14,80,41,121,HarEsP_T,"-37.81441438, 144.94433026"
781420240326,78,2024-03-26,14,36,60,96,HarEsB_T,"-37.81471642, 144.9446508"
78920241110,78,2024-11-10,9,56,65,121,HarEsB_T,"-37.81471642, 144.9446508"
27020250730,27,2025-07-30,0,25,8,33,Vic_T,"-37.80606888, 144.95644692"
79920231109,79,2023-11-09,9,462,304,766,FliSS_T,"-37.81794046, 144.96616678"
231020240203,23,2024-02-03,10,157,172,329,Col623_T,"-37.81909256, 144.95452748"
46120240404,46,2024-04-04,1,2,7,9,Pel147_T,"-37.80240719, 144.9615673"
19920240625,19,2024-06-25,9,67,85,152,LtB210_T,"-37.81237202, 144.96550671"
46520241112,46,2024-11-12,5,2,0,2,Pel147_T,"-37.80240719, 144.9615673"
201820231216,20,2023-12-16,18,484,511,995,LtB170_T,"-37.81172914, 144.9682466"
1371120240716,137,2024-07-16,11,19,50,69,BouHbr2353_T,"-37.81894815, 144.94612292"
1361320250228,136,2025-02-28,13,113,111,224,BirFed1120_T,"-37.8184141, 144.97357915"
1301220240418,130,2024-04-18,12,22,54,76,Bou892T,"-37.8204637, 144.94126826"
1171620240809,117,2024-08-09,16,158,219,377,Fli114F_T,"-37.81629332, 144.97090877"
1232220240223,123,2024-02-23,22,1,0,1,BirBridge_T,"-37.81753741, 144.97329734"
691320241119,69,2024-11-19,13,263,337,600,FLDegC_T,"-37.81687226, 144.96559144"
4620231227,4,2023-12-27,6,53,35,88,Swa123_T,"-37.81487988, 144.9660878"
4720250604,4,2025-06-04,7,244,137,381,Swa123_T,"-37.81487988, 144.9660878"
32320250809,3,2025-08-09,23,639,790,1429,Swa295_T,"-37.81101524, 144.96429485"
782320250330,78,2025-03-30,23,2,8,10,HarEsB_T,"-37.81471642, 144.9446508"
59620241220,59,2024-12-20,6,23,26,49,RMIT_T,"-37.80825648, 144.96304859"
59020251004,59,2025-10-04,0,135,77,212,RMIT_T,"-37.80825648, 144.96304859"
65920240816,65,2024-08-16,9,768,333,1101,SwaCs_T,"-37.81569416, 144.9668064"
29720241101,29,2024-11-01,7,111,79,190,AG_T,"-37.8199817, 144.96872865"
142020231027,14,2023-10-27,20,517,93,610,SanBri_T,"-37.82011242, 144.96291897"
54520240809,54,2024-08-09,5,7,10,17,Swa607_T,"-37.804024, 144.96308399"
541420241022,54,2024-10-22,14,151,104,255,Swa607_T,"-37.804024, 144.96308399"
281320241219,28,2024-12-19,13,914,904,1818,VAC_T,"-37.82129925, 144.96879309"
401820250908,40,2025-09-08,18,90,121,211,Spr201_T,"-37.80999341, 144.97227587"
401120240310,40,2024-03-10,11,50,127,177,Spr201_T,"-37.80999341, 144.97227587"
211320240421,21,2024-04-21,13,549,568,1117,Bourke155_T,"-37.81267313, 144.96788288"
21520250628,21,2025-06-28,5,8,5,13,Bourke155_T,"-37.81267313, 144.96788288"
1081520240118,108,2024-01-18,15,436,198,634,261Will_T,"-37.81295822, 144.95678789"
1171620250321,117,2025-03-21,16,192,272,464,Fli114F_T,"-37.81629332, 144.97090877"
49320240909,49,2024-09-09,3,22,18,40,Eli501_T,"-37.80730068, 144.95956055"
49220240209,49,2024-02-09,2,23,16,39,Eli501_T,"-37.80730068, 144.95956055"
171920240917,17,2024-09-17,19,73,127,200,Col15_T,"-37.81362543, 144.97323591"
1920231116,1,2023-11-16,9,407,435,842,Bou292_T,"-37.81349441, 144.96515323"
1620250114,1,2025-01-14,6,33,43,76,Bou292_T,"-37.81349441, 144.96515323"
671320250802,67,2025-08-02,13,433,556,989,FLDegS_T,"-37.81688755, 144.96562569"
18020241121,18,2024-11-21,0,0,1,1,Col12_T,"-37.81344862, 144.97305353"
18120250306,18,2025-03-06,1,0,1,1,Col12_T,"-37.81344862, 144.97305353"
621620250822,62,2025-08-22,16,352,317,669,Lat224_T,"-37.80996494, 144.96216521"
63820241104,63,2024-11-04,8,115,128,243,Bou231_T,"-37.81333081, 144.96675571"
621320240616,62,2024-06-16,13,200,127,327,Lat224_T,"-37.80996494, 144.96216521"
621720240919,62,2024-09-19,17,234,165,399,Lat224_T,"-37.80996494, 144.96216521"
861720240121,86,2024-01-21,17,34,36,70,574Qub_T,"-37.80309992, 144.94908064"
86020240328,86,2024-03-28,0,2,2,4,574Qub_T,"-37.80309992, 144.94908064"
242320250703,24,2025-07-03,23,145,208,353,Col620_T,"-37.81887963, 144.95449198"
762120241209,76,2024-12-09,21,3,12,15,KenMac_T,"-37.79453803, 144.93036194"
27720250715,27,2025-07-15,7,27,45,72,Vic_T,"-37.80606888, 144.95644692"
531220250121,53,2025-01-21,12,1037,842,1879,Col254_T,"-37.81564191, 144.965499"
362220241229,36,2024-12-29,22,49,48,97,Que85_T,"-37.81652527, 144.96121062"
51020240718,5,2024-07-18,10,367,673,1040,PriNW_T,"-37.81874249, 144.96787656"
61220240130,61,2024-01-30,2,3,6,9,RMIT14_T,"-37.80767455, 144.96309114"
1842220250919,184,2025-09-19,22,205,278,483,Eli124_T,"-37.81512416, 144.96371988"
1652220250922,165,2025-09-22,22,7,4,11,Spen475_T,"-37.80953359, 144.94939004"
1811420250821,181,2025-08-21,14,703,1050,1753,Eli368_T,"-37.81009465, 144.96143149"
1401820241130,140,2024-11-30,18,83,82,165,Boyd2837_T,"-37.82590962, 144.96185972"
1621620250220,162,2025-02-20,16,303,380,683,Eli489_T,"-37.80740397, 144.95987909"
1312220250403,131,2025-04-03,22,205,66,271,King2_T,"-37.82009057, 144.95758725"
1311920250409,131,2025-04-09,19,90,73,163,King2_T,"-37.82009057, 144.95758725"
143520250725,143,2025-07-25,5,21,15,36,Spencer_T,"-37.821728, 144.95557015"
1341920241111,134,2024-11-11,19,439,314,753,Spen201_T,"-37.81694221, 144.95303935"
1351920240706,135,2024-07-06,19,109,157,266,Spen161_T,"-37.8172861, 144.95319102"
135020240830,135,2024-08-30,0,25,26,51,Spen161_T,"-37.8172861, 144.95319102"
1351620241129,135,2024-11-29,16,729,782,1511,Spen161_T,"-37.8172861, 144.95319102"
1331920250319,133,2025-03-19,19,543,425,968,Spen229_T,"-37.81531435, 144.95227769"
118820250306,118,2025-03-06,8,43,19,62,Fli114C_T,"-37.81632783, 144.97090512"
107020240611,107,2024-06-11,0,5,2,7,280Will_T,"-37.81246271, 144.95690188"
851420250129,85,2025-01-29,14,51,63,114,488Mac_T,"-37.79432415, 144.92973378"
11620240126,1,2024-01-26,16,1327,1143,2470,Bou292_T,"-37.81349441, 144.96515323"
632220240617,63,2024-06-17,22,37,105,142,Bou231_T,"-37.81333081, 144.96675571"
181620250612,18,2025-06-12,16,515,138,653,Col12_T,"-37.81344862, 144.97305353"
86720231124,86,2023-11-24,7,25,17,42,574Qub_T,"-37.80309992, 144.94908064"
63020250617,63,2025-06-17,0,0,11,11,Bou231_T,"-37.81333081, 144.96675571"
24120250511,24,2025-05-11,1,66,89,155,Col620_T,"-37.81887963, 144.95449198"
10920250704,10,2025-07-04,9,66,86,152,BouHbr_T,"-37.81876474, 144.94710545"
761120240127,76,2024-01-27,11,57,65,122,KenMac_T,"-37.79453803, 144.93036194"
91020240816,9,2024-08-16,10,167,450,617,Col700_T,"-37.81982992, 144.95102555"
271320241209,27,2024-12-09,13,98,98,196,Vic_T,"-37.80606888, 144.95644692"
9020241205,9,2024-12-05,0,9,26,35,Col700_T,"-37.81982992, 144.95102555"
51020240103,51,2024-01-03,0,14,13,27,Fra118_T,"-37.80841815, 144.95906316"
231320240915,23,2024-09-15,13,98,127,225,Col623_T,"-37.81909256, 144.95452748"
141620241229,141,2024-12-29,6,31,24,55,474Fl_T,"-37.81997273, 144.95834911"
1411320250211,141,2025-02-11,13,227,171,398,474Fl_T,"-37.81997273, 144.95834911"
139620250119,139,2025-01-19,6,8,3,11,Signal1647_T,"-37.81959923, 144.9632832"
123920231211,123,2023-12-11,9,16,3,19,BirBridge_T,"-37.81753741, 144.97329734"
491620241228,49,2024-12-28,16,173,391,564,Eli501_T,"-37.80730068, 144.95956055"
117820240702,117,2024-07-02,8,399,116,515,Fli114F_T,"-37.81629332, 144.97090877"
1801120250317,180,2025-03-17,11,37,24,61,Mac330_T,"-37.79497059, 144.93530329"
1311020240828,131,2024-08-28,10,72,95,167,King2_T,"-37.82009057, 144.95758725"
1352120251007,135,2025-10-07,21,144,175,319,Spen161_T,"-37.8172861, 144.95319102"
291920250504,29,2025-05-04,19,106,143,249,AG_T,"-37.8199817, 144.96872865"
141920250211,14,2025-02-11,19,240,105,345,SanBri_T,"-37.82011242, 144.96291897"
14720240521,14,2024-05-21,7,186,240,426,SanBri_T,"-37.82011242, 144.96291897"
712320250418,71,2025-04-18,23,0,2,2,WestWP_T,"-37.81235775, 144.97136962"
28220240425,28,2024-04-25,2,22,22,44,VAC_T,"-37.82129925, 144.96879309"
47720250613,47,2025-06-13,7,67,164,231,Eli250_T,"-37.81258467, 144.9625775"
471020250502,47,2025-05-02,10,443,588,1031,Eli250_T,"-37.81258467, 144.9625775"
401720250509,40,2025-05-09,17,163,332,495,Spr201_T,"-37.80999341, 144.97227587"
401720241016,40,2024-10-16,17,247,331,578,Spr201_T,"-37.80999341, 144.97227587"
371120240912,37,2024-09-12,11,69,89,158,Lyg260_T,"-37.80107122, 144.96704554"
431720240420,43,2024-04-20,17,104,94,198,UM2_T,"-37.79844526, 144.96411782"
43020240626,43,2024-06-26,0,1,8,9,UM2_T,"-37.79844526, 144.96411782"
451420250323,45,2025-03-23,14,589,1517,2106,Swa148_T,"-37.81414075, 144.96609379"
45620250326,45,2025-03-26,6,29,40,69,Swa148_T,"-37.81414075, 144.96609379"
133720240920,133,2024-09-20,7,626,337,963,Spen229_T,"-37.81531435, 144.95227769"
132820250719,132,2025-07-19,8,69,25,94,King335_T,"-37.81267639, 144.95386444"
1181820250418,118,2025-04-18,18,15,4,19,Fli114C_T,"-37.81632783, 144.97090512"
611020250302,61,2025-03-02,10,234,427,661,RMIT14_T,"-37.80767455, 144.96309114"
50820240226,50,2024-02-26,8,51,91,142,Lyg309_T,"-37.79808192, 144.96721013"
1661220250803,166,2025-08-03,12,76,114,190,Spen484_T,"-37.80896733, 144.94931703"
1671020250905,167,2025-09-05,10,27,89,116,Lat526_T,"-37.81304149, 144.95155955"
1432320251001,143,2025-10-01,23,72,56,128,Spencer_T,"-37.821728, 144.95557015"
1341020231117,134,2023-11-17,10,306,273,579,Spen201_T,"-37.81694221, 144.95303935"
1351920240930,135,2024-09-30,19,205,206,411,Spen161_T,"-37.8172861, 144.95319102"
68620240202,68,2024-02-02,6,19,11,30,FLDegN_T,"-37.8168479, 144.96559789"
171620240701,17,2024-07-01,16,193,339,532,Col15_T,"-37.81362543, 144.97323591"
17020240901,17,2024-09-01,0,33,21,54,Col15_T,"-37.81362543, 144.97323591"
17720250117,17,2025-01-17,7,271,71,342,Col15_T,"-37.81362543, 144.97323591"
1420240418,1,2024-04-18,4,5,3,8,Bou292_T,"-37.81349441, 144.96515323"
11520250512,1,2025-05-12,15,938,794,1732,Bou292_T,"-37.81349441, 144.96515323"
181620240224,18,2024-02-24,16,106,85,191,Col12_T,"-37.81344862, 144.97305353"
62820231226,62,2023-12-26,8,11,12,23,Lat224_T,"-37.80996494, 144.96216521"
621620240812,62,2024-08-12,16,309,204,513,Lat224_T,"-37.80996494, 144.96216521"
72020250328,72,2025-03-28,0,18,18,36,ACMI_T,"-37.81726338, 144.96872809"
721320240318,72,2024-03-18,13,182,270,452,ACMI_T,"-37.81726338, 144.96872809"
76920240130,76,2024-01-30,9,72,59,131,KenMac_T,"-37.79453803, 144.93036194"
271720241126,27,2024-11-26,17,146,109,255,Vic_T,"-37.80606888, 144.95644692"
91520250124,9,2025-01-24,15,563,143,706,Col700_T,"-37.81982992, 144.95102555"
791920250219,79,2025-02-19,19,276,341,617,FliSS_T,"-37.81794046, 144.96616678"
231920231128,23,2023-11-28,19,113,165,278,Col623_T,"-37.81909256, 144.95452748"
511220250826,51,2025-08-26,12,111,109,220,Fra118_T,"-37.80841815, 144.95906316"
461820241225,46,2024-12-25,18,11,17,28,Pel147_T,"-37.80240719, 144.9615673"
51620240828,51,2024-08-28,6,11,4,15,Fra118_T,"-37.80841815, 144.95906316"
512120241102,51,2024-11-02,21,66,38,104,Fra118_T,"-37.80841815, 144.95906316"
511420241113,51,2024-11-13,14,71,39,110,Fra118_T,"-37.80841815, 144.95906316"
492320240507,49,2024-05-07,23,84,69,153,Eli501_T,"-37.80730068, 144.95956055"
191420250323,19,2025-03-23,14,695,664,1359,LtB210_T,"-37.81237202, 144.96550671"
23020241024,23,2024-10-24,0,12,22,34,Col623_T,"-37.81909256, 144.95452748"
23120250609,23,2025-06-09,1,45,24,69,Col623_T,"-37.81909256, 144.95452748"
201720231110,20,2023-11-10,17,276,155,431,LtB170_T,"-37.81172914, 144.9682466"
1372020250403,137,2025-04-03,20,3,0,3,BouHbr2353_T,"-37.81894815, 144.94612292"
1391720250525,139,2025-05-25,17,49,32,81,Signal1647_T,"-37.81959923, 144.9632832"
1392020240913,139,2024-09-13,20,7,27,34,Signal1647_T,"-37.81959923, 144.9632832"
1362020251002,136,2025-10-02,20,3,6,9,BirFed1120_T,"-37.8184141, 144.97357915"
136920240306,136,2024-03-06,9,74,77,151,BirFed1120_T,"-37.8184141, 144.97357915"
431820250912,43,2025-09-12,18,80,162,242,UM2_T,"-37.79844526, 144.96411782"
44820240330,44,2024-03-30,8,3,7,10,UM3_T,"-37.79698741, 144.96441306"
451820250324,45,2025-03-24,18,300,656,956,Swa148_T,"-37.81414075, 144.96609379"
1671920241023,167,2024-10-23,19,47,119,166,Lat526_T,"-37.81304149, 144.95155955"
131620240525,131,2024-05-25,6,9,29,38,King2_T,"-37.82009057, 144.95758725"
1321920250712,132,2025-07-12,19,150,136,286,King335_T,"-37.81267639, 144.95386444"
132920250731,132,2025-07-31,9,123,79,202,King335_T,"-37.81267639, 144.95386444"
1322120240130,132,2024-01-30,21,129,121,250,King335_T,"-37.81267639, 144.95386444"
1321220250113,132,2025-01-13,12,134,113,247,King335_T,"-37.81267639, 144.95386444"
134820250214,134,2025-02-14,8,265,332,597,Spen201_T,"-37.81694221, 144.95303935"
107320240618,107,2024-06-18,3,2,1,3,280Will_T,"-37.81246271, 144.95690188"
63820240202,63,2024-02-02,8,119,133,252,Bou231_T,"-37.81333081, 144.96675571"
63620240204,63,2024-02-04,6,9,20,29,Bou231_T,"-37.81333081, 144.96675571"
121420240929,12,2024-09-29,14,143,138,281,NewQ_T,"-37.81457988, 144.94292398"
721720250912,72,2025-09-12,17,219,598,817,ACMI_T,"-37.81726338, 144.96872809"
72520240210,72,2024-02-10,5,7,19,26,ACMI_T,"-37.81726338, 144.96872809"
21220240827,2,2024-08-27,12,719,1006,1725,Bou283_T,"-37.81380668, 144.96516718"
9920240223,9,2024-02-23,9,153,1173,1326,Col700_T,"-37.81982992, 144.95102555"
91320240516,9,2024-05-16,13,591,608,1199,Col700_T,"-37.81982992, 144.95102555"
271820240604,27,2024-06-04,18,161,77,238,Vic_T,"-37.80606888, 144.95644692"
27520240905,27,2024-09-05,5,10,6,16,Vic_T,"-37.80606888, 144.95644692"
531620250728,53,2025-07-28,16,524,391,915,Col254_T,"-37.81564191, 144.965499"
91820240606,9,2024-06-06,18,904,112,1016,Col700_T,"-37.81982992, 144.95102555"
91320241014,9,2024-10-14,13,437,433,870,Col700_T,"-37.81982992, 144.95102555"
92120250814,9,2025-08-14,21,65,40,105,Col700_T,"-37.81982992, 144.95102555"
531420240218,53,2024-02-18,14,940,789,1729,Col254_T,"-37.81564191, 144.965499"
791920250221,79,2025-02-21,19,666,515,1181,FliSS_T,"-37.81794046, 144.96616678"
79520250324,79,2025-03-24,5,30,26,56,FliSS_T,"-37.81794046, 144.96616678"
52120240707,52,2024-07-07,1,134,115,249,Eli263_T,"-37.81252157, 144.9619401"
23020250421,23,2025-04-21,0,16,51,67,Col623_T,"-37.81909256, 144.95452748"
251720250515,25,2025-05-15,17,833,404,1237,MCEC_T,"-37.82401776, 144.95604426"
19420231226,19,2023-12-26,4,10,27,37,LtB210_T,"-37.81237202, 144.96550671"
48120240706,48,2024-07-06,1,18,26,44,QVMQ_T,"-37.80631581, 144.95866697"
201820240515,20,2024-05-15,18,413,291,704,LtB170_T,"-37.81172914, 144.9682466"
164620241129,164,2024-11-29,6,19,33,52,Lat526_T,"-37.813005, 144.95160411"
141120241112,141,2024-11-12,1,12,13,25,474Fl_T,"-37.81997273, 144.95834911"
1412320231117,141,2023-11-17,23,122,86,208,474Fl_T,"-37.81997273, 144.95834911"
1372220231211,137,2023-12-11,22,1,9,10,BouHbr2353_T,"-37.81894815, 144.94612292"
137920250716,137,2025-07-16,9,58,53,111,BouHbr2353_T,"-37.81894815, 144.94612292"
1391220240610,139,2024-06-10,12,79,45,124,Signal1647_T,"-37.81959923, 144.9632832"
1361220250629,136,2025-06-29,12,239,66,305,BirFed1120_T,"-37.8184141, 144.97357915"
1422120250321,142,2025-03-21,21,55,52,107,Hammer1584_T,"-37.81970749, 144.96795734"
1611520250113,161,2025-01-13,15,499,968,1467,BirArt1109_T,"-37.81851276, 144.97131336"
161820250601,161,2025-06-01,8,145,108,253,BirArt1109_T,"-37.81851276, 144.97131336"
1381720240129,138,2024-01-29,17,14,7,21,EntPark1671_T,"-37.81996544, 144.95981454"
491420241204,49,2024-12-04,14,258,287,545,Eli501_T,"-37.80730068, 144.95956055"
117820231206,117,2023-12-06,8,427,133,560,Fli114F_T,"-37.81629332, 144.97090877"
1091720250327,109,2025-03-27,17,439,191,630,LatWill_T,"-37.81193681, 144.95621105"
661120250614,66,2025-06-14,11,566,795,1361,QVN_T,"-37.81057846, 144.96444294"
661220240905,66,2024-09-05,12,794,952,1746,QVN_T,"-37.81057846, 144.96444294"
691320250406,69,2025-04-06,13,269,254,523,FLDegC_T,"-37.81687226, 144.96559144"
66520240228,66,2024-02-28,5,9,24,33,QVN_T,"-37.81057846, 144.96444294"
62120250529,6,2025-05-29,21,518,495,1013,FliS_T,"-37.81911705, 144.96558255"
751620250213,75,2025-02-13,16,69,58,127,SprFli_T,"-37.81515276, 144.97467661"
751220250204,75,2025-02-04,12,71,55,126,SprFli_T,"-37.81515276, 144.97467661"
771820250628,77,2025-06-28,18,185,779,964,HarEsP_T,"-37.81441438, 144.94433026"
291720231205,29,2023-12-05,17,379,369,748,AG_T,"-37.8199817, 144.96872865"
711520250128,71,2025-01-28,15,7,10,17,WestWP_T,"-37.81235775, 144.97136962"
402220250311,40,2025-03-11,22,49,19,68,Spr201_T,"-37.80999341, 144.97227587"
362120240915,36,2024-09-15,21,34,32,66,Que85_T,"-37.81652527, 144.96121062"
51120240915,5,2024-09-15,11,1090,1075,2165,PriNW_T,"-37.81874249, 144.96787656"
1072320241116,107,2024-11-16,23,126,121,247,280Will_T,"-37.81246271, 144.95690188"
1071620240718,107,2024-07-18,16,150,128,278,280Will_T,"-37.81246271, 144.95690188"
107820240721,107,2024-07-21,8,36,34,70,280Will_T,"-37.81246271, 144.95690188"
107320240811,107,2024-08-11,3,9,8,17,280Will_T,"-37.81246271, 144.95690188"
1322020250503,132,2025-05-03,20,123,148,271,King335_T,"-37.81267639, 144.95386444"
1181820240530,118,2024-05-30,18,2,10,12,Fli114C_T,"-37.81632783, 144.97090512"
1181020250128,118,2025-01-28,10,8,10,18,Fli114C_T,"-37.81632783, 144.97090512"
611520250106,61,2025-01-06,15,203,264,467,RMIT14_T,"-37.80767455, 144.96309114"
501920250408,50,2025-04-08,19,134,137,271,Lyg309_T,"-37.79808192, 144.96721013"
501820240215,50,2024-02-15,18,216,204,420,Lyg309_T,"-37.79808192, 144.96721013"
50420241016,50,2024-10-16,4,5,0,5,Lyg309_T,"-37.79808192, 144.96721013"
1791920250401,179,2025-04-01,19,78,70,148,Pow61_T,"-37.82392385, 144.96299677"
181220250406,181,2025-04-06,2,144,142,286,Eli368_T,"-37.81009465, 144.96143149"
1811020250601,181,2025-06-01,10,307,651,958,Eli368_T,"-37.81009465, 144.96143149"
1431820250716,143,2025-07-16,18,173,200,373,Spencer_T,"-37.821728, 144.95557015"
131620250310,131,2025-03-10,6,15,14,29,King2_T,"-37.82009057, 144.95758725"
143120240715,143,2024-07-15,1,17,3,20,Spencer_T,"-37.821728, 144.95557015"
131920240527,131,2024-05-27,9,69,41,110,King2_T,"-37.82009057, 144.95758725"
135420240114,135,2024-01-14,4,24,26,50,Spen161_T,"-37.8172861, 144.95319102"
1352220240823,135,2024-08-23,22,83,77,160,Spen161_T,"-37.8172861, 144.95319102"
691120241027,69,2024-10-27,11,229,204,433,FLDegC_T,"-37.81687226, 144.96559144"
84120240918,84,2024-09-18,1,15,20,35,ElFi_T,"-37.81798049, 144.96503383"
701120250922,70,2025-09-22,11,60,60,120,Errol20_T,"-37.80456984, 144.94946228"
751120231222,75,2023-12-22,11,51,38,89,SprFli_T,"-37.81515276, 144.97467661"
41920240823,41,2024-08-23,9,179,214,393,Swa31,"-37.81668634, 144.96689733"
77520240210,77,2024-02-10,5,2,6,8,HarEsP_T,"-37.81441438, 144.94433026"
71220250326,71,2025-03-26,2,1,1,2,WestWP_T,"-37.81235775, 144.97136962"
133220240921,133,2024-09-21,2,23,10,33,Spen229_T,"-37.81531435, 144.95227769"
118520240902,118,2024-09-02,5,0,1,1,Fli114C_T,"-37.81632783, 144.97090512"
662320250407,66,2025-04-07,23,169,101,270,QVN_T,"-37.81057846, 144.96444294"
66920250503,66,2025-05-03,9,202,298,500,QVN_T,"-37.81057846, 144.96444294"
69920231113,69,2023-11-13,9,125,87,212,FLDegC_T,"-37.81687226, 144.96559144"
841820240122,84,2024-01-22,18,1052,1540,2592,ElFi_T,"-37.81798049, 144.96503383"
42020240304,4,2024-03-04,20,956,688,1644,Swa123_T,"-37.81487988, 144.9660878"
66920240326,66,2024-03-26,9,301,489,790,QVN_T,"-37.81057846, 144.96444294"
70420250920,70,2025-09-20,4,4,3,7,Errol20_T,"-37.80456984, 144.94946228"
31420240430,3,2024-04-30,14,1155,1133,2288,Swa295_T,"-37.81101524, 144.96429485"
751720231231,75,2023-12-31,17,97,70,167,SprFli_T,"-37.81515276, 144.97467661"
41020250616,41,2025-06-16,0,50,88,138,Swa31,"-37.81668634, 144.96689733"
41220250619,41,2025-06-19,2,23,37,60,Swa31,"-37.81668634, 144.96689733"
782320250828,78,2025-08-28,23,7,11,18,HarEsB_T,"-37.81471642, 144.9446508"
782020240811,78,2024-08-11,20,16,11,27,HarEsB_T,"-37.81471642, 144.9446508"
781520240822,78,2024-08-22,15,32,68,100,HarEsB_T,"-37.81471642, 144.9446508"
281120250813,28,2025-08-13,11,708,537,1245,VAC_T,"-37.82129925, 144.96879309"
281020240618,28,2024-06-18,10,600,239,839,VAC_T,"-37.82129925, 144.96879309"
311420250826,31,2025-08-26,14,99,115,214,Lyg161_T,"-37.80169681, 144.96658911"
361920250522,36,2025-05-22,19,101,123,224,Que85_T,"-37.81652527, 144.96121062"
472320240928,47,2024-09-28,23,247,254,501,Eli250_T,"-37.81258467, 144.9625775"
451020250521,45,2025-05-21,10,405,324,729,Swa148_T,"-37.81414075, 144.96609379"
5420240404,5,2024-04-04,4,17,6,23,PriNW_T,"-37.81874249, 144.96787656"
211720250916,21,2025-09-16,17,221,187,408,Bourke155_T,"-37.81267313, 144.96788288"
21520250920,21,2025-09-20,5,6,4,10,Bourke155_T,"-37.81267313, 144.96788288"
1081620240101,108,2024-01-01,16,87,90,177,261Will_T,"-37.81295822, 144.95678789"
87820250122,87,2025-01-22,8,60,55,115,Errol23_T,"-37.80454949, 144.94921863"
871620250926,87,2025-09-26,16,113,108,221,Errol23_T,"-37.80454949, 144.94921863"
61220250124,61,2025-01-24,2,18,7,25,RMIT14_T,"-37.80767455, 144.96309114"
501220240205,50,2024-02-05,12,166,196,362,Lyg309_T,"-37.79808192, 144.96721013"
50220240526,50,2024-05-26,2,0,3,3,Lyg309_T,"-37.79808192, 144.96721013"
44520250808,44,2025-08-08,5,0,4,4,UM3_T,"-37.79698741, 144.96441306"
1661920250510,166,2025-05-10,19,95,34,129,Spen484_T,"-37.80896733, 144.94931703"
492120240930,49,2024-09-30,21,161,115,276,Eli501_T,"-37.80730068, 144.95956055"
482220250423,48,2025-04-23,22,57,65,122,QVMQ_T,"-37.80631581, 144.95866697"
117520241128,117,2024-11-28,5,7,7,14,Fli114F_T,"-37.81629332, 144.97090877"
109620240704,109,2024-07-04,6,24,80,104,LatWill_T,"-37.81193681, 144.95621105"
1091120240817,109,2024-08-17,11,104,65,169,LatWill_T,"-37.81193681, 144.95621105"
49120250918,49,2025-09-18,1,26,29,55,Eli501_T,"-37.80730068, 144.95956055"
172220240426,17,2024-04-26,22,99,154,253,Col15_T,"-37.81362543, 144.97323591"
1720240813,1,2024-08-13,7,103,118,221,Bou292_T,"-37.81349441, 144.96515323"
1920241208,1,2024-12-08,9,438,668,1106,Bou292_T,"-37.81349441, 144.96515323"
631420241023,63,2024-10-23,14,351,392,743,Bou231_T,"-37.81333081, 144.96675571"
181620240602,18,2024-06-02,16,70,27,97,Col12_T,"-37.81344862, 144.97305353"
621220240419,62,2024-04-19,12,230,172,402,Lat224_T,"-37.80996494, 144.96216521"
562320240512,56,2024-05-12,23,58,44,102,Lon364_T,"-37.81234775, 144.96153311"
24120240501,24,2024-05-01,1,18,16,34,Col620_T,"-37.81887963, 144.95449198"
351720250318,35,2025-03-18,17,2693,1758,4451,SouthB_T,"-37.82018685, 144.96508508"
35720250814,35,2025-08-14,7,499,814,1313,SouthB_T,"-37.82018685, 144.96508508"
30120250506,30,2025-05-06,1,21,25,46,Lon189_T,"-37.8112185, 144.96656806"
1391320241015,139,2024-10-15,13,66,142,208,Signal1647_T,"-37.81959923, 144.9632832"
1421720251014,142,2025-10-14,17,600,444,1044,Hammer1584_T,"-37.81970749, 144.96795734"
161920240809,161,2024-08-09,9,113,123,236,BirArt1109_T,"-37.81851276, 144.97131336"
491420250313,49,2025-03-13,14,294,438,732,Eli501_T,"-37.80730068, 144.95956055"
49120240229,49,2024-02-29,1,44,41,85,Eli501_T,"-37.80730068, 144.95956055"
1091620240111,109,2024-01-11,16,354,139,493,LatWill_T,"-37.81193681, 144.95621105"
691620251011,69,2025-10-11,16,279,292,571,FLDegC_T,"-37.81687226, 144.96559144"
841320250125,84,2025-01-25,13,1198,1333,2531,ElFi_T,"-37.81798049, 144.96503383"
3720240502,3,2024-05-02,7,107,194,301,Swa295_T,"-37.81101524, 144.96429485"
8520241021,8,2024-10-21,5,8,9,17,WebBN_T,"-37.82293543, 144.9471751"
8820250212,8,2025-02-12,8,302,248,550,WebBN_T,"-37.82293543, 144.9471751"
752020241112,75,2024-11-12,20,14,22,36,SprFli_T,"-37.81515276, 144.97467661"
651420241002,65,2024-10-02,14,1001,859,1860,SwaCs_T,"-37.81569416, 144.9668064"
65520231029,65,2023-10-29,5,4,27,31,SwaCs_T,"-37.81569416, 144.9668064"
592220241116,59,2024-11-16,22,107,167,274,RMIT_T,"-37.80825648, 144.96304859"
141020240717,14,2024-07-17,10,180,93,273,SanBri_T,"-37.82011242, 144.96291897"
54120241201,54,2024-12-01,1,15,24,39,Swa607_T,"-37.804024, 144.96308399"
47020240225,47,2024-02-25,0,254,304,558,Eli250_T,"-37.81258467, 144.9625775"
471720240227,47,2024-02-27,17,1571,834,2405,Eli250_T,"-37.81258467, 144.9625775"
36720240704,36,2024-07-04,7,62,53,115,Que85_T,"-37.81652527, 144.96121062"
36320231106,36,2023-11-06,3,5,3,8,Que85_T,"-37.81652527, 144.96121062"
872120250322,87,2025-03-22,21,56,53,109,Errol23_T,"-37.80454949, 144.94921863"
871120250410,87,2025-04-10,11,124,105,229,Errol23_T,"-37.80454949, 144.94921863"
501220240901,50,2024-09-01,12,262,275,537,Lyg309_T,"-37.79808192, 144.96721013"
44620250719,44,2025-07-19,6,2,0,2,UM3_T,"-37.79698741, 144.96441306"
1652020241112,165,2024-11-12,20,42,14,56,Spen475_T,"-37.80953359, 144.94939004"
165320241202,165,2024-12-02,3,2,2,4,Spen475_T,"-37.80953359, 144.94939004"
1322320250912,132,2025-09-12,23,79,59,138,King335_T,"-37.81267639, 144.95386444"
135320241017,135,2024-10-17,3,21,10,31,Spen161_T,"-37.8172861, 144.95319102"
1352020250507,135,2025-05-07,20,101,123,224,Spen161_T,"-37.8172861, 144.95319102"
1351820240314,135,2024-03-14,18,410,384,794,Spen161_T,"-37.8172861, 144.95319102"
107420240617,107,2024-06-17,4,3,2,5,280Will_T,"-37.81246271, 144.95690188"
1071320250415,107,2025-04-15,13,246,237,483,280Will_T,"-37.81246271, 144.95690188"
1181120250326,118,2025-03-26,11,13,11,24,Fli114C_T,"-37.81632783, 144.97090512"
851720240528,85,2024-05-28,17,78,100,178,488Mac_T,"-37.79432415, 144.92973378"
851420240829,85,2024-08-29,14,54,60,114,488Mac_T,"-37.79432415, 144.92973378"
851520250727,85,2025-07-27,15,52,77,129,488Mac_T,"-37.79432415, 144.92973378"
172320231025,17,2023-10-25,23,25,37,62,Col15_T,"-37.81362543, 144.97323591"
181820250531,18,2025-05-31,18,49,65,114,Col12_T,"-37.81344862, 144.97305353"
631820250727,63,2025-07-27,18,34,82,116,Bou231_T,"-37.81333081, 144.96675571"
62720231214,62,2023-12-14,7,84,82,166,Lat224_T,"-37.80996494, 144.96216521"
862220250305,86,2025-03-05,22,10,39,49,574Qub_T,"-37.80309992, 144.94908064"
111020240226,11,2024-02-26,10,48,57,105,WatCit_T,"-37.81564989, 144.93970694"
561820250707,56,2025-07-07,18,405,450,855,Lon364_T,"-37.81234775, 144.96153311"
121620250617,12,2025-06-17,16,117,150,267,NewQ_T,"-37.81457988, 144.94292398"
281220250115,28,2025-01-15,12,1194,1672,2866,VAC_T,"-37.82129925, 144.96879309"
40720250206,40,2025-02-06,7,108,97,205,Spr201_T,"-37.80999341, 144.97227587"
31120250330,31,2025-03-30,1,21,57,78,Lyg161_T,"-37.80169681, 144.96658911"
312320241105,31,2024-11-05,23,27,72,99,Lyg161_T,"-37.80169681, 144.96658911"
21120240502,21,2024-05-02,1,36,26,62,Bourke155_T,"-37.81267313, 144.96788288"
361220250326,36,2025-03-26,12,428,281,709,Que85_T,"-37.81652527, 144.96121062"
1081220240711,108,2024-07-11,12,181,310,491,261Will_T,"-37.81295822, 144.95678789"
87720231113,87,2023-11-13,7,28,23,51,Errol23_T,"-37.80454949, 144.94921863"
611620250730,61,2025-07-30,16,763,773,1536,RMIT14_T,"-37.80767455, 144.96309114"
502120241225,50,2024-12-25,21,32,20,52,Lyg309_T,"-37.79808192, 144.96721013"
431220250829,43,2025-08-29,12,186,412,598,UM2_T,"-37.79844526, 144.96411782"
45220250803,45,2025-08-03,2,32,154,186,Swa148_T,"-37.81414075, 144.96609379"
452220241109,45,2024-11-09,22,349,674,1023,Swa148_T,"-37.81414075, 144.96609379"
45420241124,45,2024-11-24,4,8,45,53,Swa148_T,"-37.81414075, 144.96609379"
1812120250331,181,2025-03-31,21,698,545,1243,Eli368_T,"-37.81009465, 144.96143149"
1311620250331,131,2025-03-31,16,107,109,216,King2_T,"-37.82009057, 144.95758725"
1622220250129,162,2025-01-29,22,106,146,252,Eli489_T,"-37.80740397, 144.95987909"
132720231225,132,2023-12-25,7,8,5,13,King335_T,"-37.81267639, 144.95386444"
1182120240120,118,2024-01-20,21,33,14,47,Fli114C_T,"-37.81632783, 144.97090512"
1181320240711,118,2024-07-11,13,22,31,53,Fli114C_T,"-37.81632783, 144.97090512"
1241020240109,124,2024-01-09,10,0,1,1,BirBridge_T,"-37.81757416, 144.97329934"
1081620231031,108,2023-10-31,16,1008,187,1195,261Will_T,"-37.81295822, 144.95678789"
85720250103,85,2025-01-03,7,8,5,13,488Mac_T,"-37.79432415, 144.92973378"
11720240507,11,2024-05-07,7,45,34,79,WatCit_T,"-37.81564989, 144.93970694"
67120231226,67,2023-12-26,1,11,8,19,FLDegS_T,"-37.81688755, 144.96562569"
181720241221,18,2024-12-21,17,93,108,201,Col12_T,"-37.81344862, 144.97305353"
63920250806,63,2025-08-06,9,136,170,306,Bou231_T,"-37.81333081, 144.96675571"
62520240706,62,2024-07-06,5,18,18,36,Lat224_T,"-37.80996494, 144.96216521"
62320241126,62,2024-11-26,3,12,4,16,Lat224_T,"-37.80996494, 144.96216521"
27520250221,27,2025-02-21,5,6,6,12,Vic_T,"-37.80606888, 144.95644692"
30520240203,30,2024-02-03,5,24,58,82,Lon189_T,"-37.8112185, 144.96656806"
1231420240927,123,2024-09-27,14,40,8,48,BirBridge_T,"-37.81753741, 144.97329734"
1171720241024,117,2024-10-24,17,201,565,766,Fli114F_T,"-37.81629332, 144.97090877"
117420241129,117,2024-11-29,4,2,4,6,Fli114F_T,"-37.81629332, 144.97090877"
492220250710,49,2025-07-10,22,83,117,200,Eli501_T,"-37.80730068, 144.95956055"
25520251001,25,2025-10-01,5,40,35,75,MCEC_T,"-37.82401776, 144.95604426"
461320240318,46,2024-03-18,13,176,197,373,Pel147_T,"-37.80240719, 144.9615673"
138920240929,138,2024-09-29,9,2,3,5,EntPark1671_T,"-37.81996544, 144.95981454"
842320251004,84,2025-10-04,23,347,408,755,ElFi_T,"-37.81798049, 144.96503383"
41020240122,41,2024-01-22,0,277,121,398,Swa31,"-37.81668634, 144.96689733"
81420240611,8,2024-06-11,14,116,168,284,WebBN_T,"-37.82293543, 144.9471751"
78020240517,78,2024-05-17,0,1,5,6,HarEsB_T,"-37.81471642, 144.9446508"
77220250104,77,2025-01-04,2,5,14,19,HarEsP_T,"-37.81441438, 144.94433026"
761720250119,76,2025-01-19,17,25,23,48,KenMac_T,"-37.79453803, 144.93036194"
72220250413,72,2025-04-13,2,20,25,45,ACMI_T,"-37.81726338, 144.96872809"
721220240723,72,2024-07-23,12,202,281,483,ACMI_T,"-37.81726338, 144.96872809"
72120240727,72,2024-07-27,1,55,42,97,ACMI_T,"-37.81726338, 144.96872809"
35920240616,35,2024-06-16,9,643,439,1082,SouthB_T,"-37.82018685, 144.96508508"
27020240707,27,2024-07-07,0,43,9,52,Vic_T,"-37.80606888, 144.95644692"
91920240902,9,2024-09-02,19,112,53,165,Col700_T,"-37.81982992, 144.95102555"
301120250309,30,2025-03-09,11,200,330,530,Lon189_T,"-37.8112185, 144.96656806"
511320241121,51,2024-11-21,13,136,105,241,Fra118_T,"-37.80841815, 144.95906316"
192020240605,19,2024-06-05,20,272,436,708,LtB210_T,"-37.81237202, 144.96550671"
481520250212,48,2025-02-12,15,115,123,238,QVMQ_T,"-37.80631581, 144.95866697"
201620250524,20,2025-05-24,16,333,478,811,LtB170_T,"-37.81172914, 144.9682466"
1641620250104,164,2025-01-04,16,76,71,147,Lat526_T,"-37.813005, 144.95160411"
1412320241124,141,2024-11-24,23,35,87,122,474Fl_T,"-37.81997273, 144.95834911"
1371320240119,137,2024-01-19,13,27,57,84,BouHbr2353_T,"-37.81894815, 144.94612292"
1411020240729,141,2024-07-29,10,90,80,170,474Fl_T,"-37.81997273, 144.95834911"
491020250201,49,2025-02-01,10,303,387,690,Eli501_T,"-37.80730068, 144.95956055"
1172320250501,117,2025-05-01,23,33,41,74,Fli114F_T,"-37.81629332, 144.97090877"
117720250212,117,2025-02-12,7,126,67,193,Fli114F_T,"-37.81629332, 144.97090877"
491220241028,49,2024-10-28,12,334,365,699,Eli501_T,"-37.80730068, 144.95956055"
109420241111,109,2024-11-11,4,2,3,5,LatWill_T,"-37.81193681, 144.95621105"
661720240101,66,2024-01-01,17,952,956,1908,QVN_T,"-37.81057846, 144.96444294"
701520231212,70,2023-12-12,15,141,109,250,Errol20_T,"-37.80456984, 144.94946228"
32220250617,3,2025-06-17,22,291,240,531,Swa295_T,"-37.81101524, 144.96429485"
8520240603,8,2024-06-03,5,6,5,11,WebBN_T,"-37.82293543, 144.9471751"
411220241121,41,2024-11-21,12,1573,1713,3286,Swa31,"-37.81668634, 144.96689733"
411320231116,41,2023-11-16,13,1666,1459,3125,Swa31,"-37.81668634, 144.96689733"
771720240915,77,2024-09-15,17,186,99,285,HarEsP_T,"-37.81441438, 144.94433026"
591620241113,59,2024-11-13,16,342,537,879,RMIT_T,"-37.80825648, 144.96304859"
65820240222,65,2024-02-22,8,511,195,706,SwaCs_T,"-37.81569416, 144.9668064"
651520240528,65,2024-05-28,15,400,442,842,SwaCs_T,"-37.81569416, 144.9668064"
142320231021,14,2023-10-21,23,432,80,512,SanBri_T,"-37.82011242, 144.96291897"
541920250507,54,2025-05-07,19,111,211,322,Swa607_T,"-37.804024, 144.96308399"
54920240418,54,2024-04-18,9,210,58,268,Swa607_T,"-37.804024, 144.96308399"
54620240512,54,2024-05-12,6,6,2,8,Swa607_T,"-37.804024, 144.96308399"
5520250622,5,2025-06-22,5,15,21,36,PriNW_T,"-37.81874249, 144.96787656"
37620240926,37,2024-09-26,6,5,4,9,Lyg260_T,"-37.80107122, 144.96704554"
371320240304,37,2024-03-04,13,117,123,240,Lyg260_T,"-37.80107122, 144.96704554"
611420250216,61,2025-02-16,14,831,728,1559,RMIT14_T,"-37.80767455, 144.96309114"
43520250114,43,2025-01-14,5,2,1,3,UM2_T,"-37.79844526, 144.96411782"
43620251001,43,2025-10-01,6,17,10,27,UM2_T,"-37.79844526, 144.96411782"
131820250126,131,2025-01-26,8,37,34,71,King2_T,"-37.82009057, 144.95758725"
167020240827,167,2024-08-27,0,0,1,1,Lat526_T,"-37.81304149, 144.95155955"
182120250425,182,2025-04-25,1,216,128,344,King163_T,"-37.81627451, 144.95550503"
108820250503,108,2025-05-03,8,64,91,155,261Will_T,"-37.81295822, 144.95678789"
1341220240917,134,2024-09-17,12,427,421,848,Spen201_T,"-37.81694221, 144.95303935"
592320240601,59,2024-06-01,23,179,157,336,RMIT_T,"-37.80825648, 144.96304859"
29020241106,29,2024-11-06,0,12,14,26,AG_T,"-37.8199817, 144.96872865"
471620240310,47,2024-03-10,16,722,685,1407,Eli250_T,"-37.81258467, 144.9625775"
401320241115,40,2024-11-15,13,280,259,539,Spr201_T,"-37.80999341, 144.97227587"
21120241217,21,2024-12-17,1,20,24,44,Bourke155_T,"-37.81267313, 144.96788288"
37320250611,37,2025-06-11,3,0,2,2,Lyg260_T,"-37.80107122, 144.96704554"
36920240603,36,2024-06-03,9,184,137,321,Que85_T,"-37.81652527, 144.96121062"
371320250316,37,2025-03-16,13,61,51,112,Lyg260_T,"-37.80107122, 144.96704554"
871420241231,87,2024-12-31,14,116,98,214,Errol23_T,"-37.80454949, 144.94921863"
611620251006,61,2025-10-06,16,494,790,1284,RMIT14_T,"-37.80767455, 144.96309114"
611420250510,61,2025-05-10,14,496,531,1027,RMIT14_T,"-37.80767455, 144.96309114"
50120250201,50,2025-02-01,1,11,11,22,Lyg309_T,"-37.79808192, 144.96721013"
44420241220,44,2024-12-20,4,1,2,3,UM3_T,"-37.79698741, 144.96441306"
441120240209,44,2024-02-09,11,21,9,30,UM3_T,"-37.79698741, 144.96441306"
165720241009,165,2024-10-09,7,14,35,49,Spen475_T,"-37.80953359, 144.94939004"
1401420240510,140,2024-05-10,14,102,80,182,Boyd2837_T,"-37.82590962, 144.96185972"
1842320250712,184,2025-07-12,23,196,241,437,Eli124_T,"-37.81512416, 144.96371988"
143720250405,143,2025-04-05,7,37,57,94,Spencer_T,"-37.821728, 144.95557015"
1321020250827,132,2025-08-27,10,111,72,183,King335_T,"-37.81267639, 144.95386444"
1322220241111,132,2024-11-11,22,111,75,186,King335_T,"-37.81267639, 144.95386444"
67920240622,67,2024-06-22,9,288,324,612,FLDegS_T,"-37.81688755, 144.96562569"
85520250928,85,2025-09-28,5,2,0,2,488Mac_T,"-37.79432415, 144.92973378"
17220231214,17,2023-12-14,2,3,5,8,Col15_T,"-37.81362543, 144.97323591"
171720240420,17,2024-04-20,17,401,189,590,Col15_T,"-37.81362543, 144.97323591"
63120240831,63,2024-08-31,1,82,168,250,Bou231_T,"-37.81333081, 144.96675571"
632220241104,63,2024-11-04,22,100,201,301,Bou231_T,"-37.81333081, 144.96675571"
181820250817,18,2025-08-17,18,16,31,47,Col12_T,"-37.81344862, 144.97305353"
63120231108,63,2023-11-08,1,13,24,37,Bou231_T,"-37.81333081, 144.96675571"
62520231120,62,2023-11-20,5,22,10,32,Lat224_T,"-37.80996494, 144.96216521"
621520240723,62,2024-07-23,15,242,166,408,Lat224_T,"-37.80996494, 144.96216521"
621420250102,62,2025-01-02,14,201,125,326,Lat224_T,"-37.80996494, 144.96216521"
56520240512,56,2024-05-12,5,46,7,53,Lon364_T,"-37.81234775, 144.96153311"
562320240930,56,2024-09-30,23,37,70,107,Lon364_T,"-37.81234775, 144.96153311"
10820240906,10,2024-09-06,8,40,99,139,BouHbr_T,"-37.81876474, 144.94710545"
721020250113,72,2025-01-13,10,177,198,375,ACMI_T,"-37.81726338, 144.96872809"
58220250405,58,2025-04-05,2,36,98,134,Bou688_T,"-37.81686075, 144.95358075"
2520251010,2,2025-10-10,5,4,7,11,Bou283_T,"-37.81380668, 144.96516718"
581420250908,58,2025-09-08,14,523,387,910,Bou688_T,"-37.81686075, 144.95358075"
271220250316,27,2025-03-16,12,170,189,359,Vic_T,"-37.80606888, 144.95644692"
791720231020,79,2023-10-20,17,715,608,1323,FliSS_T,"-37.81794046, 144.96616678"
531820250713,53,2025-07-13,18,231,117,348,Col254_T,"-37.81564191, 144.965499"
521320250416,52,2025-04-16,13,505,458,963,Eli263_T,"-37.81252157, 144.9619401"
521520250308,52,2025-03-08,15,380,341,721,Eli263_T,"-37.81252157, 144.9619401"
231020250808,23,2025-08-08,10,177,199,376,Col623_T,"-37.81909256, 144.95452748"
792120250720,79,2025-07-20,21,77,117,194,FliSS_T,"-37.81794046, 144.96616678"
141020241003,141,2024-10-03,0,8,16,24,474Fl_T,"-37.81997273, 144.95834911"
117420240922,117,2024-09-22,4,6,2,8,Fli114F_T,"-37.81629332, 144.97090877"
1171720241231,117,2024-12-31,17,264,134,398,Fli114F_T,"-37.81629332, 144.97090877"
192020231208,19,2023-12-08,20,757,630,1387,LtB210_T,"-37.81237202, 144.96550671"
48220240818,48,2024-08-18,2,12,25,37,QVMQ_T,"-37.80631581, 144.95866697"
134420240603,134,2024-06-03,4,29,17,46,Spen201_T,"-37.81694221, 144.95303935"
1352020250907,135,2025-09-07,20,99,122,221,Spen161_T,"-37.8172861, 144.95319102"
1331920250306,133,2025-03-06,19,628,540,1168,Spen229_T,"-37.81531435, 144.95227769"
1071920240917,107,2024-09-17,19,82,87,169,280Will_T,"-37.81246271, 144.95690188"
85120240104,85,2024-01-04,1,0,2,2,488Mac_T,"-37.79432415, 144.92973378"
851320240919,85,2024-09-19,13,76,76,152,488Mac_T,"-37.79432415, 144.92973378"
17920250308,17,2025-03-08,9,124,119,243,Col15_T,"-37.81362543, 144.97323591"
171320250515,17,2025-05-15,13,672,729,1401,Col15_T,"-37.81362543, 144.97323591"
682320241210,68,2024-12-10,23,8,0,8,FLDegN_T,"-37.8168479, 144.96559789"
18820231207,18,2023-12-07,8,181,1278,1459,Col12_T,"-37.81344862, 144.97305353"
181320240502,18,2024-05-02,13,303,258,561,Col12_T,"-37.81344862, 144.97305353"
62820241010,62,2024-10-10,8,87,140,227,Lat224_T,"-37.80996494, 144.96216521"
861120240916,86,2024-09-16,11,86,43,129,574Qub_T,"-37.80309992, 144.94908064"
12820240526,12,2024-05-26,8,55,58,113,NewQ_T,"-37.81457988, 144.94292398"
10820240115,10,2024-01-15,8,63,216,279,BouHbr_T,"-37.81876474, 144.94710545"
24620250419,24,2025-04-19,6,95,115,210,Col620_T,"-37.81887963, 144.95449198"
762220240215,76,2024-02-15,22,4,9,13,KenMac_T,"-37.79453803, 144.93036194"
351220250528,35,2025-05-28,12,901,929,1830,SouthB_T,"-37.82018685, 144.96508508"
271220231102,27,2023-11-02,12,157,154,311,Vic_T,"-37.80606888, 144.95644692"
462020240507,46,2024-05-07,20,76,53,129,Pel147_T,"-37.80240719, 144.9615673"
461520240602,46,2024-06-02,15,52,75,127,Pel147_T,"-37.80240719, 144.9615673"
482120250706,48,2025-07-06,21,64,75,139,QVMQ_T,"-37.80631581, 144.95866697"
202220250215,20,2025-02-15,22,262,516,778,LtB170_T,"-37.81172914, 144.9682466"
1642220250228,164,2025-02-28,22,47,64,111,Lat526_T,"-37.813005, 144.95160411"
139720240120,139,2024-01-20,7,16,18,34,Signal1647_T,"-37.81959923, 144.9632832"
1231120250213,123,2025-02-13,11,18,19,37,BirBridge_T,"-37.81753741, 144.97329734"
1231520250608,123,2025-06-08,15,52,20,72,BirBridge_T,"-37.81753741, 144.97329734"
117920231216,117,2023-12-16,9,69,104,173,Fli114F_T,"-37.81629332, 144.97090877"
109520240724,109,2024-07-24,5,9,16,25,LatWill_T,"-37.81193681, 144.95621105"
1091820240823,109,2024-08-23,18,234,148,382,LatWill_T,"-37.81193681, 144.95621105"
109720231205,109,2023-12-05,7,50,326,376,LatWill_T,"-37.81193681, 144.95621105"
84020240808,84,2024-08-08,0,47,44,91,ElFi_T,"-37.81798049, 144.96503383"
39720250217,39,2025-02-17,7,28,36,64,AlfPl_T,"-37.81379749, 144.96995745"
751320240115,75,2024-01-15,13,54,91,145,SprFli_T,"-37.81515276, 144.97467661"
391220240102,39,2024-01-02,12,137,103,240,AlfPl_T,"-37.81379749, 144.96995745"
751820250702,75,2025-07-02,18,12,8,20,SprFli_T,"-37.81515276, 144.97467661"
81020231130,8,2023-11-30,10,107,149,256,WebBN_T,"-37.82293543, 144.9471751"
781820240613,78,2024-06-13,18,0,7,7,HarEsB_T,"-37.81471642, 144.9446508"
71620250202,71,2025-02-02,6,9,13,22,WestWP_T,"-37.81235775, 144.97136962"
592120240509,59,2024-05-09,21,406,287,693,RMIT_T,"-37.80825648, 144.96304859"
292220240901,29,2024-09-01,22,19,42,61,AG_T,"-37.8199817, 144.96872865"
29820250721,29,2025-07-21,8,149,114,263,AG_T,"-37.8199817, 144.96872865"
31620240626,31,2024-06-26,6,11,21,32,Lyg161_T,"-37.80169681, 144.96658911"
54820241118,54,2024-11-18,8,91,33,124,Swa607_T,"-37.804024, 144.96308399"
281720250519,28,2025-05-19,17,463,831,1294,VAC_T,"-37.82129925, 144.96879309"
471820250926,47,2025-09-26,18,749,844,1593,Eli250_T,"-37.81258467, 144.9625775"
66120250223,66,2025-02-23,1,168,230,398,QVN_T,"-37.81057846, 144.96444294"
61820241016,6,2024-10-16,18,1299,978,2277,FliS_T,"-37.81911705, 144.96558255"
84120240815,84,2024-08-15,1,27,36,63,ElFi_T,"-37.81798049, 144.96503383"
4320241102,4,2024-11-02,3,32,30,62,Swa123_T,"-37.81487988, 144.9660878"
41120250221,4,2025-02-21,11,1400,898,2298,Swa123_T,"-37.81487988, 144.9660878"
75420250825,75,2025-08-25,4,2,0,2,SprFli_T,"-37.81515276, 144.97467661"
771120231229,77,2023-12-29,11,143,126,269,HarEsP_T,"-37.81441438, 144.94433026"
77820240104,77,2024-01-04,8,63,67,130,HarEsP_T,"-37.81441438, 144.94433026"
77620240910,77,2024-09-10,6,42,49,91,HarEsP_T,"-37.81441438, 144.94433026"
59820231128,59,2023-11-28,8,376,189,565,RMIT_T,"-37.80825648, 144.96304859"
59420241105,59,2024-11-05,4,4,6,10,RMIT_T,"-37.80825648, 144.96304859"
282220241209,28,2024-12-09,22,128,41,169,VAC_T,"-37.82129925, 144.96879309"
292220240803,29,2024-08-03,22,125,580,705,AG_T,"-37.8199817, 144.96872865"
14720240210,14,2024-02-10,7,87,41,128,SanBri_T,"-37.82011242, 144.96291897"
141420240702,14,2024-07-02,14,367,167,534,SanBri_T,"-37.82011242, 144.96291897"
452320240302,45,2024-03-02,23,283,539,822,Swa148_T,"-37.81414075, 144.96609379"
361420240106,36,2024-01-06,14,92,97,189,Que85_T,"-37.81652527, 144.96121062"
371020241203,37,2024-12-03,10,50,35,85,Lyg260_T,"-37.80107122, 144.96704554"
501220250307,50,2025-03-07,12,188,230,418,Lyg309_T,"-37.79808192, 144.96721013"
1652020241017,165,2024-10-17,20,34,23,57,Spen475_T,"-37.80953359, 144.94939004"
181220250819,181,2025-08-19,2,38,25,63,Eli368_T,"-37.81009465, 144.96143149"
131820241210,131,2024-12-10,8,154,35,189,King2_T,"-37.82009057, 144.95758725"
1311820250202,131,2025-02-02,18,48,52,100,King2_T,"-37.82009057, 144.95758725"
1621520250404,162,2025-04-04,15,348,625,973,Eli489_T,"-37.80740397, 144.95987909"
134420240210,134,2024-02-10,4,32,16,48,Spen201_T,"-37.81694221, 144.95303935"
1071420250311,107,2025-03-11,14,126,143,269,280Will_T,"-37.81246271, 144.95690188"
107620250715,107,2025-07-15,6,8,26,34,280Will_T,"-37.81246271, 144.95690188"
1331620231029,133,2023-10-29,16,488,535,1023,Spen229_T,"-37.81531435, 144.95227769"
185920251014,185,2025-10-14,9,388,673,1061,Eli197_T,"-37.81374643, 144.96276183"
851820240602,85,2024-06-02,18,25,24,49,488Mac_T,"-37.79432415, 144.92973378"
17220240730,17,2024-07-30,2,5,6,11,Col15_T,"-37.81362543, 144.97323591"
171620251005,17,2025-10-05,16,131,104,235,Col15_T,"-37.81362543, 144.97323591"
86120231203,86,2023-12-03,1,0,4,4,574Qub_T,"-37.80309992, 144.94908064"
86020250304,86,2025-03-04,0,1,1,2,574Qub_T,"-37.80309992, 144.94908064"
62320240203,62,2024-02-03,3,48,26,74,Lat224_T,"-37.80996494, 144.96216521"
62320250506,62,2025-05-06,3,9,12,21,Lat224_T,"-37.80996494, 144.96216521"
561320240810,56,2024-08-10,13,442,335,777,Lon364_T,"-37.81234775, 144.96153311"
241620250827,24,2025-08-27,16,457,2249,2706,Col620_T,"-37.81887963, 144.95449198"
111420250721,11,2025-07-21,14,124,95,219,WatCit_T,"-37.81564989, 144.93970694"
11820250526,11,2025-05-26,8,27,16,43,WatCit_T,"-37.81564989, 144.93970694"
721420250103,72,2025-01-03,14,281,367,648,ACMI_T,"-37.81726338, 144.96872809"
761620241210,76,2024-12-10,16,58,70,128,KenMac_T,"-37.79453803, 144.93036194"
53620240507,53,2024-05-07,6,36,32,68,Col254_T,"-37.81564191, 144.965499"
401920250317,40,2025-03-17,19,81,74,155,Spr201_T,"-37.80999341, 144.97227587"
401620250111,40,2025-01-11,16,148,134,282,Spr201_T,"-37.80999341, 144.97227587"
361220250120,36,2025-01-20,12,355,314,669,Que85_T,"-37.81652527, 144.96121062"
362120250523,36,2025-05-23,21,94,149,243,Que85_T,"-37.81652527, 144.96121062"
166420250415,166,2025-04-15,4,0,1,1,Spen484_T,"-37.80896733, 144.94931703"
1791720250413,179,2025-04-13,17,58,75,133,Pow61_T,"-37.82392385, 144.96299677"
1792020250702,179,2025-07-02,20,65,26,91,Pow61_T,"-37.82392385, 144.96299677"
1401320240611,140,2024-06-11,13,61,36,97,Boyd2837_T,"-37.82590962, 144.96185972"
1432320250823,143,2025-08-23,23,242,169,411,Spencer_T,"-37.821728, 144.95557015"
135820250209,135,2025-02-09,8,158,193,351,Spen161_T,"-37.8172861, 144.95319102"
135220251010,135,2025-10-10,2,17,11,28,Spen161_T,"-37.8172861, 144.95319102"
1071820250103,107,2025-01-03,18,75,125,200,280Will_T,"-37.81246271, 144.95690188"
107920251014,107,2025-10-14,9,148,210,358,280Will_T,"-37.81246271, 144.95690188"
1181820231107,118,2023-11-07,18,25,7,32,Fli114C_T,"-37.81632783, 144.97090512"
67820240703,67,2024-07-03,8,329,229,558,FLDegS_T,"-37.81688755, 144.96562569"
85720250603,85,2025-06-03,7,53,25,78,488Mac_T,"-37.79432415, 144.92973378"
181520250904,18,2025-09-04,15,329,136,465,Col12_T,"-37.81344862, 144.97305353"
63020250115,63,2025-01-15,0,2,17,19,Bou231_T,"-37.81333081, 144.96675571"
681320240304,68,2024-03-04,13,283,208,491,FLDegN_T,"-37.8168479, 144.96559789"
56020250305,56,2025-03-05,0,33,47,80,Lon364_T,"-37.81234775, 144.96153311"
86620231030,86,2023-10-30,6,11,4,15,574Qub_T,"-37.80309992, 144.94908064"
861320241209,86,2024-12-09,13,79,99,178,574Qub_T,"-37.80309992, 144.94908064"
86720250126,86,2025-01-26,7,10,11,21,574Qub_T,"-37.80309992, 144.94908064"
86020250505,86,2025-05-05,0,1,0,1,574Qub_T,"-37.80309992, 144.94908064"
121220240323,12,2024-03-23,12,309,185,494,NewQ_T,"-37.81457988, 144.94292398"
112120240421,11,2024-04-21,21,43,43,86,WatCit_T,"-37.81564989, 144.93970694"
11220240909,11,2024-09-09,2,6,4,10,WatCit_T,"-37.81564989, 144.93970694"
24420241207,24,2024-12-07,4,8,32,40,Col620_T,"-37.81887963, 144.95449198"
242220250108,24,2025-01-08,22,200,412,612,Col620_T,"-37.81887963, 144.95449198"
761020231210,76,2023-12-10,10,46,48,94,KenMac_T,"-37.79453803, 144.93036194"
72220250117,72,2025-01-17,2,1,3,4,ACMI_T,"-37.81726338, 144.96872809"
582220250727,58,2025-07-27,22,146,149,295,Bou688_T,"-37.81686075, 144.95358075"
271020240217,27,2024-02-17,10,197,205,402,Vic_T,"-37.80606888, 144.95644692"
791220231206,79,2023-12-06,12,537,361,898,FliSS_T,"-37.81794046, 144.96616678"
91520250323,9,2025-03-23,15,59,113,172,Col700_T,"-37.81982992, 144.95102555"
53620240917,53,2024-09-17,6,48,44,92,Col254_T,"-37.81564191, 144.965499"
531920241030,53,2024-10-30,19,268,200,468,Col254_T,"-37.81564191, 144.965499"
231320240109,23,2024-01-09,13,331,486,817,Col623_T,"-37.81909256, 144.95452748"
46020250725,46,2025-07-25,0,1,0,1,Pel147_T,"-37.80240719, 144.9615673"
201620250227,20,2025-02-27,16,227,205,432,LtB170_T,"-37.81172914, 144.9682466"
1801420250311,180,2025-03-11,14,23,20,43,Mac330_T,"-37.79497059, 144.93530329"
137920250326,137,2025-03-26,9,75,48,123,BouHbr2353_T,"-37.81894815, 144.94612292"
1371820240209,137,2024-02-09,18,24,38,62,BouHbr2353_T,"-37.81894815, 144.94612292"
1362320240416,136,2024-04-16,23,3,1,4,BirFed1120_T,"-37.8184141, 144.97357915"
1301820241119,130,2024-11-19,18,63,44,107,Bou892T,"-37.8204637, 144.94126826"
142120240205,142,2024-02-05,1,5,5,10,Hammer1584_T,"-37.81970749, 144.96795734"
1171520250321,117,2025-03-21,15,142,200,342,Fli114F_T,"-37.81629332, 144.97090877"
69620240731,69,2024-07-31,6,25,3,28,FLDegC_T,"-37.81687226, 144.96559144"
302020240422,30,2024-04-22,20,198,253,451,Lon189_T,"-37.8112185, 144.96656806"
791520231107,79,2023-11-07,15,362,267,629,FliSS_T,"-37.81794046, 144.96616678"
53020250206,53,2025-02-06,0,7,33,40,Col254_T,"-37.81564191, 144.965499"
461120241105,46,2024-11-05,11,49,37,86,Pel147_T,"-37.80240719, 144.9615673"
123820240223,123,2024-02-23,8,45,8,53,BirBridge_T,"-37.81753741, 144.97329734"
141920240531,141,2024-05-31,9,104,74,178,474Fl_T,"-37.81997273, 144.95834911"
117720250710,117,2025-07-10,7,73,37,110,Fli114F_T,"-37.81629332, 144.97090877"
1171620240411,117,2024-04-11,16,179,356,535,Fli114F_T,"-37.81629332, 144.97090877"
1172320240418,117,2024-04-18,23,107,267,374,Fli114F_T,"-37.81629332, 144.97090877"
1171320241013,117,2024-10-13,13,239,415,654,Fli114F_T,"-37.81629332, 144.97090877"
109620241101,109,2024-11-01,6,19,74,93,LatWill_T,"-37.81193681, 144.95621105"
19220231117,19,2023-11-17,2,36,42,78,LtB210_T,"-37.81237202, 144.96550671"
46720240402,46,2024-04-02,7,18,8,26,Pel147_T,"-37.80240719, 144.9615673"
462120250728,46,2025-07-28,21,1,0,1,Pel147_T,"-37.80240719, 144.9615673"
1371120240914,137,2024-09-14,11,1,8,9,BouHbr2353_T,"-37.81894815, 144.94612292"
1361220250715,136,2025-07-15,12,90,73,163,BirFed1120_T,"-37.8184141, 144.97357915"
1611220250713,161,2025-07-13,12,1309,426,1735,BirArt1109_T,"-37.81851276, 144.97131336"
164620250220,164,2025-02-20,6,23,34,57,Lat526_T,"-37.813005, 144.95160411"
161220250817,161,2025-08-17,2,0,1,1,BirArt1109_T,"-37.81851276, 144.97131336"
69420250121,69,2025-01-21,4,3,4,7,FLDegC_T,"-37.81687226, 144.96559144"
84320240220,84,2024-02-20,3,18,21,39,ElFi_T,"-37.81798049, 144.96503383"
391120240809,39,2024-08-09,11,79,56,135,AlfPl_T,"-37.81379749, 144.96995745"
412020240120,41,2024-01-20,20,1364,1137,2501,Swa31,"-37.81668634, 144.96689733"
752220250405,75,2025-04-05,22,11,17,28,SprFli_T,"-37.81515276, 144.97467661"
78220251002,78,2025-10-02,2,0,4,4,HarEsB_T,"-37.81471642, 144.9446508"
711220250219,71,2025-02-19,12,40,39,79,WestWP_T,"-37.81235775, 144.97136962"
29920250505,29,2025-05-05,9,97,127,224,AG_T,"-37.8199817, 144.96872865"
282220250726,28,2025-07-26,22,377,524,901,VAC_T,"-37.82129925, 144.96879309"
471220240127,47,2024-01-27,12,990,1069,2059,Eli250_T,"-37.81258467, 144.9625775"
47820250220,47,2025-02-20,8,252,711,963,Eli250_T,"-37.81258467, 144.9625775"
40220240721,40,2024-07-21,2,21,3,24,Spr201_T,"-37.80999341, 144.97227587"
451220241009,45,2024-10-09,12,861,830,1691,Swa148_T,"-37.81414075, 144.96609379"
871520240721,87,2024-07-21,15,53,65,118,Errol23_T,"-37.80454949, 144.94921863"
61720240217,61,2024-02-17,7,45,86,131,RMIT14_T,"-37.80767455, 144.96309114"
501620250210,50,2025-02-10,16,167,127,294,Lyg309_T,"-37.79808192, 144.96721013"
501620250316,50,2025-03-16,16,162,142,304,Lyg309_T,"-37.79808192, 144.96721013"
441420250609,44,2025-06-09,14,38,64,102,UM3_T,"-37.79698741, 144.96441306"
1651920241109,165,2024-11-09,19,42,36,78,Spen475_T,"-37.80953359, 144.94939004"
143020250423,143,2025-04-23,0,33,23,56,Spencer_T,"-37.821728, 144.95557015"
132720240810,132,2024-08-10,7,27,34,61,King335_T,"-37.81267639, 144.95386444"
1351120250701,135,2025-07-01,11,242,338,580,Spen161_T,"-37.8172861, 144.95319102"
1351720250915,135,2025-09-15,17,441,414,855,Spen161_T,"-37.8172861, 144.95319102"
1331820241203,133,2024-12-03,18,801,631,1432,Spen229_T,"-37.81531435, 144.95227769"
1181320250225,118,2025-02-25,13,33,17,50,Fli114C_T,"-37.81632783, 144.97090512"
851320250512,85,2025-05-12,13,79,83,162,488Mac_T,"-37.79432415, 144.92973378"
17520250220,17,2025-02-20,5,53,19,72,Col15_T,"-37.81362543, 144.97323591"
171920250318,17,2025-03-18,19,159,150,309,Col15_T,"-37.81362543, 144.97323591"
11020240620,11,2024-06-20,0,2,2,4,WatCit_T,"-37.81564989, 144.93970694"
671020250220,67,2025-02-20,10,408,425,833,FLDegS_T,"-37.81688755, 144.96562569"
622020240820,62,2024-08-20,20,201,100,301,Lat224_T,"-37.80996494, 144.96216521"
561420240427,56,2024-04-27,14,330,331,661,Lon364_T,"-37.81234775, 144.96153311"
241520250129,24,2025-01-29,15,539,1048,1587,Col620_T,"-37.81887963, 144.95449198"
111520240805,11,2024-08-05,15,89,77,166,WatCit_T,"-37.81564989, 144.93970694"
841320250822,84,2025-08-22,13,983,1282,2265,ElFi_T,"-37.81798049, 144.96503383"
70220240909,70,2024-09-09,2,1,1,2,Errol20_T,"-37.80456984, 144.94946228"
702120250806,70,2025-08-06,21,66,67,133,Errol20_T,"-37.80456984, 144.94946228"
3920241228,3,2024-12-28,9,212,263,475,Swa295_T,"-37.81101524, 144.96429485"
39020250705,39,2025-07-05,0,6,6,12,AlfPl_T,"-37.81379749, 144.96995745"
77220250509,77,2025-05-09,2,2,0,2,HarEsP_T,"-37.81441438, 144.94433026"
71420250220,71,2025-02-20,4,1,3,4,WestWP_T,"-37.81235775, 144.97136962"
712020250316,71,2025-03-16,20,1,0,1,WestWP_T,"-37.81235775, 144.97136962"
5120231023,5,2023-10-23,1,21,17,38,PriNW_T,"-37.81874249, 144.96787656"
21320241119,21,2024-11-19,3,3,9,12,Bourke155_T,"-37.81267313, 144.96788288"
361420250729,36,2025-07-29,14,203,190,393,Que85_T,"-37.81652527, 144.96121062"
36720241121,36,2024-11-21,7,110,80,190,Que85_T,"-37.81652527, 144.96121062"
108320240211,108,2024-02-11,3,26,19,45,261Will_T,"-37.81295822, 144.95678789"
50020240229,50,2024-02-29,0,25,3,28,Lyg309_T,"-37.79808192, 144.96721013"
43620250624,43,2025-06-24,6,11,7,18,UM2_T,"-37.79844526, 144.96411782"
432320240620,43,2024-06-20,23,19,8,27,UM2_T,"-37.79844526, 144.96411782"
451320240403,45,2024-04-03,13,469,873,1342,Swa148_T,"-37.81414075, 144.96609379"
451820240814,45,2024-08-14,18,718,750,1468,Swa148_T,"-37.81414075, 144.96609379"
451820241215,45,2024-12-15,18,486,689,1175,Swa148_T,"-37.81414075, 144.96609379"
185920251009,185,2025-10-09,9,438,795,1233,Eli197_T,"-37.81374643, 144.96276183"
1661920250525,166,2025-05-25,19,20,18,38,Spen484_T,"-37.80896733, 144.94931703"
165220250820,165,2025-08-20,2,2,0,2,Spen475_T,"-37.80953359, 144.94939004"
1811120250409,181,2025-04-09,11,523,833,1356,Eli368_T,"-37.81009465, 144.96143149"
1401220240121,140,2024-01-21,12,118,89,207,Boyd2837_T,"-37.82590962, 144.96185972"
1401720240218,140,2024-02-18,17,110,95,205,Boyd2837_T,"-37.82590962, 144.96185972"
1821220250614,182,2025-06-14,12,200,137,337,King163_T,"-37.81627451, 144.95550503"
1341820250407,134,2025-04-07,18,538,410,948,Spen201_T,"-37.81694221, 144.95303935"
1351420250323,135,2025-03-23,14,828,453,1281,Spen161_T,"-37.8172861, 144.95319102"
1071220241003,107,2024-10-03,12,221,222,443,280Will_T,"-37.81246271, 144.95690188"
1072120250203,107,2025-02-03,21,66,38,104,280Will_T,"-37.81246271, 144.95690188"
1332120250108,133,2025-01-08,21,370,346,716,Spen229_T,"-37.81531435, 144.95227769"
133120240719,133,2024-07-19,1,27,10,37,Spen229_T,"-37.81531435, 144.95227769"
1181220240107,118,2024-01-07,12,15,0,15,Fli114C_T,"-37.81632783, 144.97090512"
51020250627,51,2025-06-27,0,11,15,26,Fra118_T,"-37.80841815, 144.95906316"
511420240630,51,2024-06-30,14,150,183,333,Fra118_T,"-37.80841815, 144.95906316"
49320231024,49,2023-10-24,3,38,40,78,Eli501_T,"-37.80730068, 144.95956055"
19720240229,19,2024-02-29,7,32,30,62,LtB210_T,"-37.81237202, 144.96550671"
19320240307,19,2024-03-07,3,14,14,28,LtB210_T,"-37.81237202, 144.96550671"
20720231024,20,2023-10-24,7,34,26,60,LtB170_T,"-37.81172914, 144.9682466"
164820251010,164,2025-10-10,8,94,67,161,Lat526_T,"-37.813005, 144.95160411"
141020250110,141,2025-01-10,0,26,33,59,474Fl_T,"-37.81997273, 144.95834911"
1411320240202,141,2024-02-02,13,209,126,335,474Fl_T,"-37.81997273, 144.95834911"
139820241008,139,2024-10-08,8,13,516,529,Signal1647_T,"-37.81959923, 144.9632832"
1361520250526,136,2025-05-26,15,79,40,119,BirFed1120_T,"-37.8184141, 144.97357915"
1361220250114,136,2025-01-14,12,150,169,319,BirFed1120_T,"-37.8184141, 144.97357915"
136020250222,136,2025-02-22,0,1,0,1,BirFed1120_T,"-37.8184141, 144.97357915"
136420240122,136,2024-01-22,4,0,1,1,BirFed1120_T,"-37.8184141, 144.97357915"
491120250304,49,2025-03-04,11,318,424,742,Eli501_T,"-37.80730068, 144.95956055"
109120250511,109,2025-05-11,1,15,30,45,LatWill_T,"-37.81193681, 144.95621105"
171420231115,17,2023-11-15,14,469,393,862,Col15_T,"-37.81362543, 144.97323591"
172120250706,17,2025-07-06,21,76,62,138,Col15_T,"-37.81362543, 144.97323591"
682120231211,68,2023-12-11,21,63,6,69,FLDegN_T,"-37.8168479, 144.96559789"
18620240830,18,2024-08-30,6,1,82,83,Col12_T,"-37.81344862, 144.97305353"
68720240910,68,2024-09-10,7,46,38,84,FLDegN_T,"-37.8168479, 144.96559789"
62120231207,62,2023-12-07,1,61,48,109,Lat224_T,"-37.80996494, 144.96216521"
561820250412,56,2025-04-12,18,433,468,901,Lon364_T,"-37.81234775, 144.96153311"
122320240216,12,2024-02-16,23,68,97,165,NewQ_T,"-37.81457988, 144.94292398"
111620240219,11,2024-02-19,16,63,88,151,WatCit_T,"-37.81564989, 144.93970694"
241620240430,24,2024-04-30,16,534,2057,2591,Col620_T,"-37.81887963, 144.95449198"
102020240619,10,2024-06-19,20,30,15,45,BouHbr_T,"-37.81876474, 144.94710545"
76720240817,76,2024-08-17,7,24,7,31,KenMac_T,"-37.79453803, 144.93036194"
11420250907,11,2025-09-07,4,3,0,3,WatCit_T,"-37.81564989, 144.93970694"
21420231204,2,2023-12-04,14,752,833,1585,Bou283_T,"-37.81380668, 144.96516718"
581920250330,58,2025-03-30,19,316,254,570,Bou688_T,"-37.81686075, 144.95358075"
92020240218,9,2024-02-18,20,52,62,114,Col700_T,"-37.81982992, 144.95102555"
271720250924,27,2025-09-24,17,161,115,276,Vic_T,"-37.80606888, 144.95644692"
522220240804,52,2024-08-04,22,85,81,166,Eli263_T,"-37.81252157, 144.9619401"
28620240203,28,2024-02-03,6,38,86,124,VAC_T,"-37.82129925, 144.96879309"
541820241203,54,2024-12-03,18,83,112,195,Swa607_T,"-37.804024, 144.96308399"
54220231228,54,2023-12-28,2,4,4,8,Swa607_T,"-37.804024, 144.96308399"
471620250410,47,2025-04-10,16,1094,1018,2112,Eli250_T,"-37.81258467, 144.9625775"
36820241118,36,2024-11-18,8,243,149,392,Que85_T,"-37.81652527, 144.96121062"
50220250523,50,2025-05-23,2,1,1,2,Lyg309_T,"-37.79808192, 144.96721013"
441320240406,44,2024-04-06,13,8,13,21,UM3_T,"-37.79698741, 144.96441306"
45320250319,45,2025-03-19,3,9,31,40,Swa148_T,"-37.81414075, 144.96609379"
1661520250810,166,2025-08-10,15,80,66,146,Spen484_T,"-37.80896733, 144.94931703"
1661620251001,166,2025-10-01,16,75,60,135,Spen484_T,"-37.80896733, 144.94931703"
162720250114,162,2025-01-14,7,136,96,232,Eli489_T,"-37.80740397, 144.95987909"
143020240429,143,2024-04-29,0,59,38,97,Spencer_T,"-37.821728, 144.95557015"
134520241021,134,2024-10-21,5,83,58,141,Spen201_T,"-37.81694221, 144.95303935"
135720231027,135,2023-10-27,7,218,160,378,Spen161_T,"-37.8172861, 144.95319102"
107520241228,107,2024-12-28,5,3,19,22,280Will_T,"-37.81246271, 144.95690188"
69420250425,69,2025-04-25,4,1,2,3,FLDegC_T,"-37.81687226, 144.96559144"
691620250719,69,2025-07-19,16,177,204,381,FLDegC_T,"-37.81687226, 144.96559144"
62020250308,6,2025-03-08,20,1008,1159,2167,FliS_T,"-37.81911705, 144.96558255"
841020240404,84,2024-04-04,10,752,493,1245,ElFi_T,"-37.81798049, 144.96503383"
3620240713,3,2024-07-13,6,26,51,77,Swa295_T,"-37.81101524, 144.96429485"
391120241116,39,2024-11-16,11,66,43,109,AlfPl_T,"-37.81379749, 144.96995745"
391820250827,39,2025-08-27,18,74,34,108,AlfPl_T,"-37.81379749, 144.96995745"
75420250113,75,2025-01-13,4,2,0,2,SprFli_T,"-37.81515276, 144.97467661"
411320250425,41,2025-04-25,13,2186,1632,3818,Swa31,"-37.81668634, 144.96689733"
781720250602,78,2025-06-02,17,3,37,40,HarEsB_T,"-37.81471642, 144.9446508"
78620240424,78,2024-04-24,6,0,1,1,HarEsB_T,"-37.81471642, 144.9446508"
592020240424,59,2024-04-24,20,493,486,979,RMIT_T,"-37.80825648, 144.96304859"
67920240405,67,2024-04-05,9,284,264,548,FLDegS_T,"-37.81688755, 144.96562569"
11920250226,1,2025-02-26,19,732,471,1203,Bou292_T,"-37.81349441, 144.96515323"
1120250318,1,2025-03-18,1,13,13,26,Bou292_T,"-37.81349441, 144.96515323"
21220231216,2,2023-12-16,12,1308,1258,2566,Bou283_T,"-37.81380668, 144.96516718"
351820240924,35,2024-09-24,18,1491,1584,3075,SouthB_T,"-37.82018685, 144.96508508"
76820240614,76,2024-06-14,8,93,49,142,KenMac_T,"-37.79453803, 144.93036194"
76320240504,76,2024-05-04,3,0,1,1,KenMac_T,"-37.79453803, 144.93036194"
91120231204,9,2023-12-04,11,215,242,457,Col700_T,"-37.81982992, 144.95102555"
91520250418,9,2025-04-18,15,56,95,151,Col700_T,"-37.81982992, 144.95102555"
531020250102,53,2025-01-02,10,494,367,861,Col254_T,"-37.81564191, 144.965499"
251220231103,25,2023-11-03,12,0,0,0,MCEC_T,"-37.82401776, 144.95604426"
201320241113,20,2024-11-13,13,169,217,386,LtB170_T,"-37.81172914, 144.9682466"
202020250212,20,2025-02-12,20,150,282,432,LtB170_T,"-37.81172914, 144.9682466"
231320240818,23,2024-08-18,13,133,196,329,Col623_T,"-37.81909256, 144.95452748"
123820231217,123,2023-12-17,8,27,26,53,BirBridge_T,"-37.81753741, 144.97329734"
1231320250110,123,2025-01-10,13,39,49,88,BirBridge_T,"-37.81753741, 144.97329734"
1301920240903,130,2024-09-03,19,2,1,3,Bou892T,"-37.8204637, 144.94126826"
1302220241001,130,2024-10-01,22,4,1,5,Bou892T,"-37.8204637, 144.94126826"
117520250508,117,2025-05-08,5,13,5,18,Fli114F_T,"-37.81629332, 144.97090877"
1092120250429,109,2025-04-29,21,42,53,95,LatWill_T,"-37.81193681, 144.95621105"
191420250715,19,2025-07-15,14,465,455,920,LtB210_T,"-37.81237202, 144.96550671"
180520250924,180,2025-09-24,5,3,5,8,Mac330_T,"-37.79497059, 144.93530329"
1371120241018,137,2024-10-18,11,4,7,11,BouHbr2353_T,"-37.81894815, 144.94612292"
142620240309,142,2024-03-09,6,36,10,46,Hammer1584_T,"-37.81970749, 144.96795734"
130720250423,130,2025-04-23,7,10,15,25,Bou892T,"-37.8204637, 144.94126826"
69920250827,69,2025-08-27,9,260,146,406,FLDegC_T,"-37.81687226, 144.96559144"
70720250530,70,2025-05-30,7,24,26,50,Errol20_T,"-37.80456984, 144.94946228"
42220240916,4,2024-09-16,22,147,162,309,Swa123_T,"-37.81487988, 144.9660878"
41720250508,4,2025-05-08,17,1934,1436,3370,Swa123_T,"-37.81487988, 144.9660878"
3320240413,3,2024-04-13,3,188,124,312,Swa295_T,"-37.81101524, 144.96429485"
41820240719,41,2024-07-19,8,91,100,191,Swa31,"-37.81668634, 144.96689733"
751120250704,75,2025-07-04,11,43,37,80,SprFli_T,"-37.81515276, 144.97467661"
782220240109,78,2024-01-09,22,7,3,10,HarEsB_T,"-37.81471642, 144.9446508"
77720250109,77,2025-01-09,7,69,96,165,HarEsP_T,"-37.81441438, 144.94433026"
711820250922,71,2025-09-22,18,13,17,30,WestWP_T,"-37.81235775, 144.97136962"
29520240610,29,2024-06-10,5,3,4,7,AG_T,"-37.8199817, 144.96872865"
282020250103,28,2025-01-03,20,300,591,891,VAC_T,"-37.82129925, 144.96879309"
47720240815,47,2024-08-15,7,135,255,390,Eli250_T,"-37.81258467, 144.9625775"
312020231216,31,2023-12-16,20,255,323,578,Lyg161_T,"-37.80169681, 144.96658911"
451320240724,45,2024-07-24,13,755,919,1674,Swa148_T,"-37.81414075, 144.96609379"
37820240808,37,2024-08-08,8,19,57,76,Lyg260_T,"-37.80107122, 144.96704554"
87520250324,87,2025-03-24,5,3,0,3,Errol23_T,"-37.80454949, 144.94921863"
871720250426,87,2025-04-26,17,94,88,182,Errol23_T,"-37.80454949, 144.94921863"
61120240927,61,2024-09-27,1,52,15,67,RMIT14_T,"-37.80767455, 144.96309114"
50720250313,50,2025-03-13,7,32,42,74,Lyg309_T,"-37.79808192, 144.96721013"
44720240602,44,2024-06-02,7,7,8,15,UM3_T,"-37.79698741, 144.96441306"
1651820240919,165,2024-09-19,18,36,21,57,Spen475_T,"-37.80953359, 144.94939004"
165320241228,165,2024-12-28,3,5,2,7,Spen475_T,"-37.80953359, 144.94939004"
1311220250216,131,2025-02-16,12,126,110,236,King2_T,"-37.82009057, 144.95758725"
182520250828,182,2025-08-28,5,25,39,64,King163_T,"-37.81627451, 144.95550503"
143420241230,143,2024-12-30,4,29,5,34,Spencer_T,"-37.821728, 144.95557015"
108220250226,108,2025-02-26,2,9,7,16,261Will_T,"-37.81295822, 144.95678789"
1081920250228,108,2025-02-28,19,312,192,504,261Will_T,"-37.81295822, 144.95678789"
134420250513,134,2025-05-13,4,21,24,45,Spen201_T,"-37.81694221, 144.95303935"
135720250202,135,2025-02-02,7,83,78,161,Spen161_T,"-37.8172861, 144.95319102"
107720231227,107,2023-12-27,7,12,17,29,280Will_T,"-37.81246271, 144.95690188"
133420240617,133,2024-06-17,4,8,21,29,Spen229_T,"-37.81531435, 144.95227769"
852120240509,85,2024-05-09,21,9,12,21,488Mac_T,"-37.79432415, 144.92973378"
79220240408,79,2024-04-08,2,12,10,22,FliSS_T,"-37.81794046, 144.96616678"
23220250717,23,2025-07-17,2,6,5,11,Col623_T,"-37.81909256, 144.95452748"
48320240106,48,2024-01-06,3,9,12,21,QVMQ_T,"-37.80631581, 144.95866697"
251620250130,25,2025-01-30,16,832,469,1301,MCEC_T,"-37.82401776, 144.95604426"
52120241205,52,2024-12-05,1,5,25,30,Eli263_T,"-37.81252157, 144.9619401"
1371520250202,137,2025-02-02,15,2,16,18,BouHbr2353_T,"-37.81894815, 144.94612292"
1361820250819,136,2025-08-19,18,26,9,35,BirFed1120_T,"-37.8184141, 144.97357915"
1421420240208,142,2024-02-08,14,377,429,806,Hammer1584_T,"-37.81970749, 144.96795734"
842020240222,84,2024-02-22,20,629,964,1593,ElFi_T,"-37.81798049, 144.96503383"
661920240614,66,2024-06-14,19,1204,1227,2431,QVN_T,"-37.81057846, 144.96444294"
701320240117,70,2024-01-17,13,147,127,274,Errol20_T,"-37.80456984, 144.94946228"
70820250524,70,2025-05-24,8,38,38,76,Errol20_T,"-37.80456984, 144.94946228"
752220240607,75,2024-06-07,22,10,15,25,SprFli_T,"-37.81515276, 144.97467661"
75820250104,75,2025-01-04,8,14,18,32,SprFli_T,"-37.81515276, 144.97467661"
391820241220,39,2024-12-20,18,88,50,138,AlfPl_T,"-37.81379749, 144.96995745"
81520250826,8,2025-08-26,15,96,218,314,WebBN_T,"-37.82293543, 144.9471751"
8820250507,8,2025-05-07,8,298,225,523,WebBN_T,"-37.82293543, 144.9471751"
77920240709,77,2024-07-09,9,30,23,53,HarEsP_T,"-37.81441438, 144.94433026"
771320250523,77,2025-05-23,13,94,71,165,HarEsP_T,"-37.81441438, 144.94433026"
78320231129,78,2023-11-29,3,0,2,2,HarEsB_T,"-37.81471642, 144.9446508"
711420250522,71,2025-05-22,14,4,6,10,WestWP_T,"-37.81235775, 144.97136962"
711220240405,71,2024-04-05,12,35,36,71,WestWP_T,"-37.81235775, 144.97136962"
281620240112,28,2024-01-12,16,375,930,1305,VAC_T,"-37.82129925, 144.96879309"
31420240225,31,2024-02-25,4,11,1,12,Lyg161_T,"-37.80169681, 144.96658911"
541320241112,54,2024-11-12,13,134,132,266,Swa607_T,"-37.804024, 144.96308399"
362020250129,36,2025-01-29,20,87,89,176,Que85_T,"-37.81652527, 144.96121062"
362220241201,36,2024-12-01,22,28,21,49,Que85_T,"-37.81652527, 144.96121062"
37920241013,37,2024-10-13,9,53,32,85,Lyg260_T,"-37.80107122, 144.96704554"
371620250107,37,2025-01-07,16,134,131,265,Lyg260_T,"-37.80107122, 144.96704554"
451720241124,45,2024-11-24,17,336,816,1152,Swa148_T,"-37.81414075, 144.96609379"
5220250411,5,2025-04-11,2,10,16,26,PriNW_T,"-37.81874249, 144.96787656"
51720250508,5,2025-05-08,17,1214,901,2115,PriNW_T,"-37.81874249, 144.96787656"
1082220240811,108,2024-08-11,22,14,33,47,261Will_T,"-37.81295822, 144.95678789"
871420241226,87,2024-12-26,14,30,22,52,Errol23_T,"-37.80454949, 144.94921863"
501620231105,50,2023-11-05,16,315,262,577,Lyg309_T,"-37.79808192, 144.96721013"
501720250327,50,2025-03-27,17,204,224,428,Lyg309_T,"-37.79808192, 144.96721013"
502220240810,50,2024-08-10,22,192,97,289,Lyg309_T,"-37.79808192, 144.96721013"
431520231018,43,2023-10-18,15,257,317,574,UM2_T,"-37.79844526, 144.96411782"
431120241022,43,2024-10-22,11,83,86,169,UM2_T,"-37.79844526, 144.96411782"
167620240815,167,2024-08-15,6,0,1,1,Lat526_T,"-37.81304149, 144.95155955"
1401520240115,140,2024-01-15,15,61,55,116,Boyd2837_T,"-37.82590962, 144.96185972"
162520240919,162,2024-09-19,5,17,10,27,Eli489_T,"-37.80740397, 144.95987909"
143920250403,143,2025-04-03,9,73,132,205,Spencer_T,"-37.821728, 144.95557015"
1351420240119,135,2024-01-19,14,442,458,900,Spen161_T,"-37.8172861, 144.95319102"
1351020241219,135,2024-12-19,10,365,366,731,Spen161_T,"-37.8172861, 144.95319102"
1351520250516,135,2025-05-16,15,453,454,907,Spen161_T,"-37.8172861, 144.95319102"
118020250309,118,2025-03-09,0,13,6,19,Fli114C_T,"-37.81632783, 144.97090512"
17320250823,17,2025-08-23,3,11,10,21,Col15_T,"-37.81362543, 144.97323591"
1520240222,1,2024-02-22,5,6,6,12,Bou292_T,"-37.81349441, 144.96515323"
631720240527,63,2024-05-27,17,228,318,546,Bou231_T,"-37.81333081, 144.96675571"
631220240929,63,2024-09-29,12,192,166,358,Bou231_T,"-37.81333081, 144.96675571"
1320241225,1,2024-12-25,3,5,24,29,Bou292_T,"-37.81349441, 144.96515323"
62720240528,62,2024-05-28,7,40,53,93,Lat224_T,"-37.80996494, 144.96216521"
10420250712,10,2025-07-12,4,1,0,1,BouHbr_T,"-37.81876474, 144.94710545"
582120240504,58,2024-05-04,21,259,288,547,Bou688_T,"-37.81686075, 144.95358075"
581920231202,58,2023-12-02,19,346,217,563,Bou688_T,"-37.81686075, 144.95358075"
582320250627,58,2025-06-27,23,164,159,323,Bou688_T,"-37.81686075, 144.95358075"
531620240504,53,2024-05-04,16,758,606,1364,Col254_T,"-37.81564191, 144.965499"
53520240910,53,2024-09-10,5,7,9,16,Col254_T,"-37.81564191, 144.965499"
27820250824,27,2025-08-24,8,48,73,121,Vic_T,"-37.80606888, 144.95644692"
201620250710,20,2025-07-10,16,284,319,603,LtB170_T,"-37.81172914, 144.9682466"
521520250515,52,2025-05-15,15,506,236,742,Eli263_T,"-37.81252157, 144.9619401"
512120250302,51,2025-03-02,21,90,112,202,Fra118_T,"-37.80841815, 144.95906316"
1231020240516,123,2024-05-16,10,16,4,20,BirBridge_T,"-37.81753741, 144.97329734"
141220250218,141,2025-02-18,2,6,6,12,474Fl_T,"-37.81997273, 144.95834911"
117220250228,117,2025-02-28,2,9,7,16,Fli114F_T,"-37.81629332, 144.97090877"
19720251009,19,2025-10-09,7,33,16,49,LtB210_T,"-37.81237202, 144.96550671"
49720231203,49,2023-12-03,7,47,57,104,Eli501_T,"-37.80730068, 144.95956055"
49720240106,49,2024-01-06,7,49,51,100,Eli501_T,"-37.80730068, 144.95956055"
19420240610,19,2024-06-10,4,12,20,32,LtB210_T,"-37.81237202, 144.96550671"
48720240409,48,2024-04-09,7,80,50,130,QVMQ_T,"-37.80631581, 144.95866697"
46720240713,46,2024-07-13,7,8,5,13,Pel147_T,"-37.80240719, 144.9615673"
1801720250312,180,2025-03-12,17,58,70,128,Mac330_T,"-37.79497059, 144.93530329"
137120250817,137,2025-08-17,1,1,0,1,BouHbr2353_T,"-37.81894815, 144.94612292"
136920250612,136,2025-06-12,9,108,90,198,BirFed1120_T,"-37.8184141, 144.97357915"
164020250511,164,2025-05-11,0,9,18,27,Lat526_T,"-37.813005, 144.95160411"
1381920240320,138,2024-03-20,19,3,6,9,EntPark1671_T,"-37.81996544, 144.95981454"
1381920241208,138,2024-12-08,19,1,7,8,EntPark1671_T,"-37.81996544, 144.95981454"
842020240605,84,2024-06-05,20,458,757,1215,ElFi_T,"-37.81798049, 144.96503383"
42220240131,4,2024-01-31,22,319,282,601,Swa123_T,"-37.81487988, 144.9660878"
4920241127,4,2024-11-27,9,797,456,1253,Swa123_T,"-37.81487988, 144.9660878"
391820240801,39,2024-08-01,18,112,61,173,AlfPl_T,"-37.81379749, 144.96995745"
751120250531,75,2025-05-31,11,44,40,84,SprFli_T,"-37.81515276, 144.97467661"
411720231101,41,2023-11-01,17,1493,2073,3566,Swa31,"-37.81668634, 144.96689733"
651720240201,65,2024-02-01,17,505,937,1442,SwaCs_T,"-37.81569416, 144.9668064"
591320241126,59,2024-11-26,13,451,469,920,RMIT_T,"-37.80825648, 144.96304859"
59320241215,59,2024-12-15,3,65,13,78,RMIT_T,"-37.80825648, 144.96304859"
292220250320,29,2025-03-20,22,137,385,522,AG_T,"-37.8199817, 144.96872865"
141920241130,14,2024-11-30,19,370,167,537,SanBri_T,"-37.82011242, 144.96291897"
401820250117,40,2025-01-17,18,149,242,391,Spr201_T,"-37.80999341, 144.97227587"
212220240912,21,2024-09-12,22,128,163,291,Bourke155_T,"-37.81267313, 144.96788288"
871320250206,87,2025-02-06,13,133,141,274,Errol23_T,"-37.80454949, 144.94921863"
871020240103,87,2024-01-03,10,90,91,181,Errol23_T,"-37.80454949, 144.94921863"
611320240315,61,2024-03-15,13,635,681,1316,RMIT14_T,"-37.80767455, 144.96309114"
611020240408,61,2024-04-08,10,370,560,930,RMIT14_T,"-37.80767455, 144.96309114"
50320250705,50,2025-07-05,3,3,0,3,Lyg309_T,"-37.79808192, 144.96721013"
50620241009,50,2024-10-09,6,7,13,20,Lyg309_T,"-37.79808192, 144.96721013"
441920250323,44,2025-03-23,19,48,38,86,UM3_T,"-37.79698741, 144.96441306"
167920241122,167,2024-11-22,9,19,76,95,Lat526_T,"-37.81304149, 144.95155955"
1651920250419,165,2025-04-19,19,15,19,34,Spen475_T,"-37.80953359, 144.94939004"
165720250629,165,2025-06-29,7,8,14,22,Spen475_T,"-37.80953359, 144.94939004"
140620241224,140,2024-12-24,6,20,10,30,Boyd2837_T,"-37.82590962, 144.96185972"
140720231219,140,2023-12-19,7,55,14,69,Boyd2837_T,"-37.82590962, 144.96185972"
1621820250904,162,2025-09-04,18,254,255,509,Eli489_T,"-37.80740397, 144.95987909"
1431920250124,143,2025-01-24,19,188,254,442,Spencer_T,"-37.821728, 144.95557015"
62520240716,62,2024-07-16,5,23,5,28,Lat224_T,"-37.80996494, 144.96216521"
62120250310,62,2025-03-10,1,41,29,70,Lat224_T,"-37.80996494, 144.96216521"
12220240714,12,2024-07-14,2,2,9,11,NewQ_T,"-37.81457988, 144.94292398"
101620240503,10,2024-05-03,16,167,43,210,BouHbr_T,"-37.81876474, 144.94710545"
101920240620,10,2024-06-20,19,21,21,42,BouHbr_T,"-37.81876474, 144.94710545"
582320240423,58,2024-04-23,23,61,71,132,Bou688_T,"-37.81686075, 144.95358075"
21420240613,2,2024-06-13,14,510,485,995,Bou283_T,"-37.81380668, 144.96516718"
9120250222,9,2025-02-22,1,4,8,12,Col700_T,"-37.81982992, 144.95102555"
91720250524,9,2025-05-24,17,89,128,217,Col700_T,"-37.81982992, 144.95102555"
30920241006,30,2024-10-06,9,56,149,205,Lon189_T,"-37.8112185, 144.96656806"
511120241108,51,2024-11-08,11,93,77,170,Fra118_T,"-37.80841815, 144.95906316"
511020240521,51,2024-05-21,10,146,122,268,Fra118_T,"-37.80841815, 144.95906316"
191520250429,19,2025-04-29,15,294,303,597,LtB210_T,"-37.81237202, 144.96550671"
48020240306,48,2024-03-06,0,25,29,54,QVMQ_T,"-37.80631581, 144.95866697"
521020250902,52,2025-09-02,10,216,169,385,Eli263_T,"-37.81252157, 144.9619401"
1371920240702,137,2024-07-02,19,4,12,16,BouHbr2353_T,"-37.81894815, 144.94612292"
136020231208,136,2023-12-08,0,2,2,4,BirFed1120_T,"-37.8184141, 144.97357915"
142020240504,142,2024-05-04,0,46,42,88,Hammer1584_T,"-37.81970749, 144.96795734"
1422220240527,142,2024-05-27,22,45,26,71,Hammer1584_T,"-37.81970749, 144.96795734"
130120241130,130,2024-11-30,1,2,0,2,Bou892T,"-37.8204637, 144.94126826"
161020241207,161,2024-12-07,0,1,0,1,BirArt1109_T,"-37.81851276, 144.97131336"
138920241118,138,2024-11-18,9,1,2,3,EntPark1671_T,"-37.81996544, 144.95981454"
69520241028,69,2024-10-28,5,2,4,6,FLDegC_T,"-37.81687226, 144.96559144"
84420240103,84,2024-01-03,4,18,29,47,ElFi_T,"-37.81798049, 144.96503383"
842120241224,84,2024-12-24,21,1459,1775,3234,ElFi_T,"-37.81798049, 144.96503383"
4120240228,4,2024-02-28,1,25,19,44,Swa123_T,"-37.81487988, 144.9660878"
391720250429,39,2025-04-29,17,154,57,211,AlfPl_T,"-37.81379749, 144.96995745"
81620250114,8,2025-01-14,16,196,409,605,WebBN_T,"-37.82293543, 144.9471751"
81920250303,8,2025-03-03,19,80,137,217,WebBN_T,"-37.82293543, 144.9471751"
41020241024,41,2024-10-24,0,85,73,158,Swa31,"-37.81668634, 144.96689733"
29220240312,29,2024-03-12,2,15,5,20,AG_T,"-37.8199817, 144.96872865"
14220231101,14,2023-11-01,2,6,3,9,SanBri_T,"-37.82011242, 144.96291897"
47620240129,47,2024-01-29,6,24,138,162,Eli250_T,"-37.81258467, 144.9625775"
5220240414,5,2024-04-14,2,53,74,127,PriNW_T,"-37.81874249, 144.96787656"
51820240714,5,2024-07-14,18,468,605,1073,PriNW_T,"-37.81874249, 144.96787656"
45720240121,45,2024-01-21,7,35,52,87,Swa148_T,"-37.81414075, 144.96609379"
211420231129,21,2023-11-29,14,278,347,625,Bourke155_T,"-37.81267313, 144.96788288"
211120240423,21,2024-04-23,11,298,261,559,Bourke155_T,"-37.81267313, 144.96788288"
361720231114,36,2023-11-14,17,323,272,595,Que85_T,"-37.81652527, 144.96121062"
61620240408,61,2024-04-08,6,29,48,77,RMIT14_T,"-37.80767455, 144.96309114"
44520250323,44,2025-03-23,5,1,0,1,UM3_T,"-37.79698741, 144.96441306"
185020250712,185,2025-07-12,0,135,145,280,Eli197_T,"-37.81374643, 144.96276183"
1322220231102,132,2023-11-02,22,68,46,114,King335_T,"-37.81267639, 144.95386444"
132120240319,132,2024-03-19,1,29,18,47,King335_T,"-37.81267639, 144.95386444"
85420250903,85,2025-09-03,4,2,1,3,488Mac_T,"-37.79432415, 144.92973378"
1342120250115,134,2025-01-15,21,427,341,768,Spen201_T,"-37.81694221, 144.95303935"
135620250521,135,2025-05-21,6,36,51,87,Spen161_T,"-37.8172861, 144.95319102"
118020240226,118,2024-02-26,0,1,0,1,Fli114C_T,"-37.81632783, 144.97090512"
1181220240608,118,2024-06-08,12,17,26,43,Fli114C_T,"-37.81632783, 144.97090512"
1181020241011,118,2024-10-11,10,12,15,27,Fli114C_T,"-37.81632783, 144.97090512"
101020250715,10,2025-07-15,10,79,67,146,BouHbr_T,"-37.81876474, 144.94710545"
10420240202,10,2024-02-02,4,1,2,3,BouHbr_T,"-37.81876474, 144.94710545"
101120250925,10,2025-09-25,11,83,52,135,BouHbr_T,"-37.81876474, 144.94710545"
581320250403,58,2025-04-03,13,789,539,1328,Bou688_T,"-37.81686075, 144.95358075"
761120251013,76,2025-10-13,11,62,57,119,KenMac_T,"-37.79453803, 144.93036194"
2920250810,2,2025-08-10,9,177,270,447,Bou283_T,"-37.81380668, 144.96516718"
21120240423,2,2024-04-23,11,506,405,911,Bou283_T,"-37.81380668, 144.96516718"
532120240826,53,2024-08-26,21,98,161,259,Col254_T,"-37.81564191, 144.965499"
27320241024,27,2024-10-24,3,4,0,4,Vic_T,"-37.80606888, 144.95644692"
301520240325,30,2024-03-25,15,224,396,620,Lon189_T,"-37.8112185, 144.96656806"
92020250301,9,2025-03-01,20,54,64,118,Col700_T,"-37.81982992, 144.95102555"
201720231221,20,2023-12-21,17,359,181,540,LtB170_T,"-37.81172914, 144.9682466"
25520240527,25,2024-05-27,5,21,26,47,MCEC_T,"-37.82401776, 144.95604426"
232120240401,23,2024-04-01,21,20,54,74,Col623_T,"-37.81909256, 144.95452748"
1171520250904,117,2025-09-04,15,130,181,311,Fli114F_T,"-37.81629332, 144.97090877"
481220250403,48,2025-04-03,12,376,245,621,QVMQ_T,"-37.80631581, 144.95866697"
109120240710,109,2024-07-10,1,6,3,9,LatWill_T,"-37.81193681, 144.95621105"
49120250609,49,2025-06-09,1,30,31,61,Eli501_T,"-37.80730068, 144.95956055"
19120250216,19,2025-02-16,1,72,125,197,LtB210_T,"-37.81237202, 144.96550671"
48120240403,48,2024-04-03,1,9,15,24,QVMQ_T,"-37.80631581, 144.95866697"
252320241015,25,2024-10-15,23,56,46,102,MCEC_T,"-37.82401776, 144.95604426"
1412120250930,141,2025-09-30,21,45,71,116,474Fl_T,"-37.81997273, 144.95834911"
1371120240129,137,2024-01-29,11,19,57,76,BouHbr2353_T,"-37.81894815, 144.94612292"
1372220250306,137,2025-03-06,22,0,3,3,BouHbr2353_T,"-37.81894815, 144.94612292"
671120250503,67,2025-05-03,11,417,440,857,FLDegS_T,"-37.81688755, 144.96562569"
1120240930,1,2024-09-30,1,8,15,23,Bou292_T,"-37.81349441, 144.96515323"
242120231125,24,2023-11-25,21,456,346,802,Col620_T,"-37.81887963, 144.95449198"
121020241101,12,2024-11-01,10,93,112,205,NewQ_T,"-37.81457988, 144.94292398"
6620240214,6,2024-02-14,6,204,312,516,FliS_T,"-37.81911705, 144.96558255"
842220240130,84,2024-01-30,22,389,487,876,ElFi_T,"-37.81798049, 144.96503383"
3320231208,3,2023-12-08,3,102,61,163,Swa295_T,"-37.81101524, 144.96429485"
81820250506,8,2025-05-06,18,60,60,120,WebBN_T,"-37.82293543, 144.9471751"
78620240505,78,2024-05-05,6,1,2,3,HarEsB_T,"-37.81471642, 144.9446508"
711820241129,71,2024-11-29,18,14,21,35,WestWP_T,"-37.81235775, 144.97136962"
711320250210,71,2025-02-10,13,20,15,35,WestWP_T,"-37.81235775, 144.97136962"
592220241021,59,2024-10-21,22,135,132,267,RMIT_T,"-37.80825648, 144.96304859"
281520240421,28,2024-04-21,15,1199,774,1973,VAC_T,"-37.82129925, 144.96879309"
172020231102,17,2023-11-02,20,81,124,205,Col15_T,"-37.81362543, 144.97323591"
171820250605,17,2025-06-05,18,155,308,463,Col15_T,"-37.81362543, 144.97323591"
12220231104,1,2023-11-04,22,588,201,789,Bou292_T,"-37.81349441, 144.96515323"
11220240412,1,2024-04-12,12,1376,1250,2626,Bou292_T,"-37.81349441, 144.96515323"
681220240830,68,2024-08-30,12,351,219,570,FLDegN_T,"-37.8168479, 144.96559789"
63320231218,63,2023-12-18,3,11,8,19,Bou231_T,"-37.81333081, 144.96675571"
63920240111,63,2024-01-11,9,130,142,272,Bou231_T,"-37.81333081, 144.96675571"
681320250606,68,2025-06-06,13,390,401,791,FLDegN_T,"-37.8168479, 144.96559789"
86820240507,86,2024-05-07,8,40,22,62,574Qub_T,"-37.80309992, 144.94908064"
86320240406,86,2024-04-06,3,0,2,2,574Qub_T,"-37.80309992, 144.94908064"
111420241129,11,2024-11-29,14,113,85,198,WatCit_T,"-37.81564989, 144.93970694"
101120250412,10,2025-04-12,11,54,41,95,BouHbr_T,"-37.81876474, 144.94710545"
101120250618,10,2025-06-18,11,86,59,145,BouHbr_T,"-37.81876474, 144.94710545"
721020250730,72,2025-07-30,10,181,133,314,ACMI_T,"-37.81726338, 144.96872809"
581120231104,58,2023-11-04,11,752,361,1113,Bou688_T,"-37.81686075, 144.95358075"
351220250305,35,2025-03-05,12,1258,1034,2292,SouthB_T,"-37.82018685, 144.96508508"
2820250525,2,2025-05-25,8,32,65,97,Bou283_T,"-37.81380668, 144.96516718"
21020240311,2,2024-03-11,10,223,252,475,Bou283_T,"-37.81380668, 144.96516718"
22220240515,2,2024-05-15,22,33,85,118,Bou283_T,"-37.81380668, 144.96516718"
53320240923,53,2024-09-23,3,5,4,9,Col254_T,"-37.81564191, 144.965499"
30420250809,30,2025-08-09,4,85,76,161,Lon189_T,"-37.8112185, 144.96656806"
301920240502,30,2024-05-02,19,267,419,686,Lon189_T,"-37.8112185, 144.96656806"
52720241112,52,2024-11-12,7,82,99,181,Eli263_T,"-37.81252157, 144.9619401"
251020240404,25,2024-04-04,10,169,476,645,MCEC_T,"-37.82401776, 144.95604426"
481120240325,48,2024-03-25,11,193,147,340,QVMQ_T,"-37.80631581, 144.95866697"
201420240823,20,2024-08-23,14,234,286,520,LtB170_T,"-37.81172914, 144.9682466"
137820240529,137,2024-05-29,8,97,9,106,BouHbr2353_T,"-37.81894815, 144.94612292"
1361720240204,136,2024-02-04,17,84,19,103,BirFed1120_T,"-37.8184141, 144.97357915"
117520240407,117,2024-04-07,5,5,9,14,Fli114F_T,"-37.81629332, 144.97090877"
49620241109,49,2024-11-09,6,46,49,95,Eli501_T,"-37.80730068, 144.95956055"
491120240404,49,2024-04-04,11,307,465,772,Eli501_T,"-37.80730068, 144.95956055"
1091520241127,109,2024-11-27,15,198,100,298,LatWill_T,"-37.81193681, 144.95621105"
661420240903,66,2024-09-03,14,1040,1111,2151,QVN_T,"-37.81057846, 144.96444294"
84720250816,84,2025-08-16,7,162,101,263,ElFi_T,"-37.81798049, 144.96503383"
702120250929,70,2025-09-29,21,64,53,117,Errol20_T,"-37.80456984, 144.94946228"
31120240212,3,2024-02-12,11,582,732,1314,Swa295_T,"-37.81101524, 144.96429485"
3120240216,3,2024-02-16,1,113,63,176,Swa295_T,"-37.81101524, 144.96429485"
31120241019,3,2024-10-19,11,521,754,1275,Swa295_T,"-37.81101524, 144.96429485"
8920250723,8,2025-07-23,9,218,117,335,WebBN_T,"-37.82293543, 144.9471751"
772020240301,77,2024-03-01,20,210,187,397,HarEsP_T,"-37.81441438, 144.94433026"
781620250215,78,2025-02-15,16,18,51,69,HarEsB_T,"-37.81471642, 144.9446508"
651420240126,65,2024-01-26,14,1502,1518,3020,SwaCs_T,"-37.81569416, 144.9668064"
31320250307,31,2025-03-07,3,16,8,24,Lyg161_T,"-37.80169681, 144.96658911"
47920240331,47,2024-03-31,9,320,310,630,Eli250_T,"-37.81258467, 144.9625775"
47820241029,47,2024-10-29,8,293,705,998,Eli250_T,"-37.81258467, 144.9625775"
401820250421,40,2025-04-21,18,129,66,195,Spr201_T,"-37.80999341, 144.97227587"
51820240521,5,2024-05-21,18,563,620,1183,PriNW_T,"-37.81874249, 144.96787656"
212220241220,21,2024-12-20,22,392,346,738,Bourke155_T,"-37.81267313, 144.96788288"
21120250128,21,2025-01-28,1,20,12,32,Bourke155_T,"-37.81267313, 144.96788288"
36420241112,36,2024-11-12,4,1,0,1,Que85_T,"-37.81652527, 144.96121062"
87720240728,87,2024-07-28,7,12,10,22,Errol23_T,"-37.80454949, 144.94921863"
141420250113,14,2025-01-13,14,365,110,475,SanBri_T,"-37.82011242, 144.96291897"
14320250118,14,2025-01-18,3,32,4,36,SanBri_T,"-37.82011242, 144.96291897"
14820240610,14,2024-06-10,8,91,37,128,SanBri_T,"-37.82011242, 144.96291897"
401020250215,40,2025-02-15,10,70,77,147,Spr201_T,"-37.80999341, 144.97227587"
31320240115,31,2024-01-15,3,3,6,9,Lyg161_T,"-37.80169681, 144.96658911"
311720250513,31,2025-05-13,17,206,121,327,Lyg161_T,"-37.80169681, 144.96658911"
21220250330,21,2025-03-30,2,108,151,259,Bourke155_T,"-37.81267313, 144.96788288"
211220250605,21,2025-06-05,12,513,374,887,Bourke155_T,"-37.81267313, 144.96788288"
1661520250209,166,2025-02-09,15,50,65,115,Spen484_T,"-37.80896733, 144.94931703"
1311620240711,131,2024-07-11,16,179,126,305,King2_T,"-37.82009057, 144.95758725"
1621820250118,162,2025-01-18,18,251,289,540,Eli489_T,"-37.80740397, 144.95987909"
1431320250329,143,2025-03-29,13,247,310,557,Spencer_T,"-37.821728, 144.95557015"
134720250610,134,2025-06-10,7,186,182,368,Spen201_T,"-37.81694221, 144.95303935"
1351120240225,135,2024-02-25,11,496,590,1086,Spen161_T,"-37.8172861, 144.95319102"
1331220240605,133,2024-06-05,12,546,525,1071,Spen229_T,"-37.81531435, 144.95227769"
1241420250720,124,2025-07-20,14,8,39,47,BirBridge_T,"-37.81757416, 144.97329934"
851920231207,85,2023-12-07,19,84,81,165,488Mac_T,"-37.79432415, 144.92973378"
85020240813,85,2024-08-13,0,1,4,5,488Mac_T,"-37.79432415, 144.92973378"
171220231213,17,2023-12-13,12,783,646,1429,Col15_T,"-37.81362543, 144.97323591"
631420240111,63,2024-01-11,14,337,402,739,Bou231_T,"-37.81333081, 144.96675571"
122120231117,12,2023-11-17,21,201,182,383,NewQ_T,"-37.81457988, 144.94292398"
621920240801,62,2024-08-01,19,285,190,475,Lat224_T,"-37.80996494, 144.96216521"
621720240808,62,2024-08-08,17,343,189,532,Lat224_T,"-37.80996494, 144.96216521"
121520241218,12,2024-12-18,15,238,173,411,NewQ_T,"-37.81457988, 144.94292398"
121120231219,12,2023-12-19,11,39,71,110,NewQ_T,"-37.81457988, 144.94292398"
24320240604,24,2024-06-04,3,13,12,25,Col620_T,"-37.81887963, 144.95449198"
111920251012,11,2025-10-12,19,11,13,24,WatCit_T,"-37.81564989, 144.93970694"
581320240507,58,2024-05-07,13,744,552,1296,Bou688_T,"-37.81686075, 144.95358075"
351420231031,35,2023-10-31,14,742,880,1622,SouthB_T,"-37.82018685, 144.96508508"
76620240325,76,2024-03-25,6,13,11,24,KenMac_T,"-37.79453803, 144.93036194"
58320250629,58,2025-06-29,3,19,36,55,Bou688_T,"-37.81686075, 144.95358075"
2020240825,2,2024-08-25,0,52,94,146,Bou283_T,"-37.81380668, 144.96516718"
2020240317,2,2024-03-17,0,48,111,159,Bou283_T,"-37.81380668, 144.96516718"
30020250321,30,2025-03-21,0,90,137,227,Lon189_T,"-37.8112185, 144.96656806"
251220240110,25,2024-01-10,12,562,715,1277,MCEC_T,"-37.82401776, 144.95604426"
521920250211,52,2025-02-11,19,280,227,507,Eli263_T,"-37.81252157, 144.9619401"
521220240115,52,2024-01-15,12,373,243,616,Eli263_T,"-37.81252157, 144.9619401"
23520240623,23,2024-06-23,5,1,21,22,Col623_T,"-37.81909256, 144.95452748"
141620240921,141,2024-09-21,6,19,112,131,474Fl_T,"-37.81997273, 144.95834911"
139620240914,139,2024-09-14,6,2,3,5,Signal1647_T,"-37.81959923, 144.9632832"
1372220240306,137,2024-03-06,22,1,6,7,BouHbr2353_T,"-37.81894815, 144.94612292"
1371120250604,137,2025-06-04,11,18,56,74,BouHbr2353_T,"-37.81894815, 144.94612292"
1361820240122,136,2024-01-22,18,222,321,543,BirFed1120_T,"-37.8184141, 144.97357915"
1421620250814,142,2025-08-14,16,415,384,799,Hammer1584_T,"-37.81970749, 144.96795734"
1381120240509,138,2024-05-09,11,3,5,8,EntPark1671_T,"-37.81996544, 144.95981454"
66620250514,66,2025-05-14,6,23,87,110,QVN_T,"-37.81057846, 144.96444294"
69820250516,69,2025-05-16,8,257,83,340,FLDegC_T,"-37.81687226, 144.96559144"
6920240721,6,2024-07-21,9,425,312,737,FliS_T,"-37.81911705, 144.96558255"
4620231201,4,2023-12-01,6,140,64,204,Swa123_T,"-37.81487988, 144.9660878"
70720240909,70,2024-09-09,7,34,22,56,Errol20_T,"-37.80456984, 144.94946228"
39720250718,39,2025-07-18,7,14,8,22,AlfPl_T,"-37.81379749, 144.96995745"
421220240727,42,2024-07-27,12,79,85,164,UM1_T,"-37.80008566, 144.96386412"
711620250403,71,2025-04-03,16,27,30,57,WestWP_T,"-37.81235775, 144.97136962"
14420231210,14,2023-12-10,4,72,15,87,SanBri_T,"-37.82011242, 144.96291897"
591720250110,59,2025-01-10,17,324,514,838,RMIT_T,"-37.80825648, 144.96304859"
59120250403,59,2025-04-03,1,18,38,56,RMIT_T,"-37.80825648, 144.96304859"
28520240809,28,2024-08-09,5,21,21,42,VAC_T,"-37.82129925, 144.96879309"
281220241108,28,2024-11-08,12,405,395,800,VAC_T,"-37.82129925, 144.96879309"
28620240405,28,2024-04-05,6,111,31,142,VAC_T,"-37.82129925, 144.96879309"
29520231025,29,2023-10-25,5,15,11,26,AG_T,"-37.8199817, 144.96872865"
542120240420,54,2024-04-20,21,164,117,281,Swa607_T,"-37.804024, 144.96308399"
471520241217,47,2024-12-17,15,994,1035,2029,Eli250_T,"-37.81258467, 144.9625775"
31320241004,31,2024-10-04,3,9,2,11,Lyg161_T,"-37.80169681, 144.96658911"
37620250820,37,2025-08-20,6,9,3,12,Lyg260_T,"-37.80107122, 144.96704554"
1082220240328,108,2024-03-28,22,139,118,257,261Will_T,"-37.81295822, 144.95678789"
44020240827,44,2024-08-27,0,1,0,1,UM3_T,"-37.79698741, 144.96441306"
431820231230,43,2023-12-30,18,32,15,47,UM2_T,"-37.79844526, 144.96411782"
165220241107,165,2024-11-07,2,2,3,5,Spen475_T,"-37.80953359, 144.94939004"
1811120250510,181,2025-05-10,11,542,976,1518,Eli368_T,"-37.81009465, 144.96143149"
1431020250629,143,2025-06-29,10,80,194,274,Spencer_T,"-37.821728, 144.95557015"
1431320250120,143,2025-01-20,13,154,201,355,Spencer_T,"-37.821728, 144.95557015"
1341820240831,134,2024-08-31,18,478,375,853,Spen201_T,"-37.81694221, 144.95303935"
135720241126,135,2024-11-26,7,181,167,348,Spen161_T,"-37.8172861, 144.95319102"
1351820240425,135,2024-04-25,18,148,263,411,Spen161_T,"-37.8172861, 144.95319102"
1331120250521,133,2025-05-21,11,384,364,748,Spen229_T,"-37.81531435, 144.95227769"
851820250220,85,2025-02-20,18,71,85,156,488Mac_T,"-37.79432415, 144.92973378"
171920231112,17,2023-11-12,19,71,74,145,Col15_T,"-37.81362543, 144.97323591"
17720250112,17,2025-01-12,7,32,25,57,Col15_T,"-37.81362543, 144.97323591"
631820241024,63,2024-10-24,18,378,362,740,Bou231_T,"-37.81333081, 144.96675571"
67120250604,67,2025-06-04,1,2,6,8,FLDegS_T,"-37.81688755, 144.96562569"
121920241123,12,2024-11-23,19,243,259,502,NewQ_T,"-37.81457988, 144.94292398"
24620250216,24,2025-02-16,6,90,76,166,Col620_T,"-37.81887963, 144.95449198"
24020240714,24,2024-07-14,0,115,176,291,Col620_T,"-37.81887963, 144.95449198"
101120240624,10,2024-06-24,11,92,60,152,BouHbr_T,"-37.81876474, 144.94710545"
121920250813,12,2025-08-13,19,42,39,81,NewQ_T,"-37.81457988, 144.94292398"
721620241126,72,2024-11-26,16,130,566,696,ACMI_T,"-37.81726338, 144.96872809"
452120240929,45,2024-09-29,21,93,411,504,Swa148_T,"-37.81414075, 144.96609379"
167620250422,167,2025-04-22,6,3,12,15,Lat526_T,"-37.81304149, 144.95155955"
1401420250613,140,2025-06-13,14,93,67,160,Boyd2837_T,"-37.82590962, 144.96185972"
1311520250220,131,2025-02-20,15,130,96,226,King2_T,"-37.82009057, 144.95758725"
1342120250120,134,2025-01-20,21,554,448,1002,Spen201_T,"-37.81694221, 144.95303935"
1341820231113,134,2023-11-13,18,425,388,813,Spen201_T,"-37.81694221, 144.95303935"
1351420240106,135,2024-01-06,14,329,381,710,Spen161_T,"-37.8172861, 144.95319102"
1332120250528,133,2025-05-28,21,240,160,400,Spen229_T,"-37.81531435, 144.95227769"
133220251016,133,2025-10-16,2,11,12,23,Spen229_T,"-37.81531435, 144.95227769"
108620250717,108,2025-07-17,6,25,225,250,261Will_T,"-37.81295822, 144.95678789"
672320240101,67,2024-01-01,23,24,41,65,FLDegS_T,"-37.81688755, 144.96562569"
67120240701,67,2024-07-01,1,5,14,19,FLDegS_T,"-37.81688755, 144.96562569"
67320250207,67,2025-02-07,3,2,7,9,FLDegS_T,"-37.81688755, 144.96562569"
68120240224,68,2024-02-24,1,1,0,1,FLDegN_T,"-37.8168479, 144.96559789"
63820241020,63,2024-10-20,8,33,59,92,Bou231_T,"-37.81333081, 144.96675571"
631720241109,63,2024-11-09,17,472,416,888,Bou231_T,"-37.81333081, 144.96675571"
632120241207,63,2024-12-07,21,219,357,576,Bou231_T,"-37.81333081, 144.96675571"
681820241115,68,2024-11-15,18,216,147,363,FLDegN_T,"-37.8168479, 144.96559789"
62520231025,62,2023-10-25,5,2,3,5,Lat224_T,"-37.80996494, 144.96216521"
122120240308,12,2024-03-08,21,259,234,493,NewQ_T,"-37.81457988, 144.94292398"
12820231129,12,2023-11-29,8,44,35,79,NewQ_T,"-37.81457988, 144.94292398"
122020231130,12,2023-11-30,20,90,69,159,NewQ_T,"-37.81457988, 144.94292398"
112120240714,11,2024-07-14,21,17,18,35,WatCit_T,"-37.81564989, 144.93970694"
101020250503,10,2025-05-03,10,34,24,58,BouHbr_T,"-37.81876474, 144.94710545"
2020250123,2,2025-01-23,0,18,38,56,Bou283_T,"-37.81380668, 144.96516718"
79120240623,79,2024-06-23,1,90,99,189,FliSS_T,"-37.81794046, 144.96616678"
531520240620,53,2024-06-20,15,543,534,1077,Col254_T,"-37.81564191, 144.965499"
53220231231,53,2023-12-31,2,9,21,30,Col254_T,"-37.81564191, 144.965499"
791220241213,79,2024-12-13,12,680,491,1171,FliSS_T,"-37.81794046, 144.96616678"
52520240330,52,2024-03-30,5,10,12,22,Eli263_T,"-37.81252157, 144.9619401"
511520250303,51,2025-03-03,15,106,121,227,Fra118_T,"-37.80841815, 144.95906316"
252220240902,25,2024-09-02,22,52,53,105,MCEC_T,"-37.82401776, 144.95604426"
48220240616,48,2024-06-16,2,12,19,31,QVMQ_T,"-37.80631581, 144.95866697"
481920240727,48,2024-07-27,19,102,115,217,QVMQ_T,"-37.80631581, 144.95866697"
141320250104,141,2025-01-04,3,1,1,2,474Fl_T,"-37.81997273, 144.95834911"
1411320240606,141,2024-06-06,13,150,140,290,474Fl_T,"-37.81997273, 144.95834911"
139920241211,139,2024-12-11,9,17,111,128,Signal1647_T,"-37.81959923, 144.9632832"
139020240915,139,2024-09-15,0,7,5,12,Signal1647_T,"-37.81959923, 144.9632832"
136720241007,136,2024-10-07,7,50,75,125,BirFed1120_T,"-37.8184141, 144.97357915"
1422320240719,142,2024-07-19,23,51,14,65,Hammer1584_T,"-37.81970749, 144.96795734"
49920250513,49,2025-05-13,9,198,242,440,Eli501_T,"-37.80730068, 144.95956055"
6520250214,6,2025-02-14,5,72,84,156,FliS_T,"-37.81911705, 144.96558255"
4620250802,4,2025-08-02,6,44,43,87,Swa123_T,"-37.81487988, 144.9660878"
31320250613,3,2025-06-13,13,915,992,1907,Swa295_T,"-37.81101524, 144.96429485"
39420250418,39,2025-04-18,4,0,1,1,AlfPl_T,"-37.81379749, 144.96995745"
82020240818,8,2024-08-18,20,24,14,38,WebBN_T,"-37.82293543, 144.9471751"
75720241013,75,2024-10-13,7,36,305,341,SprFli_T,"-37.81515276, 144.97467661"
82320231108,8,2023-11-08,23,5,6,11,WebBN_T,"-37.82293543, 144.9471751"
771220250826,77,2025-08-26,12,103,36,139,HarEsP_T,"-37.81441438, 144.94433026"
711420240429,71,2024-04-29,14,14,25,39,WestWP_T,"-37.81235775, 144.97136962"
71220250527,71,2025-05-27,2,1,0,1,WestWP_T,"-37.81235775, 144.97136962"
591620240308,59,2024-03-08,16,1092,1663,2755,RMIT_T,"-37.80825648, 144.96304859"
142320231023,14,2023-10-23,23,117,29,146,SanBri_T,"-37.82011242, 144.96291897"
14220240107,14,2024-01-07,2,103,21,124,SanBri_T,"-37.82011242, 144.96291897"
31420250806,31,2025-08-06,4,6,1,7,Lyg161_T,"-37.80169681, 144.96658911"
541520240213,54,2024-02-13,15,87,222,309,Swa607_T,"-37.804024, 144.96308399"
47220241022,47,2024-10-22,2,32,19,51,Eli250_T,"-37.81258467, 144.9625775"
40520240407,40,2024-04-07,5,11,1,12,Spr201_T,"-37.80999341, 144.97227587"
5320250430,5,2025-04-30,3,19,7,26,PriNW_T,"-37.81874249, 144.96787656"
5620250825,5,2025-08-25,6,68,278,346,PriNW_T,"-37.81874249, 144.96787656"
36420231105,36,2023-11-05,4,11,6,17,Que85_T,"-37.81652527, 144.96121062"
871520250106,87,2025-01-06,15,71,85,156,Errol23_T,"-37.80454949, 144.94921863"
50020240523,50,2024-05-23,0,17,7,24,Lyg309_T,"-37.79808192, 144.96721013"
431420250218,43,2025-02-18,14,115,103,218,UM2_T,"-37.79844526, 144.96411782"
1841120250816,184,2025-08-16,11,1002,833,1835,Eli124_T,"-37.81512416, 144.96371988"
1791920250512,179,2025-05-12,19,63,66,129,Pow61_T,"-37.82392385, 144.96299677"
140620250921,140,2025-09-21,6,13,7,20,Boyd2837_T,"-37.82590962, 144.96185972"
131120240725,131,2024-07-25,1,6,12,18,King2_T,"-37.82009057, 144.95758725"
1431720241003,143,2024-10-03,17,361,381,742,Spencer_T,"-37.821728, 144.95557015"
1322320250425,132,2025-04-25,23,41,42,83,King335_T,"-37.81267639, 144.95386444"
1351320231102,135,2023-11-02,13,434,517,951,Spen161_T,"-37.8172861, 144.95319102"
135420240127,135,2024-01-27,4,14,22,36,Spen161_T,"-37.8172861, 144.95319102"
172120231102,17,2023-11-02,21,83,83,166,Col15_T,"-37.81362543, 144.97323591"
17620250401,17,2025-04-01,6,147,54,201,Col15_T,"-37.81362543, 144.97323591"
56920231224,56,2023-12-24,9,156,66,222,Lon364_T,"-37.81234775, 144.96153311"
56120240320,56,2024-03-20,1,20,20,40,Lon364_T,"-37.81234775, 144.96153311"
56520250506,56,2025-05-06,5,7,7,14,Lon364_T,"-37.81234775, 144.96153311"
562120250530,56,2025-05-30,21,281,376,657,Lon364_T,"-37.81234775, 144.96153311"
101320240608,10,2024-06-08,13,48,37,85,BouHbr_T,"-37.81876474, 144.94710545"
761320250513,76,2025-05-13,13,70,74,144,KenMac_T,"-37.79453803, 144.93036194"
721920240624,72,2024-06-24,19,48,75,123,ACMI_T,"-37.81726338, 144.96872809"
58520240823,58,2024-08-23,5,60,24,84,Bou688_T,"-37.81686075, 144.95358075"
582120240916,58,2024-09-16,21,149,177,326,Bou688_T,"-37.81686075, 144.95358075"
351420240817,35,2024-08-17,14,1282,1409,2691,SouthB_T,"-37.82018685, 144.96508508"
2320240319,2,2024-03-19,3,4,5,9,Bou283_T,"-37.81380668, 144.96516718"
581020250103,58,2025-01-03,10,514,182,696,Bou688_T,"-37.81686075, 144.95358075"
27620240610,27,2024-06-10,6,9,8,17,Vic_T,"-37.80606888, 144.95644692"
91120250608,9,2025-06-08,11,43,66,109,Col700_T,"-37.81982992, 144.95102555"
9420240808,9,2024-08-08,4,4,2,6,Col700_T,"-37.81982992, 144.95102555"
532020240806,53,2024-08-06,20,96,191,287,Col254_T,"-37.81564191, 144.965499"
52420240925,52,2024-09-25,4,2,12,14,Eli263_T,"-37.81252157, 144.9619401"
52320250129,52,2025-01-29,3,4,9,13,Eli263_T,"-37.81252157, 144.9619401"
522120231205,52,2023-12-05,21,201,149,350,Eli263_T,"-37.81252157, 144.9619401"
511620231115,51,2023-11-15,16,116,107,223,Fra118_T,"-37.80841815, 144.95906316"
180920250526,180,2025-05-26,9,26,13,39,Mac330_T,"-37.79497059, 144.93530329"
68520241126,68,2024-11-26,5,2,0,2,FLDegN_T,"-37.8168479, 144.96559789"
621420250605,62,2025-06-05,14,188,218,406,Lat224_T,"-37.80996494, 144.96216521"
561720241007,56,2024-10-07,17,344,360,704,Lon364_T,"-37.81234775, 144.96153311"
562020241226,56,2024-12-26,20,316,388,704,Lon364_T,"-37.81234775, 144.96153311"
861020250324,86,2025-03-24,10,48,50,98,574Qub_T,"-37.80309992, 144.94908064"
111720240117,11,2024-01-17,17,138,106,244,WatCit_T,"-37.81564989, 144.93970694"
24620231026,24,2023-10-26,6,365,122,487,Col620_T,"-37.81887963, 144.95449198"
12020241224,12,2024-12-24,0,12,21,33,NewQ_T,"-37.81457988, 144.94292398"
241020250627,24,2025-06-27,10,669,385,1054,Col620_T,"-37.81887963, 144.95449198"
56920250825,56,2025-08-25,9,182,191,373,Lon364_T,"-37.81234775, 144.96153311"
101520250723,10,2025-07-23,15,164,65,229,BouHbr_T,"-37.81876474, 144.94710545"
21620240527,2,2024-05-27,16,474,432,906,Bou283_T,"-37.81380668, 144.96516718"
27520250902,27,2025-09-02,5,4,2,6,Vic_T,"-37.80606888, 144.95644692"
9520240211,9,2024-02-11,5,3,4,7,Col700_T,"-37.81982992, 144.95102555"
302120250218,30,2025-02-18,21,187,303,490,Lon189_T,"-37.8112185, 144.96656806"
302220250521,30,2025-05-21,22,156,299,455,Lon189_T,"-37.8112185, 144.96656806"
48720240125,48,2024-01-25,7,58,51,109,QVMQ_T,"-37.80631581, 144.95866697"
252020240711,25,2024-07-11,20,249,247,496,MCEC_T,"-37.82401776, 144.95604426"
251820250912,25,2025-09-12,18,612,589,1201,MCEC_T,"-37.82401776, 144.95604426"
201220240228,20,2024-02-28,12,258,234,492,LtB170_T,"-37.81172914, 144.9682466"
462120250601,46,2025-06-01,21,11,5,16,Pel147_T,"-37.80240719, 144.9615673"
511120250716,51,2025-07-16,11,84,86,170,Fra118_T,"-37.80841815, 144.95906316"
141820240919,141,2024-09-19,8,153,128,281,474Fl_T,"-37.81997273, 144.95834911"
1411120250213,141,2025-02-13,11,124,103,227,474Fl_T,"-37.81997273, 144.95834911"
139920241226,139,2024-12-26,9,72,26,98,Signal1647_T,"-37.81959923, 144.9632832"
161720250924,161,2025-09-24,7,112,212,324,BirArt1109_T,"-37.81851276, 144.97131336"
1172320250514,117,2025-05-14,23,46,43,89,Fli114F_T,"-37.81629332, 144.97090877"
109020241021,109,2024-10-21,0,19,29,48,LatWill_T,"-37.81193681, 144.95621105"
109920250118,109,2025-01-18,9,73,69,142,LatWill_T,"-37.81193681, 144.95621105"
19820250110,19,2025-01-10,8,42,31,73,LtB210_T,"-37.81237202, 144.96550671"
69420250605,69,2025-06-05,4,4,3,7,FLDegC_T,"-37.81687226, 144.96559144"
3620231202,3,2023-12-02,6,50,59,109,Swa295_T,"-37.81101524, 144.96429485"
661420240110,66,2024-01-10,14,948,826,1774,QVN_T,"-37.81057846, 144.96444294"
42320250321,4,2025-03-21,23,892,668,1560,Swa123_T,"-37.81487988, 144.9660878"
75720250105,75,2025-01-05,7,13,9,22,SprFli_T,"-37.81515276, 144.97467661"
8820240427,8,2024-04-27,8,55,99,154,WebBN_T,"-37.82293543, 144.9471751"
81320240128,8,2024-01-28,13,149,241,390,WebBN_T,"-37.82293543, 144.9471751"
412020250629,41,2025-06-29,20,444,525,969,Swa31,"-37.81668634, 144.96689733"
411220250213,41,2025-02-13,12,1477,1333,2810,Swa31,"-37.81668634, 144.96689733"
71720251009,71,2025-10-09,7,17,23,40,WestWP_T,"-37.81235775, 144.97136962"
71420250515,71,2025-05-15,4,1,0,1,WestWP_T,"-37.81235775, 144.97136962"
541920250730,54,2025-07-30,19,147,241,388,Swa607_T,"-37.804024, 144.96308399"
361320250802,36,2025-08-02,13,174,242,416,Que85_T,"-37.81652527, 144.96121062"
5420240502,5,2024-05-02,4,18,8,26,PriNW_T,"-37.81874249, 144.96787656"
21620241113,21,2024-11-13,6,19,22,41,Bourke155_T,"-37.81267313, 144.96788288"
108020241121,108,2024-11-21,0,25,17,42,261Will_T,"-37.81295822, 144.95678789"
501620250722,50,2025-07-22,16,149,98,247,Lyg309_T,"-37.79808192, 144.96721013"
1411020240921,141,2024-09-21,10,312,179,491,474Fl_T,"-37.81997273, 144.95834911"
1391120241002,139,2024-10-02,11,32,80,112,Signal1647_T,"-37.81959923, 144.9632832"
1361220250423,136,2025-04-23,12,89,87,176,BirFed1120_T,"-37.8184141, 144.97357915"
691820250206,69,2025-02-06,18,96,102,198,FLDegC_T,"-37.81687226, 144.96559144"
841020240320,84,2024-03-20,10,814,603,1417,ElFi_T,"-37.81798049, 144.96503383"
84820240513,84,2024-05-13,8,1274,364,1638,ElFi_T,"-37.81798049, 144.96503383"
842120240821,84,2024-08-21,21,454,736,1190,ElFi_T,"-37.81798049, 144.96503383"
701720240130,70,2024-01-30,17,157,140,297,Errol20_T,"-37.80456984, 144.94946228"
42520240817,42,2024-08-17,5,6,3,9,UM1_T,"-37.80008566, 144.96386412"
77820231207,77,2023-12-07,8,166,190,356,HarEsP_T,"-37.81441438, 144.94433026"
71020231130,71,2023-11-30,0,5,1,6,WestWP_T,"-37.81235775, 144.97136962"
59920250606,59,2025-06-06,9,498,266,764,RMIT_T,"-37.80825648, 144.96304859"
291820250513,29,2025-05-13,18,162,201,363,AG_T,"-37.8199817, 144.96872865"
29420240815,29,2024-08-15,4,6,0,6,AG_T,"-37.8199817, 144.96872865"
31520241201,31,2024-12-01,5,6,1,7,Lyg161_T,"-37.80169681, 144.96658911"
311420250228,31,2025-02-28,14,172,169,341,Lyg161_T,"-37.80169681, 144.96658911"
541420240619,54,2024-06-19,14,154,153,307,Swa607_T,"-37.804024, 144.96308399"
47220240604,47,2024-06-04,2,11,16,27,Eli250_T,"-37.81258467, 144.9625775"
40320231107,40,2023-11-07,3,7,5,12,Spr201_T,"-37.80999341, 144.97227587"
5620241122,5,2024-11-22,6,31,50,81,PriNW_T,"-37.81874249, 144.96787656"
51720250213,5,2025-02-13,17,247,394,641,PriNW_T,"-37.81874249, 144.96787656"
371120250801,37,2025-08-01,11,88,102,190,Lyg260_T,"-37.80107122, 144.96704554"
431320240812,43,2024-08-12,13,256,328,584,UM2_T,"-37.79844526, 144.96411782"
432220250315,43,2025-03-15,22,31,22,53,UM2_T,"-37.79844526, 144.96411782"
45220250215,45,2025-02-15,2,26,105,131,Swa148_T,"-37.81414075, 144.96609379"
1852120250727,185,2025-07-27,21,249,227,476,Eli197_T,"-37.81374643, 144.96276183"
1072120231102,107,2023-11-02,21,64,64,128,280Will_T,"-37.81246271, 144.95690188"
1432320250821,143,2025-08-21,23,113,74,187,Spencer_T,"-37.821728, 144.95557015"
1321120240705,132,2024-07-05,11,164,80,244,King335_T,"-37.81267639, 144.95386444"
1341420250118,134,2025-01-18,14,362,303,665,Spen201_T,"-37.81694221, 144.95303935"
1081820250920,108,2025-09-20,18,159,164,323,261Will_T,"-37.81295822, 144.95678789"
58520250320,58,2025-03-20,5,81,27,108,Bou688_T,"-37.81686075, 144.95358075"
272020240620,27,2024-06-20,20,74,55,129,Vic_T,"-37.80606888, 144.95644692"
792120240407,79,2024-04-07,21,154,256,410,FliSS_T,"-37.81794046, 144.96616678"
511220251004,51,2025-10-04,12,169,151,320,Fra118_T,"-37.80841815, 144.95906316"
231820240921,23,2024-09-21,18,191,188,379,Col623_T,"-37.81909256, 144.95452748"
231020250312,23,2025-03-12,10,262,284,546,Col623_T,"-37.81909256, 144.95452748"
19720250516,19,2025-05-16,7,29,17,46,LtB210_T,"-37.81237202, 144.96550671"
251220241115,25,2024-11-15,12,688,744,1432,MCEC_T,"-37.82401776, 144.95604426"
482120240112,48,2024-01-12,21,114,137,251,QVMQ_T,"-37.80631581, 144.95866697"
164720241128,164,2024-11-28,7,60,57,117,Lat526_T,"-37.813005, 144.95160411"
137620241005,137,2024-10-05,6,0,3,3,BouHbr2353_T,"-37.81894815, 144.94612292"
1411020231220,141,2023-12-20,10,108,106,214,474Fl_T,"-37.81997273, 144.95834911"
130020240929,130,2024-09-29,0,1,3,4,Bou892T,"-37.8204637, 144.94126826"
1231720250727,123,2025-07-27,17,23,36,59,BirBridge_T,"-37.81753741, 144.97329734"
1381820231127,138,2023-11-27,18,13,4,17,EntPark1671_T,"-37.81996544, 144.95981454"
841820240109,84,2024-01-09,18,939,1603,2542,ElFi_T,"-37.81798049, 144.96503383"
3220240420,3,2024-04-20,2,237,155,392,Swa295_T,"-37.81101524, 144.96429485"
82120240627,8,2024-06-27,21,21,20,41,WebBN_T,"-37.82293543, 144.9471751"
75720240807,75,2024-08-07,7,54,26,80,SprFli_T,"-37.81515276, 144.97467661"
782020240227,78,2024-02-27,20,7,18,25,HarEsB_T,"-37.81471642, 144.9446508"
77520240919,77,2024-09-19,5,2,10,12,HarEsP_T,"-37.81441438, 144.94433026"
771920250325,77,2025-03-25,19,280,205,485,HarEsP_T,"-37.81441438, 144.94433026"
78120241029,78,2024-10-29,1,0,4,4,HarEsB_T,"-37.81471642, 144.9446508"
471020251015,47,2025-10-15,10,424,581,1005,Eli250_T,"-37.81258467, 144.9625775"
40120240922,40,2024-09-22,1,28,8,36,Spr201_T,"-37.80999341, 144.97227587"
401020250925,40,2025-09-25,10,193,178,371,Spr201_T,"-37.80999341, 144.97227587"
40220241125,40,2024-11-25,2,8,7,15,Spr201_T,"-37.80999341, 144.97227587"
51020240731,5,2024-07-31,10,289,477,766,PriNW_T,"-37.81874249, 144.96787656"
52320241126,5,2024-11-26,23,123,120,243,PriNW_T,"-37.81874249, 144.96787656"
45820240202,45,2024-02-02,8,208,217,425,Swa148_T,"-37.81414075, 144.96609379"
5020231112,5,2023-11-12,0,289,224,513,PriNW_T,"-37.81874249, 144.96787656"
21820250329,21,2025-03-29,8,32,38,70,Bourke155_T,"-37.81267313, 144.96788288"
211120250808,21,2025-08-08,11,246,228,474,Bourke155_T,"-37.81267313, 144.96788288"
611120240131,61,2024-01-31,11,193,287,480,RMIT14_T,"-37.80767455, 144.96309114"
501320240306,50,2024-03-06,13,241,205,446,Lyg309_T,"-37.79808192, 144.96721013"
451420240607,45,2024-06-07,14,453,716,1169,Swa148_T,"-37.81414075, 144.96609379"
45620250118,45,2025-01-18,6,22,30,52,Swa148_T,"-37.81414075, 144.96609379"
1661420250409,166,2025-04-09,14,49,63,112,Spen484_T,"-37.80896733, 144.94931703"
1672120250326,167,2025-03-26,21,14,31,45,Lat526_T,"-37.81304149, 144.95155955"
165620241126,165,2024-11-26,6,13,16,29,Spen475_T,"-37.80953359, 144.94939004"
165020250510,165,2025-05-10,0,4,2,6,Spen475_T,"-37.80953359, 144.94939004"
1401220250212,140,2025-02-12,12,70,60,130,Boyd2837_T,"-37.82590962, 144.96185972"
182120250618,182,2025-06-18,1,23,17,40,King163_T,"-37.81627451, 144.95550503"
1431720251011,143,2025-10-11,17,676,357,1033,Spencer_T,"-37.821728, 144.95557015"
1431920240530,143,2024-05-30,19,15,30,45,Spencer_T,"-37.821728, 144.95557015"
1322320250131,132,2025-01-31,23,41,71,112,King335_T,"-37.81267639, 144.95386444"
1341320240309,134,2024-03-09,13,197,210,407,Spen201_T,"-37.81694221, 144.95303935"
135520231202,135,2023-12-02,5,33,23,56,Spen161_T,"-37.8172861, 144.95319102"
135720240523,135,2024-05-23,7,266,179,445,Spen161_T,"-37.8172861, 144.95319102"
133220250529,133,2025-05-29,2,6,2,8,Spen229_T,"-37.81531435, 144.95227769"
133720241003,133,2024-10-03,7,712,409,1121,Spen229_T,"-37.81531435, 144.95227769"
1081120231116,108,2023-11-16,11,276,297,573,261Will_T,"-37.81295822, 144.95678789"
672120231129,67,2023-11-29,21,115,125,240,FLDegS_T,"-37.81688755, 144.96562569"
671320250527,67,2025-05-27,13,440,630,1070,FLDegS_T,"-37.81688755, 144.96562569"
622020250815,62,2025-08-15,20,264,245,509,Lat224_T,"-37.80996494, 144.96216521"
622120250830,62,2025-08-30,21,246,254,500,Lat224_T,"-37.80996494, 144.96216521"
861320250214,86,2025-02-14,13,68,80,148,574Qub_T,"-37.80309992, 144.94908064"
24320231116,24,2023-11-16,3,12,10,22,Col620_T,"-37.81887963, 144.95449198"
242020250709,24,2025-07-09,20,296,490,786,Col620_T,"-37.81887963, 144.95449198"
102320250318,10,2025-03-18,23,10,5,15,BouHbr_T,"-37.81876474, 144.94710545"
761920250731,76,2025-07-31,19,23,37,60,KenMac_T,"-37.79453803, 144.93036194"
72820250126,72,2025-01-26,8,40,73,113,ACMI_T,"-37.81726338, 144.96872809"
582320240824,58,2024-08-24,23,198,190,388,Bou688_T,"-37.81686075, 144.95358075"
67920231202,67,2023-12-02,9,103,125,228,FLDegS_T,"-37.81688755, 144.96562569"
17020240319,17,2024-03-19,0,28,27,55,Col15_T,"-37.81362543, 144.97323591"
18520250501,18,2025-05-01,5,0,16,16,Col12_T,"-37.81344862, 144.97305353"
621020240916,62,2024-09-16,10,133,100,233,Lat224_T,"-37.80996494, 144.96216521"
86820240730,86,2024-07-30,8,43,23,66,574Qub_T,"-37.80309992, 144.94908064"
861120240901,86,2024-09-01,11,65,49,114,574Qub_T,"-37.80309992, 144.94908064"
24320240612,24,2024-06-12,3,14,29,43,Col620_T,"-37.81887963, 144.95449198"
10820240601,10,2024-06-01,8,18,20,38,BouHbr_T,"-37.81876474, 144.94710545"
101920250806,10,2025-08-06,19,46,32,78,BouHbr_T,"-37.81876474, 144.94710545"
35920241009,35,2024-10-09,9,1010,973,1983,SouthB_T,"-37.82018685, 144.96508508"
272120240207,27,2024-02-07,21,161,64,225,Vic_T,"-37.80606888, 144.95644692"
27420231019,27,2023-10-19,4,7,1,8,Vic_T,"-37.80606888, 144.95644692"
581720250518,58,2025-05-18,17,552,391,943,Bou688_T,"-37.81686075, 144.95358075"
53520250427,53,2025-04-27,5,8,9,17,Col254_T,"-37.81564191, 144.965499"
522020250716,52,2025-07-16,20,261,188,449,Eli263_T,"-37.81252157, 144.9619401"
201820250514,20,2025-05-14,18,452,376,828,LtB170_T,"-37.81172914, 144.9682466"
521920250420,52,2025-04-20,19,369,374,743,Eli263_T,"-37.81252157, 144.9619401"
522320250330,52,2025-03-30,23,51,50,101,Eli263_T,"-37.81252157, 144.9619401"
521320240727,52,2024-07-27,13,252,203,455,Eli263_T,"-37.81252157, 144.9619401"
461420240926,46,2024-09-26,14,85,53,138,Pel147_T,"-37.80240719, 144.9615673"
123920250906,123,2025-09-06,9,38,30,68,BirBridge_T,"-37.81753741, 144.97329734"
492220241020,49,2024-10-20,22,112,88,200,Eli501_T,"-37.80730068, 144.95956055"
19720240501,19,2024-05-01,7,32,23,55,LtB210_T,"-37.81237202, 144.96550671"
25520250828,25,2025-08-28,5,14,27,41,MCEC_T,"-37.82401776, 144.95604426"
251220250516,25,2025-05-16,12,572,502,1074,MCEC_T,"-37.82401776, 144.95604426"
1801620250414,180,2025-04-14,16,59,40,99,Mac330_T,"-37.79497059, 144.93530329"
137920250421,137,2025-04-21,9,10,3,13,BouHbr2353_T,"-37.81894815, 144.94612292"
1371520250510,137,2025-05-10,15,6,117,123,BouHbr2353_T,"-37.81894815, 144.94612292"
1361820231219,136,2023-12-19,18,137,98,235,BirFed1120_T,"-37.8184141, 144.97357915"
1421720250712,142,2025-07-12,17,571,530,1101,Hammer1584_T,"-37.81970749, 144.96795734"
164220250418,164,2025-04-18,2,2,3,5,Lat526_T,"-37.813005, 144.95160411"
69420240606,69,2024-06-06,4,1,1,2,FLDegC_T,"-37.81687226, 144.96559144"
84520240929,84,2024-09-29,5,49,40,89,ElFi_T,"-37.81798049, 144.96503383"
70020250107,70,2025-01-07,0,1,1,2,Errol20_T,"-37.80456984, 144.94946228"
75720240621,75,2024-06-21,7,31,27,58,SprFli_T,"-37.81515276, 144.97467661"
75720241129,75,2024-11-29,7,29,24,53,SprFli_T,"-37.81515276, 144.97467661"
41720231209,41,2023-12-09,7,206,135,341,Swa31,"-37.81668634, 144.96689733"
41520250308,41,2025-03-08,5,62,83,145,Swa31,"-37.81668634, 144.96689733"
41720250311,41,2025-03-11,7,923,312,1235,Swa31,"-37.81668634, 144.96689733"
41420250627,41,2025-06-27,4,38,60,98,Swa31,"-37.81668634, 144.96689733"
42720241103,42,2024-11-03,7,4,8,12,UM1_T,"-37.80008566, 144.96386412"
42120250924,42,2025-09-24,1,9,6,15,UM1_T,"-37.80008566, 144.96386412"
42420250116,42,2025-01-16,4,1,1,2,UM1_T,"-37.80008566, 144.96386412"
71820240117,71,2024-01-17,8,8,5,13,WestWP_T,"-37.81235775, 144.97136962"
712120250829,71,2025-08-29,21,6,2,8,WestWP_T,"-37.81235775, 144.97136962"
59220240413,59,2024-04-13,2,80,43,123,RMIT_T,"-37.80825648, 144.96304859"
29920250712,29,2025-07-12,9,124,187,311,AG_T,"-37.8199817, 144.96872865"
282220240216,28,2024-02-16,22,267,284,551,VAC_T,"-37.82129925, 144.96879309"
29220250324,29,2025-03-24,2,2,1,3,AG_T,"-37.8199817, 144.96872865"
292020240828,29,2024-08-28,20,29,107,136,AG_T,"-37.8199817, 144.96872865"
291520241007,29,2024-10-07,15,178,88,266,AG_T,"-37.8199817, 144.96872865"
141520240406,14,2024-04-06,15,486,163,649,SanBri_T,"-37.82011242, 144.96291897"
54020241001,54,2024-10-01,0,32,35,67,Swa607_T,"-37.804024, 144.96308399"
401620240410,40,2024-04-10,16,236,246,482,Spr201_T,"-37.80999341, 144.97227587"
31920241029,31,2024-10-29,9,66,67,133,Lyg161_T,"-37.80169681, 144.96658911"
1082220240604,108,2024-06-04,22,20,44,64,261Will_T,"-37.81295822, 144.95678789"
1081620240823,108,2024-08-23,16,219,157,376,261Will_T,"-37.81295822, 144.95678789"
871220240830,87,2024-08-30,12,182,156,338,Errol23_T,"-37.80454949, 144.94921863"
44520240218,44,2024-02-18,5,1,1,2,UM3_T,"-37.79698741, 144.96441306"
1401720250808,140,2025-08-08,17,115,118,233,Boyd2837_T,"-37.82590962, 144.96185972"
1431820250107,143,2025-01-07,18,166,207,373,Spencer_T,"-37.821728, 144.95557015"
108420250412,108,2025-04-12,4,17,9,26,261Will_T,"-37.81295822, 144.95678789"
133720241223,133,2024-12-23,7,543,246,789,Spen229_T,"-37.81531435, 144.95227769"
133420250307,133,2025-03-07,4,11,36,47,Spen229_T,"-37.81531435, 144.95227769"
1072220250630,107,2025-06-30,22,32,49,81,280Will_T,"-37.81246271, 144.95690188"
1920240604,1,2024-06-04,9,235,327,562,Bou292_T,"-37.81349441, 144.96515323"
11920231020,11,2023-10-20,9,57,66,123,WatCit_T,"-37.81564989, 144.93970694"
431020231021,43,2023-10-21,10,51,39,90,UM2_T,"-37.79844526, 144.96411782"
431020240614,43,2024-06-14,10,110,104,214,UM2_T,"-37.79844526, 144.96411782"
441520240120,44,2024-01-20,15,4,4,8,UM3_T,"-37.79698741, 144.96441306"
1851620250818,185,2025-08-18,16,728,566,1294,Eli197_T,"-37.81374643, 144.96276183"
179620250330,179,2025-03-30,6,5,8,13,Pow61_T,"-37.82392385, 144.96299677"
162520250929,162,2025-09-29,5,13,7,20,Eli489_T,"-37.80740397, 144.95987909"
1321620250302,132,2025-03-02,16,129,154,283,King335_T,"-37.81267639, 144.95386444"
1321320250728,132,2025-07-28,13,156,138,294,King335_T,"-37.81267639, 144.95386444"
1311620231119,131,2023-11-19,16,122,43,165,King2_T,"-37.82009057, 144.95758725"
1182220231216,118,2023-12-16,22,45,17,62,Fli114C_T,"-37.81632783, 144.97090512"
62220240503,62,2024-05-03,2,28,27,55,Lat224_T,"-37.80996494, 144.96216521"
62120240731,62,2024-07-31,1,34,16,50,Lat224_T,"-37.80996494, 144.96216521"
561320250629,56,2025-06-29,13,351,370,721,Lon364_T,"-37.81234775, 144.96153311"
72520241004,72,2024-10-04,5,21,9,30,ACMI_T,"-37.81726338, 144.96872809"
35020241014,35,2024-10-14,0,76,126,202,SouthB_T,"-37.82018685, 144.96508508"
581420250212,58,2025-02-12,14,562,454,1016,Bou688_T,"-37.81686075, 144.95358075"
27120250917,27,2025-09-17,1,16,2,18,Vic_T,"-37.80606888, 144.95644692"
9420231202,9,2023-12-02,4,3,9,12,Col700_T,"-37.81982992, 144.95102555"
30120240829,30,2024-08-29,1,26,54,80,Lon189_T,"-37.8112185, 144.96656806"
9720241218,9,2024-12-18,7,71,1154,1225,Col700_T,"-37.81982992, 144.95102555"
231720240318,23,2024-03-18,17,160,625,785,Col623_T,"-37.81909256, 144.95452748"
232120250226,23,2025-02-26,21,71,111,182,Col623_T,"-37.81909256, 144.95452748"
23520250609,23,2025-06-09,5,4,23,27,Col623_T,"-37.81909256, 144.95452748"
30820250731,30,2025-07-31,8,99,101,200,Lon189_T,"-37.8112185, 144.96656806"
521620241219,52,2024-12-19,16,332,325,657,Eli263_T,"-37.81252157, 144.9619401"
461120250731,46,2025-07-31,11,98,101,199,Pel147_T,"-37.80240719, 144.9615673"
137920250408,137,2025-04-08,9,42,33,75,BouHbr2353_T,"-37.81894815, 144.94612292"
139620250201,139,2025-02-01,6,4,3,7,Signal1647_T,"-37.81959923, 144.9632832"
1642120241213,164,2024-12-13,21,56,79,135,Lat526_T,"-37.813005, 144.95160411"
482120250928,48,2025-09-28,21,63,108,171,QVMQ_T,"-37.80631581, 144.95866697"
180920250608,180,2025-06-08,9,21,7,28,Mac330_T,"-37.79497059, 144.93530329"
692020240825,69,2024-08-25,20,12,9,21,FLDegC_T,"-37.81687226, 144.96559144"
61220250407,6,2025-04-07,12,868,712,1580,FliS_T,"-37.81911705, 144.96558255"
841420251009,84,2025-10-09,14,885,1286,2171,ElFi_T,"-37.81798049, 144.96503383"
4420240114,4,2024-01-14,4,29,51,80,Swa123_T,"-37.81487988, 144.9660878"
41120240823,4,2024-08-23,11,1147,748,1895,Swa123_T,"-37.81487988, 144.9660878"
31620240524,3,2024-05-24,16,1101,1270,2371,Swa295_T,"-37.81101524, 144.96429485"
82320241104,8,2024-11-04,23,15,7,22,WebBN_T,"-37.82293543, 144.9471751"
41820240326,41,2024-03-26,8,2049,457,2506,Swa31,"-37.81668634, 144.96689733"
411520240116,41,2024-01-16,15,1343,1571,2914,Swa31,"-37.81668634, 144.96689733"
421920241230,42,2024-12-30,19,28,33,61,UM1_T,"-37.80008566, 144.96386412"
78320250105,78,2025-01-05,3,0,3,3,HarEsB_T,"-37.81471642, 144.9446508"
781220231124,78,2023-11-24,12,60,133,193,HarEsB_T,"-37.81471642, 144.9446508"
71320240410,71,2024-04-10,3,3,7,10,WestWP_T,"-37.81235775, 144.97136962"
122120250402,12,2025-04-02,21,220,200,420,NewQ_T,"-37.81457988, 144.94292398"
241520231201,24,2023-12-01,15,453,1004,1457,Col620_T,"-37.81887963, 144.95449198"
581220240516,58,2024-05-16,12,794,541,1335,Bou688_T,"-37.81686075, 144.95358075"
792120250417,79,2025-04-17,21,375,419,794,FliSS_T,"-37.81794046, 144.96616678"
23120240115,23,2024-01-15,1,8,24,32,Col623_T,"-37.81909256, 144.95452748"
231220240706,23,2024-07-06,12,242,228,470,Col623_T,"-37.81909256, 144.95452748"
512020250625,51,2025-06-25,20,107,73,180,Fra118_T,"-37.80841815, 144.95906316"
25320240205,25,2024-02-05,3,9,10,19,MCEC_T,"-37.82401776, 144.95604426"
251620250115,25,2025-01-15,16,852,494,1346,MCEC_T,"-37.82401776, 144.95604426"
1412220241110,141,2024-11-10,22,45,59,104,474Fl_T,"-37.81997273, 144.95834911"
1412220241125,141,2024-11-25,22,26,38,64,474Fl_T,"-37.81997273, 144.95834911"
1422220240720,142,2024-07-20,22,121,144,265,Hammer1584_T,"-37.81970749, 144.96795734"
1301020250828,130,2025-08-28,10,63,29,92,Bou892T,"-37.8204637, 144.94126826"
1611620250920,161,2025-09-20,16,4262,59,4321,BirArt1109_T,"-37.81851276, 144.97131336"
1172020250507,117,2025-05-07,20,127,76,203,Fli114F_T,"-37.81629332, 144.97090877"
117420231117,117,2023-11-17,4,5,2,7,Fli114F_T,"-37.81629332, 144.97090877"
1171920241219,117,2024-12-19,19,158,215,373,Fli114F_T,"-37.81629332, 144.97090877"
109520240916,109,2024-09-16,5,13,16,29,LatWill_T,"-37.81193681, 144.95621105"
1092320240221,109,2024-02-21,23,31,53,84,LatWill_T,"-37.81193681, 144.95621105"
69520250302,69,2025-03-02,5,1,2,3,FLDegC_T,"-37.81687226, 144.96559144"
31820250201,3,2025-02-01,18,856,1085,1941,Swa295_T,"-37.81101524, 144.96429485"
32020250304,3,2025-03-04,20,688,729,1417,Swa295_T,"-37.81101524, 144.96429485"
3320240509,3,2024-05-09,3,47,55,102,Swa295_T,"-37.81101524, 144.96429485"
39120231113,39,2023-11-13,1,1,1,2,AlfPl_T,"-37.81379749, 144.96995745"
422020251001,42,2025-10-01,20,45,45,90,UM1_T,"-37.80008566, 144.96386412"
711520241122,71,2024-11-22,15,22,14,36,WestWP_T,"-37.81235775, 144.97136962"
591520250419,59,2025-04-19,15,248,437,685,RMIT_T,"-37.80825648, 144.96304859"
142220240628,14,2024-06-28,22,331,94,425,SanBri_T,"-37.82011242, 144.96291897"
31920250917,31,2025-09-17,9,76,74,150,Lyg161_T,"-37.80169681, 144.96658911"
542020240606,54,2024-06-06,20,154,204,358,Swa607_T,"-37.804024, 144.96308399"
211220250319,21,2025-03-19,12,503,407,910,Bourke155_T,"-37.81267313, 144.96788288"
37020231109,37,2023-11-09,0,19,11,30,Lyg260_T,"-37.80107122, 144.96704554"
871220250406,87,2025-04-06,12,110,102,212,Errol23_T,"-37.80454949, 144.94921863"
87520240122,87,2024-01-22,5,3,1,4,Errol23_T,"-37.80454949, 144.94921863"
871620240624,87,2024-06-24,16,97,101,198,Errol23_T,"-37.80454949, 144.94921863"
611620241012,61,2024-10-12,16,582,443,1025,RMIT14_T,"-37.80767455, 144.96309114"
502220250402,50,2025-04-02,22,74,42,116,Lyg309_T,"-37.79808192, 144.96721013"
431320240728,43,2024-07-28,13,109,97,206,UM2_T,"-37.79844526, 144.96411782"
1311920240609,131,2024-06-09,19,110,77,187,King2_T,"-37.82009057, 144.95758725"
1622320240808,162,2024-08-08,23,75,48,123,Eli489_T,"-37.80740397, 144.95987909"
107220231105,107,2023-11-05,2,26,17,43,280Will_T,"-37.81246271, 144.95690188"
131720250322,131,2025-03-22,7,15,31,46,King2_T,"-37.82009057, 144.95758725"
135120241130,135,2024-11-30,1,68,84,152,Spen161_T,"-37.8172861, 144.95319102"
1351120250329,135,2025-03-29,11,506,511,1017,Spen161_T,"-37.8172861, 144.95319102"
1082320240628,108,2024-06-28,23,25,82,107,261Will_T,"-37.81295822, 144.95678789"
69020240101,69,2024-01-01,0,20,26,46,FLDegC_T,"-37.81687226, 144.96559144"
392020250829,39,2025-08-29,20,31,28,59,AlfPl_T,"-37.81379749, 144.96995745"
81020241129,8,2024-11-29,10,165,315,480,WebBN_T,"-37.82293543, 144.9471751"
78120231209,78,2023-12-09,1,4,23,27,HarEsB_T,"-37.81471642, 144.9446508"
291520231223,29,2023-12-23,15,394,1123,1517,AG_T,"-37.8199817, 144.96872865"
14020240228,14,2024-02-28,0,37,14,51,SanBri_T,"-37.82011242, 144.96291897"
142220240909,14,2024-09-09,22,122,42,164,SanBri_T,"-37.82011242, 144.96291897"
14820240101,14,2024-01-01,8,61,28,89,SanBri_T,"-37.82011242, 144.96291897"
141220240127,14,2024-01-27,12,400,149,549,SanBri_T,"-37.82011242, 144.96291897"
711820240206,71,2024-02-06,18,13,11,24,WestWP_T,"-37.81235775, 144.97136962"
591320240229,59,2024-02-29,13,1333,1709,3042,RMIT_T,"-37.80825648, 144.96304859"
542220250220,54,2025-02-20,22,57,73,130,Swa607_T,"-37.804024, 144.96308399"
541420240309,54,2024-03-09,14,115,100,215,Swa607_T,"-37.804024, 144.96308399"
28220241109,28,2024-11-09,2,22,10,32,VAC_T,"-37.82129925, 144.96879309"
29320241031,29,2024-10-31,3,3,4,7,AG_T,"-37.8199817, 144.96872865"
291520250627,29,2025-06-27,15,220,277,497,AG_T,"-37.8199817, 144.96872865"
40020240702,40,2024-07-02,0,10,2,12,Spr201_T,"-37.80999341, 144.97227587"
402020231019,40,2023-10-19,20,92,65,157,Spr201_T,"-37.80999341, 144.97227587"
37020240419,37,2024-04-19,0,10,8,18,Lyg260_T,"-37.80107122, 144.96704554"
431020241224,43,2024-12-24,10,25,31,56,UM2_T,"-37.79844526, 144.96411782"
43620250704,43,2025-07-04,6,5,4,9,UM2_T,"-37.79844526, 144.96411782"
441920240323,44,2024-03-23,19,13,5,18,UM3_T,"-37.79698741, 144.96441306"
1311620240226,131,2024-02-26,16,119,101,220,King2_T,"-37.82009057, 144.95758725"
1322220231112,132,2023-11-12,22,60,54,114,King335_T,"-37.81267639, 144.95386444"
135420241202,135,2024-12-02,4,17,19,36,Spen161_T,"-37.8172861, 144.95319102"
1071420250422,107,2025-04-22,14,105,110,215,280Will_T,"-37.81246271, 144.95690188"
1331920251005,133,2025-10-05,19,464,365,829,Spen229_T,"-37.81531435, 144.95227769"
1182320250728,118,2025-07-28,23,0,4,4,Fli114C_T,"-37.81632783, 144.97090512"
67320251010,67,2025-10-10,3,13,10,23,FLDegS_T,"-37.81688755, 144.96562569"
171720250116,17,2025-01-16,17,281,763,1044,Col15_T,"-37.81362543, 144.97323591"
632120250517,63,2025-05-17,21,61,210,271,Bou231_T,"-37.81333081, 144.96675571"
621120250825,62,2025-08-25,11,193,195,388,Lat224_T,"-37.80996494, 144.96216521"
631720251014,63,2025-10-14,17,439,509,948,Bou231_T,"-37.81333081, 144.96675571"
861420240102,86,2024-01-02,14,37,43,80,574Qub_T,"-37.80309992, 144.94908064"
861720241031,86,2024-10-31,17,59,80,139,574Qub_T,"-37.80309992, 144.94908064"
62720240907,62,2024-09-07,7,46,36,82,Lat224_T,"-37.80996494, 144.96216521"
561120250216,56,2025-02-16,11,327,200,527,Lon364_T,"-37.81234775, 144.96153311"
671920240314,67,2024-03-14,19,269,358,627,FLDegS_T,"-37.81688755, 144.96562569"
101220250803,10,2025-08-03,12,85,40,125,BouHbr_T,"-37.81876474, 144.94710545"
12420240925,12,2024-09-25,4,1,0,1,NewQ_T,"-37.81457988, 144.94292398"
762020240430,76,2024-04-30,20,3,18,21,KenMac_T,"-37.79453803, 144.93036194"
352120240513,35,2024-05-13,21,313,472,785,SouthB_T,"-37.82018685, 144.96508508"
58820250126,58,2025-01-26,8,194,80,274,Bou688_T,"-37.81686075, 144.95358075"
2420240710,2,2024-07-10,4,2,0,2,Bou283_T,"-37.81380668, 144.96516718"
2720240807,2,2024-08-07,7,45,73,118,Bou283_T,"-37.81380668, 144.96516718"
272220250528,27,2025-05-28,22,45,14,59,Vic_T,"-37.80606888, 144.95644692"
79120241103,79,2024-11-03,1,89,118,207,FliSS_T,"-37.81794046, 144.96616678"
79620240607,79,2024-06-07,6,95,52,147,FliSS_T,"-37.81794046, 144.96616678"
231320250327,23,2025-03-27,13,346,700,1046,Col623_T,"-37.81909256, 144.95452748"
1920250905,1,2025-09-05,9,299,365,664,Bou292_T,"-37.81349441, 144.96515323"
12720240203,12,2024-02-03,7,40,38,78,NewQ_T,"-37.81457988, 144.94292398"
10820250111,10,2025-01-11,8,24,15,39,BouHbr_T,"-37.81876474, 144.94710545"
111220250222,11,2025-02-22,12,56,57,113,WatCit_T,"-37.81564989, 144.93970694"
761820250704,76,2025-07-04,18,56,46,102,KenMac_T,"-37.79453803, 144.93036194"
72320250722,72,2025-07-22,3,0,1,1,ACMI_T,"-37.81726338, 144.96872809"
532120231207,53,2023-12-07,21,220,292,512,Col254_T,"-37.81564191, 144.965499"
302020250319,30,2025-03-19,20,247,369,616,Lon189_T,"-37.8112185, 144.96656806"
301020250111,30,2025-01-11,10,117,231,348,Lon189_T,"-37.8112185, 144.96656806"
531920250730,53,2025-07-30,19,179,165,344,Col254_T,"-37.81564191, 144.965499"
20220250702,20,2025-07-02,2,3,4,7,LtB170_T,"-37.81172914, 144.9682466"
491720240318,49,2024-03-18,17,252,200,452,Eli501_T,"-37.80730068, 144.95956055"
192220240422,19,2024-04-22,22,132,205,337,LtB210_T,"-37.81237202, 144.96550671"
19120250113,19,2025-01-13,1,32,20,52,LtB210_T,"-37.81237202, 144.96550671"
1362120240711,136,2024-07-11,21,0,2,2,BirFed1120_T,"-37.8184141, 144.97357915"
1611020241219,161,2024-12-19,10,27,62,89,BirArt1109_T,"-37.81851276, 144.97131336"
84520250516,84,2025-05-16,5,44,27,71,ElFi_T,"-37.81798049, 144.96503383"
4520231027,4,2023-10-27,5,26,18,44,Swa123_T,"-37.81487988, 144.9660878"
41720250715,4,2025-07-15,17,1853,1519,3372,Swa123_T,"-37.81487988, 144.9660878"
391320250323,39,2025-03-23,13,40,39,79,AlfPl_T,"-37.81379749, 144.96995745"
781820240814,78,2024-08-14,18,2,16,18,HarEsB_T,"-37.81471642, 144.9446508"
41420241110,41,2024-11-10,4,59,88,147,Swa31,"-37.81668634, 144.96689733"
42420250902,42,2025-09-02,4,4,1,5,UM1_T,"-37.80008566, 144.96386412"
652020231112,65,2023-11-12,20,138,316,454,SwaCs_T,"-37.81569416, 144.9668064"
71620231028,71,2023-10-28,6,9,12,21,WestWP_T,"-37.81235775, 144.97136962"
291420250930,29,2025-09-30,14,172,284,456,AG_T,"-37.8199817, 144.96872865"
281920240327,28,2024-03-27,19,278,298,576,VAC_T,"-37.82129925, 144.96879309"
14720250823,14,2025-08-23,7,55,31,86,SanBri_T,"-37.82011242, 144.96291897"
311320231123,31,2023-11-23,13,167,210,377,Lyg161_T,"-37.80169681, 144.96658911"
47720240202,47,2024-02-02,7,97,224,321,Eli250_T,"-37.81258467, 144.9625775"
401120250705,40,2025-07-05,11,122,157,279,Spr201_T,"-37.80999341, 144.97227587"
1082120241215,108,2024-12-15,21,56,74,130,261Will_T,"-37.81295822, 144.95678789"
431620250804,43,2025-08-04,16,304,548,852,UM2_T,"-37.79844526, 144.96411782"
1662320250406,166,2025-04-06,23,1,1,2,Spen484_T,"-37.80896733, 144.94931703"
167720250326,167,2025-03-26,7,13,49,62,Lat526_T,"-37.81304149, 144.95155955"
1651420250126,165,2025-01-26,14,30,40,70,Spen475_T,"-37.80953359, 144.94939004"
1401520241102,140,2024-11-02,15,85,74,159,Boyd2837_T,"-37.82590962, 144.96185972"
1401620240125,140,2024-01-25,16,54,78,132,Boyd2837_T,"-37.82590962, 144.96185972"
143420240515,143,2024-05-15,4,19,5,24,Spencer_T,"-37.821728, 144.95557015"
143920250225,143,2025-02-25,9,74,148,222,Spencer_T,"-37.821728, 144.95557015"
134920240915,134,2024-09-15,9,226,264,490,Spen201_T,"-37.81694221, 144.95303935"
134220240304,134,2024-03-04,2,22,5,27,Spen201_T,"-37.81694221, 144.95303935"
1331620250304,133,2025-03-04,16,623,705,1328,Spen229_T,"-37.81531435, 144.95227769"
1331920240608,133,2024-06-08,19,345,337,682,Spen229_T,"-37.81531435, 144.95227769"
1181220250401,118,2025-04-01,12,23,19,42,Fli114C_T,"-37.81632783, 144.97090512"
851220240926,85,2024-09-26,12,120,111,231,488Mac_T,"-37.79432415, 144.92973378"
23920231209,23,2023-12-09,9,144,107,251,Col623_T,"-37.81909256, 144.95452748"
251520250518,25,2025-05-18,15,1179,697,1876,MCEC_T,"-37.82401776, 144.95604426"
1801920250416,180,2025-04-16,19,7,16,23,Mac330_T,"-37.79497059, 144.93530329"
1391020240711,139,2024-07-11,10,32,65,97,Signal1647_T,"-37.81959923, 144.9632832"
1361120240812,136,2024-08-12,11,40,40,80,BirFed1120_T,"-37.8184141, 144.97357915"
136520250304,136,2025-03-04,5,9,1,10,BirFed1120_T,"-37.8184141, 144.97357915"
1422120250421,142,2025-04-21,21,9,5,14,Hammer1584_T,"-37.81970749, 144.96795734"
142920241116,142,2024-11-16,9,460,322,782,Hammer1584_T,"-37.81970749, 144.96795734"
130720250214,130,2025-02-14,7,17,15,32,Bou892T,"-37.8204637, 144.94126826"
117420250922,117,2025-09-22,4,0,4,4,Fli114F_T,"-37.81629332, 144.97090877"
49020240427,49,2024-04-27,0,88,56,144,Eli501_T,"-37.80730068, 144.95956055"
491420240907,49,2024-09-07,14,505,656,1161,Eli501_T,"-37.80730068, 144.95956055"
1091520241109,109,2024-11-09,15,84,135,219,LatWill_T,"-37.81193681, 144.95621105"
1091420250220,109,2025-02-20,14,213,131,344,LatWill_T,"-37.81193681, 144.95621105"
841620240211,84,2024-02-11,16,805,1301,2106,ElFi_T,"-37.81798049, 144.96503383"
842120250604,84,2025-06-04,21,366,631,997,ElFi_T,"-37.81798049, 144.96503383"
701020241203,70,2024-12-03,10,93,90,183,Errol20_T,"-37.80456984, 144.94946228"
31820240423,3,2024-04-23,18,1235,1292,2527,Swa295_T,"-37.81101524, 144.96429485"
411020241018,41,2024-10-18,10,244,327,571,Swa31,"-37.81668634, 144.96689733"
782120240609,78,2024-06-09,21,4,10,14,HarEsB_T,"-37.81471642, 144.9446508"
652220240404,65,2024-04-04,22,111,458,569,SwaCs_T,"-37.81569416, 144.9668064"
711920250119,71,2025-01-19,19,3,7,10,WestWP_T,"-37.81235775, 144.97136962"
652020240904,65,2024-09-04,20,296,335,631,SwaCs_T,"-37.81569416, 144.9668064"
59520241104,59,2024-11-04,5,10,12,22,RMIT_T,"-37.80825648, 144.96304859"
59720241107,59,2024-11-07,7,148,66,214,RMIT_T,"-37.80825648, 144.96304859"
311520240228,31,2024-02-28,15,94,128,222,Lyg161_T,"-37.80169681, 144.96658911"
281020250321,28,2025-03-21,10,769,256,1025,VAC_T,"-37.82129925, 144.96879309"
402020241010,40,2024-10-10,20,114,67,181,Spr201_T,"-37.80999341, 144.97227587"
401020240812,40,2024-08-12,10,252,261,513,Spr201_T,"-37.80999341, 144.97227587"
21820241018,21,2024-10-18,8,81,79,160,Bourke155_T,"-37.81267313, 144.96788288"
21820250120,21,2025-01-20,8,81,72,153,Bourke155_T,"-37.81267313, 144.96788288"
36120241007,36,2024-10-07,1,10,10,20,Que85_T,"-37.81652527, 144.96121062"
87420231223,87,2023-12-23,4,3,0,3,Errol23_T,"-37.80454949, 144.94921863"
611420231227,61,2023-12-27,14,160,309,469,RMIT14_T,"-37.80767455, 144.96309114"
44620250401,44,2025-04-01,6,2,13,15,UM3_T,"-37.79698741, 144.96441306"
431420250308,43,2025-03-08,14,68,60,128,UM2_T,"-37.79844526, 144.96411782"
431520250608,43,2025-06-08,15,82,76,158,UM2_T,"-37.79844526, 144.96411782"
44320240614,44,2024-06-14,3,3,0,3,UM3_T,"-37.79698741, 144.96441306"
140920250807,140,2025-08-07,9,127,50,177,Boyd2837_T,"-37.82590962, 144.96185972"
1401520240110,140,2024-01-10,15,66,83,149,Boyd2837_T,"-37.82590962, 144.96185972"
131320231023,131,2023-10-23,3,4,16,20,King2_T,"-37.82009057, 144.95758725"
167920241019,167,2024-10-19,9,12,38,50,Lat526_T,"-37.81304149, 144.95155955"
1431020250518,143,2025-05-18,10,173,416,589,Spencer_T,"-37.821728, 144.95557015"
1322120250317,132,2025-03-17,21,92,100,192,King335_T,"-37.81267639, 144.95386444"
1341520241004,134,2024-10-04,15,534,612,1146,Spen201_T,"-37.81694221, 144.95303935"
118720250103,118,2025-01-03,7,4,2,6,Fli114C_T,"-37.81632783, 144.97090512"
108920250123,108,2025-01-23,9,245,963,1208,261Will_T,"-37.81295822, 144.95678789"
108920231023,108,2023-10-23,9,234,874,1108,261Will_T,"-37.81295822, 144.95678789"
87220241004,87,2024-10-04,2,0,2,2,Errol23_T,"-37.80454949, 144.94921863"
1822220250417,182,2025-04-17,22,234,235,469,King163_T,"-37.81627451, 144.95550503"
179020250327,179,2025-03-27,0,2,5,7,Pow61_T,"-37.82392385, 144.96299677"
1811920250726,181,2025-07-26,19,721,723,1444,Eli368_T,"-37.81009465, 144.96143149"
1720240506,1,2024-05-06,7,69,69,138,Bou292_T,"-37.81349441, 144.96515323"
112020240618,11,2024-06-18,20,27,47,74,WatCit_T,"-37.81564989, 144.93970694"
632020240725,63,2024-07-25,20,162,332,494,Bou231_T,"-37.81333081, 144.96675571"
681520250718,68,2025-07-18,15,455,318,773,FLDegN_T,"-37.8168479, 144.96559789"
181220241211,18,2024-12-11,12,306,332,638,Col12_T,"-37.81344862, 144.97305353"
18420250912,18,2025-09-12,4,3,0,3,Col12_T,"-37.81344862, 144.97305353"
63920251013,63,2025-10-13,9,203,262,465,Bou231_T,"-37.81333081, 144.96675571"
68920240112,68,2024-01-12,9,137,101,238,FLDegN_T,"-37.8168479, 144.96559789"
24120231026,24,2023-10-26,1,31,34,65,Col620_T,"-37.81887963, 144.95449198"
722320241022,72,2024-10-22,23,33,58,91,ACMI_T,"-37.81726338, 144.96872809"
582020240909,58,2024-09-09,20,162,190,352,Bou688_T,"-37.81686075, 144.95358075"
581220231129,58,2023-11-29,12,819,398,1217,Bou688_T,"-37.81686075, 144.95358075"
271120240525,27,2024-05-25,11,342,266,608,Vic_T,"-37.80606888, 144.95644692"
2820250220,2,2025-02-20,8,126,240,366,Bou283_T,"-37.81380668, 144.96516718"
2520240709,2,2024-07-09,5,2,4,6,Bou283_T,"-37.81380668, 144.96516718"
30820240131,30,2024-01-31,8,106,78,184,Lon189_T,"-37.8112185, 144.96656806"
531820250609,53,2025-06-09,18,192,173,365,Col254_T,"-37.81564191, 144.965499"
251620231112,25,2023-11-12,16,1471,695,2166,MCEC_T,"-37.82401776, 144.95604426"
201920241117,20,2024-11-17,19,385,338,723,LtB170_T,"-37.81172914, 144.9682466"
52520250325,52,2025-03-25,5,8,4,12,Eli263_T,"-37.81252157, 144.9619401"
51820250521,51,2025-05-21,8,86,39,125,Fra118_T,"-37.80841815, 144.95906316"
511320250822,51,2025-08-22,13,137,141,278,Fra118_T,"-37.80841815, 144.95906316"
51120240926,51,2024-09-26,1,11,4,15,Fra118_T,"-37.80841815, 144.95906316"
1231020250203,123,2025-02-03,10,3,14,17,BirBridge_T,"-37.81753741, 144.97329734"
19120250830,19,2025-08-30,1,71,109,180,LtB210_T,"-37.81237202, 144.96550671"
491520250127,49,2025-01-27,15,82,102,184,Eli501_T,"-37.80730068, 144.95956055"
25220240930,25,2024-09-30,2,2,1,3,MCEC_T,"-37.82401776, 144.95604426"
139720250113,139,2025-01-13,7,23,97,120,Signal1647_T,"-37.81959923, 144.9632832"
141320240108,141,2024-01-08,3,1,0,1,474Fl_T,"-37.81997273, 144.95834911"
1362220250815,136,2025-08-15,22,1,0,1,BirFed1120_T,"-37.8184141, 144.97357915"
1381420250121,138,2025-01-21,14,12,9,21,EntPark1671_T,"-37.81996544, 144.95981454"
66820250406,66,2025-04-06,8,92,140,232,QVN_T,"-37.81057846, 144.96444294"
21620231121,2,2023-11-21,16,814,705,1519,Bou283_T,"-37.81380668, 144.96516718"
58420240623,58,2024-06-23,4,20,32,52,Bou688_T,"-37.81686075, 144.95358075"
761720250513,76,2025-05-13,17,51,77,128,KenMac_T,"-37.79453803, 144.93036194"
761120240505,76,2024-05-05,11,79,72,151,KenMac_T,"-37.79453803, 144.93036194"
76520240617,76,2024-06-17,5,3,1,4,KenMac_T,"-37.79453803, 144.93036194"
272320240307,27,2024-03-07,23,58,18,76,Vic_T,"-37.80606888, 144.95644692"
2320250716,2,2025-07-16,3,2,4,6,Bou283_T,"-37.81380668, 144.96516718"
271920250319,27,2025-03-19,19,130,79,209,Vic_T,"-37.80606888, 144.95644692"
30220241220,30,2024-12-20,2,49,63,112,Lon189_T,"-37.8112185, 144.96656806"
201520251005,20,2025-10-05,15,204,522,726,LtB170_T,"-37.81172914, 144.9682466"
52620240912,52,2024-09-12,6,25,12,37,Eli263_T,"-37.81252157, 144.9619401"
1412220240527,141,2024-05-27,22,33,39,72,474Fl_T,"-37.81997273, 144.95834911"
1092220250430,109,2025-04-30,22,58,73,131,LatWill_T,"-37.81193681, 144.95621105"
192120250723,19,2025-07-23,21,264,343,607,LtB210_T,"-37.81237202, 144.96550671"
1422220240120,142,2024-01-20,22,503,327,830,Hammer1584_T,"-37.81970749, 144.96795734"
67520250105,67,2025-01-05,5,7,6,13,FLDegS_T,"-37.81688755, 144.96562569"
67720241127,67,2024-11-27,7,97,111,208,FLDegS_T,"-37.81688755, 144.96562569"
681820231228,68,2023-12-28,18,169,93,262,FLDegN_T,"-37.8168479, 144.96559789"
62720231020,62,2023-10-20,7,45,46,91,Lat224_T,"-37.80996494, 144.96216521"
11620250306,11,2025-03-06,6,21,21,42,WatCit_T,"-37.81564989, 144.93970694"
241420231022,24,2023-10-22,14,331,507,838,Col620_T,"-37.81887963, 144.95449198"
241720240312,24,2024-03-12,17,573,2426,2999,Col620_T,"-37.81887963, 144.95449198"
101020250101,10,2025-01-01,10,30,38,68,BouHbr_T,"-37.81876474, 144.94710545"
72920250816,72,2025-08-16,9,126,198,324,ACMI_T,"-37.81726338, 144.96872809"
76920240322,76,2024-03-22,9,89,87,176,KenMac_T,"-37.79453803, 144.93036194"
11420240505,11,2024-05-05,4,0,1,1,WatCit_T,"-37.81564989, 144.93970694"
531720241212,53,2024-12-12,17,942,585,1527,Col254_T,"-37.81564191, 144.965499"
192320231021,19,2023-10-21,23,405,340,745,LtB210_T,"-37.81237202, 144.96550671"
19820240217,19,2024-02-17,8,42,43,85,LtB210_T,"-37.81237202, 144.96550671"
461420240218,46,2024-02-18,14,56,55,111,Pel147_T,"-37.80240719, 144.9615673"
46620240607,46,2024-06-07,6,7,7,14,Pel147_T,"-37.80240719, 144.9615673"
20820250223,20,2025-02-23,8,57,20,77,LtB170_T,"-37.81172914, 144.9682466"
180420250322,180,2025-03-22,4,0,1,1,Mac330_T,"-37.79497059, 144.93530329"
136820250412,136,2025-04-12,8,77,103,180,BirFed1120_T,"-37.8184141, 144.97357915"
1361320240301,136,2024-03-01,13,63,53,116,BirFed1120_T,"-37.8184141, 144.97357915"
1381220240825,138,2024-08-25,12,1,11,12,EntPark1671_T,"-37.81996544, 144.95981454"
123720241118,123,2024-11-18,7,7,1,8,BirBridge_T,"-37.81753741, 144.97329734"
1231620241217,123,2024-12-17,16,9,7,16,BirBridge_T,"-37.81753741, 144.97329734"
117520250619,117,2025-06-19,5,13,5,18,Fli114F_T,"-37.81629332, 144.97090877"
661820250426,66,2025-04-26,18,1207,1219,2426,QVN_T,"-37.81057846, 144.96444294"
4620240215,4,2024-02-15,6,137,56,193,Swa123_T,"-37.81487988, 144.9660878"
70220240214,70,2024-02-14,2,2,2,4,Errol20_T,"-37.80456984, 144.94946228"
701220250524,70,2025-05-24,12,184,168,352,Errol20_T,"-37.80456984, 144.94946228"
392020240224,39,2024-02-24,20,49,48,97,AlfPl_T,"-37.81379749, 144.96995745"
82020241224,8,2024-12-24,20,74,99,173,WebBN_T,"-37.82293543, 144.9471751"
771520240409,77,2024-04-09,15,142,61,203,HarEsP_T,"-37.81441438, 144.94433026"
65120240225,65,2024-02-25,1,42,171,213,SwaCs_T,"-37.81569416, 144.9668064"
652120240903,65,2024-09-03,21,326,264,590,SwaCs_T,"-37.81569416, 144.9668064"
311820240910,31,2024-09-10,18,193,121,314,Lyg161_T,"-37.80169681, 144.96658911"
471420250521,47,2025-05-21,14,752,844,1596,Eli250_T,"-37.81258467, 144.9625775"
472320250825,47,2025-08-25,23,107,105,212,Eli250_T,"-37.81258467, 144.9625775"
21120240321,21,2024-03-21,1,32,54,86,Bourke155_T,"-37.81267313, 144.96788288"
371420250313,37,2025-03-13,14,84,115,199,Lyg260_T,"-37.80107122, 144.96704554"
371020250616,37,2025-06-16,10,54,51,105,Lyg260_T,"-37.80107122, 144.96704554"
871420241024,87,2024-10-24,14,86,99,185,Errol23_T,"-37.80454949, 144.94921863"
872320241122,87,2024-11-22,23,14,16,30,Errol23_T,"-37.80454949, 144.94921863"
50120240202,50,2024-02-02,1,8,0,8,Lyg309_T,"-37.79808192, 144.96721013"
50820240418,50,2024-04-18,8,24,88,112,Lyg309_T,"-37.79808192, 144.96721013"
851220240823,85,2024-08-23,12,133,130,263,488Mac_T,"-37.79432415, 144.92973378"
11820240223,11,2024-02-23,8,72,56,128,WatCit_T,"-37.81564989, 144.93970694"
631420241103,63,2024-11-03,14,405,383,788,Bou231_T,"-37.81333081, 144.96675571"
181420240612,18,2024-06-12,14,252,164,416,Col12_T,"-37.81344862, 144.97305353"
17320250506,17,2025-05-06,3,1,0,1,Col15_T,"-37.81362543, 144.97323591"
562020240117,56,2024-01-17,20,295,216,511,Lon364_T,"-37.81234775, 144.96153311"
241320240204,24,2024-02-04,13,385,535,920,Col620_T,"-37.81887963, 144.95449198"
121220241017,12,2024-10-17,12,269,336,605,NewQ_T,"-37.81457988, 144.94292398"
24420250623,24,2025-06-23,4,13,21,34,Col620_T,"-37.81887963, 144.95449198"
10520250217,10,2025-02-17,5,8,5,13,BouHbr_T,"-37.81876474, 144.94710545"
841720250825,84,2025-08-25,17,947,2031,2978,ElFi_T,"-37.81798049, 144.96503383"
42220250710,4,2025-07-10,22,402,464,866,Swa123_T,"-37.81487988, 144.9660878"
661720231203,66,2023-12-03,17,1389,1566,2955,QVN_T,"-37.81057846, 144.96444294"
751220231203,75,2023-12-03,12,65,41,106,SprFli_T,"-37.81515276, 144.97467661"
781220240215,78,2024-02-15,12,35,55,90,HarEsB_T,"-37.81471642, 144.9446508"
591920240519,59,2024-05-19,19,417,276,693,RMIT_T,"-37.80825648, 144.96304859"
59320250118,59,2025-01-18,3,99,9,108,RMIT_T,"-37.80825648, 144.96304859"
651720240409,65,2024-04-09,17,790,1071,1861,SwaCs_T,"-37.81569416, 144.9668064"
29120250217,29,2025-02-17,1,5,3,8,AG_T,"-37.8199817, 144.96872865"
291920240706,29,2024-07-06,19,103,319,422,AG_T,"-37.8199817, 144.96872865"
29220231222,29,2023-12-22,2,26,8,34,AG_T,"-37.8199817, 144.96872865"
542120241205,54,2024-12-05,21,73,86,159,Swa607_T,"-37.804024, 144.96308399"
281520250723,28,2025-07-23,15,371,785,1156,VAC_T,"-37.82129925, 144.96879309"
471120240630,47,2024-06-30,11,618,723,1341,Eli250_T,"-37.81258467, 144.9625775"
311420250903,31,2025-09-03,14,117,151,268,Lyg161_T,"-37.80169681, 144.96658911"
361620250904,36,2025-09-04,16,215,233,448,Que85_T,"-37.81652527, 144.96121062"
371820250621,37,2025-06-21,18,112,105,217,Lyg260_T,"-37.80107122, 144.96704554"
87320250814,87,2025-08-14,3,2,2,4,Errol23_T,"-37.80454949, 144.94921863"
611420250717,61,2025-07-17,14,472,559,1031,RMIT14_T,"-37.80767455, 144.96309114"
50420240422,50,2024-04-22,4,6,1,7,Lyg309_T,"-37.79808192, 144.96721013"
50020241021,50,2024-10-21,0,9,1,10,Lyg309_T,"-37.79808192, 144.96721013"
44220240804,44,2024-08-04,2,4,0,4,UM3_T,"-37.79698741, 144.96441306"
1311420231129,131,2023-11-29,14,47,28,75,King2_T,"-37.82009057, 144.95758725"
1322320231227,132,2023-12-27,23,61,56,117,King335_T,"-37.81267639, 144.95386444"
1331320240215,133,2024-02-15,13,611,645,1256,Spen229_T,"-37.81531435, 144.95227769"
1181620250307,118,2025-03-07,16,17,25,42,Fli114C_T,"-37.81632783, 144.97090512"
1181420250905,118,2025-09-05,14,18,20,38,Fli114C_T,"-37.81632783, 144.97090512"
118020241012,118,2024-10-12,0,1,3,4,Fli114C_T,"-37.81632783, 144.97090512"
11920240217,1,2024-02-17,19,1116,650,1766,Bou292_T,"-37.81349441, 144.96515323"
681720231106,68,2023-11-06,17,238,126,364,FLDegN_T,"-37.8168479, 144.96559789"
182120250413,18,2025-04-13,21,24,11,35,Col12_T,"-37.81344862, 144.97305353"
862220240103,86,2024-01-03,22,2,5,7,574Qub_T,"-37.80309992, 144.94908064"
86820240114,86,2024-01-14,8,17,9,26,574Qub_T,"-37.80309992, 144.94908064"
862120250301,86,2025-03-01,21,20,72,92,574Qub_T,"-37.80309992, 144.94908064"
68820250921,68,2025-09-21,8,73,63,136,FLDegN_T,"-37.8168479, 144.96559789"
24520250622,24,2025-06-22,5,44,35,79,Col620_T,"-37.81887963, 144.95449198"
58920231208,58,2023-12-08,9,912,171,1083,Bou688_T,"-37.81686075, 144.95358075"
76220250822,76,2025-08-22,2,0,1,1,KenMac_T,"-37.79453803, 144.93036194"
27520240603,27,2024-06-03,5,10,6,16,Vic_T,"-37.80606888, 144.95644692"
21020250617,2,2025-06-17,10,227,230,457,Bou283_T,"-37.81380668, 144.96516718"
58020250705,58,2025-07-05,0,139,130,269,Bou688_T,"-37.81686075, 144.95358075"
531620241219,53,2024-12-19,16,856,677,1533,Col254_T,"-37.81564191, 144.965499"
451820250408,45,2025-04-08,18,503,1243,1746,Swa148_T,"-37.81414075, 144.96609379"
140920241221,140,2024-12-21,9,98,28,126,Boyd2837_T,"-37.82590962, 144.96185972"
131820241011,131,2024-10-11,8,109,76,185,King2_T,"-37.82009057, 144.95758725"
131020250614,131,2025-06-14,0,62,85,147,King2_T,"-37.82009057, 144.95758725"
1622020240907,162,2024-09-07,20,275,212,487,Eli489_T,"-37.80740397, 144.95987909"
132620240308,132,2024-03-08,6,32,18,50,King335_T,"-37.81267639, 144.95386444"
132120240520,132,2024-05-20,1,6,17,23,King335_T,"-37.81267639, 144.95386444"
132620250609,132,2025-06-09,6,8,5,13,King335_T,"-37.81267639, 144.95386444"
1351920250305,135,2025-03-05,19,274,330,604,Spen161_T,"-37.8172861, 144.95319102"
1071720241118,107,2024-11-18,17,209,171,380,280Will_T,"-37.81246271, 144.95690188"
1081020231114,108,2023-11-14,10,258,369,627,261Will_T,"-37.81295822, 144.95678789"
182420250528,182,2025-05-28,4,7,12,19,King163_T,"-37.81627451, 144.95550503"
179420250624,179,2025-06-24,4,3,1,4,Pow61_T,"-37.82392385, 144.96299677"
1661620250113,166,2025-01-13,16,62,61,123,Spen484_T,"-37.80896733, 144.94931703"
1661920250210,166,2025-02-10,19,68,73,141,Spen484_T,"-37.80896733, 144.94931703"
85720250519,85,2025-05-19,7,52,15,67,488Mac_T,"-37.79432415, 144.92973378"
11420231031,1,2023-10-31,14,1146,981,2127,Bou292_T,"-37.81349441, 144.96515323"
1620250305,1,2025-03-05,6,31,58,89,Bou292_T,"-37.81349441, 144.96515323"
18120240107,18,2024-01-07,1,0,1,1,Col12_T,"-37.81344862, 144.97305353"
862320250330,86,2025-03-30,23,0,4,4,574Qub_T,"-37.80309992, 144.94908064"
681820240813,68,2024-08-13,18,117,28,145,FLDegN_T,"-37.8168479, 144.96559789"
62720240709,62,2024-07-09,7,58,59,117,Lat224_T,"-37.80996494, 144.96216521"
12120251008,12,2025-10-08,1,1,4,5,NewQ_T,"-37.81457988, 144.94292398"
101820231230,10,2023-12-30,18,52,36,88,BouHbr_T,"-37.81876474, 144.94710545"
101020240517,10,2024-05-17,10,51,57,108,BouHbr_T,"-37.81876474, 144.94710545"
761920240824,76,2024-08-24,19,31,33,64,KenMac_T,"-37.79453803, 144.93036194"
581720231028,58,2023-10-28,17,573,375,948,Bou688_T,"-37.81686075, 144.95358075"
76220241124,76,2024-11-24,2,0,1,1,KenMac_T,"-37.79453803, 144.93036194"
21620240913,2,2024-09-13,16,625,526,1151,Bou283_T,"-37.81380668, 144.96516718"
301520250325,30,2025-03-25,15,169,331,500,Lon189_T,"-37.8112185, 144.96656806"
48820241118,48,2024-11-18,8,135,53,188,QVMQ_T,"-37.80631581, 144.95866697"
481020231213,48,2023-12-13,10,160,121,281,QVMQ_T,"-37.80631581, 144.95866697"
251020250608,25,2025-06-08,10,200,1346,1546,MCEC_T,"-37.82401776, 144.95604426"
461720231020,46,2023-10-20,17,138,115,253,Pel147_T,"-37.80240719, 144.9615673"
25020240713,25,2024-07-13,0,60,79,139,MCEC_T,"-37.82401776, 144.95604426"
522320231021,52,2023-10-21,23,415,328,743,Eli263_T,"-37.81252157, 144.9619401"
191320250104,19,2025-01-04,13,526,534,1060,LtB210_T,"-37.81237202, 144.96550671"
1412120250827,141,2025-08-27,21,44,62,106,474Fl_T,"-37.81997273, 144.95834911"
1381920240215,138,2024-02-15,19,5,9,14,EntPark1671_T,"-37.81996544, 144.95981454"
1231620240502,123,2024-05-02,16,20,9,29,BirBridge_T,"-37.81753741, 144.97329734"
138920240118,138,2024-01-18,9,0,5,5,EntPark1671_T,"-37.81996544, 144.95981454"
191420241025,19,2024-10-25,14,385,482,867,LtB210_T,"-37.81237202, 144.96550671"
66420250418,66,2025-04-18,4,17,9,26,QVN_T,"-37.81057846, 144.96444294"
701820240717,70,2024-07-17,18,136,192,328,Errol20_T,"-37.80456984, 144.94946228"
701020241125,70,2024-11-25,10,60,56,116,Errol20_T,"-37.80456984, 144.94946228"
791520240727,79,2024-07-27,15,475,475,950,FliSS_T,"-37.81794046, 144.96616678"
201520250729,20,2025-07-29,15,137,187,324,LtB170_T,"-37.81172914, 144.9682466"
20020250214,20,2025-02-14,0,69,86,155,LtB170_T,"-37.81172914, 144.9682466"
20720250707,20,2025-07-07,7,20,25,45,LtB170_T,"-37.81172914, 144.9682466"
522320231228,52,2023-12-28,23,88,99,187,Eli263_T,"-37.81252157, 144.9619401"
511020250915,51,2025-09-15,10,76,51,127,Fra118_T,"-37.80841815, 144.95906316"
51620241215,51,2024-12-15,6,11,14,25,Fra118_T,"-37.80841815, 144.95906316"
48620250622,48,2025-06-22,6,16,16,32,QVMQ_T,"-37.80631581, 144.95866697"
49920241024,49,2024-10-24,9,136,206,342,Eli501_T,"-37.80730068, 144.95956055"
1092220250603,109,2025-06-03,22,32,40,72,LatWill_T,"-37.81193681, 144.95621105"
19620250403,19,2025-04-03,6,24,10,34,LtB210_T,"-37.81237202, 144.96550671"
481820240423,48,2024-04-23,18,110,152,262,QVMQ_T,"-37.80631581, 144.95866697"
481420241106,48,2024-11-06,14,157,118,275,QVMQ_T,"-37.80631581, 144.95866697"
1371720250102,137,2025-01-02,17,14,79,93,BouHbr2353_T,"-37.81894815, 144.94612292"
1641620250217,164,2025-02-17,16,114,128,242,Lat526_T,"-37.813005, 144.95160411"
662220240101,66,2024-01-01,22,303,201,504,QVN_T,"-37.81057846, 144.96444294"
691120240820,69,2024-08-20,11,144,104,248,FLDegC_T,"-37.81687226, 144.96559144"
41520240120,4,2024-01-20,15,2004,1728,3732,Swa123_T,"-37.81487988, 144.9660878"
81220250727,8,2025-07-27,12,185,255,440,WebBN_T,"-37.82293543, 144.9471751"
782120240721,78,2024-07-21,21,4,9,13,HarEsB_T,"-37.81471642, 144.9446508"
781820240306,78,2024-03-06,18,33,176,209,HarEsB_T,"-37.81471642, 144.9446508"
77720250318,77,2025-03-18,7,121,160,281,HarEsP_T,"-37.81441438, 144.94433026"
711620251015,71,2025-10-15,16,17,10,27,WestWP_T,"-37.81235775, 144.97136962"
59520240112,59,2024-01-12,5,26,25,51,RMIT_T,"-37.80825648, 144.96304859"
281620241221,28,2024-12-21,16,592,1629,2221,VAC_T,"-37.82129925, 144.96879309"
281020240416,28,2024-04-16,10,461,199,660,VAC_T,"-37.82129925, 144.96879309"
471120250214,47,2025-02-14,11,598,752,1350,Eli250_T,"-37.81258467, 144.9625775"
311920231127,31,2023-11-27,19,165,142,307,Lyg161_T,"-37.80169681, 144.96658911"
31320250624,31,2025-06-24,3,1,1,2,Lyg161_T,"-37.80169681, 144.96658911"
5820250505,5,2025-05-05,8,310,840,1150,PriNW_T,"-37.81874249, 144.96787656"
361420240822,36,2024-08-22,14,210,310,520,Que85_T,"-37.81652527, 144.96121062"
36120240826,36,2024-08-26,1,2,4,6,Que85_T,"-37.81652527, 144.96121062"
37820240705,37,2024-07-05,8,19,39,58,Lyg260_T,"-37.80107122, 144.96704554"
1081820240317,108,2024-03-17,18,159,95,254,261Will_T,"-37.81295822, 144.95678789"
872220240517,87,2024-05-17,22,36,13,49,Errol23_T,"-37.80454949, 144.94921863"
611720240326,61,2024-03-26,17,589,716,1305,RMIT14_T,"-37.80767455, 144.96309114"
1792020250902,179,2025-09-02,20,54,47,101,Pow61_T,"-37.82392385, 144.96299677"
181020250911,181,2025-09-11,0,162,87,249,Eli368_T,"-37.81009465, 144.96143149"
182020250506,182,2025-05-06,0,33,39,72,King163_T,"-37.81627451, 144.95550503"
682120250909,68,2025-09-09,21,58,40,98,FLDegN_T,"-37.8168479, 144.96559789"
17720250321,17,2025-03-21,7,297,76,373,Col15_T,"-37.81362543, 144.97323591"
63020250313,63,2025-03-13,0,5,51,56,Bou231_T,"-37.81333081, 144.96675571"
11720240610,11,2024-06-10,7,16,12,28,WatCit_T,"-37.81564989, 144.93970694"
861020250914,86,2025-09-14,10,47,39,86,574Qub_T,"-37.80309992, 144.94908064"
75020240812,75,2024-08-12,0,1,1,2,SprFli_T,"-37.81515276, 144.97467661"
751020241010,75,2024-10-10,10,55,44,99,SprFli_T,"-37.81515276, 144.97467661"
781720240217,78,2024-02-17,17,63,71,134,HarEsB_T,"-37.81471642, 144.9446508"
65720240102,65,2024-01-02,7,115,41,156,SwaCs_T,"-37.81569416, 144.9668064"
14020240428,14,2024-04-28,0,253,43,296,SanBri_T,"-37.82011242, 144.96291897"
711020240720,71,2024-07-20,10,24,22,46,WestWP_T,"-37.81235775, 144.97136962"
54820241113,54,2024-11-13,8,108,41,149,Swa607_T,"-37.804024, 144.96308399"
28820231109,28,2023-11-09,8,581,305,886,VAC_T,"-37.82129925, 144.96879309"
51820241111,5,2024-11-11,18,882,913,1795,PriNW_T,"-37.81874249, 144.96787656"
5420250311,5,2025-03-11,4,33,13,46,PriNW_T,"-37.81874249, 144.96787656"
5520250611,5,2025-06-11,5,32,50,82,PriNW_T,"-37.81874249, 144.96787656"
361820241130,36,2024-11-30,18,140,119,259,Que85_T,"-37.81652527, 144.96121062"
871920250626,87,2025-06-26,19,46,77,123,Errol23_T,"-37.80454949, 144.94921863"
872320250709,87,2025-07-09,23,3,12,15,Errol23_T,"-37.80454949, 144.94921863"
44620250218,44,2025-02-18,6,6,11,17,UM3_T,"-37.79698741, 144.96441306"
441120240322,44,2024-03-22,11,115,96,211,UM3_T,"-37.79698741, 144.96441306"
140920250626,140,2025-06-26,9,103,43,146,Boyd2837_T,"-37.82590962, 144.96185972"
167220241218,167,2024-12-18,2,0,5,5,Lat526_T,"-37.81304149, 144.95155955"
1622220241122,162,2024-11-22,22,205,146,351,Eli489_T,"-37.80740397, 144.95987909"
1322220240628,132,2024-06-28,22,107,87,194,King335_T,"-37.81267639, 144.95386444"
1342220240221,134,2024-02-21,22,158,184,342,Spen201_T,"-37.81694221, 144.95303935"
134920241027,134,2024-10-27,9,319,363,682,Spen201_T,"-37.81694221, 144.95303935"
134020250724,134,2025-07-24,0,48,58,106,Spen201_T,"-37.81694221, 144.95303935"
135220240605,135,2024-06-05,2,7,8,15,Spen161_T,"-37.8172861, 144.95319102"
1071120240627,107,2024-06-27,11,117,122,239,280Will_T,"-37.81246271, 144.95690188"
1331620231021,133,2023-10-21,16,631,595,1226,Spen229_T,"-37.81531435, 144.95227769"
133020231113,133,2023-11-13,0,40,20,60,Spen229_T,"-37.81531435, 144.95227769"
1241520250416,124,2025-04-16,15,1,0,1,BirBridge_T,"-37.81757416, 144.97329934"
1241620250612,124,2025-06-12,16,5,6,11,BirBridge_T,"-37.81757416, 144.97329934"
1791020251007,179,2025-10-07,10,51,40,91,Pow61_T,"-37.82392385, 144.96299677"
179420250728,179,2025-07-28,4,0,2,2,Pow61_T,"-37.82392385, 144.96299677"
165620241118,165,2024-11-18,6,8,15,23,Spen475_T,"-37.80953359, 144.94939004"
1651120240824,165,2024-08-24,11,55,37,92,Spen475_T,"-37.80953359, 144.94939004"
1811920250718,181,2025-07-18,19,765,929,1694,Eli368_T,"-37.81009465, 144.96143149"
1720240428,1,2024-04-28,7,24,28,52,Bou292_T,"-37.81349441, 144.96515323"
63620240611,63,2024-06-11,6,22,17,39,Bou231_T,"-37.81333081, 144.96675571"
181720240428,18,2024-04-28,17,27,14,41,Col12_T,"-37.81344862, 144.97305353"
622220240622,62,2024-06-22,22,132,90,222,Lat224_T,"-37.80996494, 144.96216521"
62720250120,62,2025-01-20,7,44,64,108,Lat224_T,"-37.80996494, 144.96216521"
56820240604,56,2024-06-04,8,110,157,267,Lon364_T,"-37.81234775, 144.96153311"
561820240805,56,2024-08-05,18,305,359,664,Lon364_T,"-37.81234775, 144.96153311"
241320231128,24,2023-11-28,13,615,654,1269,Col620_T,"-37.81887963, 144.95449198"
24120240929,24,2024-09-29,1,99,111,210,Col620_T,"-37.81887963, 144.95449198"
721020250623,72,2025-06-23,10,131,129,260,ACMI_T,"-37.81726338, 144.96872809"
72020250720,72,2025-07-20,0,38,52,90,ACMI_T,"-37.81726338, 144.96872809"
721320250418,72,2025-04-18,13,308,407,715,ACMI_T,"-37.81726338, 144.96872809"
721620231223,72,2023-12-23,16,239,556,795,ACMI_T,"-37.81726338, 144.96872809"
351520240105,35,2024-01-05,15,1248,1585,2833,SouthB_T,"-37.82018685, 144.96508508"
271820240819,27,2024-08-19,18,141,86,227,Vic_T,"-37.80606888, 144.95644692"
272220240907,27,2024-09-07,22,55,32,87,Vic_T,"-37.80606888, 144.95644692"
9620240816,9,2024-08-16,6,18,241,259,Col700_T,"-37.81982992, 144.95102555"
862120240715,86,2024-07-15,21,1,4,5,574Qub_T,"-37.80309992, 144.94908064"
68520250313,68,2025-03-13,5,3,2,5,FLDegN_T,"-37.8168479, 144.96559789"
86520250419,86,2025-04-19,5,2,2,4,574Qub_T,"-37.80309992, 144.94908064"
12720250402,12,2025-04-02,7,125,99,224,NewQ_T,"-37.81457988, 144.94292398"
12420250408,12,2025-04-08,4,2,3,5,NewQ_T,"-37.81457988, 144.94292398"
72620250819,72,2025-08-19,6,60,24,84,ACMI_T,"-37.81726338, 144.96872809"
72420240819,72,2024-08-19,4,0,4,4,ACMI_T,"-37.81726338, 144.96872809"
2320240414,2,2024-04-14,3,14,37,51,Bou283_T,"-37.81380668, 144.96516718"
532120250309,53,2025-03-09,21,140,268,408,Col254_T,"-37.81564191, 144.965499"
25520240320,25,2024-03-20,5,16,39,55,MCEC_T,"-37.82401776, 144.95604426"
201020250319,20,2025-03-19,10,103,95,198,LtB170_T,"-37.81172914, 144.9682466"
52220250315,52,2025-03-15,2,94,85,179,Eli263_T,"-37.81252157, 144.9619401"
231220250302,23,2025-03-02,12,94,164,258,Col623_T,"-37.81909256, 144.95452748"
231020240229,23,2024-02-29,10,217,205,422,Col623_T,"-37.81909256, 144.95452748"
123920250120,123,2025-01-20,9,13,47,60,BirBridge_T,"-37.81753741, 144.97329734"
1172320250315,117,2025-03-15,23,248,201,449,Fli114F_T,"-37.81629332, 144.97090877"
191020250725,19,2025-07-25,10,176,118,294,LtB210_T,"-37.81237202, 144.96550671"
19120241210,19,2024-12-10,1,40,34,74,LtB210_T,"-37.81237202, 144.96550671"
481620240516,48,2024-05-16,16,170,165,335,QVMQ_T,"-37.80631581, 144.95866697"
48720231031,48,2023-10-31,7,83,46,129,QVMQ_T,"-37.80631581, 144.95866697"
1412120250724,141,2025-07-24,21,104,123,227,474Fl_T,"-37.81997273, 144.95834911"
1422220240223,142,2024-02-23,22,251,189,440,Hammer1584_T,"-37.81970749, 144.96795734"
1302020250708,130,2025-07-08,20,15,6,21,Bou892T,"-37.8204637, 144.94126826"
691620231018,69,2023-10-18,16,117,138,255,FLDegC_T,"-37.81687226, 144.96559144"
69920250319,69,2025-03-19,9,224,112,336,FLDegC_T,"-37.81687226, 144.96559144"
84620240422,84,2024-04-22,6,261,113,374,ElFi_T,"-37.81798049, 144.96503383"
69420250907,69,2025-09-07,4,0,1,1,FLDegC_T,"-37.81687226, 144.96559144"
78520250702,78,2025-07-02,5,2,1,3,HarEsB_T,"-37.81471642, 144.9446508"
41020250701,41,2025-07-01,0,66,49,115,Swa31,"-37.81668634, 144.96689733"
54420250124,54,2025-01-24,4,3,2,5,Swa607_T,"-37.804024, 144.96308399"
281520250212,28,2025-02-12,15,393,640,1033,VAC_T,"-37.82129925, 144.96879309"
471320231111,47,2023-11-11,13,810,1085,1895,Eli250_T,"-37.81258467, 144.9625775"
47120231224,47,2023-12-24,1,115,122,237,Eli250_T,"-37.81258467, 144.9625775"
211620250614,21,2025-06-14,16,378,359,737,Bourke155_T,"-37.81267313, 144.96788288"
371020240210,37,2024-02-10,10,83,71,154,Lyg260_T,"-37.80107122, 144.96704554"
871620250322,87,2025-03-22,16,96,95,191,Errol23_T,"-37.80454949, 144.94921863"
872020231129,87,2023-11-29,20,58,60,118,Errol23_T,"-37.80454949, 144.94921863"
441320240311,44,2024-03-11,13,99,56,155,UM3_T,"-37.79698741, 144.96441306"
179820250509,179,2025-05-09,8,73,29,102,Pow61_T,"-37.82392385, 144.96299677"
1651120250918,165,2025-09-18,11,21,27,48,Spen475_T,"-37.80953359, 144.94939004"
1311720241212,131,2024-12-12,17,110,218,328,King2_T,"-37.82009057, 144.95758725"
132420231231,132,2023-12-31,4,7,8,15,King335_T,"-37.81267639, 144.95386444"
1341920250814,134,2025-08-14,19,370,345,715,Spen201_T,"-37.81694221, 144.95303935"
134920240130,134,2024-01-30,9,237,217,454,Spen201_T,"-37.81694221, 144.95303935"
1352220240713,135,2024-07-13,22,98,75,173,Spen161_T,"-37.8172861, 144.95319102"
107120250426,107,2025-04-26,1,15,9,24,280Will_T,"-37.81246271, 144.95690188"
1181820240628,118,2024-06-28,18,8,15,23,Fli114C_T,"-37.81632783, 144.97090512"
1082320250623,108,2025-06-23,23,36,32,68,261Will_T,"-37.81295822, 144.95678789"
851920250516,85,2025-05-16,19,74,63,137,488Mac_T,"-37.79432415, 144.92973378"
30720250811,30,2025-08-11,7,31,47,78,Lon189_T,"-37.8112185, 144.96656806"
20920241012,20,2024-10-12,9,38,68,106,LtB170_T,"-37.81172914, 144.9682466"
25620231115,25,2023-11-15,6,116,158,274,MCEC_T,"-37.82401776, 144.95604426"
251220250309,25,2025-03-09,12,524,737,1261,MCEC_T,"-37.82401776, 144.95604426"
522120250204,52,2025-02-04,21,139,127,266,Eli263_T,"-37.81252157, 144.9619401"
521120241023,52,2024-10-23,11,296,211,507,Eli263_T,"-37.81252157, 144.9619401"
1371320240610,137,2024-06-10,13,3,24,27,BouHbr2353_T,"-37.81894815, 144.94612292"
1371020240704,137,2024-07-04,10,19,14,33,BouHbr2353_T,"-37.81894815, 144.94612292"
1411420240319,141,2024-03-19,14,144,125,269,474Fl_T,"-37.81997273, 144.95834911"
1171520250221,117,2025-02-21,15,167,221,388,Fli114F_T,"-37.81629332, 144.97090877"
1092320250104,109,2025-01-04,23,36,50,86,LatWill_T,"-37.81193681, 144.95621105"
66620240927,66,2024-09-27,6,18,31,49,QVN_T,"-37.81057846, 144.96444294"
42220240805,4,2024-08-05,22,155,202,357,Swa123_T,"-37.81487988, 144.9660878"
41620250515,4,2025-05-15,16,1330,1218,2548,Swa123_T,"-37.81487988, 144.9660878"
512220240511,51,2024-05-11,22,54,41,95,Fra118_T,"-37.80841815, 144.95906316"
231620250406,23,2025-04-06,16,120,279,399,Col623_T,"-37.81909256, 144.95452748"
25520240604,25,2024-06-04,5,20,34,54,MCEC_T,"-37.82401776, 144.95604426"
52020240813,52,2024-08-13,0,6,23,29,Eli263_T,"-37.81252157, 144.9619401"
522120240509,52,2024-05-09,21,233,145,378,Eli263_T,"-37.81252157, 144.9619401"
1391420240104,139,2024-01-04,14,89,55,144,Signal1647_T,"-37.81959923, 144.9632832"
139020240202,139,2024-02-02,0,4,6,10,Signal1647_T,"-37.81959923, 144.9632832"
1381120240413,138,2024-04-13,11,8,10,18,EntPark1671_T,"-37.81996544, 144.95981454"
1381420240511,138,2024-05-11,14,5,4,9,EntPark1671_T,"-37.81996544, 144.95981454"
481220250706,48,2025-07-06,12,679,414,1093,QVMQ_T,"-37.80631581, 144.95866697"
141920240807,141,2024-08-07,9,145,90,235,474Fl_T,"-37.81997273, 144.95834911"
191720240910,19,2024-09-10,17,490,342,832,LtB210_T,"-37.81237202, 144.96550671"
137620250520,137,2025-05-20,6,6,2,8,BouHbr2353_T,"-37.81894815, 144.94612292"
31020231101,3,2023-11-01,10,353,465,818,Swa295_T,"-37.81101524, 144.96429485"
31820250312,3,2025-03-12,18,1004,1164,2168,Swa295_T,"-37.81101524, 144.96429485"
65120240114,65,2024-01-14,1,35,122,157,SwaCs_T,"-37.81569416, 144.9668064"
771120240209,77,2024-02-09,11,81,74,155,HarEsP_T,"-37.81441438, 144.94433026"
591820240502,59,2024-05-02,18,752,989,1741,RMIT_T,"-37.80825648, 144.96304859"
59320250110,59,2025-01-10,3,15,6,21,RMIT_T,"-37.80825648, 144.96304859"
141020240124,14,2024-01-24,10,255,177,432,SanBri_T,"-37.82011242, 144.96291897"
281020250305,28,2025-03-05,10,685,228,913,VAC_T,"-37.82129925, 144.96879309"
291720250514,29,2025-05-14,17,324,439,763,AG_T,"-37.8199817, 144.96872865"
29120250908,29,2025-09-08,1,0,6,6,AG_T,"-37.8199817, 144.96872865"
14720250918,14,2025-09-18,7,174,272,446,SanBri_T,"-37.82011242, 144.96291897"
312320240105,31,2024-01-05,23,128,232,360,Lyg161_T,"-37.80169681, 144.96658911"
54720240611,54,2024-06-11,7,31,35,66,Swa607_T,"-37.804024, 144.96308399"
28820250901,28,2025-09-01,8,677,277,954,VAC_T,"-37.82129925, 144.96879309"
471520241121,47,2024-11-21,15,894,929,1823,Eli250_T,"-37.81258467, 144.9625775"
371120250518,37,2025-05-18,11,83,74,157,Lyg260_T,"-37.80107122, 144.96704554"
171120240301,17,2024-03-01,11,352,259,611,Col15_T,"-37.81362543, 144.97323591"
11020240714,1,2024-07-14,10,419,529,948,Bou292_T,"-37.81349441, 144.96515323"
861820250713,86,2025-07-13,18,39,35,74,574Qub_T,"-37.80309992, 144.94908064"
12220241217,12,2024-12-17,2,2,4,6,NewQ_T,"-37.81457988, 144.94292398"
102120250308,10,2025-03-08,21,40,29,69,BouHbr_T,"-37.81876474, 144.94710545"
102020240928,10,2024-09-28,20,33,25,58,BouHbr_T,"-37.81876474, 144.94710545"
722020250104,72,2025-01-04,20,84,186,270,ACMI_T,"-37.81726338, 144.96872809"
76620250928,76,2025-09-28,6,7,6,13,KenMac_T,"-37.79453803, 144.93036194"
22020240202,2,2024-02-02,20,301,335,636,Bou283_T,"-37.81380668, 144.96516718"
91520250514,9,2025-05-14,15,1045,178,1223,Col700_T,"-37.81982992, 144.95102555"
70320240818,70,2024-08-18,3,1,3,4,Errol20_T,"-37.80456984, 144.94946228"
391220250807,39,2025-08-07,12,284,152,436,AlfPl_T,"-37.81379749, 144.96995745"
391420240630,39,2024-06-30,14,63,61,124,AlfPl_T,"-37.81379749, 144.96995745"
81820240609,8,2024-06-09,18,67,41,108,WebBN_T,"-37.82293543, 144.9471751"
411220231203,41,2023-12-03,12,3138,1418,4556,Swa31,"-37.81668634, 144.96689733"
8920240107,8,2024-01-07,9,62,86,148,WebBN_T,"-37.82293543, 144.9471751"
78220240313,78,2024-03-13,2,4,7,11,HarEsB_T,"-37.81471642, 144.9446508"
42420250108,42,2025-01-08,4,2,0,2,UM1_T,"-37.80008566, 144.96386412"
772320250423,77,2025-04-23,23,21,20,41,HarEsP_T,"-37.81441438, 144.94433026"
28320250308,28,2025-03-08,3,32,17,49,VAC_T,"-37.82129925, 144.96879309"
472020240426,47,2024-04-26,20,701,550,1251,Eli250_T,"-37.81258467, 144.9625775"
40720250915,40,2025-09-15,7,118,107,225,Spr201_T,"-37.80999341, 144.97227587"
51320250131,5,2025-01-31,13,1007,1152,2159,PriNW_T,"-37.81874249, 144.96787656"
51820250628,5,2025-06-28,18,741,1555,2296,PriNW_T,"-37.81874249, 144.96787656"
36120240110,36,2024-01-10,1,7,4,11,Que85_T,"-37.81652527, 144.96121062"
37420231020,37,2023-10-20,4,2,10,12,Lyg260_T,"-37.80107122, 144.96704554"
872020240913,87,2024-09-13,20,40,75,115,Errol23_T,"-37.80454949, 144.94921863"
442320250501,44,2025-05-01,23,22,3,25,UM3_T,"-37.79698741, 144.96441306"
501820240508,50,2024-05-08,18,160,142,302,Lyg309_T,"-37.79808192, 144.96721013"
501720250412,50,2025-04-12,17,242,259,501,Lyg309_T,"-37.79808192, 144.96721013"
45020250619,45,2025-06-19,0,5,6,11,Swa148_T,"-37.81414075, 144.96609379"
45520231021,45,2023-10-21,5,19,46,65,Swa148_T,"-37.81414075, 144.96609379"
1401720250627,140,2025-06-27,17,50,67,117,Boyd2837_T,"-37.82590962, 144.96185972"
140920250910,140,2025-09-10,9,105,49,154,Boyd2837_T,"-37.82590962, 144.96185972"
1311920250928,131,2025-09-28,19,68,83,151,King2_T,"-37.82009057, 144.95758725"
143820250605,143,2025-06-05,8,130,176,306,Spencer_T,"-37.821728, 144.95557015"
1322120240317,132,2024-03-17,21,149,128,277,King335_T,"-37.81267639, 144.95386444"
1341220250604,134,2025-06-04,12,384,438,822,Spen201_T,"-37.81694221, 144.95303935"
134420250624,134,2025-06-24,4,15,15,30,Spen201_T,"-37.81694221, 144.95303935"
1341320250629,134,2025-06-29,13,260,272,532,Spen201_T,"-37.81694221, 144.95303935"
133820240129,133,2024-01-29,8,509,464,973,Spen229_T,"-37.81531435, 144.95227769"
1181520241016,118,2024-10-16,15,13,26,39,Fli114C_T,"-37.81632783, 144.97090512"
1181220250712,118,2025-07-12,12,13,36,49,Fli114C_T,"-37.81632783, 144.97090512"
1182020231114,118,2023-11-14,20,6,10,16,Fli114C_T,"-37.81632783, 144.97090512"
166520250115,166,2025-01-15,5,1,2,3,Spen484_T,"-37.80896733, 144.94931703"
167820250320,167,2025-03-20,8,36,166,202,Lat526_T,"-37.81304149, 144.95155955"
851020240812,85,2024-08-12,10,65,52,117,488Mac_T,"-37.79432415, 144.92973378"
86920241030,86,2024-10-30,9,30,23,53,574Qub_T,"-37.80309992, 144.94908064"
621920231224,62,2023-12-24,19,148,62,210,Lat224_T,"-37.80996494, 144.96216521"
56120240501,56,2024-05-01,1,23,15,38,Lon364_T,"-37.81234775, 144.96153311"
24520231106,24,2023-11-06,5,72,56,128,Col620_T,"-37.81887963, 144.95449198"
241320240101,24,2024-01-01,13,280,407,687,Col620_T,"-37.81887963, 144.95449198"
67820250819,67,2025-08-19,8,308,281,589,FLDegS_T,"-37.81688755, 144.96562569"
581820231123,58,2023-11-23,18,702,600,1302,Bou688_T,"-37.81686075, 144.95358075"
91620241218,9,2024-12-18,16,1842,158,2000,Col700_T,"-37.81982992, 144.95102555"
271120250826,27,2025-08-26,11,94,87,181,Vic_T,"-37.80606888, 144.95644692"
531420240611,53,2024-06-11,14,640,589,1229,Col254_T,"-37.81564191, 144.965499"
511620241116,51,2024-11-16,16,113,97,210,Fra118_T,"-37.80841815, 144.95906316"
232020250531,23,2025-05-31,20,115,212,327,Col623_T,"-37.81909256, 144.95452748"
27820240219,27,2024-02-19,8,56,75,131,Vic_T,"-37.80606888, 144.95644692"
791620250405,79,2025-04-05,16,791,579,1370,FliSS_T,"-37.81794046, 144.96616678"
301320240529,30,2024-05-29,13,314,450,764,Lon189_T,"-37.8112185, 144.96656806"
201420240102,20,2024-01-02,14,162,269,431,LtB170_T,"-37.81172914, 144.9682466"
52020231228,52,2023-12-28,0,25,44,69,Eli263_T,"-37.81252157, 144.9619401"
511620250806,51,2025-08-06,16,97,124,221,Fra118_T,"-37.80841815, 144.95906316"
142620250301,142,2025-03-01,6,37,10,47,Hammer1584_T,"-37.81970749, 144.96795734"
1411520240110,141,2024-01-10,15,197,121,318,474Fl_T,"-37.81997273, 144.95834911"
491920240129,49,2024-01-29,19,160,141,301,Eli501_T,"-37.80730068, 144.95956055"
191420240509,19,2024-05-09,14,387,439,826,LtB210_T,"-37.81237202, 144.96550671"
192320231210,19,2023-12-10,23,124,199,323,LtB210_T,"-37.81237202, 144.96550671"
1372220250401,137,2025-04-01,22,1,2,3,BouHbr2353_T,"-37.81894815, 144.94612292"
1391320240617,139,2024-06-17,13,70,90,160,Signal1647_T,"-37.81959923, 144.9632832"
371020240831,37,2024-08-31,10,71,77,148,Lyg260_T,"-37.80107122, 144.96704554"
432320240605,43,2024-06-05,23,12,30,42,UM2_T,"-37.79844526, 144.96411782"
1332320250510,133,2025-05-10,23,134,108,242,Spen229_T,"-37.81531435, 144.95227769"
1321120250323,132,2025-03-23,11,176,84,260,King335_T,"-37.81267639, 144.95386444"
1181820250310,118,2025-03-10,18,18,35,53,Fli114C_T,"-37.81632783, 144.97090512"
1182020250519,118,2025-05-19,20,10,4,14,Fli114C_T,"-37.81632783, 144.97090512"
1181420250913,118,2025-09-13,14,15,18,33,Fli114C_T,"-37.81632783, 144.97090512"
118020240831,118,2024-08-31,0,0,1,1,Fli114C_T,"-37.81632783, 144.97090512"
61320240429,61,2024-04-29,3,11,7,18,RMIT14_T,"-37.80767455, 144.96309114"
184720251011,184,2025-10-11,7,66,116,182,Eli124_T,"-37.81512416, 144.96371988"
1851720250816,185,2025-08-16,17,706,661,1367,Eli197_T,"-37.81374643, 144.96276183"
1791320250404,179,2025-04-04,13,48,63,111,Pow61_T,"-37.82392385, 144.96299677"
179020250706,179,2025-07-06,0,22,26,48,Pow61_T,"-37.82392385, 144.96299677"
1652220250525,165,2025-05-25,22,8,2,10,Spen475_T,"-37.80953359, 144.94939004"
1651820250601,165,2025-06-01,18,26,11,37,Spen475_T,"-37.80953359, 144.94939004"
1811320250809,181,2025-08-09,13,817,1323,2140,Eli368_T,"-37.81009465, 144.96143149"
1401220250824,140,2025-08-24,12,132,66,198,Boyd2837_T,"-37.82590962, 144.96185972"
1342320250102,134,2025-01-02,23,101,103,204,Spen201_T,"-37.81694221, 144.95303935"
681720240313,68,2024-03-13,17,279,130,409,FLDegN_T,"-37.8168479, 144.96559789"
85720241208,85,2024-12-08,7,9,7,16,488Mac_T,"-37.79432415, 144.92973378"
17020231211,17,2023-12-11,0,12,15,27,Col15_T,"-37.81362543, 144.97323591"
171620250909,17,2025-09-09,16,195,382,577,Col15_T,"-37.81362543, 144.97323591"
682320251008,68,2025-10-08,23,18,10,28,FLDegN_T,"-37.8168479, 144.96559789"
562020250324,56,2025-03-24,20,290,325,615,Lon364_T,"-37.81234775, 144.96153311"
101920241021,10,2024-10-21,19,57,54,111,BouHbr_T,"-37.81876474, 144.94710545"
241620240311,24,2024-03-11,16,291,483,774,Col620_T,"-37.81887963, 144.95449198"
121120250416,12,2025-04-16,11,101,108,209,NewQ_T,"-37.81457988, 144.94292398"
761220241123,76,2024-11-23,12,35,42,77,KenMac_T,"-37.79453803, 144.93036194"
761120250131,76,2025-01-31,11,58,48,106,KenMac_T,"-37.79453803, 144.93036194"
58720250926,58,2025-09-26,7,99,61,160,Bou688_T,"-37.81686075, 144.95358075"
35920250621,35,2025-06-21,9,715,500,1215,SouthB_T,"-37.82018685, 144.96508508"
91220240830,9,2024-08-30,12,527,513,1040,Col700_T,"-37.81982992, 144.95102555"
91420250618,9,2025-06-18,14,456,212,668,Col700_T,"-37.81982992, 144.95102555"
45420250218,45,2025-02-18,4,3,8,11,Swa148_T,"-37.81414075, 144.96609379"
451620250501,45,2025-05-01,16,449,684,1133,Swa148_T,"-37.81414075, 144.96609379"
21120240121,21,2024-01-21,1,277,256,533,Bourke155_T,"-37.81267313, 144.96788288"
50620240511,50,2024-05-11,6,5,3,8,Lyg309_T,"-37.79808192, 144.96721013"
501020240606,50,2024-06-06,10,84,110,194,Lyg309_T,"-37.79808192, 144.96721013"
1661520241203,166,2024-12-03,15,44,45,89,Spen484_T,"-37.80896733, 144.94931703"
1821420250415,182,2025-04-15,14,226,228,454,King163_T,"-37.81627451, 144.95550503"
1672320250803,167,2025-08-03,23,4,5,9,Lat526_T,"-37.81304149, 144.95155955"
181720250405,181,2025-04-05,7,68,129,197,Eli368_T,"-37.81009465, 144.96143149"
1311720250313,131,2025-03-13,17,164,224,388,King2_T,"-37.82009057, 144.95758725"
132020250918,132,2025-09-18,0,19,21,40,King335_T,"-37.81267639, 144.95386444"
135720241023,135,2024-10-23,7,195,235,430,Spen161_T,"-37.8172861, 144.95319102"
851920240207,85,2024-02-07,19,51,54,105,488Mac_T,"-37.79432415, 144.92973378"
85120250126,85,2025-01-26,1,0,2,2,488Mac_T,"-37.79432415, 144.92973378"
12020250323,1,2025-03-23,20,274,263,537,Bou292_T,"-37.81349441, 144.96515323"
681920241011,68,2024-10-11,19,194,71,265,FLDegN_T,"-37.8168479, 144.96559789"
621420240513,62,2024-05-13,14,252,151,403,Lat224_T,"-37.80996494, 144.96216521"
622020250523,62,2025-05-23,20,172,164,336,Lat224_T,"-37.80996494, 144.96216521"
62420250613,62,2025-06-13,4,13,6,19,Lat224_T,"-37.80996494, 144.96216521"
56820250317,56,2025-03-17,8,135,222,357,Lon364_T,"-37.81234775, 144.96153311"
11520250604,11,2025-06-04,5,2,3,5,WatCit_T,"-37.81564989, 144.93970694"
121420250426,12,2025-04-26,14,204,202,406,NewQ_T,"-37.81457988, 144.94292398"
242220241224,24,2024-12-24,22,277,530,807,Col620_T,"-37.81887963, 144.95449198"
241320250507,24,2025-05-07,13,717,801,1518,Col620_T,"-37.81887963, 144.95449198"
111420250901,11,2025-09-01,14,82,65,147,WatCit_T,"-37.81564989, 144.93970694"
11620250904,11,2025-09-04,6,31,33,64,WatCit_T,"-37.81564989, 144.93970694"
351720250818,35,2025-08-18,17,1732,1121,2853,SouthB_T,"-37.82018685, 144.96508508"
21720240909,2,2024-09-09,17,499,370,869,Bou283_T,"-37.81380668, 144.96516718"
27820250809,27,2025-08-09,8,81,80,161,Vic_T,"-37.80606888, 144.95644692"
272120241012,27,2024-10-12,21,88,60,148,Vic_T,"-37.80606888, 144.95644692"
23420250330,23,2025-03-30,4,5,22,27,Col623_T,"-37.81909256, 144.95452748"
481620231209,48,2023-12-09,16,280,218,498,QVMQ_T,"-37.80631581, 144.95866697"
481220241018,48,2024-10-18,12,311,190,501,QVMQ_T,"-37.80631581, 144.95866697"
461420240715,46,2024-07-15,14,60,75,135,Pel147_T,"-37.80240719, 144.9615673"
52020250929,52,2025-09-29,0,10,29,39,Eli263_T,"-37.81252157, 144.9619401"
46920250509,46,2025-05-09,9,136,37,173,Pel147_T,"-37.80240719, 144.9615673"
461220250701,46,2025-07-01,12,76,103,179,Pel147_T,"-37.80240719, 144.9615673"
461420231108,46,2023-11-08,14,85,111,196,Pel147_T,"-37.80240719, 144.9615673"
137820250608,137,2025-06-08,8,1,1,2,BouHbr2353_T,"-37.81894815, 144.94612292"
139020240122,139,2024-01-22,0,11,21,32,Signal1647_T,"-37.81959923, 144.9632832"
1391720240917,139,2024-09-17,17,293,37,330,Signal1647_T,"-37.81959923, 144.9632832"
161020250801,161,2025-08-01,0,0,1,1,BirArt1109_T,"-37.81851276, 144.97131336"
1231220250601,123,2025-06-01,12,55,20,75,BirBridge_T,"-37.81753741, 144.97329734"
130020250227,130,2025-02-27,0,0,2,2,Bou892T,"-37.8204637, 144.94126826"
1381920250304,138,2025-03-04,19,4,11,15,EntPark1671_T,"-37.81996544, 144.95981454"
1612020240722,161,2024-07-22,20,0,2,2,BirArt1109_T,"-37.81851276, 144.97131336"
1172020240912,117,2024-09-12,20,96,100,196,Fli114F_T,"-37.81629332, 144.97090877"
49920240420,49,2024-04-20,9,262,302,564,Eli501_T,"-37.80730068, 144.95956055"
1091920240911,109,2024-09-11,19,97,63,160,LatWill_T,"-37.81193681, 144.95621105"
191020240619,19,2024-06-19,10,158,109,267,LtB210_T,"-37.81237202, 144.96550671"
1641420250928,164,2025-09-28,14,109,46,155,Lat526_T,"-37.813005, 144.95160411"
1341320241017,134,2024-10-17,13,512,449,961,Spen201_T,"-37.81694221, 144.95303935"
133020240209,133,2024-02-09,0,44,25,69,Spen229_T,"-37.81531435, 144.95227769"
301620240521,30,2024-05-21,16,208,370,578,Lon189_T,"-37.8112185, 144.96656806"
53420250506,53,2025-05-06,4,2,2,4,Col254_T,"-37.81564191, 144.965499"
51720240208,51,2024-02-08,7,29,27,56,Fra118_T,"-37.80841815, 144.95906316"
23320250328,23,2025-03-28,3,13,20,33,Col623_T,"-37.81909256, 144.95452748"
30120250330,30,2025-03-30,1,256,310,566,Lon189_T,"-37.8112185, 144.96656806"
30720250612,30,2025-06-12,7,45,57,102,Lon189_T,"-37.8112185, 144.96656806"
51820250208,51,2025-02-08,8,38,39,77,Fra118_T,"-37.80841815, 144.95906316"
1421720241030,142,2024-10-30,17,678,456,1134,Hammer1584_T,"-37.81970749, 144.96795734"
1641220250513,164,2025-05-13,12,149,77,226,Lat526_T,"-37.813005, 144.95160411"
164020250606,164,2025-06-06,0,11,11,22,Lat526_T,"-37.813005, 144.95160411"
1381320240308,138,2024-03-08,13,7,9,16,EntPark1671_T,"-37.81996544, 144.95981454"
117820250226,117,2025-02-26,8,380,122,502,Fli114F_T,"-37.81629332, 144.97090877"
141620250430,141,2025-04-30,6,24,16,40,474Fl_T,"-37.81997273, 144.95834911"
109720240303,109,2024-03-03,7,18,19,37,LatWill_T,"-37.81193681, 144.95621105"
841720250920,84,2025-09-20,17,782,1236,2018,ElFi_T,"-37.81798049, 144.96503383"
42020241029,4,2024-10-29,20,560,322,882,Swa123_T,"-37.81487988, 144.9660878"
411920240117,41,2024-01-17,19,986,1137,2123,Swa31,"-37.81668634, 144.96689733"
412220250517,41,2025-05-17,22,115,93,208,Swa31,"-37.81668634, 144.96689733"
81820250601,8,2025-06-01,18,33,11,44,WebBN_T,"-37.82293543, 144.9471751"
8920240315,8,2024-03-15,9,174,120,294,WebBN_T,"-37.82293543, 144.9471751"
77720241214,77,2024-12-14,7,27,46,73,HarEsP_T,"-37.81441438, 144.94433026"
59020240617,59,2024-06-17,0,49,33,82,RMIT_T,"-37.80825648, 144.96304859"
54420241229,54,2024-12-29,4,4,2,6,Swa607_T,"-37.804024, 144.96308399"
54820240121,54,2024-01-21,8,23,18,41,Swa607_T,"-37.804024, 144.96308399"
472220250115,47,2025-01-15,22,248,179,427,Eli250_T,"-37.81258467, 144.9625775"
401020250120,40,2025-01-20,10,139,163,302,Spr201_T,"-37.80999341, 144.97227587"
211220250510,21,2025-05-10,12,370,374,744,Bourke155_T,"-37.81267313, 144.96788288"
211620240415,21,2024-04-15,16,407,374,781,Bourke155_T,"-37.81267313, 144.96788288"
37520240630,37,2024-06-30,5,4,8,12,Lyg260_T,"-37.80107122, 144.96704554"
37820240903,37,2024-09-03,8,42,57,99,Lyg260_T,"-37.80107122, 144.96704554"
442020240204,44,2024-02-04,20,3,1,4,UM3_T,"-37.79698741, 144.96441306"
451720250907,45,2025-09-07,17,329,698,1027,Swa148_T,"-37.81414075, 144.96609379"
45320250304,45,2025-03-04,3,2,4,6,Swa148_T,"-37.81414075, 144.96609379"
135020250628,135,2025-06-28,0,39,58,97,Spen161_T,"-37.8172861, 144.95319102"
135020241008,135,2024-10-08,0,24,30,54,Spen161_T,"-37.8172861, 144.95319102"
135720250228,135,2025-02-28,7,195,227,422,Spen161_T,"-37.8172861, 144.95319102"
87520250226,87,2025-02-26,5,2,1,3,Errol23_T,"-37.80454949, 144.94921863"
61520240111,61,2024-01-11,5,13,14,27,RMIT14_T,"-37.80767455, 144.96309114"
1652020240921,165,2024-09-21,20,33,28,61,Spen475_T,"-37.80953359, 144.94939004"
1341620241019,134,2024-10-19,16,553,524,1077,Spen201_T,"-37.81694221, 144.95303935"
852120240328,85,2024-03-28,21,21,26,47,488Mac_T,"-37.79432415, 144.92973378"
631820240928,63,2024-09-28,18,318,334,652,Bou231_T,"-37.81333081, 144.96675571"
67920250828,67,2025-08-28,9,454,323,777,FLDegS_T,"-37.81688755, 144.96562569"
68620231116,68,2023-11-16,6,27,12,39,FLDegN_T,"-37.8168479, 144.96559789"
62120240323,62,2024-03-23,1,54,47,101,Lat224_T,"-37.80996494, 144.96216521"
241520241130,24,2024-11-30,15,581,785,1366,Col620_T,"-37.81887963, 144.95449198"
52320231118,52,2023-11-18,3,21,48,69,Eli263_T,"-37.81252157, 144.9619401"
522020231130,52,2023-11-30,20,319,240,559,Eli263_T,"-37.81252157, 144.9619401"
164020250304,164,2025-03-04,0,5,12,17,Lat526_T,"-37.813005, 144.95160411"
1371420241219,137,2024-12-19,14,19,60,79,BouHbr2353_T,"-37.81894815, 144.94612292"
141820240331,141,2024-03-31,8,36,20,56,474Fl_T,"-37.81997273, 144.95834911"
141820250702,141,2025-07-02,8,106,113,219,474Fl_T,"-37.81997273, 144.95834911"
136520240718,136,2024-07-18,5,0,1,1,BirFed1120_T,"-37.8184141, 144.97357915"
1172220250812,117,2025-08-12,22,50,60,110,Fli114F_T,"-37.81629332, 144.97090877"
841420231114,84,2023-11-14,14,867,1228,2095,ElFi_T,"-37.81798049, 144.96503383"
84420231208,84,2023-12-08,4,48,71,119,ElFi_T,"-37.81798049, 144.96503383"
841520240127,84,2024-01-27,15,1111,1948,3059,ElFi_T,"-37.81798049, 144.96503383"
41920240914,4,2024-09-14,19,803,856,1659,Swa123_T,"-37.81487988, 144.9660878"
70820240731,70,2024-07-31,8,58,54,112,Errol20_T,"-37.80456984, 144.94946228"
70520250320,70,2025-03-20,5,2,1,3,Errol20_T,"-37.80456984, 144.94946228"
702020250719,70,2025-07-19,20,109,164,273,Errol20_T,"-37.80456984, 144.94946228"
702320250816,70,2025-08-16,23,32,25,57,Errol20_T,"-37.80456984, 144.94946228"
751420250706,75,2025-07-06,14,59,61,120,SprFli_T,"-37.81515276, 144.97467661"
392120241216,39,2024-12-16,21,8,3,11,AlfPl_T,"-37.81379749, 144.96995745"
29220231118,29,2023-11-18,2,5,16,21,AG_T,"-37.8199817, 144.96872865"
14920240929,14,2024-09-29,9,141,61,202,SanBri_T,"-37.82011242, 144.96291897"
281320250624,28,2025-06-24,13,543,502,1045,VAC_T,"-37.82129925, 144.96879309"
281120250420,28,2025-04-20,11,1095,905,2000,VAC_T,"-37.82129925, 144.96879309"
291120241213,29,2024-12-13,11,197,295,492,AG_T,"-37.8199817, 144.96872865"
291720250428,29,2025-04-28,17,226,269,495,AG_T,"-37.8199817, 144.96872865"
47020240220,47,2024-02-20,0,58,80,138,Eli250_T,"-37.81258467, 144.9625775"
211320250119,21,2025-01-19,13,319,366,685,Bourke155_T,"-37.81267313, 144.96788288"
51520250126,5,2025-01-26,15,1757,1670,3427,PriNW_T,"-37.81874249, 144.96787656"
362220250823,36,2025-08-23,22,194,174,368,Que85_T,"-37.81652527, 144.96121062"
371320241006,37,2024-10-06,13,112,84,196,Lyg260_T,"-37.80107122, 144.96704554"
431620250623,43,2025-06-23,16,137,134,271,UM2_T,"-37.79844526, 144.96411782"
451920240805,45,2024-08-05,19,346,476,822,Swa148_T,"-37.81414075, 144.96609379"
452120240514,45,2024-05-14,21,115,292,407,Swa148_T,"-37.81414075, 144.96609379"
451220240215,45,2024-02-15,12,794,881,1675,Swa148_T,"-37.81414075, 144.96609379"
131820240225,131,2024-02-25,8,34,42,76,King2_T,"-37.82009057, 144.95758725"
1621420250708,162,2025-07-08,14,353,658,1011,Eli489_T,"-37.80740397, 144.95987909"
107520231120,107,2023-11-20,5,6,6,12,280Will_T,"-37.81246271, 144.95690188"
1321520240211,132,2024-02-11,15,145,129,274,King335_T,"-37.81267639, 144.95386444"
1352120240116,135,2024-01-16,21,217,195,412,Spen161_T,"-37.8172861, 144.95319102"
1181520250602,118,2025-06-02,15,18,16,34,Fli114C_T,"-37.81632783, 144.97090512"
181020251015,181,2025-10-15,0,154,134,288,Eli368_T,"-37.81009465, 144.96143149"
1651120250209,165,2025-02-09,11,44,39,83,Spen475_T,"-37.80953359, 144.94939004"
1661320250312,166,2025-03-12,13,47,44,91,Spen484_T,"-37.80896733, 144.94931703"
165320241124,165,2024-11-24,3,7,0,7,Spen475_T,"-37.80953359, 144.94939004"
85820250105,85,2025-01-05,8,69,39,108,488Mac_T,"-37.79432415, 144.92973378"
671420250807,67,2025-08-07,14,447,497,944,FLDegS_T,"-37.81688755, 144.96562569"
67320240709,67,2024-07-09,3,0,4,4,FLDegS_T,"-37.81688755, 144.96562569"
18920240427,18,2024-04-27,9,40,70,110,Col12_T,"-37.81344862, 144.97305353"
86920240315,86,2024-03-15,9,60,40,100,574Qub_T,"-37.80309992, 144.94908064"
51920241031,51,2024-10-31,9,42,35,77,Fra118_T,"-37.80841815, 144.95906316"
302320250416,30,2025-04-16,23,107,181,288,Lon189_T,"-37.8112185, 144.96656806"
301520250219,30,2025-02-19,15,178,386,564,Lon189_T,"-37.8112185, 144.96656806"
46720231024,46,2023-10-24,7,20,43,63,Pel147_T,"-37.80240719, 144.9615673"
20520240815,20,2024-08-15,5,5,4,9,LtB170_T,"-37.81172914, 144.9682466"
25420240528,25,2024-05-28,4,8,5,13,MCEC_T,"-37.82401776, 144.95604426"
491720250619,49,2025-06-19,17,305,264,569,Eli501_T,"-37.80730068, 144.95956055"
180820250810,180,2025-08-10,8,32,16,48,Mac330_T,"-37.79497059, 144.93530329"
1381020250711,138,2025-07-11,10,2,8,10,EntPark1671_T,"-37.81996544, 144.95981454"
1382020241123,138,2024-11-23,20,3,1,4,EntPark1671_T,"-37.81996544, 144.95981454"
1611220241118,161,2024-11-18,12,145,140,285,BirArt1109_T,"-37.81851276, 144.97131336"
123720240326,123,2024-03-26,7,28,5,33,BirBridge_T,"-37.81753741, 144.97329734"
1172220241226,117,2024-12-26,22,94,60,154,Fli114F_T,"-37.81629332, 144.97090877"
109720231027,109,2023-10-27,7,37,241,278,LatWill_T,"-37.81193681, 144.95621105"
51620240626,5,2024-06-26,16,1347,753,2100,PriNW_T,"-37.81874249, 144.96787656"
871520240927,87,2024-09-27,15,103,90,193,Errol23_T,"-37.80454949, 144.94921863"
61620240405,61,2024-04-05,6,16,58,74,RMIT14_T,"-37.80767455, 144.96309114"
441220250206,44,2025-02-06,12,53,59,112,UM3_T,"-37.79698741, 144.96441306"
441420250617,44,2025-06-17,14,133,68,201,UM3_T,"-37.79698741, 144.96441306"
43720241111,43,2024-11-11,7,40,35,75,UM2_T,"-37.79844526, 144.96411782"
431920231109,43,2023-11-09,19,119,144,263,UM2_T,"-37.79844526, 144.96411782"
45520250224,45,2025-02-24,5,9,24,33,Swa148_T,"-37.81414075, 144.96609379"
51620250927,5,2025-09-27,16,1168,1054,2222,PriNW_T,"-37.81874249, 144.96787656"
181820250404,181,2025-04-04,8,487,491,978,Eli368_T,"-37.81009465, 144.96143149"
131220240323,131,2024-03-23,2,43,117,160,King2_T,"-37.82009057, 144.95758725"
1621320241116,162,2024-11-16,13,597,993,1590,Eli489_T,"-37.80740397, 144.95987909"
132120251002,132,2025-10-02,1,10,11,21,King335_T,"-37.81267639, 144.95386444"
134520240814,134,2024-08-14,5,50,40,90,Spen201_T,"-37.81694221, 144.95303935"
135220231020,135,2023-10-20,2,5,10,15,Spen161_T,"-37.8172861, 144.95319102"
135520240105,135,2024-01-05,5,21,20,41,Spen161_T,"-37.8172861, 144.95319102"
135520240408,135,2024-04-08,5,19,19,38,Spen161_T,"-37.8172861, 144.95319102"
1351520250113,135,2025-01-13,15,470,426,896,Spen161_T,"-37.8172861, 144.95319102"
135220250120,135,2025-01-20,2,12,20,32,Spen161_T,"-37.8172861, 144.95319102"
1182320250425,118,2025-04-25,23,8,5,13,Fli114C_T,"-37.81632783, 144.97090512"
1081620240409,108,2024-04-09,16,437,178,615,261Will_T,"-37.81295822, 144.95678789"
108020240804,108,2024-08-04,0,5,30,35,261Will_T,"-37.81295822, 144.95678789"
1661120250521,166,2025-05-21,11,44,55,99,Spen484_T,"-37.80896733, 144.94931703"
61620250522,6,2025-05-22,16,1697,890,2587,FliS_T,"-37.81911705, 144.96558255"
4720240106,4,2024-01-06,7,116,69,185,Swa123_T,"-37.81487988, 144.9660878"
701020250823,70,2025-08-23,10,130,133,263,Errol20_T,"-37.80456984, 144.94946228"
751320250129,75,2025-01-29,13,86,76,162,SprFli_T,"-37.81515276, 144.97467661"
81620240908,8,2024-09-08,16,125,111,236,WebBN_T,"-37.82293543, 144.9471751"
411920240722,41,2024-07-22,19,88,63,151,Swa31,"-37.81668634, 144.96689733"
77720240628,77,2024-06-28,7,61,54,115,HarEsP_T,"-37.81441438, 144.94433026"
771720250208,77,2025-02-08,17,387,1278,1665,HarEsP_T,"-37.81441438, 144.94433026"
781720250804,78,2025-08-04,17,14,167,181,HarEsB_T,"-37.81471642, 144.9446508"
651220240606,65,2024-06-06,12,534,411,945,SwaCs_T,"-37.81569416, 144.9668064"
422120241016,42,2024-10-16,21,83,169,252,UM1_T,"-37.80008566, 144.96386412"
691420241018,69,2024-10-18,14,133,130,263,FLDegC_T,"-37.81687226, 144.96559144"
66420240118,66,2024-01-18,4,6,24,30,QVN_T,"-37.81057846, 144.96444294"
4520251015,4,2025-10-15,5,42,26,68,Swa123_T,"-37.81487988, 144.9660878"
81020250801,8,2025-08-01,10,123,160,283,WebBN_T,"-37.82293543, 144.9471751"
78620250504,78,2025-05-04,6,3,0,3,HarEsB_T,"-37.81471642, 144.9446508"
78720250529,78,2025-05-29,7,17,10,27,HarEsB_T,"-37.81471642, 144.9446508"
591320240305,59,2024-03-05,13,1898,1638,3536,RMIT_T,"-37.80825648, 144.96304859"
65320240928,65,2024-09-28,3,19,19,38,SwaCs_T,"-37.81569416, 144.9668064"
282020240522,28,2024-05-22,20,124,168,292,VAC_T,"-37.82129925, 144.96879309"
28920241027,28,2024-10-27,9,111,142,253,VAC_T,"-37.82129925, 144.96879309"
311920231228,31,2023-12-28,19,329,279,608,Lyg161_T,"-37.80169681, 144.96658911"
31120250531,31,2025-05-31,1,33,54,87,Lyg161_T,"-37.80169681, 144.96658911"
47220250614,47,2025-06-14,2,40,44,84,Eli250_T,"-37.81258467, 144.9625775"
211320250529,21,2025-05-29,13,366,469,835,Bourke155_T,"-37.81267313, 144.96788288"
611520231226,61,2023-12-26,15,164,187,351,RMIT14_T,"-37.80767455, 144.96309114"
441620250504,44,2025-05-04,16,67,42,109,UM3_T,"-37.79698741, 144.96441306"
1622220250124,162,2025-01-24,22,193,86,279,Eli489_T,"-37.80740397, 144.95987909"
131820250321,131,2025-03-21,8,92,36,128,King2_T,"-37.82009057, 144.95758725"
1431220250928,143,2025-09-28,12,130,214,344,Spencer_T,"-37.821728, 144.95557015"
1321320240216,132,2024-02-16,13,256,211,467,King335_T,"-37.81267639, 144.95386444"
1231620250829,123,2025-08-29,16,20,10,30,BirBridge_T,"-37.81753741, 144.97329734"
109220250811,109,2025-08-11,2,3,5,8,LatWill_T,"-37.81193681, 144.95621105"
19420240319,19,2024-03-19,4,5,8,13,LtB210_T,"-37.81237202, 144.96550671"
191820240615,19,2024-06-15,18,978,586,1564,LtB210_T,"-37.81237202, 144.96550671"
85720231225,85,2023-12-25,7,4,4,8,488Mac_T,"-37.79432415, 144.92973378"
852120240708,85,2024-07-08,21,3,3,6,488Mac_T,"-37.79432415, 144.92973378"
631320250216,63,2025-02-16,13,552,452,1004,Bou231_T,"-37.81333081, 144.96675571"
632220250627,63,2025-06-27,22,73,203,276,Bou231_T,"-37.81333081, 144.96675571"
561620240401,56,2024-04-01,16,243,300,543,Lon364_T,"-37.81234775, 144.96153311"
111820240516,11,2024-05-16,18,85,93,178,WatCit_T,"-37.81564989, 144.93970694"
241920250601,24,2025-06-01,19,254,309,563,Col620_T,"-37.81887963, 144.95449198"
581420240121,58,2024-01-21,14,469,309,778,Bou688_T,"-37.81686075, 144.95358075"
76320240811,76,2024-08-11,3,1,0,1,KenMac_T,"-37.79453803, 144.93036194"
762020241122,76,2024-11-22,20,33,27,60,KenMac_T,"-37.79453803, 144.93036194"
352320250531,35,2025-05-31,23,299,298,597,SouthB_T,"-37.82018685, 144.96508508"
351420241109,35,2024-11-09,14,1134,1317,2451,SouthB_T,"-37.82018685, 144.96508508"
761020231127,76,2023-11-27,10,43,39,82,KenMac_T,"-37.79453803, 144.93036194"
531720240308,53,2024-03-08,17,692,517,1209,Col254_T,"-37.81564191, 144.965499"
9120240226,9,2024-02-26,1,7,3,10,Col700_T,"-37.81982992, 144.95102555"
27020250409,27,2025-04-09,0,12,8,20,Vic_T,"-37.80606888, 144.95644692"
53920250918,53,2025-09-18,9,432,315,747,Col254_T,"-37.81564191, 144.965499"
53120250324,53,2025-03-24,1,4,5,9,Col254_T,"-37.81564191, 144.965499"
422220250101,42,2025-01-01,22,11,8,19,UM1_T,"-37.80008566, 144.96386412"
281720240126,28,2024-01-26,17,633,1121,1754,VAC_T,"-37.82129925, 144.96879309"
47020250108,47,2025-01-08,0,56,45,101,Eli250_T,"-37.81258467, 144.9625775"
402120250802,40,2025-08-02,21,344,96,440,Spr201_T,"-37.80999341, 144.97227587"
402220250914,40,2025-09-14,22,25,16,41,Spr201_T,"-37.80999341, 144.97227587"
40020240805,40,2024-08-05,0,11,0,11,Spr201_T,"-37.80999341, 144.97227587"
671020240912,67,2024-09-12,10,378,323,701,FLDegS_T,"-37.81688755, 144.96562569"
172220240622,17,2024-06-22,22,185,170,355,Col15_T,"-37.81362543, 144.97323591"
171120241127,17,2024-11-27,11,370,254,624,Col15_T,"-37.81362543, 144.97323591"
17520250731,17,2025-07-31,5,93,26,119,Col15_T,"-37.81362543, 144.97323591"
11720241217,1,2024-12-17,17,1825,1580,3405,Bou292_T,"-37.81349441, 144.96515323"
1620250130,1,2025-01-30,6,38,54,92,Bou292_T,"-37.81349441, 144.96515323"
1620250504,1,2025-05-04,6,11,13,24,Bou292_T,"-37.81349441, 144.96515323"
632020250518,63,2025-05-18,20,23,137,160,Bou231_T,"-37.81333081, 144.96675571"
671920231031,67,2023-10-31,19,218,302,520,FLDegS_T,"-37.81688755, 144.96562569"
861920241109,86,2024-11-09,19,34,65,99,574Qub_T,"-37.80309992, 144.94908064"
681620240215,68,2024-02-15,16,229,142,371,FLDegN_T,"-37.8168479, 144.96559789"
62420231026,62,2023-10-26,4,21,21,42,Lat224_T,"-37.80996494, 144.96216521"
62320250609,62,2025-06-09,3,23,13,36,Lat224_T,"-37.80996494, 144.96216521"
12420231229,12,2023-12-29,4,1,0,1,NewQ_T,"-37.81457988, 144.94292398"
721220231222,72,2023-12-22,12,359,402,761,ACMI_T,"-37.81726338, 144.96872809"
761920250713,76,2025-07-13,19,5,10,15,KenMac_T,"-37.79453803, 144.93036194"
762320250112,76,2025-01-12,23,0,1,1,KenMac_T,"-37.79453803, 144.93036194"
271820231104,27,2023-11-04,18,118,101,219,Vic_T,"-37.80606888, 144.95644692"
581520250510,58,2025-05-10,15,674,1152,1826,Bou688_T,"-37.81686075, 144.95358075"
581820250528,58,2025-05-28,18,492,478,970,Bou688_T,"-37.81686075, 144.95358075"
2620240924,2,2024-09-24,6,18,49,67,Bou283_T,"-37.81380668, 144.96516718"
562120250729,56,2025-07-29,21,186,222,408,Lon364_T,"-37.81234775, 144.96153311"
20020250725,20,2025-07-25,0,28,73,101,LtB170_T,"-37.81172914, 144.9682466"
20220251012,20,2025-10-12,2,121,205,326,LtB170_T,"-37.81172914, 144.9682466"
25220240111,25,2024-01-11,2,4,2,6,MCEC_T,"-37.82401776, 144.95604426"
522020250604,52,2025-06-04,20,206,161,367,Eli263_T,"-37.81252157, 144.9619401"
137520241130,137,2024-11-30,5,0,1,1,BouHbr2353_T,"-37.81894815, 144.94612292"
1612320250522,161,2025-05-22,23,0,3,3,BirArt1109_T,"-37.81851276, 144.97131336"
492320240316,49,2024-03-16,23,94,132,226,Eli501_T,"-37.80730068, 144.95956055"
691620240422,69,2024-04-22,16,110,108,218,FLDegC_T,"-37.81687226, 144.96559144"
6120231126,6,2023-11-26,1,273,139,412,FliS_T,"-37.81911705, 144.96558255"
62120241224,6,2024-12-24,21,2560,2520,5080,FliS_T,"-37.81911705, 144.96558255"
41520240802,4,2024-08-02,15,1529,1197,2726,Swa123_T,"-37.81487988, 144.9660878"
4320250109,4,2025-01-09,3,14,15,29,Swa123_T,"-37.81487988, 144.9660878"
70820240516,70,2024-05-16,8,74,71,145,Errol20_T,"-37.80456984, 144.94946228"
3120250601,3,2025-06-01,1,196,193,389,Swa295_T,"-37.81101524, 144.96429485"
70320250921,70,2025-09-21,3,1,3,4,Errol20_T,"-37.80456984, 144.94946228"
3620240519,3,2024-05-19,6,62,58,120,Swa295_T,"-37.81101524, 144.96429485"
391620231231,39,2023-12-31,16,77,58,135,AlfPl_T,"-37.81379749, 144.96995745"
772120240126,77,2024-01-26,21,236,233,469,HarEsP_T,"-37.81441438, 144.94433026"
782320240501,78,2024-05-01,23,0,11,11,HarEsB_T,"-37.81471642, 144.9446508"
65320240521,65,2024-05-21,3,2,1,3,SwaCs_T,"-37.81569416, 144.9668064"
421120250616,42,2025-06-16,11,204,317,521,UM1_T,"-37.80008566, 144.96386412"
42520250625,42,2025-06-25,5,7,5,12,UM1_T,"-37.80008566, 144.96386412"
272320250531,27,2025-05-31,23,46,27,73,Vic_T,"-37.80606888, 144.95644692"
79320240915,79,2024-09-15,3,43,61,104,FliSS_T,"-37.81794046, 144.96616678"
791920240521,79,2024-05-21,19,219,250,469,FliSS_T,"-37.81794046, 144.96616678"
53520250401,53,2025-04-01,5,6,12,18,Col254_T,"-37.81564191, 144.965499"
51120231212,51,2023-12-12,1,16,19,35,Fra118_T,"-37.80841815, 144.95906316"
511720240317,51,2024-03-17,17,86,106,192,Fra118_T,"-37.80841815, 144.95906316"
231520250511,23,2025-05-11,15,107,167,274,Col623_T,"-37.81909256, 144.95452748"
462220250316,46,2025-03-16,22,2,1,3,Pel147_T,"-37.80240719, 144.9615673"
201820250418,20,2025-04-18,18,652,627,1279,LtB170_T,"-37.81172914, 144.9682466"
522320240924,52,2024-09-24,23,31,61,92,Eli263_T,"-37.81252157, 144.9619401"
52520240506,52,2024-05-06,5,5,11,16,Eli263_T,"-37.81252157, 144.9619401"
136120240913,136,2024-09-13,1,1,0,1,BirFed1120_T,"-37.8184141, 144.97357915"
117220240203,117,2024-02-03,2,18,9,27,Fli114F_T,"-37.81629332, 144.97090877"
1172320241229,117,2024-12-29,23,70,39,109,Fli114F_T,"-37.81629332, 144.97090877"
109720231104,109,2023-11-04,7,25,33,58,LatWill_T,"-37.81193681, 144.95621105"
191720250531,19,2025-05-31,17,935,510,1445,LtB210_T,"-37.81237202, 144.96550671"
137120241205,137,2024-12-05,1,1,2,3,BouHbr2353_T,"-37.81894815, 144.94612292"
1392120241001,139,2024-10-01,21,24,12,36,Signal1647_T,"-37.81959923, 144.9632832"
662320240312,66,2024-03-12,23,133,106,239,QVN_T,"-37.81057846, 144.96444294"
69320240405,69,2024-04-05,3,8,7,15,FLDegC_T,"-37.81687226, 144.96559144"
842120250405,84,2025-04-05,21,664,951,1615,ElFi_T,"-37.81798049, 144.96503383"
84320250910,84,2025-09-10,3,17,11,28,ElFi_T,"-37.81798049, 144.96503383"
70520240501,70,2024-05-01,5,5,2,7,Errol20_T,"-37.80456984, 144.94946228"
31720250119,3,2025-01-19,17,791,934,1725,Swa295_T,"-37.81101524, 144.96429485"
81720240824,8,2024-08-24,17,273,195,468,WebBN_T,"-37.82293543, 144.9471751"
42920250830,42,2025-08-30,9,16,19,35,UM1_T,"-37.80008566, 144.96386412"
77020240129,77,2024-01-29,0,37,16,53,HarEsP_T,"-37.81441438, 144.94433026"
59220240405,59,2024-04-05,2,57,22,79,RMIT_T,"-37.80825648, 144.96304859"
591120241121,59,2024-11-21,11,280,331,611,RMIT_T,"-37.80825648, 144.96304859"
591120250811,59,2025-08-11,11,1178,1099,2277,RMIT_T,"-37.80825648, 144.96304859"
28120240124,28,2024-01-24,1,73,30,103,VAC_T,"-37.82129925, 144.96879309"
47920231129,47,2023-11-29,9,238,550,788,Eli250_T,"-37.81258467, 144.9625775"
471020250824,47,2025-08-24,10,512,662,1174,Eli250_T,"-37.81258467, 144.9625775"
40020250224,40,2025-02-24,0,15,1,16,Spr201_T,"-37.80999341, 144.97227587"
211820240323,21,2024-03-23,18,610,684,1294,Bourke155_T,"-37.81267313, 144.96788288"
50620241104,50,2024-11-04,6,8,8,16,Lyg309_T,"-37.79808192, 144.96721013"
502320250607,50,2025-06-07,23,68,22,90,Lyg309_T,"-37.79808192, 144.96721013"
1311020240414,131,2024-04-14,10,76,157,233,King2_T,"-37.82009057, 144.95758725"
118520240212,118,2024-02-12,5,0,1,1,Fli114C_T,"-37.81632783, 144.97090512"
872320231028,87,2023-10-28,23,22,15,37,Errol23_T,"-37.80454949, 144.94921863"
61220240412,61,2024-04-12,2,17,8,25,RMIT14_T,"-37.80767455, 144.96309114"
166420250201,166,2025-02-01,4,3,2,5,Spen484_T,"-37.80896733, 144.94931703"
143720250818,143,2025-08-18,7,69,98,167,Spencer_T,"-37.821728, 144.95557015"
1341620241226,134,2024-12-26,16,428,385,813,Spen201_T,"-37.81694221, 144.95303935"
20220250710,20,2025-07-10,2,9,10,19,LtB170_T,"-37.81172914, 144.9682466"
20320251003,20,2025-10-03,3,69,36,105,LtB170_T,"-37.81172914, 144.9682466"
251620240724,25,2024-07-24,16,793,432,1225,MCEC_T,"-37.82401776, 144.95604426"
251220240903,25,2024-09-03,12,530,640,1170,MCEC_T,"-37.82401776, 144.95604426"
521520240626,52,2024-06-26,15,401,286,687,Eli263_T,"-37.81252157, 144.9619401"
1361520250717,136,2025-07-17,15,41,75,116,BirFed1120_T,"-37.8184141, 144.97357915"
1421020250905,142,2025-09-05,10,268,192,460,Hammer1584_T,"-37.81970749, 144.96795734"
142020240520,142,2024-05-20,0,1,2,3,Hammer1584_T,"-37.81970749, 144.96795734"
1301420240501,130,2024-05-01,14,27,44,71,Bou892T,"-37.8204637, 144.94126826"
142320241213,14,2024-12-13,23,1104,200,1304,SanBri_T,"-37.82011242, 144.96291897"
711220240903,71,2024-09-03,12,30,21,51,WestWP_T,"-37.81235775, 144.97136962"
29620250723,29,2025-07-23,6,34,68,102,AG_T,"-37.8199817, 144.96872865"
471820231210,47,2023-12-10,18,900,740,1640,Eli250_T,"-37.81258467, 144.9625775"
40220250506,40,2025-05-06,2,2,2,4,Spr201_T,"-37.80999341, 144.97227587"
47720250505,47,2025-05-05,7,112,251,363,Eli250_T,"-37.81258467, 144.9625775"
40820240917,40,2024-09-17,8,237,427,664,Spr201_T,"-37.80999341, 144.97227587"
51920240517,5,2024-05-17,19,515,995,1510,PriNW_T,"-37.81874249, 144.96787656"
50420231018,50,2023-10-18,4,5,1,6,Lyg309_T,"-37.79808192, 144.96721013"
43520250323,43,2025-03-23,5,4,2,6,UM2_T,"-37.79844526, 144.96411782"
451120240528,45,2024-05-28,11,273,360,633,Swa148_T,"-37.81414075, 144.96609379"
1321020240111,132,2024-01-11,10,145,92,237,King335_T,"-37.81267639, 144.95386444"
1341020240903,134,2024-09-03,10,307,330,637,Spen201_T,"-37.81694221, 144.95303935"
1071720250808,107,2025-08-08,17,235,178,413,280Will_T,"-37.81246271, 144.95690188"
133520241021,133,2024-10-21,5,74,72,146,Spen229_T,"-37.81531435, 144.95227769"
165020241027,165,2024-10-27,0,10,9,19,Spen475_T,"-37.80953359, 144.94939004"
167320250916,167,2025-09-16,3,0,2,2,Lat526_T,"-37.81304149, 144.95155955"
1651620241004,165,2024-10-04,16,53,32,85,Spen475_T,"-37.80953359, 144.94939004"
1811820250804,181,2025-08-04,18,916,1093,2009,Eli368_T,"-37.81009465, 144.96143149"
621120240524,62,2024-05-24,11,231,171,402,Lat224_T,"-37.80996494, 144.96216521"
622220240726,62,2024-07-26,22,178,142,320,Lat224_T,"-37.80996494, 144.96216521"
62320241023,62,2024-10-23,3,20,7,27,Lat224_T,"-37.80996494, 144.96216521"
562320240103,56,2024-01-03,23,71,78,149,Lon364_T,"-37.81234775, 144.96153311"
111420250824,11,2025-08-24,14,344,132,476,WatCit_T,"-37.81564989, 144.93970694"
241620251008,24,2025-10-08,16,471,2059,2530,Col620_T,"-37.81887963, 144.95449198"
10820250527,10,2025-05-27,8,53,215,268,BouHbr_T,"-37.81876474, 144.94710545"
76420240825,76,2024-08-25,4,1,0,1,KenMac_T,"-37.79453803, 144.93036194"
91620240805,9,2024-08-05,16,1981,126,2107,Col700_T,"-37.81982992, 144.95102555"
22120251003,2,2025-10-03,21,291,309,600,Bou283_T,"-37.81380668, 144.96516718"
791720240528,79,2024-05-28,17,596,472,1068,FliSS_T,"-37.81794046, 144.96616678"
231620250414,23,2025-04-14,16,161,404,565,Col623_T,"-37.81909256, 144.95452748"
231920250512,23,2025-05-12,19,132,193,325,Col623_T,"-37.81909256, 144.95452748"
23620240728,23,2024-07-28,6,9,21,30,Col623_T,"-37.81909256, 144.95452748"
301120240910,30,2024-09-10,11,195,235,430,Lon189_T,"-37.8112185, 144.96656806"
192320231029,19,2023-10-29,23,93,185,278,LtB210_T,"-37.81237202, 144.96550671"
491420250321,49,2025-03-21,14,254,439,693,Eli501_T,"-37.80730068, 144.95956055"
137720240418,137,2024-04-18,7,87,15,102,BouHbr2353_T,"-37.81894815, 144.94612292"
1371020250324,137,2025-03-24,10,36,33,69,BouHbr2353_T,"-37.81894815, 144.94612292"
141920250324,141,2025-03-24,9,68,89,157,474Fl_T,"-37.81997273, 144.95834911"
1381020240227,138,2024-02-27,10,6,5,11,EntPark1671_T,"-37.81996544, 144.95981454"
1231820240201,123,2024-02-01,18,2,8,10,BirBridge_T,"-37.81753741, 144.97329734"
49320240118,49,2024-01-18,3,14,22,36,Eli501_T,"-37.80730068, 144.95956055"
851520231206,85,2023-12-06,15,119,96,215,488Mac_T,"-37.79432415, 144.92973378"
851220250616,85,2025-06-16,12,88,85,173,488Mac_T,"-37.79432415, 144.92973378"
63820240908,63,2024-09-08,8,29,61,90,Bou231_T,"-37.81333081, 144.96675571"
49620250206,49,2025-02-06,6,26,39,65,Eli501_T,"-37.80730068, 144.95956055"
141620240128,141,2024-01-28,6,29,17,46,474Fl_T,"-37.81997273, 144.95834911"
1412120250819,141,2025-08-19,21,59,68,127,474Fl_T,"-37.81997273, 144.95834911"
191220240728,19,2024-07-28,12,511,398,909,LtB210_T,"-37.81237202, 144.96550671"
1801320250327,180,2025-03-27,13,26,35,61,Mac330_T,"-37.79497059, 144.93530329"
139620241010,139,2024-10-10,6,9,38,47,Signal1647_T,"-37.81959923, 144.9632832"
621120240516,62,2024-05-16,11,172,142,314,Lat224_T,"-37.80996494, 144.96216521"
56820250328,56,2025-03-28,8,141,149,290,Lon364_T,"-37.81234775, 144.96153311"
86020250206,86,2025-02-06,0,0,5,5,574Qub_T,"-37.80309992, 144.94908064"
242020250324,24,2025-03-24,20,269,433,702,Col620_T,"-37.81887963, 144.95449198"
101120250113,10,2025-01-13,11,91,64,155,BouHbr_T,"-37.81876474, 144.94710545"
122220250608,12,2025-06-08,22,4,10,14,NewQ_T,"-37.81457988, 144.94292398"
721720231216,72,2023-12-16,17,520,720,1240,ACMI_T,"-37.81726338, 144.96872809"
10420240823,10,2024-08-23,4,2,0,2,BouHbr_T,"-37.81876474, 144.94710545"
58020240903,58,2024-09-03,0,43,33,76,Bou688_T,"-37.81686075, 144.95358075"
351220250612,35,2025-06-12,12,1292,1231,2523,SouthB_T,"-37.82018685, 144.96508508"
2520231028,2,2023-10-28,5,5,9,14,Bou283_T,"-37.81380668, 144.96516718"
53820240528,53,2024-05-28,8,410,317,727,Col254_T,"-37.81564191, 144.965499"
271520240628,27,2024-06-28,15,154,127,281,Vic_T,"-37.80606888, 144.95644692"
271320250307,27,2025-03-07,13,193,145,338,Vic_T,"-37.80606888, 144.95644692"
27020250608,27,2025-06-08,0,32,14,46,Vic_T,"-37.80606888, 144.95644692"
301320240322,30,2024-03-22,13,266,415,681,Lon189_T,"-37.8112185, 144.96656806"
23520240528,23,2024-05-28,5,24,21,45,Col623_T,"-37.81909256, 144.95452748"
30020250313,30,2025-03-13,0,80,102,182,Lon189_T,"-37.8112185, 144.96656806"
30420250618,30,2025-06-18,4,2,12,14,Lon189_T,"-37.8112185, 144.96656806"
462320240921,46,2024-09-21,23,1,1,2,Pel147_T,"-37.80240719, 144.9615673"
691120240130,69,2024-01-30,11,99,105,204,FLDegC_T,"-37.81687226, 144.96559144"
691720250103,69,2025-01-03,17,156,207,363,FLDegC_T,"-37.81687226, 144.96559144"
62020240216,6,2024-02-16,20,913,863,1776,FliS_T,"-37.81911705, 144.96558255"
62120240302,6,2024-03-02,21,950,777,1727,FliS_T,"-37.81911705, 144.96558255"
701220250929,70,2025-09-29,12,170,157,327,Errol20_T,"-37.80456984, 144.94946228"
701120240422,70,2024-04-22,11,116,113,229,Errol20_T,"-37.80456984, 144.94946228"
3120240929,3,2024-09-29,1,168,154,322,Swa295_T,"-37.81101524, 144.96429485"
32120250321,3,2025-03-21,21,998,893,1891,Swa295_T,"-37.81101524, 144.96429485"
391020240225,39,2024-02-25,10,58,53,111,AlfPl_T,"-37.81379749, 144.96995745"
75720241225,75,2024-12-25,7,7,13,20,SprFli_T,"-37.81515276, 144.97467661"
8420250506,8,2025-05-06,4,2,1,3,WebBN_T,"-37.82293543, 144.9471751"
81920250704,8,2025-07-04,19,31,9,40,WebBN_T,"-37.82293543, 144.9471751"
82120240309,8,2024-03-09,21,52,68,120,WebBN_T,"-37.82293543, 144.9471751"
591020240409,59,2024-04-09,10,1061,684,1745,RMIT_T,"-37.80825648, 144.96304859"
59320240422,59,2024-04-22,3,12,6,18,RMIT_T,"-37.80825648, 144.96304859"
652020240724,65,2024-07-24,20,320,214,534,SwaCs_T,"-37.81569416, 144.9668064"
29020240106,29,2024-01-06,0,47,58,105,AG_T,"-37.8199817, 144.96872865"
31320241203,31,2024-12-03,3,4,8,12,Lyg161_T,"-37.80169681, 144.96658911"
361120241027,36,2024-10-27,11,125,79,204,Que85_T,"-37.81652527, 144.96121062"
44620250704,44,2025-07-04,6,3,2,5,UM3_T,"-37.79698741, 144.96441306"
63120241107,63,2024-11-07,1,6,22,28,Bou231_T,"-37.81333081, 144.96675571"
18020250821,18,2025-08-21,0,3,1,4,Col12_T,"-37.81344862, 144.97305353"
66120231020,66,2023-10-20,1,99,32,131,QVN_T,"-37.81057846, 144.96444294"
70020241126,70,2024-11-26,0,1,2,3,Errol20_T,"-37.80456984, 144.94946228"
701220250420,70,2025-04-20,12,99,91,190,Errol20_T,"-37.80456984, 144.94946228"
3120241015,3,2024-10-15,1,61,27,88,Swa295_T,"-37.81101524, 144.96429485"
751020250222,75,2025-02-22,10,31,35,66,SprFli_T,"-37.81515276, 144.97467661"
712220240521,71,2024-05-21,22,8,3,11,WestWP_T,"-37.81235775, 144.97136962"
711220250116,71,2025-01-16,12,21,18,39,WestWP_T,"-37.81235775, 144.97136962"
591920250717,59,2025-07-17,19,514,393,907,RMIT_T,"-37.80825648, 144.96304859"
592120231124,59,2023-11-24,21,297,195,492,RMIT_T,"-37.80825648, 144.96304859"
591920240415,59,2024-04-15,19,568,740,1308,RMIT_T,"-37.80825648, 144.96304859"
31920240814,31,2024-08-14,9,89,90,179,Lyg161_T,"-37.80169681, 144.96658911"
54120250829,54,2025-08-29,1,21,18,39,Swa607_T,"-37.804024, 144.96308399"
281820250921,28,2025-09-21,18,345,133,478,VAC_T,"-37.82129925, 144.96879309"
402320250521,40,2025-05-21,23,16,16,32,Spr201_T,"-37.80999341, 144.97227587"
401920250817,40,2025-08-17,19,56,57,113,Spr201_T,"-37.80999341, 144.97227587"
401920240516,40,2024-05-16,19,79,92,171,Spr201_T,"-37.80999341, 144.97227587"
21620250410,21,2025-04-10,6,16,21,37,Bourke155_T,"-37.81267313, 144.96788288"
21620240108,21,2024-01-08,6,22,39,61,Bourke155_T,"-37.81267313, 144.96788288"
612220241201,61,2024-12-01,22,205,108,313,RMIT14_T,"-37.80767455, 144.96309114"
61920250108,61,2025-01-08,9,108,243,351,RMIT14_T,"-37.80767455, 144.96309114"
87720250430,87,2025-04-30,7,39,37,76,Errol23_T,"-37.80454949, 144.94921863"
442220240420,44,2024-04-20,22,12,10,22,UM3_T,"-37.79698741, 144.96441306"
1401120231207,140,2023-12-07,11,80,56,136,Boyd2837_T,"-37.82590962, 144.96185972"
1401020240305,140,2024-03-05,10,98,28,126,Boyd2837_T,"-37.82590962, 144.96185972"
181320250328,181,2025-03-28,3,55,52,107,Eli368_T,"-37.81009465, 144.96143149"
162520241206,162,2024-12-06,5,29,12,41,Eli489_T,"-37.80740397, 144.95987909"
1322320240511,132,2024-05-11,23,54,69,123,King335_T,"-37.81267639, 144.95386444"
132920241020,132,2024-10-20,9,130,67,197,King335_T,"-37.81267639, 144.95386444"
135320240527,135,2024-05-27,3,18,16,34,Spen161_T,"-37.8172861, 144.95319102"
1351320250118,135,2025-01-18,13,415,543,958,Spen161_T,"-37.8172861, 144.95319102"
1332120250515,133,2025-05-15,21,407,331,738,Spen229_T,"-37.81531435, 144.95227769"
118720240622,118,2024-06-22,7,1,0,1,Fli114C_T,"-37.81632783, 144.97090512"
118820241116,118,2024-11-16,8,4,2,6,Fli114C_T,"-37.81632783, 144.97090512"
1082120240319,108,2024-03-19,21,123,92,215,261Will_T,"-37.81295822, 144.95678789"
1792020250227,179,2025-02-27,20,52,59,111,Pow61_T,"-37.82392385, 144.96299677"
1651520241023,165,2024-10-23,15,64,48,112,Spen475_T,"-37.80953359, 144.94939004"
17520240429,17,2024-04-29,5,47,11,58,Col15_T,"-37.81362543, 144.97323591"
17020240711,17,2024-07-11,0,8,5,13,Col15_T,"-37.81362543, 144.97323591"
1120241111,1,2024-11-11,1,29,26,55,Bou292_T,"-37.81349441, 144.96515323"
18720240803,18,2024-08-03,7,8,7,15,Col12_T,"-37.81344862, 144.97305353"
56020231112,56,2023-11-12,0,85,82,167,Lon364_T,"-37.81234775, 144.96153311"
561720250407,56,2025-04-07,17,412,415,827,Lon364_T,"-37.81234775, 144.96153311"
111020240524,11,2024-05-24,10,48,51,99,WatCit_T,"-37.81564989, 144.93970694"
12320250206,12,2025-02-06,3,1,1,2,NewQ_T,"-37.81457988, 144.94292398"
121420250522,12,2025-05-22,14,109,147,256,NewQ_T,"-37.81457988, 144.94292398"
12220240329,12,2024-03-29,2,4,8,12,NewQ_T,"-37.81457988, 144.94292398"
10520250225,10,2025-02-25,5,4,3,7,BouHbr_T,"-37.81876474, 144.94710545"
72020241030,72,2024-10-30,0,26,27,53,ACMI_T,"-37.81726338, 144.96872809"
721420250312,72,2025-03-12,14,301,409,710,ACMI_T,"-37.81726338, 144.96872809"
231520250307,23,2025-03-07,15,223,297,520,Col623_T,"-37.81909256, 144.95452748"
791920251014,79,2025-10-14,19,263,240,503,FliSS_T,"-37.81794046, 144.96616678"
481320240630,48,2024-06-30,13,639,360,999,QVMQ_T,"-37.80631581, 144.95866697"
202120241130,20,2024-11-30,21,271,512,783,LtB170_T,"-37.81172914, 144.9682466"
251220240213,25,2024-02-13,12,290,319,609,MCEC_T,"-37.82401776, 144.95604426"
521620250826,52,2025-08-26,16,235,260,495,Eli263_T,"-37.81252157, 144.9619401"
137920240801,137,2024-08-01,9,92,28,120,BouHbr2353_T,"-37.81894815, 144.94612292"
1371320241105,137,2024-11-05,13,13,14,27,BouHbr2353_T,"-37.81894815, 144.94612292"
1412020250417,141,2025-04-17,20,106,138,244,474Fl_T,"-37.81997273, 144.95834911"
139520241129,139,2024-11-29,5,1,1,2,Signal1647_T,"-37.81959923, 144.9632832"
1421420240917,142,2024-09-17,14,346,290,636,Hammer1584_T,"-37.81970749, 144.96795734"
130920231203,130,2023-12-03,9,8,15,23,Bou892T,"-37.8204637, 144.94126826"
1641920250111,164,2025-01-11,19,67,78,145,Lat526_T,"-37.813005, 144.95160411"
61320231224,6,2023-12-24,13,858,918,1776,FliS_T,"-37.81911705, 144.96558255"
75720240930,75,2024-09-30,7,38,29,67,SprFli_T,"-37.81515276, 144.97467661"
8020240902,8,2024-09-02,0,0,2,2,WebBN_T,"-37.82293543, 144.9471751"
751220250514,75,2025-05-14,12,74,56,130,SprFli_T,"-37.81515276, 144.97467661"
412020240105,41,2024-01-05,20,1021,1146,2167,Swa31,"-37.81668634, 144.96689733"
41220240317,41,2024-03-17,2,176,272,448,Swa31,"-37.81668634, 144.96689733"
41120231231,41,2023-12-31,1,144,222,366,Swa31,"-37.81668634, 144.96689733"
421920240717,42,2024-07-17,19,59,65,124,UM1_T,"-37.80008566, 144.96386412"
59520250707,59,2025-07-07,5,14,16,30,RMIT_T,"-37.80825648, 144.96304859"
311120250901,31,2025-09-01,11,104,85,189,Lyg161_T,"-37.80169681, 144.96658911"
40520250417,40,2025-04-17,5,8,15,23,Spr201_T,"-37.80999341, 144.97227587"
51820251016,5,2025-10-16,18,921,1246,2167,PriNW_T,"-37.81874249, 144.96787656"
452120250227,45,2025-02-27,21,173,560,733,Swa148_T,"-37.81414075, 144.96609379"
431420250303,43,2025-03-03,14,329,520,849,UM2_T,"-37.79844526, 144.96411782"
43920231222,43,2023-12-22,9,26,30,56,UM2_T,"-37.79844526, 144.96411782"
1792120250801,179,2025-08-01,21,49,60,109,Pow61_T,"-37.82392385, 144.96299677"
165920241020,165,2024-10-20,9,25,38,63,Spen475_T,"-37.80953359, 144.94939004"
1321820240224,132,2024-02-24,18,219,178,397,King335_T,"-37.81267639, 144.95386444"
1311220240428,131,2024-04-28,12,135,135,270,King2_T,"-37.82009057, 144.95758725"
131320240503,131,2024-05-03,3,3,28,31,King2_T,"-37.82009057, 144.95758725"
1311820240701,131,2024-07-01,18,45,66,111,King2_T,"-37.82009057, 144.95758725"
133020250513,133,2025-05-13,0,62,17,79,Spen229_T,"-37.81531435, 144.95227769"
133820240528,133,2024-05-28,8,603,466,1069,Spen229_T,"-37.81531435, 144.95227769"
67220240125,67,2024-01-25,2,4,4,8,FLDegS_T,"-37.81688755, 144.96562569"
85520240519,85,2024-05-19,5,3,2,5,488Mac_T,"-37.79432415, 144.92973378"
1120241016,1,2024-10-16,1,10,9,19,Bou292_T,"-37.81349441, 144.96515323"
11020250504,1,2025-05-04,10,527,570,1097,Bou292_T,"-37.81349441, 144.96515323"
621720241002,62,2024-10-02,17,301,200,501,Lat224_T,"-37.80996494, 144.96216521"
561220240604,56,2024-06-04,12,347,247,594,Lon364_T,"-37.81234775, 144.96153311"
56420250603,56,2025-06-03,4,3,2,5,Lon364_T,"-37.81234775, 144.96153311"
241620240820,24,2024-08-20,16,466,2031,2497,Col620_T,"-37.81887963, 144.95449198"
72220250104,72,2025-01-04,2,2,8,10,ACMI_T,"-37.81726338, 144.96872809"
72520250219,72,2025-02-19,5,11,23,34,ACMI_T,"-37.81726338, 144.96872809"
10020250906,10,2025-09-06,0,2,9,11,BouHbr_T,"-37.81876474, 144.94710545"
58120241215,58,2024-12-15,1,89,155,244,Bou688_T,"-37.81686075, 144.95358075"
35620241002,35,2024-10-02,6,296,381,677,SouthB_T,"-37.82018685, 144.96508508"
352320250126,35,2025-01-26,23,476,1883,2359,SouthB_T,"-37.82018685, 144.96508508"
791620250715,79,2025-07-15,16,529,430,959,FliSS_T,"-37.81794046, 144.96616678"
531220250623,53,2025-06-23,12,784,558,1342,Col254_T,"-37.81564191, 144.965499"
35920231217,35,2023-12-17,9,608,468,1076,SouthB_T,"-37.82018685, 144.96508508"
27420240914,27,2024-09-14,4,4,2,6,Vic_T,"-37.80606888, 144.95644692"
51920240316,51,2024-03-16,9,80,79,159,Fra118_T,"-37.80841815, 144.95906316"
231320240508,23,2024-05-08,13,344,522,866,Col623_T,"-37.81909256, 144.95452748"
20720231121,20,2023-11-21,7,37,29,66,LtB170_T,"-37.81172914, 144.9682466"
20020240423,20,2024-04-23,0,12,8,20,LtB170_T,"-37.81172914, 144.9682466"
52020250407,52,2025-04-07,0,12,19,31,Eli263_T,"-37.81252157, 144.9619401"
52920240729,52,2024-07-29,9,100,185,285,Eli263_T,"-37.81252157, 144.9619401"
51020250813,51,2025-08-13,0,7,13,20,Fra118_T,"-37.80841815, 144.95906316"
49920241127,49,2024-11-27,9,133,156,289,Eli501_T,"-37.80730068, 144.95956055"
491820250905,49,2025-09-05,18,249,288,537,Eli501_T,"-37.80730068, 144.95956055"
1301220240926,130,2024-09-26,12,76,92,168,Bou892T,"-37.8204637, 144.94126826"
1611620240722,161,2024-07-22,16,119,95,214,BirArt1109_T,"-37.81851276, 144.97131336"
1231520241202,123,2024-12-02,15,5,4,9,BirBridge_T,"-37.81753741, 144.97329734"
117720250511,117,2025-05-11,7,33,73,106,Fli114F_T,"-37.81629332, 144.97090877"
117820240807,117,2024-08-07,8,375,103,478,Fli114F_T,"-37.81629332, 144.97090877"
66520250208,66,2025-02-08,5,18,27,45,QVN_T,"-37.81057846, 144.96444294"
6620240801,6,2024-08-01,6,163,326,489,FliS_T,"-37.81911705, 144.96558255"
6220250514,6,2025-05-14,2,6,10,16,FliS_T,"-37.81911705, 144.96558255"
3120240229,3,2024-02-29,1,99,57,156,Swa295_T,"-37.81101524, 144.96429485"
4720240711,4,2024-07-11,7,165,91,256,Swa123_T,"-37.81487988, 144.9660878"
41520240913,4,2024-09-13,15,1184,1151,2335,Swa123_T,"-37.81487988, 144.9660878"
70520231114,70,2023-11-14,5,1,2,3,Errol20_T,"-37.80456984, 144.94946228"
702120250104,70,2025-01-04,21,75,70,145,Errol20_T,"-37.80456984, 144.94946228"
39720231202,39,2023-12-02,7,27,16,43,AlfPl_T,"-37.81379749, 144.96995745"
8420240903,8,2024-09-03,4,2,0,2,WebBN_T,"-37.82293543, 144.9471751"
422320250120,42,2025-01-20,23,18,17,35,UM1_T,"-37.80008566, 144.96386412"
141020241108,14,2024-11-08,10,203,86,289,SanBri_T,"-37.82011242, 144.96291897"
141120240914,14,2024-09-14,11,265,116,381,SanBri_T,"-37.82011242, 144.96291897"
591620251007,59,2025-10-07,16,1258,1562,2820,RMIT_T,"-37.80825648, 144.96304859"
711220240601,71,2024-06-01,12,10,8,18,WestWP_T,"-37.81235775, 144.97136962"
71320241231,71,2024-12-31,3,0,1,1,WestWP_T,"-37.81235775, 144.97136962"
712020250313,71,2025-03-13,20,11,14,25,WestWP_T,"-37.81235775, 144.97136962"
52120250501,5,2025-05-01,21,276,294,570,PriNW_T,"-37.81874249, 144.96787656"
372120240528,37,2024-05-28,21,83,107,190,Lyg260_T,"-37.80107122, 144.96704554"
37520240811,37,2024-08-11,5,3,5,8,Lyg260_T,"-37.80107122, 144.96704554"
431720241115,43,2024-11-15,17,152,143,295,UM2_T,"-37.79844526, 144.96411782"
441720240710,44,2024-07-10,17,70,70,140,UM3_T,"-37.79698741, 144.96441306"
52220250915,5,2025-09-15,22,261,221,482,PriNW_T,"-37.81874249, 144.96787656"
162520250723,162,2025-07-23,5,10,12,22,Eli489_T,"-37.80740397, 144.95987909"
1321220231115,132,2023-11-15,12,167,157,324,King335_T,"-37.81267639, 144.95386444"
132420231223,132,2023-12-23,4,10,15,25,King335_T,"-37.81267639, 144.95386444"
132220240323,132,2024-03-23,2,32,21,53,King335_T,"-37.81267639, 144.95386444"
1322020241128,132,2024-11-28,20,101,130,231,King335_T,"-37.81267639, 144.95386444"
134320240216,134,2024-02-16,3,18,10,28,Spen201_T,"-37.81694221, 144.95303935"
1342020250722,134,2025-07-22,20,236,185,421,Spen201_T,"-37.81694221, 144.95303935"
1072320240925,107,2024-09-25,23,18,7,25,280Will_T,"-37.81246271, 144.95690188"
118820240401,118,2024-04-01,8,5,1,6,Fli114C_T,"-37.81632783, 144.97090512"
43820231202,43,2023-12-02,8,20,2,22,UM2_T,"-37.79844526, 144.96411782"
432220240903,43,2024-09-03,22,30,38,68,UM2_T,"-37.79844526, 144.96411782"
451920250831,45,2025-08-31,19,221,491,712,Swa148_T,"-37.81414075, 144.96609379"
451320250612,45,2025-06-12,13,603,847,1450,Swa148_T,"-37.81414075, 144.96609379"
131220250209,131,2025-02-09,2,95,150,245,King2_T,"-37.82009057, 144.95758725"
135220240518,135,2024-05-18,2,27,16,43,Spen161_T,"-37.8172861, 144.95319102"
1352020241006,135,2024-10-06,20,286,266,552,Spen161_T,"-37.8172861, 144.95319102"
1351620250303,135,2025-03-03,16,476,476,952,Spen161_T,"-37.8172861, 144.95319102"
1071820231129,107,2023-11-29,18,125,122,247,280Will_T,"-37.81246271, 144.95690188"
1082020250621,108,2025-06-21,20,110,98,208,261Will_T,"-37.81295822, 144.95678789"
87320231203,87,2023-12-03,3,3,1,4,Errol23_T,"-37.80454949, 144.94921863"
61120231109,61,2023-11-09,1,33,11,44,RMIT14_T,"-37.80767455, 144.96309114"
1841420250828,184,2025-08-28,14,797,997,1794,Eli124_T,"-37.81512416, 144.96371988"
166220250417,166,2025-04-17,2,2,0,2,Spen484_T,"-37.80896733, 144.94931703"
1401320250823,140,2025-08-23,13,116,74,190,Boyd2837_T,"-37.82590962, 144.96185972"
671120240123,67,2024-01-23,11,314,379,693,FLDegS_T,"-37.81688755, 144.96562569"
851220240831,85,2024-08-31,12,90,97,187,488Mac_T,"-37.79432415, 144.92973378"
851920250611,85,2025-06-11,19,36,39,75,488Mac_T,"-37.79432415, 144.92973378"
17620240818,17,2024-08-18,6,22,18,40,Col15_T,"-37.81362543, 144.97323591"
172120241121,17,2024-11-21,21,89,138,227,Col15_T,"-37.81362543, 144.97323591"
1620240512,1,2024-05-12,6,10,8,18,Bou292_T,"-37.81349441, 144.96515323"
63820241211,63,2024-12-11,8,180,177,357,Bou231_T,"-37.81333081, 144.96675571"
181620240917,18,2024-09-17,16,597,94,691,Col12_T,"-37.81344862, 144.97305353"
11820240913,11,2024-09-13,8,55,46,101,WatCit_T,"-37.81564989, 144.93970694"
671320250611,67,2025-06-11,13,585,642,1227,FLDegS_T,"-37.81688755, 144.96562569"
62320240824,62,2024-08-24,3,24,25,49,Lat224_T,"-37.80996494, 144.96216521"
56020240930,56,2024-09-30,0,18,23,41,Lon364_T,"-37.81234775, 144.96153311"
561620250205,56,2025-02-05,16,308,285,593,Lon364_T,"-37.81234775, 144.96153311"
242220231204,24,2023-12-04,22,121,259,380,Col620_T,"-37.81887963, 144.95449198"
241020240601,24,2024-06-01,10,628,315,943,Col620_T,"-37.81887963, 144.95449198"
121420250114,12,2025-01-14,14,150,140,290,NewQ_T,"-37.81457988, 144.94292398"
35120240525,35,2024-05-25,1,107,198,305,SouthB_T,"-37.82018685, 144.96508508"
111420250418,11,2025-04-18,14,207,46,253,WatCit_T,"-37.81564989, 144.93970694"
111920240530,11,2024-05-30,19,0,2,2,WatCit_T,"-37.81564989, 144.93970694"
21020250713,2,2025-07-13,10,273,311,584,Bou283_T,"-37.81380668, 144.96516718"
302320240512,30,2024-05-12,23,119,133,252,Lon189_T,"-37.8112185, 144.96656806"
531220250925,53,2025-09-25,12,1285,922,2207,Col254_T,"-37.81564191, 144.965499"
531920241117,53,2024-11-17,19,205,200,405,Col254_T,"-37.81564191, 144.965499"
232120240409,23,2024-04-09,21,63,177,240,Col623_T,"-37.81909256, 144.95452748"
48920240412,48,2024-04-12,9,183,114,297,QVMQ_T,"-37.80631581, 144.95866697"
25520250222,25,2025-02-22,5,15,20,35,MCEC_T,"-37.82401776, 144.95604426"
201520240401,20,2024-04-01,15,180,225,405,LtB170_T,"-37.81172914, 144.9682466"
201220240407,20,2024-04-07,12,364,334,698,LtB170_T,"-37.81172914, 144.9682466"
1381420241226,138,2024-12-26,14,11,0,11,EntPark1671_T,"-37.81996544, 144.95981454"
161820241229,161,2024-12-29,8,228,110,338,BirArt1109_T,"-37.81851276, 144.97131336"
1231020250108,123,2025-01-08,10,51,43,94,BirBridge_T,"-37.81753741, 144.97329734"
1411820240212,141,2024-02-12,18,93,122,215,474Fl_T,"-37.81997273, 144.95834911"
1171320240427,117,2024-04-27,13,210,255,465,Fli114F_T,"-37.81629332, 144.97090877"
491520240310,49,2024-03-10,15,254,376,630,Eli501_T,"-37.80730068, 144.95956055"
191920250524,19,2025-05-24,19,996,664,1660,LtB210_T,"-37.81237202, 144.96550671"
191220240813,19,2024-08-13,12,488,426,914,LtB210_T,"-37.81237202, 144.96550671"
1391520240922,139,2024-09-22,15,50,67,117,Signal1647_T,"-37.81959923, 144.9632832"
1391920250414,139,2025-04-14,19,36,26,62,Signal1647_T,"-37.81959923, 144.9632832"
691720250923,69,2025-09-23,17,141,280,421,FLDegC_T,"-37.81687226, 144.96559144"
691220251007,69,2025-10-07,12,106,143,249,FLDegC_T,"-37.81687226, 144.96559144"
61820250628,6,2025-06-28,18,971,1019,1990,FliS_T,"-37.81911705, 144.96558255"
31720250222,3,2025-02-22,17,990,1347,2337,Swa295_T,"-37.81101524, 144.96429485"
391520241111,39,2024-11-11,15,84,76,160,AlfPl_T,"-37.81379749, 144.96995745"
751420240809,75,2024-08-09,14,53,69,122,SprFli_T,"-37.81515276, 144.97467661"
8820250112,8,2025-01-12,8,59,130,189,WebBN_T,"-37.82293543, 144.9471751"
8820251002,8,2025-10-02,8,323,126,449,WebBN_T,"-37.82293543, 144.9471751"
421120250720,42,2025-07-20,11,30,44,74,UM1_T,"-37.80008566, 144.96386412"
421420250817,42,2025-08-17,14,565,637,1202,UM1_T,"-37.80008566, 144.96386412"
141520241217,14,2024-12-17,15,575,148,723,SanBri_T,"-37.82011242, 144.96291897"
542120250817,54,2025-08-17,21,112,111,223,Swa607_T,"-37.804024, 144.96308399"
471120231019,47,2023-10-19,11,616,662,1278,Eli250_T,"-37.81258467, 144.9625775"
401520251007,40,2025-10-07,15,178,140,318,Spr201_T,"-37.80999341, 144.97227587"
45820231105,45,2023-11-05,8,75,78,153,Swa148_T,"-37.81414075, 144.96609379"
371820250510,37,2025-05-10,18,194,206,400,Lyg260_T,"-37.80107122, 144.96704554"
371520250725,37,2025-07-25,15,65,98,163,Lyg260_T,"-37.80107122, 144.96704554"
501620250308,50,2025-03-08,16,258,239,497,Lyg309_T,"-37.79808192, 144.96721013"
43320250606,43,2025-06-06,3,2,1,3,UM2_T,"-37.79844526, 144.96411782"
43420250626,43,2025-06-26,4,0,2,2,UM2_T,"-37.79844526, 144.96411782"
1311820240419,131,2024-04-19,18,103,87,190,King2_T,"-37.82009057, 144.95758725"
1312020240922,131,2024-09-22,20,84,74,158,King2_T,"-37.82009057, 144.95758725"
1181220250427,118,2025-04-27,12,30,75,105,Fli114C_T,"-37.81632783, 144.97090512"
1181220250531,118,2025-05-31,12,12,18,30,Fli114C_T,"-37.81632783, 144.97090512"
1072220241018,107,2024-10-18,22,28,48,76,280Will_T,"-37.81246271, 144.95690188"
107220241213,107,2024-12-13,2,11,2,13,280Will_T,"-37.81246271, 144.95690188"
108620250928,108,2025-09-28,6,18,23,41,261Will_T,"-37.81295822, 144.95678789"
871220250321,87,2025-03-21,12,137,164,301,Errol23_T,"-37.80454949, 144.94921863"
872020240619,87,2024-06-19,20,52,34,86,Errol23_T,"-37.80454949, 144.94921863"
611720250318,61,2025-03-18,17,1007,1571,2578,RMIT14_T,"-37.80767455, 144.96309114"
87520231110,87,2023-11-10,5,6,4,10,Errol23_T,"-37.80454949, 144.94921863"
871220231219,87,2023-12-19,12,170,144,314,Errol23_T,"-37.80454949, 144.94921863"
611420250605,61,2025-06-05,14,392,578,970,RMIT14_T,"-37.80767455, 144.96309114"
611720240229,61,2024-02-29,17,539,788,1327,RMIT14_T,"-37.80767455, 144.96309114"
1821420250924,182,2025-09-24,14,207,216,423,King163_T,"-37.81627451, 144.95550503"
1661220250313,166,2025-03-13,12,59,55,114,Spen484_T,"-37.80896733, 144.94931703"
1671520241203,167,2024-12-03,15,33,44,77,Lat526_T,"-37.81304149, 144.95155955"
167320241227,167,2024-12-27,3,3,0,3,Lat526_T,"-37.81304149, 144.95155955"
140720240915,140,2024-09-15,7,32,7,39,Boyd2837_T,"-37.82590962, 144.96185972"
681120250206,68,2025-02-06,11,182,158,340,FLDegN_T,"-37.8168479, 144.96559789"
851820240507,85,2024-05-07,18,59,107,166,488Mac_T,"-37.79432415, 144.92973378"
182020250406,18,2025-04-06,20,17,12,29,Col12_T,"-37.81344862, 144.97305353"
182120250421,18,2025-04-21,21,8,9,17,Col12_T,"-37.81344862, 144.97305353"
18020250829,18,2025-08-29,0,2,0,2,Col12_T,"-37.81344862, 144.97305353"
63820250728,63,2025-07-28,8,133,148,281,Bou231_T,"-37.81333081, 144.96675571"
112120250107,11,2025-01-07,21,148,126,274,WatCit_T,"-37.81564989, 144.93970694"
681720250511,68,2025-05-11,17,185,179,364,FLDegN_T,"-37.8168479, 144.96559789"
48920240826,48,2024-08-26,9,118,82,200,QVMQ_T,"-37.80631581, 144.95866697"
252320250312,25,2025-03-12,23,66,74,140,MCEC_T,"-37.82401776, 144.95604426"
511920250726,51,2025-07-26,19,110,72,182,Fra118_T,"-37.80841815, 144.95906316"
141020240116,141,2024-01-16,0,18,115,133,474Fl_T,"-37.81997273, 144.95834911"
1362320231117,136,2023-11-17,23,14,10,24,BirFed1120_T,"-37.8184141, 144.97357915"
491320250817,49,2025-08-17,13,473,703,1176,Eli501_T,"-37.80730068, 144.95956055"
691920240605,69,2024-06-05,19,30,29,59,FLDegC_T,"-37.81687226, 144.96559144"
842020240724,84,2024-07-24,20,479,801,1280,ElFi_T,"-37.81798049, 144.96503383"
391420240625,39,2024-06-25,14,118,131,249,AlfPl_T,"-37.81379749, 144.96995745"
421420250403,42,2025-04-03,14,529,654,1183,UM1_T,"-37.80008566, 144.96386412"
592020231208,59,2023-12-08,20,496,380,876,RMIT_T,"-37.80825648, 144.96304859"
652220240319,65,2024-03-19,22,85,189,274,SwaCs_T,"-37.81569416, 144.9668064"
31220250303,31,2025-03-03,2,2,3,5,Lyg161_T,"-37.80169681, 144.96658911"
312320240520,31,2024-05-20,23,7,16,23,Lyg161_T,"-37.80169681, 144.96658911"
311420241219,31,2024-12-19,14,118,152,270,Lyg161_T,"-37.80169681, 144.96658911"
361320240417,36,2024-04-17,13,314,338,652,Que85_T,"-37.81652527, 144.96121062"
372320240515,37,2024-05-15,23,19,43,62,Lyg260_T,"-37.80107122, 144.96704554"
472120250918,47,2025-09-18,21,489,307,796,Eli250_T,"-37.81258467, 144.9625775"
471020250930,47,2025-09-30,10,413,487,900,Eli250_T,"-37.81258467, 144.9625775"
47020250306,47,2025-03-06,0,80,82,162,Eli250_T,"-37.81258467, 144.9625775"
45720250212,45,2025-02-12,7,106,173,279,Swa148_T,"-37.81414075, 144.96609379"
452120250702,45,2025-07-02,21,192,354,546,Swa148_T,"-37.81414075, 144.96609379"
50020240216,50,2024-02-16,0,14,4,18,Lyg309_T,"-37.79808192, 144.96721013"
441220250707,44,2025-07-07,12,86,73,159,UM3_T,"-37.79698741, 144.96441306"
432120240518,43,2024-05-18,21,41,55,96,UM2_T,"-37.79844526, 144.96411782"
167120250219,167,2025-02-19,1,0,1,1,Lat526_T,"-37.81304149, 144.95155955"
1401220250507,140,2025-05-07,12,10,6,16,Boyd2837_T,"-37.82590962, 144.96185972"
182920251005,182,2025-10-05,9,83,93,176,King163_T,"-37.81627451, 144.95550503"
108120250501,108,2025-05-01,1,3,8,11,261Will_T,"-37.81295822, 144.95678789"
1342320240730,134,2024-07-30,23,58,67,125,Spen201_T,"-37.81694221, 144.95303935"
1311920240622,131,2024-06-22,19,99,73,172,King2_T,"-37.82009057, 144.95758725"
1331320250222,133,2025-02-22,13,516,437,953,Spen229_T,"-37.81531435, 144.95227769"
1181020240117,118,2024-01-17,10,6,17,23,Fli114C_T,"-37.81632783, 144.97090512"
1181720240801,118,2024-08-01,17,23,44,67,Fli114C_T,"-37.81632783, 144.97090512"
671920240722,67,2024-07-22,19,149,308,457,FLDegS_T,"-37.81688755, 144.96562569"
671220241223,67,2024-12-23,12,521,696,1217,FLDegS_T,"-37.81688755, 144.96562569"
171120250930,17,2025-09-30,11,361,249,610,Col15_T,"-37.81362543, 144.97323591"
18420231216,18,2023-12-16,4,1,1,2,Col12_T,"-37.81344862, 144.97305353"
181120250525,18,2025-05-25,11,69,57,126,Col12_T,"-37.81344862, 144.97305353"
861820241020,86,2024-10-20,18,51,93,144,574Qub_T,"-37.80309992, 144.94908064"
722020250908,72,2025-09-08,20,22,66,88,ACMI_T,"-37.81726338, 144.96872809"
101820251014,10,2025-10-14,18,106,65,171,BouHbr_T,"-37.81876474, 144.94710545"
101320250131,10,2025-01-31,13,100,78,178,BouHbr_T,"-37.81876474, 144.94710545"
2120231101,2,2023-11-01,1,36,20,56,Bou283_T,"-37.81380668, 144.96516718"
581620241103,58,2024-11-03,16,667,469,1136,Bou688_T,"-37.81686075, 144.95358075"
581820240301,58,2024-03-01,18,686,490,1176,Bou688_T,"-37.81686075, 144.95358075"
27720231029,27,2023-10-29,7,18,15,33,Vic_T,"-37.80606888, 144.95644692"
58820250714,58,2025-07-14,8,1493,174,1667,Bou688_T,"-37.81686075, 144.95358075"
582220250809,58,2025-08-09,22,907,313,1220,Bou688_T,"-37.81686075, 144.95358075"
30720250413,30,2025-04-13,7,31,78,109,Lon189_T,"-37.8112185, 144.96656806"
791020231216,79,2023-12-16,10,466,335,801,FliSS_T,"-37.81794046, 144.96616678"
512120240909,51,2024-09-09,21,33,33,66,Fra118_T,"-37.80841815, 144.95906316"
232320241113,23,2024-11-13,23,12,44,56,Col623_T,"-37.81909256, 144.95452748"
481820240721,48,2024-07-21,18,194,79,273,QVMQ_T,"-37.80631581, 144.95866697"
252120240615,25,2024-06-15,21,316,297,613,MCEC_T,"-37.82401776, 144.95604426"
201120240911,20,2024-09-11,11,190,97,287,LtB170_T,"-37.81172914, 144.9682466"
201220250309,20,2025-03-09,12,273,198,471,LtB170_T,"-37.81172914, 144.9682466"
52720251012,52,2025-10-12,7,25,17,42,Eli263_T,"-37.81252157, 144.9619401"
521520250523,52,2025-05-23,15,384,227,611,Eli263_T,"-37.81252157, 144.9619401"
461520250123,46,2025-01-23,15,51,55,106,Pel147_T,"-37.80240719, 144.9615673"
521720240130,52,2024-01-30,17,382,352,734,Eli263_T,"-37.81252157, 144.9619401"
1411420250708,141,2025-07-08,14,173,126,299,474Fl_T,"-37.81997273, 144.95834911"
1391320250317,139,2025-03-17,13,81,78,159,Signal1647_T,"-37.81959923, 144.9632832"
137720240210,137,2024-02-10,7,3,5,8,BouHbr2353_T,"-37.81894815, 144.94612292"
1172020250212,117,2025-02-12,20,109,205,314,Fli114F_T,"-37.81629332, 144.97090877"
49620240611,49,2024-06-11,6,36,37,73,Eli501_T,"-37.80730068, 144.95956055"
109020240313,109,2024-03-13,0,22,12,34,LatWill_T,"-37.81193681, 144.95621105"
1801620250902,180,2025-09-02,16,49,72,121,Mac330_T,"-37.79497059, 144.93530329"
661720250123,66,2025-01-23,17,1271,1364,2635,QVN_T,"-37.81057846, 144.96444294"
691420240101,69,2024-01-01,14,237,121,358,FLDegC_T,"-37.81687226, 144.96559144"
4920240629,4,2024-06-29,9,395,200,595,Swa123_T,"-37.81487988, 144.9660878"
411920250409,41,2025-04-09,19,958,1800,2758,Swa31,"-37.81668634, 144.96689733"
771420240507,77,2024-05-07,14,139,75,214,HarEsP_T,"-37.81441438, 144.94433026"
142020241203,14,2024-12-03,20,285,119,404,SanBri_T,"-37.82011242, 144.96291897"
141520250501,14,2025-05-01,15,535,126,661,SanBri_T,"-37.82011242, 144.96291897"
40920240504,40,2024-05-04,9,78,65,143,Spr201_T,"-37.80999341, 144.97227587"
54920250513,54,2025-05-13,9,222,47,269,Swa607_T,"-37.804024, 144.96308399"
47020241101,47,2024-11-01,0,129,162,291,Eli250_T,"-37.81258467, 144.9625775"
45020250715,45,2025-07-15,0,16,52,68,Swa148_T,"-37.81414075, 144.96609379"
52020250727,5,2025-07-27,20,94,154,248,PriNW_T,"-37.81874249, 144.96787656"
1082320240920,108,2024-09-20,23,56,63,119,261Will_T,"-37.81295822, 144.95678789"
61820240930,61,2024-09-30,8,378,289,667,RMIT14_T,"-37.80767455, 144.96309114"
1792020250717,179,2025-07-17,20,53,63,116,Pow61_T,"-37.82392385, 144.96299677"
1651520250410,165,2025-04-10,15,43,42,85,Spen475_T,"-37.80953359, 144.94939004"
181020250628,181,2025-06-28,0,194,168,362,Eli368_T,"-37.81009465, 144.96143149"
1671420250419,167,2025-04-19,14,17,31,48,Lat526_T,"-37.81304149, 144.95155955"
181420250411,181,2025-04-11,4,33,35,68,Eli368_T,"-37.81009465, 144.96143149"
1321820240808,132,2024-08-08,18,127,138,265,King335_T,"-37.81267639, 144.95386444"
1321020250515,132,2025-05-15,10,167,75,242,King335_T,"-37.81267639, 144.95386444"
1182120241022,118,2024-10-22,21,4,7,11,Fli114C_T,"-37.81632783, 144.97090512"
1072220240411,107,2024-04-11,22,54,64,118,280Will_T,"-37.81246271, 144.95690188"
1071520240705,107,2024-07-05,15,111,120,231,280Will_T,"-37.81246271, 144.95690188"
851020240414,85,2024-04-14,10,102,96,198,488Mac_T,"-37.79432415, 144.92973378"
171720250415,17,2025-04-15,17,280,782,1062,Col15_T,"-37.81362543, 144.97323591"
241620231227,24,2023-12-27,16,359,874,1233,Col620_T,"-37.81887963, 144.95449198"
242320241110,24,2024-11-10,23,114,207,321,Col620_T,"-37.81887963, 144.95449198"
721220250523,72,2025-05-23,12,184,192,376,ACMI_T,"-37.81726338, 144.96872809"
721120241015,72,2024-10-15,11,177,195,372,ACMI_T,"-37.81726338, 144.96872809"
271920231212,27,2023-12-12,19,77,54,131,Vic_T,"-37.80606888, 144.95644692"
581520250907,58,2025-09-07,15,397,321,718,Bou688_T,"-37.81686075, 144.95358075"
21420250513,2,2025-05-13,14,494,498,992,Bou283_T,"-37.81380668, 144.96516718"
91720240929,9,2024-09-29,17,59,59,118,Col700_T,"-37.81982992, 144.95102555"
79920241203,79,2024-12-03,9,487,255,742,FliSS_T,"-37.81794046, 144.96616678"
79920250713,79,2025-07-13,9,373,210,583,FliSS_T,"-37.81794046, 144.96616678"
792120231106,79,2023-11-06,21,266,365,631,FliSS_T,"-37.81794046, 144.96616678"
231120240320,23,2024-03-20,11,178,318,496,Col623_T,"-37.81909256, 144.95452748"
51520241221,51,2024-12-21,5,4,11,15,Fra118_T,"-37.80841815, 144.95906316"
23920240709,23,2024-07-09,9,467,202,669,Col623_T,"-37.81909256, 144.95452748"
481420231102,48,2023-11-02,14,316,171,487,QVMQ_T,"-37.80631581, 144.95866697"
48020241029,48,2024-10-29,0,10,10,20,QVMQ_T,"-37.80631581, 144.95866697"
48620231021,48,2023-10-21,6,18,23,41,QVMQ_T,"-37.80631581, 144.95866697"
522020250204,52,2025-02-04,20,221,126,347,Eli263_T,"-37.81252157, 144.9619401"
521920250320,52,2025-03-20,19,293,243,536,Eli263_T,"-37.81252157, 144.9619401"
521220250613,52,2025-06-13,12,396,305,701,Eli263_T,"-37.81252157, 144.9619401"
46520241125,46,2024-11-25,5,1,1,2,Pel147_T,"-37.80240719, 144.9615673"
462020250517,46,2025-05-17,20,2,1,3,Pel147_T,"-37.80240719, 144.9615673"
51520250328,51,2025-03-28,5,18,23,41,Fra118_T,"-37.80841815, 144.95906316"
137120250314,137,2025-03-14,1,1,1,2,BouHbr2353_T,"-37.81894815, 144.94612292"
1371920240312,137,2024-03-12,19,13,78,91,BouHbr2353_T,"-37.81894815, 144.94612292"
1361120240928,136,2024-09-28,11,5968,279,6247,BirFed1120_T,"-37.8184141, 144.97357915"
142820240514,142,2024-05-14,8,172,219,391,Hammer1584_T,"-37.81970749, 144.96795734"
1421820250329,142,2025-03-29,18,879,595,1474,Hammer1584_T,"-37.81970749, 144.96795734"
130720240218,130,2024-02-18,7,1,0,1,Bou892T,"-37.8204637, 144.94126826"
1611420241220,161,2024-12-20,14,26,36,62,BirArt1109_T,"-37.81851276, 144.97131336"
1611320251013,161,2025-10-13,13,139,177,316,BirArt1109_T,"-37.81851276, 144.97131336"
491020250117,49,2025-01-17,10,292,349,641,Eli501_T,"-37.80730068, 144.95956055"
117320240601,117,2024-06-01,3,8,1,9,Fli114F_T,"-37.81629332, 144.97090877"
1172320240614,117,2024-06-14,23,98,81,179,Fli114F_T,"-37.81629332, 144.97090877"
1091820250123,109,2025-01-23,18,153,90,243,LatWill_T,"-37.81193681, 144.95621105"
109320250302,109,2025-03-02,3,12,18,30,LatWill_T,"-37.81193681, 144.95621105"
191520250416,19,2025-04-16,15,472,522,994,LtB210_T,"-37.81237202, 144.96550671"
191720240802,19,2024-08-02,17,791,441,1232,LtB210_T,"-37.81237202, 144.96550671"
661320241102,66,2024-11-02,13,1330,1415,2745,QVN_T,"-37.81057846, 144.96444294"
84620240725,84,2024-07-25,6,257,107,364,ElFi_T,"-37.81798049, 144.96503383"
31820231031,3,2023-10-31,18,1036,1274,2310,Swa295_T,"-37.81101524, 144.96429485"
61920250601,6,2025-06-01,19,504,506,1010,FliS_T,"-37.81911705, 144.96558255"
751220231120,75,2023-11-20,12,64,40,104,SprFli_T,"-37.81515276, 144.97467661"
751720250611,75,2025-06-11,17,65,40,105,SprFli_T,"-37.81515276, 144.97467661"
411920240330,41,2024-03-30,19,1615,1468,3083,Swa31,"-37.81668634, 144.96689733"
411820250918,41,2025-09-18,18,1504,2024,3528,Swa31,"-37.81668634, 144.96689733"
77020241204,77,2024-12-04,0,17,6,23,HarEsP_T,"-37.81441438, 144.94433026"
77620250909,77,2025-09-09,6,24,36,60,HarEsP_T,"-37.81441438, 144.94433026"
42820240628,42,2024-06-28,8,93,69,162,UM1_T,"-37.80008566, 144.96386412"
711520250825,71,2025-08-25,15,13,11,24,WestWP_T,"-37.81235775, 144.97136962"
591220250910,59,2025-09-10,12,1449,1368,2817,RMIT_T,"-37.80825648, 144.96304859"
292020250611,29,2025-06-11,20,39,62,101,AG_T,"-37.8199817, 144.96872865"
292320250131,29,2025-01-31,23,32,117,149,AG_T,"-37.8199817, 144.96872865"
291820240418,29,2024-04-18,18,136,186,322,AG_T,"-37.8199817, 144.96872865"
31520240408,31,2024-04-08,5,6,7,13,Lyg161_T,"-37.80169681, 144.96658911"
47620241020,47,2024-10-20,6,38,72,110,Eli250_T,"-37.81258467, 144.9625775"
471620231101,47,2023-11-01,16,1047,792,1839,Eli250_T,"-37.81258467, 144.9625775"
451620240714,45,2024-07-14,16,817,1000,1817,Swa148_T,"-37.81414075, 144.96609379"
51620241003,5,2024-10-03,16,1635,953,2588,PriNW_T,"-37.81874249, 144.96787656"
108020250729,108,2025-07-29,0,29,13,42,261Will_T,"-37.81295822, 144.95678789"
87720241228,87,2024-12-28,7,15,16,31,Errol23_T,"-37.80454949, 144.94921863"
441920250428,44,2025-04-28,19,23,98,121,UM3_T,"-37.79698741, 144.96441306"
442220250907,44,2025-09-07,22,12,19,31,UM3_T,"-37.79698741, 144.96441306"
44820240317,44,2024-03-17,8,16,10,26,UM3_T,"-37.79698741, 144.96441306"
118220250713,118,2025-07-13,2,0,1,1,Fli114C_T,"-37.81632783, 144.97090512"
1322020240110,132,2024-01-10,20,134,167,301,King335_T,"-37.81267639, 144.95386444"
135020240119,135,2024-01-19,0,49,45,94,Spen161_T,"-37.8172861, 144.95319102"
1351420240909,135,2024-09-09,14,270,271,541,Spen161_T,"-37.8172861, 144.95319102"
1351220250127,135,2025-01-27,12,223,345,568,Spen161_T,"-37.8172861, 144.95319102"
1071420240802,107,2024-08-02,14,153,171,324,280Will_T,"-37.81246271, 144.95690188"
1182220250303,118,2025-03-03,22,1,6,7,Fli114C_T,"-37.81632783, 144.97090512"
1661120250926,166,2025-09-26,11,41,55,96,Spen484_T,"-37.80896733, 144.94931703"
165320251013,165,2025-10-13,3,2,0,2,Spen475_T,"-37.80953359, 144.94939004"
67420250728,67,2025-07-28,4,1,2,3,FLDegS_T,"-37.81688755, 144.96562569"
621120240412,62,2024-04-12,11,200,184,384,Lat224_T,"-37.80996494, 144.96216521"
56820241017,56,2024-10-17,8,137,162,299,Lon364_T,"-37.81234775, 144.96153311"
561520250425,56,2025-04-25,15,373,287,660,Lon364_T,"-37.81234775, 144.96153311"
11620240608,11,2024-06-08,6,4,6,10,WatCit_T,"-37.81564989, 144.93970694"
1620250916,1,2025-09-16,6,32,60,92,Bou292_T,"-37.81349441, 144.96515323"
102320250811,10,2025-08-11,23,2,3,5,BouHbr_T,"-37.81876474, 144.94710545"
72420231027,72,2023-10-27,4,3,12,15,ACMI_T,"-37.81726338, 144.96872809"
272320240815,27,2024-08-15,23,37,15,52,Vic_T,"-37.80606888, 144.95644692"
21320241007,2,2024-10-07,13,662,793,1455,Bou283_T,"-37.81380668, 144.96516718"
21920241011,2,2024-10-11,19,424,299,723,Bou283_T,"-37.81380668, 144.96516718"
2820240525,2,2024-05-25,8,36,54,90,Bou283_T,"-37.81380668, 144.96516718"
56220250605,56,2025-06-05,2,4,6,10,Lon364_T,"-37.81234775, 144.96153311"
53820240701,53,2024-07-01,8,339,211,550,Col254_T,"-37.81564191, 144.965499"
30520250919,30,2025-09-19,5,12,20,32,Lon189_T,"-37.8112185, 144.96656806"
251820240915,25,2024-09-15,18,774,191,965,MCEC_T,"-37.82401776, 144.95604426"
462220250210,46,2025-02-10,22,1,1,2,Pel147_T,"-37.80240719, 144.9615673"
138920250723,138,2025-07-23,9,3,11,14,EntPark1671_T,"-37.81996544, 144.95981454"
1381020240409,138,2024-04-09,10,2,4,6,EntPark1671_T,"-37.81996544, 144.95981454"
1231820240314,123,2024-03-14,18,99,35,134,BirBridge_T,"-37.81753741, 144.97329734"
1171820250827,117,2025-08-27,18,153,251,404,Fli114F_T,"-37.81629332, 144.97090877"
69620231021,69,2023-10-21,6,10,8,18,FLDegC_T,"-37.81687226, 144.96559144"
701820231020,70,2023-10-20,18,173,254,427,Errol20_T,"-37.80456984, 144.94946228"
701220231207,70,2023-12-07,12,176,177,353,Errol20_T,"-37.80456984, 144.94946228"
702120240408,70,2024-04-08,21,28,28,56,Errol20_T,"-37.80456984, 144.94946228"
70420240709,70,2024-07-09,4,3,1,4,Errol20_T,"-37.80456984, 144.94946228"
701320250515,70,2025-05-15,13,165,153,318,Errol20_T,"-37.80456984, 144.94946228"
392320250624,39,2025-06-24,23,7,7,14,AlfPl_T,"-37.81379749, 144.96995745"
1791120250723,179,2025-07-23,11,49,45,94,Pow61_T,"-37.82392385, 144.96299677"
162820250126,162,2025-01-26,8,145,143,288,Eli489_T,"-37.80740397, 144.95987909"
1311220250508,131,2025-05-08,12,150,187,337,King2_T,"-37.82009057, 144.95758725"
134420250124,134,2025-01-24,4,34,27,61,Spen201_T,"-37.81694221, 144.95303935"
1332020250928,133,2025-09-28,20,337,251,588,Spen229_T,"-37.81531435, 144.95227769"
133820240708,133,2024-07-08,8,499,513,1012,Spen229_T,"-37.81531435, 144.95227769"
501520250626,50,2025-06-26,15,163,121,284,Lyg309_T,"-37.79808192, 144.96721013"
441220250304,44,2025-03-04,12,80,86,166,UM3_T,"-37.79698741, 144.96441306"
165220250402,165,2025-04-02,2,2,0,2,Spen475_T,"-37.80953359, 144.94939004"
1401520240408,140,2024-04-08,15,76,80,156,Boyd2837_T,"-37.82590962, 144.96185972"
143420240505,143,2024-05-05,4,41,18,59,Spencer_T,"-37.821728, 144.95557015"
143120241022,143,2024-10-22,1,55,25,80,Spencer_T,"-37.821728, 144.95557015"
1342320240103,134,2024-01-03,23,78,96,174,Spen201_T,"-37.81694221, 144.95303935"
1352020240330,135,2024-03-30,20,181,258,439,Spen161_T,"-37.8172861, 144.95319102"
1181020250126,118,2025-01-26,10,13,19,32,Fli114C_T,"-37.81632783, 144.97090512"
1241020250623,124,2025-06-23,10,3,5,8,BirBridge_T,"-37.81757416, 144.97329934"
107920240115,107,2024-01-15,9,56,141,197,280Will_T,"-37.81246271, 144.95690188"
851520231110,85,2023-11-10,15,143,116,259,488Mac_T,"-37.79432415, 144.92973378"
851520240717,85,2024-07-17,15,74,94,168,488Mac_T,"-37.79432415, 144.92973378"
851520241217,85,2024-12-17,15,106,80,186,488Mac_T,"-37.79432415, 144.92973378"
17920240616,17,2024-06-16,9,76,60,136,Col15_T,"-37.81362543, 144.97323591"
1320240807,1,2024-08-07,3,3,4,7,Bou292_T,"-37.81349441, 144.96515323"
1420240819,1,2024-08-19,4,2,3,5,Bou292_T,"-37.81349441, 144.96515323"
631120250203,63,2025-02-03,11,209,271,480,Bou231_T,"-37.81333081, 144.96675571"
68820240213,68,2024-02-13,8,128,178,306,FLDegN_T,"-37.8168479, 144.96559789"
562320240804,56,2024-08-04,23,42,54,96,Lon364_T,"-37.81234775, 144.96153311"
561820241112,56,2024-11-12,18,338,382,720,Lon364_T,"-37.81234775, 144.96153311"
76720240525,76,2024-05-25,7,21,13,34,KenMac_T,"-37.79453803, 144.93036194"
2320240401,2,2024-04-01,3,6,24,30,Bou283_T,"-37.81380668, 144.96516718"
2320240901,2,2024-09-01,3,35,71,106,Bou283_T,"-37.81380668, 144.96516718"
531520240607,53,2024-06-07,15,671,587,1258,Col254_T,"-37.81564191, 144.965499"
9220231214,9,2023-12-14,2,3,2,5,Col700_T,"-37.81982992, 144.95102555"
271020240719,27,2024-07-19,10,95,96,191,Vic_T,"-37.80606888, 144.95644692"
271920241221,27,2024-12-21,19,96,75,171,Vic_T,"-37.80606888, 144.95644692"
302320250128,30,2025-01-28,23,96,144,240,Lon189_T,"-37.8112185, 144.96656806"
251920250903,25,2025-09-03,19,297,310,607,MCEC_T,"-37.82401776, 144.95604426"
46420240708,46,2024-07-08,4,0,1,1,Pel147_T,"-37.80240719, 144.9615673"
139820240216,139,2024-02-16,8,31,269,300,Signal1647_T,"-37.81959923, 144.9632832"
1611120241226,161,2024-12-26,11,125,58,183,BirArt1109_T,"-37.81851276, 144.97131336"
1171020250603,117,2025-06-03,10,86,91,177,Fli114F_T,"-37.81629332, 144.97090877"
138820240623,138,2024-06-23,8,0,4,4,EntPark1671_T,"-37.81996544, 144.95981454"
109420250814,109,2025-08-14,4,2,2,4,LatWill_T,"-37.81193681, 144.95621105"
66820241026,66,2024-10-26,8,80,124,204,QVN_T,"-37.81057846, 144.96444294"
662020250106,66,2025-01-06,20,779,634,1413,QVN_T,"-37.81057846, 144.96444294"
841120250612,84,2025-06-12,11,698,603,1301,ElFi_T,"-37.81798049, 144.96503383"
3320231125,3,2023-11-25,3,162,71,233,Swa295_T,"-37.81101524, 144.96429485"
582220240513,58,2024-05-13,22,132,133,265,Bou688_T,"-37.81686075, 144.95358075"
762220241120,76,2024-11-20,22,3,15,18,KenMac_T,"-37.79453803, 144.93036194"
761920240219,76,2024-02-19,19,39,41,80,KenMac_T,"-37.79453803, 144.93036194"
35020250618,35,2025-06-18,0,26,11,37,SouthB_T,"-37.82018685, 144.96508508"
2020250714,2,2025-07-14,0,3,3,6,Bou283_T,"-37.81380668, 144.96516718"
21220240127,2,2024-01-27,12,854,928,1782,Bou283_T,"-37.81380668, 144.96516718"
351520250821,35,2025-08-21,15,1171,1093,2264,SouthB_T,"-37.82018685, 144.96508508"
53520240815,53,2024-08-15,5,10,7,17,Col254_T,"-37.81564191, 144.965499"
92020231018,9,2023-10-18,20,152,70,222,Col700_T,"-37.81982992, 144.95102555"
791420240823,79,2024-08-23,14,456,430,886,FliSS_T,"-37.81794046, 144.96616678"
53520250902,53,2025-09-02,5,5,6,11,Col254_T,"-37.81564191, 144.965499"
53520240918,53,2024-09-18,5,16,18,34,Col254_T,"-37.81564191, 144.965499"
531620241107,53,2024-11-07,16,621,461,1082,Col254_T,"-37.81564191, 144.965499"
23120241216,23,2024-12-16,1,5,15,20,Col623_T,"-37.81909256, 144.95452748"
23020231128,23,2023-11-28,0,16,26,42,Col623_T,"-37.81909256, 144.95452748"
512220240130,51,2024-01-30,22,42,34,76,Fra118_T,"-37.80841815, 144.95906316"
30920250909,30,2025-09-09,9,83,128,211,Lon189_T,"-37.8112185, 144.96656806"
461120241010,46,2024-10-10,11,130,116,246,Pel147_T,"-37.80240719, 144.9615673"
461420240307,46,2024-03-07,14,149,219,368,Pel147_T,"-37.80240719, 144.9615673"
20020241216,20,2024-12-16,0,30,49,79,LtB170_T,"-37.81172914, 144.9682466"
1641020250329,164,2025-03-29,10,136,48,184,Lat526_T,"-37.813005, 144.95160411"
1611820250518,161,2025-05-18,18,0,7,7,BirArt1109_T,"-37.81851276, 144.97131336"
1412320240917,141,2024-09-17,23,19,27,46,474Fl_T,"-37.81997273, 144.95834911"
1171520240912,117,2024-09-12,15,153,193,346,Fli114F_T,"-37.81629332, 144.97090877"
109620241006,109,2024-10-06,6,11,11,22,LatWill_T,"-37.81193681, 144.95621105"
191620241227,19,2024-12-27,16,572,541,1113,LtB210_T,"-37.81237202, 144.96550671"
1372320250524,137,2025-05-24,23,4,0,4,BouHbr2353_T,"-37.81894815, 144.94612292"
1391620250402,139,2025-04-02,16,168,25,193,Signal1647_T,"-37.81959923, 144.9632832"
139520250912,139,2025-09-12,5,1,4,5,Signal1647_T,"-37.81959923, 144.9632832"
281120250601,28,2025-06-01,11,376,348,724,VAC_T,"-37.82129925, 144.96879309"
37920241008,37,2024-10-08,9,40,50,90,Lyg260_T,"-37.80107122, 144.96704554"
502320250522,50,2025-05-22,23,32,9,41,Lyg309_T,"-37.79808192, 144.96721013"
451120250215,45,2025-02-15,11,299,488,787,Swa148_T,"-37.81414075, 144.96609379"
1311520250218,131,2025-02-18,15,94,101,195,King2_T,"-37.82009057, 144.95758725"
1352020231214,135,2023-12-14,20,210,208,418,Spen161_T,"-37.8172861, 144.95319102"
133020250621,133,2025-06-21,0,102,44,146,Spen229_T,"-37.81531435, 144.95227769"
133220250129,133,2025-01-29,2,12,7,19,Spen229_T,"-37.81531435, 144.95227769"
1181620240901,118,2024-09-01,16,11,16,27,Fli114C_T,"-37.81632783, 144.97090512"
1241420250307,124,2025-03-07,14,4,3,7,BirBridge_T,"-37.81757416, 144.97329934"
1071120240619,107,2024-06-19,11,117,124,241,280Will_T,"-37.81246271, 144.95690188"
1072220240914,107,2024-09-14,22,59,50,109,280Will_T,"-37.81246271, 144.95690188"
107120250522,107,2025-05-22,1,5,8,13,280Will_T,"-37.81246271, 144.95690188"
611020250821,61,2025-08-21,10,463,522,985,RMIT14_T,"-37.80767455, 144.96309114"
1791020250421,179,2025-04-21,10,72,57,129,Pow61_T,"-37.82392385, 144.96299677"
166720250912,166,2025-09-12,7,34,11,45,Spen484_T,"-37.80896733, 144.94931703"
167320250813,167,2025-08-13,3,1,2,3,Lat526_T,"-37.81304149, 144.95155955"
1431320251002,143,2025-10-02,13,106,164,270,Spencer_T,"-37.821728, 144.95557015"
132920240813,132,2024-08-13,9,259,77,336,King335_T,"-37.81267639, 144.95386444"
132020240828,132,2024-08-28,0,27,12,39,King335_T,"-37.81267639, 144.95386444"
61720250523,6,2025-05-23,17,1578,1312,2890,FliS_T,"-37.81911705, 144.96558255"
70420250528,70,2025-05-28,4,0,1,1,Errol20_T,"-37.80456984, 144.94946228"
751820240524,75,2024-05-24,18,48,49,97,SprFli_T,"-37.81515276, 144.97467661"
81120240625,8,2024-06-25,11,104,199,303,WebBN_T,"-37.82293543, 144.9471751"
71420250922,71,2025-09-22,4,2,0,2,WestWP_T,"-37.81235775, 144.97136962"
141520240502,14,2024-05-02,15,469,123,592,SanBri_T,"-37.82011242, 144.96291897"
681420250115,68,2025-01-15,14,435,438,873,FLDegN_T,"-37.8168479, 144.96559789"
68120250222,68,2025-02-22,1,5,6,11,FLDegN_T,"-37.8168479, 144.96559789"
671120250529,67,2025-05-29,11,379,505,884,FLDegS_T,"-37.81688755, 144.96562569"
86820240209,86,2024-02-09,8,45,19,64,574Qub_T,"-37.80309992, 144.94908064"
861720240523,86,2024-05-23,17,37,77,114,574Qub_T,"-37.80309992, 144.94908064"
86120240917,86,2024-09-17,1,2,1,3,574Qub_T,"-37.80309992, 144.94908064"
56420240624,56,2024-06-24,4,22,12,34,Lon364_T,"-37.81234775, 144.96153311"
562320240904,56,2024-09-04,23,53,69,122,Lon364_T,"-37.81234775, 144.96153311"
10420240107,10,2024-01-07,4,0,3,3,BouHbr_T,"-37.81876474, 144.94710545"
721620241222,72,2024-12-22,16,298,530,828,ACMI_T,"-37.81726338, 144.96872809"
58420240701,58,2024-07-01,4,19,12,31,Bou688_T,"-37.81686075, 144.95358075"
581820240907,58,2024-09-07,18,586,372,958,Bou688_T,"-37.81686075, 144.95358075"
72420250501,72,2025-05-01,4,2,4,6,ACMI_T,"-37.81726338, 144.96872809"
56420250925,56,2025-09-25,4,1,14,15,Lon364_T,"-37.81234775, 144.96153311"
272020241123,27,2024-11-23,20,90,50,140,Vic_T,"-37.80606888, 144.95644692"
272320250720,27,2025-07-20,23,19,8,27,Vic_T,"-37.80606888, 144.95644692"
27020240202,27,2024-02-02,0,24,4,28,Vic_T,"-37.80606888, 144.95644692"
252020250806,25,2025-08-06,20,168,189,357,MCEC_T,"-37.82401776, 144.95604426"
202220250429,20,2025-04-29,22,62,90,152,LtB170_T,"-37.81172914, 144.9682466"
252120240105,25,2024-01-05,21,777,470,1247,MCEC_T,"-37.82401776, 144.95604426"
522120240110,52,2024-01-10,21,220,111,331,Eli263_T,"-37.81252157, 144.9619401"
51820250425,51,2025-04-25,8,41,18,59,Fra118_T,"-37.80841815, 144.95906316"
1302220240905,130,2024-09-05,22,11,11,22,Bou892T,"-37.8204637, 144.94126826"
492320250316,49,2025-03-16,23,102,81,183,Eli501_T,"-37.80730068, 144.95956055"
117520250412,117,2025-04-12,5,1,3,4,Fli114F_T,"-37.81629332, 144.97090877"
1171120231128,117,2023-11-28,11,109,124,233,Fli114F_T,"-37.81629332, 144.97090877"
109120240123,109,2024-01-23,1,2,15,17,LatWill_T,"-37.81193681, 144.95621105"
1802320250620,180,2025-06-20,23,0,1,1,Mac330_T,"-37.79497059, 144.93530329"
69520240906,69,2024-09-06,5,7,6,13,FLDegC_T,"-37.81687226, 144.96559144"
4820250815,4,2025-08-15,8,551,433,984,Swa123_T,"-37.81487988, 144.9660878"
701920241209,70,2024-12-09,19,122,116,238,Errol20_T,"-37.80456984, 144.94946228"
751620231204,75,2023-12-04,16,39,58,97,SprFli_T,"-37.81515276, 144.97467661"
8920250823,8,2025-08-23,9,76,290,366,WebBN_T,"-37.82293543, 144.9471751"
782120240816,78,2024-08-16,21,2,20,22,HarEsB_T,"-37.81471642, 144.9446508"
41420241206,41,2024-12-06,4,27,88,115,Swa31,"-37.81668634, 144.96689733"
771920250201,77,2025-02-01,19,131,172,303,HarEsP_T,"-37.81441438, 144.94433026"
59420240224,59,2024-02-24,4,28,10,38,RMIT_T,"-37.80825648, 144.96304859"
40420240326,40,2024-03-26,4,4,1,5,Spr201_T,"-37.80999341, 144.97227587"
42120231115,4,2023-11-15,21,709,510,1219,Swa123_T,"-37.81487988, 144.9660878"
4120231026,4,2023-10-26,1,25,21,46,Swa123_T,"-37.81487988, 144.9660878"
31720251014,3,2025-10-14,17,1206,1343,2549,Swa295_T,"-37.81101524, 144.96429485"
392320240619,39,2024-06-19,23,11,8,19,AlfPl_T,"-37.81379749, 144.96995745"
391520241026,39,2024-10-26,15,93,68,161,AlfPl_T,"-37.81379749, 144.96995745"
751020250511,75,2025-05-11,10,34,41,75,SprFli_T,"-37.81515276, 144.97467661"
411620241128,41,2024-11-28,16,1512,2215,3727,Swa31,"-37.81668634, 144.96689733"
411820250516,41,2025-05-16,18,367,285,652,Swa31,"-37.81668634, 144.96689733"
781820250218,78,2025-02-18,18,30,153,183,HarEsB_T,"-37.81471642, 144.9446508"
14820240909,14,2024-09-09,8,285,453,738,SanBri_T,"-37.82011242, 144.96291897"
141220250827,14,2025-08-27,12,248,140,388,SanBri_T,"-37.82011242, 144.96291897"
592220240225,59,2024-02-25,22,278,137,415,RMIT_T,"-37.80825648, 144.96304859"
592320240918,59,2024-09-18,23,67,68,135,RMIT_T,"-37.80825648, 144.96304859"
28620231111,28,2023-11-11,6,43,35,78,VAC_T,"-37.82129925, 144.96879309"
311020231031,31,2023-10-31,10,75,77,152,Lyg161_T,"-37.80169681, 144.96658911"
541320250705,54,2025-07-05,13,90,98,188,Swa607_T,"-37.804024, 144.96308399"
371120241207,37,2024-12-07,11,64,63,127,Lyg260_T,"-37.80107122, 144.96704554"
371320241220,37,2024-12-20,13,105,119,224,Lyg260_T,"-37.80107122, 144.96704554"
37620250629,37,2025-06-29,6,1,10,11,Lyg260_T,"-37.80107122, 144.96704554"
37520250926,37,2025-09-26,5,3,0,3,Lyg260_T,"-37.80107122, 144.96704554"
471320250407,47,2025-04-07,13,913,1018,1931,Eli250_T,"-37.81258467, 144.9625775"
472220240319,47,2024-03-19,22,302,178,480,Eli250_T,"-37.81258467, 144.9625775"
361120231201,36,2023-12-01,11,201,200,401,Que85_T,"-37.81652527, 144.96121062"
49620250621,49,2025-06-21,6,34,37,71,Eli501_T,"-37.80730068, 144.95956055"
1172320240906,117,2024-09-06,23,278,697,975,Fli114F_T,"-37.81629332, 144.97090877"
66920240826,66,2024-08-26,9,359,516,875,QVN_T,"-37.81057846, 144.96444294"
842220250618,84,2025-06-18,22,299,444,743,ElFi_T,"-37.81798049, 144.96503383"
32020231201,3,2023-12-01,20,1033,1081,2114,Swa295_T,"-37.81101524, 144.96429485"
39020250720,39,2025-07-20,0,6,11,17,AlfPl_T,"-37.81379749, 144.96995745"
751620240120,75,2024-01-20,16,46,127,173,SprFli_T,"-37.81515276, 144.97467661"
751320240519,75,2024-05-19,13,86,20,106,SprFli_T,"-37.81515276, 144.97467661"
82020250412,8,2025-04-12,20,39,38,77,WebBN_T,"-37.82293543, 144.9471751"
81920250526,8,2025-05-26,19,4,11,15,WebBN_T,"-37.82293543, 144.9471751"
411520250710,41,2025-07-10,15,1466,1570,3036,Swa31,"-37.81668634, 144.96689733"
782220240529,78,2024-05-29,22,0,5,5,HarEsB_T,"-37.81471642, 144.9446508"
711320251013,71,2025-10-13,13,21,22,43,WestWP_T,"-37.81235775, 144.97136962"
14920240208,14,2024-02-08,9,265,254,519,SanBri_T,"-37.82011242, 144.96291897"
59620240121,59,2024-01-21,6,23,23,46,RMIT_T,"-37.80825648, 144.96304859"
291420250901,29,2025-09-01,14,202,172,374,AG_T,"-37.8199817, 144.96872865"
31120251016,31,2025-10-16,1,20,6,26,Lyg161_T,"-37.80169681, 144.96658911"
542020250908,54,2025-09-08,20,119,154,273,Swa607_T,"-37.804024, 144.96308399"
36520250916,36,2025-09-16,5,6,8,14,Que85_T,"-37.81652527, 144.96121062"
471420240309,47,2024-03-09,14,698,784,1482,Eli250_T,"-37.81258467, 144.9625775"
36920240127,36,2024-01-27,9,98,69,167,Que85_T,"-37.81652527, 144.96121062"
1081020250617,108,2025-06-17,10,263,384,647,261Will_T,"-37.81295822, 144.95678789"
611020241225,61,2024-12-25,10,54,161,215,RMIT14_T,"-37.80767455, 144.96309114"
611920240212,61,2024-02-12,19,332,431,763,RMIT14_T,"-37.80767455, 144.96309114"
44620241001,44,2024-10-01,6,13,13,26,UM3_T,"-37.79698741, 144.96441306"
441720250304,44,2025-03-04,17,222,193,415,UM3_T,"-37.79698741, 144.96441306"
51720240508,5,2024-05-08,17,1356,1106,2462,PriNW_T,"-37.81874249, 144.96787656"
36120240731,36,2024-07-31,1,3,1,4,Que85_T,"-37.81652527, 144.96121062"
37320250516,37,2025-05-16,3,3,0,3,Lyg260_T,"-37.80107122, 144.96704554"
37820240627,37,2024-06-27,8,34,66,100,Lyg260_T,"-37.80107122, 144.96704554"
44720240525,44,2024-05-25,7,11,10,21,UM3_T,"-37.79698741, 144.96441306"
50320241007,50,2024-10-07,3,4,0,4,Lyg309_T,"-37.79808192, 144.96721013"
431320240725,43,2024-07-25,13,179,315,494,UM2_T,"-37.79844526, 144.96411782"
451020250203,45,2025-02-03,10,356,280,636,Swa148_T,"-37.81414075, 144.96609379"
1351020250627,135,2025-06-27,10,318,373,691,Spen161_T,"-37.8172861, 144.95319102"
107220241109,107,2024-11-09,2,15,8,23,280Will_T,"-37.81246271, 144.95690188"
1071720241222,107,2024-12-22,17,69,86,155,280Will_T,"-37.81246271, 144.95690188"
107420250603,107,2025-06-03,4,1,5,6,280Will_T,"-37.81246271, 144.95690188"
108420250301,108,2025-03-01,4,11,8,19,261Will_T,"-37.81295822, 144.95678789"
1082220241224,108,2024-12-24,22,95,76,171,261Will_T,"-37.81295822, 144.95678789"
1081220240530,108,2024-05-30,12,208,341,549,261Will_T,"-37.81295822, 144.95678789"
1082220240302,108,2024-03-02,22,132,140,272,261Will_T,"-37.81295822, 144.95678789"
87220240805,87,2024-08-05,2,0,1,1,Errol23_T,"-37.80454949, 144.94921863"
87320240719,87,2024-07-19,3,1,0,1,Errol23_T,"-37.80454949, 144.94921863"
166120241113,166,2024-11-13,1,3,1,4,Spen484_T,"-37.80896733, 144.94931703"
166520251005,166,2025-10-05,5,2,2,4,Spen484_T,"-37.80896733, 144.94931703"
167320250829,167,2025-08-29,3,0,1,1,Lat526_T,"-37.81304149, 144.95155955"
1432220240526,143,2024-05-26,22,100,68,168,Spencer_T,"-37.821728, 144.95557015"
132420240229,132,2024-02-29,4,10,10,20,King335_T,"-37.81267639, 144.95386444"
132720240905,132,2024-09-05,7,67,39,106,King335_T,"-37.81267639, 144.95386444"
134920231028,134,2023-10-28,9,312,312,624,Spen201_T,"-37.81694221, 144.95303935"
134920240820,134,2024-08-20,9,303,249,552,Spen201_T,"-37.81694221, 144.95303935"
851020240104,85,2024-01-04,10,67,56,123,488Mac_T,"-37.79432415, 144.92973378"
851320240416,85,2024-04-16,13,78,66,144,488Mac_T,"-37.79432415, 144.92973378"
172020241122,17,2024-11-22,20,141,154,295,Col15_T,"-37.81362543, 144.97323591"
62720240502,62,2024-05-02,7,50,65,115,Lat224_T,"-37.80996494, 144.96216521"
10220250113,10,2025-01-13,2,1,0,1,BouHbr_T,"-37.81876474, 144.94710545"
581920240829,58,2024-08-29,19,397,366,763,Bou688_T,"-37.81686075, 144.95358075"
582120240530,58,2024-05-30,21,153,205,358,Bou688_T,"-37.81686075, 144.95358075"
351620231018,35,2023-10-18,16,1321,1036,2357,SouthB_T,"-37.82018685, 144.96508508"
272020250606,27,2025-06-06,20,89,47,136,Vic_T,"-37.80606888, 144.95644692"
79320240130,79,2024-01-30,3,19,18,37,FliSS_T,"-37.81794046, 144.96616678"
201520241116,20,2024-11-16,15,155,119,274,LtB170_T,"-37.81172914, 144.9682466"
20620240316,20,2024-03-16,6,15,7,22,LtB170_T,"-37.81172914, 144.9682466"
251620231104,25,2023-11-04,16,0,0,0,MCEC_T,"-37.82401776, 144.95604426"
1362120240615,136,2024-06-15,21,1,5,6,BirFed1120_T,"-37.8184141, 144.97357915"
1391920231209,139,2023-12-09,19,17,31,48,Signal1647_T,"-37.81959923, 144.9632832"
1611620241127,161,2024-11-27,16,105,89,194,BirArt1109_T,"-37.81851276, 144.97131336"
49420250629,49,2025-06-29,4,29,30,59,Eli501_T,"-37.80730068, 144.95956055"
141320250713,141,2025-07-13,3,41,38,79,474Fl_T,"-37.81997273, 144.95834911"
19020250423,19,2025-04-23,0,72,83,155,LtB210_T,"-37.81237202, 144.96550671"
19620240722,19,2024-07-22,6,20,10,30,LtB210_T,"-37.81237202, 144.96550671"
19720240803,19,2024-08-03,7,13,11,24,LtB210_T,"-37.81237202, 144.96550671"
180020250628,180,2025-06-28,0,4,1,5,Mac330_T,"-37.79497059, 144.93530329"
662320241027,66,2024-10-27,23,157,119,276,QVN_T,"-37.81057846, 144.96444294"
69620241218,69,2024-12-18,6,19,10,29,FLDegC_T,"-37.81687226, 144.96559144"
61020240425,6,2024-04-25,10,739,716,1455,FliS_T,"-37.81911705, 144.96558255"
6520240627,6,2024-06-27,5,94,96,190,FliS_T,"-37.81911705, 144.96558255"
61720240920,6,2024-09-20,17,1566,1067,2633,FliS_T,"-37.81911705, 144.96558255"
842220241027,84,2024-10-27,22,424,486,910,ElFi_T,"-37.81798049, 144.96503383"
701220241015,70,2024-10-15,12,123,141,264,Errol20_T,"-37.80456984, 144.94946228"
31720251009,3,2025-10-09,17,1383,1497,2880,Swa295_T,"-37.81101524, 144.96429485"
391220240402,39,2024-04-02,12,380,231,611,AlfPl_T,"-37.81379749, 144.96995745"
75720250213,75,2025-02-13,7,46,28,74,SprFli_T,"-37.81515276, 144.97467661"
781620240303,78,2024-03-03,16,39,60,99,HarEsB_T,"-37.81471642, 144.9446508"
41420250723,41,2025-07-23,4,39,70,109,Swa31,"-37.81668634, 144.96689733"
591220240404,59,2024-04-04,12,486,609,1095,RMIT_T,"-37.80825648, 144.96304859"
71020240927,71,2024-09-27,0,13,0,13,WestWP_T,"-37.81235775, 144.97136962"
292020240923,29,2024-09-23,20,65,113,178,AG_T,"-37.8199817, 144.96872865"
142220240925,14,2024-09-25,22,130,52,182,SanBri_T,"-37.82011242, 144.96291897"
54220240218,54,2024-02-18,2,28,7,35,Swa607_T,"-37.804024, 144.96308399"
472320250309,47,2025-03-09,23,253,199,452,Eli250_T,"-37.81258467, 144.9625775"
472020250315,47,2025-03-15,20,714,569,1283,Eli250_T,"-37.81258467, 144.9625775"
401320250710,40,2025-07-10,13,403,230,633,Spr201_T,"-37.80999341, 144.97227587"
401620240315,40,2024-03-15,16,131,185,316,Spr201_T,"-37.80999341, 144.97227587"
21020240810,21,2024-08-10,0,138,206,344,Bourke155_T,"-37.81267313, 144.96788288"
371220240929,37,2024-09-29,12,72,64,136,Lyg260_T,"-37.80107122, 144.96704554"
37820231111,37,2023-11-11,8,22,19,41,Lyg260_T,"-37.80107122, 144.96704554"
501920250421,50,2025-04-21,19,163,109,272,Lyg309_T,"-37.79808192, 144.96721013"
502320240219,50,2024-02-19,23,26,7,33,Lyg309_T,"-37.79808192, 144.96721013"
451520250528,45,2025-05-28,15,422,535,957,Swa148_T,"-37.81414075, 144.96609379"
1311420240128,131,2024-01-28,14,151,138,289,King2_T,"-37.82009057, 144.95758725"
1312020250509,131,2025-05-09,20,97,90,187,King2_T,"-37.82009057, 144.95758725"
1071820240102,107,2024-01-02,18,16,19,35,280Will_T,"-37.81246271, 144.95690188"
107720250303,107,2025-03-03,7,42,98,140,280Will_T,"-37.81246271, 144.95690188"
108820241107,108,2024-11-07,8,122,2394,2516,261Will_T,"-37.81295822, 144.95678789"
872120240301,87,2024-03-01,21,69,58,127,Errol23_T,"-37.80454949, 144.94921863"
1791320250905,179,2025-09-05,13,69,68,137,Pow61_T,"-37.82392385, 144.96299677"
1671520250720,167,2025-07-20,15,52,74,126,Lat526_T,"-37.81304149, 144.95155955"
1401520250204,140,2025-02-04,15,72,80,152,Boyd2837_T,"-37.82590962, 144.96185972"
1431020250430,143,2025-04-30,10,73,125,198,Spencer_T,"-37.821728, 144.95557015"
132720240120,132,2024-01-20,7,48,24,72,King335_T,"-37.81267639, 144.95386444"
1342020240420,134,2024-04-20,20,298,315,613,Spen201_T,"-37.81694221, 144.95303935"
122020240116,12,2024-01-16,20,304,277,581,NewQ_T,"-37.81457988, 144.94292398"
721020250208,72,2025-02-08,10,190,215,405,ACMI_T,"-37.81726338, 144.96872809"
721520240127,72,2024-01-27,15,336,577,913,ACMI_T,"-37.81726338, 144.96872809"
72820240712,72,2024-07-12,8,379,66,445,ACMI_T,"-37.81726338, 144.96872809"
581620240525,58,2024-05-25,16,1665,374,2039,Bou688_T,"-37.81686075, 144.95358075"
76020250223,76,2025-02-23,0,1,6,7,KenMac_T,"-37.79453803, 144.93036194"
761620250701,76,2025-07-01,16,54,67,121,KenMac_T,"-37.79453803, 144.93036194"
11320240924,11,2024-09-24,3,1,0,1,WatCit_T,"-37.81564989, 144.93970694"
91120240831,9,2024-08-31,11,77,137,214,Col700_T,"-37.81982992, 144.95102555"
30720241026,30,2024-10-26,7,12,43,55,Lon189_T,"-37.8112185, 144.96656806"
231220240620,23,2024-06-20,12,431,540,971,Col623_T,"-37.81909256, 144.95452748"
522320250425,52,2025-04-25,23,131,177,308,Eli263_T,"-37.81252157, 144.9619401"
51620250110,51,2025-01-10,6,13,12,25,Fra118_T,"-37.80841815, 144.95906316"
511220250521,51,2025-05-21,12,119,116,235,Fra118_T,"-37.80841815, 144.95906316"
1311720250618,131,2025-06-18,17,94,151,245,King2_T,"-37.82009057, 144.95758725"
1341820250715,134,2025-07-15,18,560,485,1045,Spen201_T,"-37.81694221, 144.95303935"
134720250605,134,2025-06-05,7,301,268,569,Spen201_T,"-37.81694221, 144.95303935"
1331220250207,133,2025-02-07,12,636,595,1231,Spen229_T,"-37.81531435, 144.95227769"
1182020250112,118,2025-01-12,20,26,8,34,Fli114C_T,"-37.81632783, 144.97090512"
68920231214,68,2023-12-14,9,190,164,354,FLDegN_T,"-37.8168479, 144.96559789"
17520231221,17,2023-12-21,5,41,13,54,Col15_T,"-37.81362543, 144.97323591"
171720231230,17,2023-12-30,17,158,102,260,Col15_T,"-37.81362543, 144.97323591"
172020250704,17,2025-07-04,20,73,106,179,Col15_T,"-37.81362543, 144.97323591"
182020250226,18,2025-02-26,20,57,28,85,Col12_T,"-37.81344862, 144.97305353"
631420250128,63,2025-01-28,14,340,405,745,Bou231_T,"-37.81333081, 144.96675571"
62920240325,62,2024-03-25,9,120,144,264,Lat224_T,"-37.80996494, 144.96216521"
86720250920,86,2025-09-20,7,24,13,37,574Qub_T,"-37.80309992, 144.94908064"
63220250105,63,2025-01-05,2,0,38,38,Bou231_T,"-37.81333081, 144.96675571"
12420241215,12,2024-12-15,4,3,4,7,NewQ_T,"-37.81457988, 144.94292398"
121720250930,12,2025-09-30,17,160,229,389,NewQ_T,"-37.81457988, 144.94292398"
10120240517,10,2024-05-17,1,0,1,1,BouHbr_T,"-37.81876474, 144.94710545"
10820250124,10,2025-01-24,8,22,95,117,BouHbr_T,"-37.81876474, 144.94710545"
2220240910,2,2024-09-10,2,4,20,24,Bou283_T,"-37.81380668, 144.96516718"
92120240720,9,2024-07-20,21,30,43,73,Col700_T,"-37.81982992, 144.95102555"
271520250323,27,2025-03-23,15,285,196,481,Vic_T,"-37.80606888, 144.95644692"
271620250529,27,2025-05-29,16,128,105,233,Vic_T,"-37.80606888, 144.95644692"
79820250202,79,2025-02-02,8,115,56,171,FliSS_T,"-37.81794046, 144.96616678"
23320231022,23,2023-10-22,3,11,25,36,Col623_T,"-37.81909256, 144.95452748"
231420250919,23,2025-09-19,14,163,321,484,Col623_T,"-37.81909256, 144.95452748"
51020240617,51,2024-06-17,0,13,6,19,Fra118_T,"-37.80841815, 144.95906316"
512320250201,51,2025-02-01,23,49,24,73,Fra118_T,"-37.80841815, 144.95906316"
231620241226,23,2024-12-26,16,65,152,217,Col623_T,"-37.81909256, 144.95452748"
48020240529,48,2024-05-29,0,19,23,42,QVMQ_T,"-37.80631581, 144.95866697"
251520250704,25,2025-07-04,15,700,603,1303,MCEC_T,"-37.82401776, 144.95604426"
201020231120,20,2023-11-20,10,141,120,261,LtB170_T,"-37.81172914, 144.9682466"
202320240609,20,2024-06-09,23,124,212,336,LtB170_T,"-37.81172914, 144.9682466"
251920231218,25,2023-12-18,19,618,291,909,MCEC_T,"-37.82401776, 144.95604426"
522220250814,52,2025-08-14,22,104,94,198,Eli263_T,"-37.81252157, 144.9619401"
52720241002,52,2024-10-02,7,74,72,146,Eli263_T,"-37.81252157, 144.9619401"
521820241111,52,2024-11-11,18,294,310,604,Eli263_T,"-37.81252157, 144.9619401"
1371920250710,137,2025-07-10,19,2,20,22,BouHbr2353_T,"-37.81894815, 144.94612292"
67820251005,67,2025-10-05,8,102,85,187,FLDegS_T,"-37.81688755, 144.96562569"
682320241225,68,2024-12-25,23,32,12,44,FLDegN_T,"-37.8168479, 144.96559789"
11120250117,1,2025-01-17,11,1051,950,2001,Bou292_T,"-37.81349441, 144.96515323"
671020250827,67,2025-08-27,10,403,420,823,FLDegS_T,"-37.81688755, 144.96562569"
18120251001,18,2025-10-01,1,2,0,2,Col12_T,"-37.81344862, 144.97305353"
681720240512,68,2024-05-12,17,109,33,142,FLDegN_T,"-37.8168479, 144.96559789"
561520240903,56,2024-09-03,15,297,227,524,Lon364_T,"-37.81234775, 144.96153311"
121020231103,12,2023-11-03,10,80,97,177,NewQ_T,"-37.81457988, 144.94292398"
24520250426,24,2025-04-26,5,34,23,57,Col620_T,"-37.81887963, 144.95449198"
562220250815,56,2025-08-15,22,222,241,463,Lon364_T,"-37.81234775, 144.96153311"
77120240415,77,2024-04-15,1,8,7,15,HarEsP_T,"-37.81441438, 144.94433026"
78320240225,78,2024-02-25,3,12,6,18,HarEsB_T,"-37.81471642, 144.9446508"
651820240419,65,2024-04-19,18,1023,560,1583,SwaCs_T,"-37.81569416, 144.9668064"
421120241030,42,2024-10-30,11,134,331,465,UM1_T,"-37.80008566, 144.96386412"
291120241205,29,2024-12-05,11,155,260,415,AG_T,"-37.8199817, 144.96872865"
211720250408,21,2025-04-08,17,544,459,1003,Bourke155_T,"-37.81267313, 144.96788288"
5520241025,5,2024-10-25,5,21,50,71,PriNW_T,"-37.81874249, 144.96787656"
372320241023,37,2024-10-23,23,30,28,58,Lyg260_T,"-37.80107122, 144.96704554"
87720240905,87,2024-09-05,7,46,49,95,Errol23_T,"-37.80454949, 144.94921863"
87920240908,87,2024-09-08,9,58,83,141,Errol23_T,"-37.80454949, 144.94921863"
84120240608,84,2024-06-08,1,99,140,239,ElFi_T,"-37.81798049, 144.96503383"
82020250810,8,2025-08-10,20,4,4,8,WebBN_T,"-37.82293543, 144.9471751"
41620231215,41,2023-12-15,6,490,220,710,Swa31,"-37.81668634, 144.96689733"
411820240903,41,2024-09-03,18,212,136,348,Swa31,"-37.81668634, 144.96689733"
771120250131,77,2025-01-31,11,93,71,164,HarEsP_T,"-37.81441438, 144.94433026"
291120240601,29,2024-06-01,11,178,255,433,AG_T,"-37.8199817, 144.96872865"
14220240128,14,2024-01-28,2,112,15,127,SanBri_T,"-37.82011242, 144.96291897"
71820240325,71,2024-03-25,8,21,38,59,WestWP_T,"-37.81235775, 144.97136962"
59020250116,59,2025-01-16,0,55,31,86,RMIT_T,"-37.80825648, 144.96304859"
40020250503,40,2025-05-03,0,31,6,37,Spr201_T,"-37.80999341, 144.97227587"
401120241126,40,2024-11-26,11,232,305,537,Spr201_T,"-37.80999341, 144.97227587"
371220250601,37,2025-06-01,12,54,74,128,Lyg260_T,"-37.80107122, 144.96704554"
87420250506,87,2025-05-06,4,1,1,2,Errol23_T,"-37.80454949, 144.94921863"
61320251015,61,2025-10-15,3,2,4,6,RMIT14_T,"-37.80767455, 144.96309114"
432020250203,43,2025-02-03,20,35,42,77,UM2_T,"-37.79844526, 144.96411782"
431120250513,43,2025-05-13,11,176,255,431,UM2_T,"-37.79844526, 144.96411782"
441320240526,44,2024-05-26,13,56,71,127,UM3_T,"-37.79698741, 144.96441306"
1432120250731,143,2025-07-31,21,137,106,243,Spencer_T,"-37.821728, 144.95557015"
134120240708,134,2024-07-08,1,20,20,40,Spen201_T,"-37.81694221, 144.95303935"
135720250816,135,2025-08-16,7,69,97,166,Spen161_T,"-37.8172861, 144.95319102"
107320250721,107,2025-07-21,3,2,2,4,280Will_T,"-37.81246271, 144.95690188"
1332120241109,133,2024-11-09,21,370,301,671,Spen229_T,"-37.81531435, 144.95227769"
1661220250321,166,2025-03-21,12,33,35,68,Spen484_T,"-37.80896733, 144.94931703"
1661320250923,166,2025-09-23,13,53,43,96,Spen484_T,"-37.80896733, 144.94931703"
181220250716,181,2025-07-16,2,31,41,72,Eli368_T,"-37.81009465, 144.96143149"
67020250430,67,2025-04-30,0,6,10,16,FLDegS_T,"-37.81688755, 144.96562569"
681020250816,68,2025-08-16,10,276,322,598,FLDegN_T,"-37.8168479, 144.96559789"
862020250405,86,2025-04-05,20,57,86,143,574Qub_T,"-37.80309992, 144.94908064"
111820240409,11,2024-04-09,18,66,61,127,WatCit_T,"-37.81564989, 144.93970694"
1120250827,1,2025-08-27,1,14,13,27,Bou292_T,"-37.81349441, 144.96515323"
122220240807,12,2024-08-07,22,44,40,84,NewQ_T,"-37.81457988, 144.94292398"
121820231203,12,2023-12-03,18,228,301,529,NewQ_T,"-37.81457988, 144.94292398"
102020241127,10,2024-11-27,20,36,25,61,BouHbr_T,"-37.81876474, 144.94710545"
138820250316,138,2025-03-16,8,1,3,4,EntPark1671_T,"-37.81996544, 144.95981454"
141620240810,141,2024-08-10,6,15,7,22,474Fl_T,"-37.81997273, 144.95834911"
491920240510,49,2024-05-10,19,188,207,395,Eli501_T,"-37.80730068, 144.95956055"
1091820250427,109,2025-04-27,18,63,118,181,LatWill_T,"-37.81193681, 144.95621105"
109620250523,109,2025-05-23,6,24,74,98,LatWill_T,"-37.81193681, 144.95621105"
481620240818,48,2024-08-18,16,614,230,844,QVMQ_T,"-37.80631581, 144.95866697"
1801420250917,180,2025-09-17,14,14,24,38,Mac330_T,"-37.79497059, 144.93530329"
1391420240820,139,2024-08-20,14,47,36,83,Signal1647_T,"-37.81959923, 144.9632832"
139720250208,139,2025-02-08,7,7,10,17,Signal1647_T,"-37.81959923, 144.9632832"
139620250423,139,2025-04-23,6,11,21,32,Signal1647_T,"-37.81959923, 144.9632832"
1392020250519,139,2025-05-19,20,8,10,18,Signal1647_T,"-37.81959923, 144.9632832"
85620231104,85,2023-11-04,6,10,6,16,488Mac_T,"-37.79432415, 144.92973378"
851520250308,85,2025-03-08,15,95,86,181,488Mac_T,"-37.79432415, 144.92973378"
171320240314,17,2024-03-14,13,777,745,1522,Col15_T,"-37.81362543, 144.97323591"
17220240618,17,2024-06-18,2,15,13,28,Col15_T,"-37.81362543, 144.97323591"
172320240822,17,2024-08-22,23,21,67,88,Col15_T,"-37.81362543, 144.97323591"
631820241213,63,2024-12-13,18,541,611,1152,Bou231_T,"-37.81333081, 144.96675571"
631620240306,63,2024-03-06,16,334,400,734,Bou231_T,"-37.81333081, 144.96675571"
111220240803,11,2024-08-03,12,155,113,268,WatCit_T,"-37.81564989, 144.93970694"
11720241126,11,2024-11-26,7,50,42,92,WatCit_T,"-37.81564989, 144.93970694"
111120250105,11,2025-01-05,11,180,194,374,WatCit_T,"-37.81564989, 144.93970694"
622320240719,62,2024-07-19,23,141,64,205,Lat224_T,"-37.80996494, 144.96216521"
122220241022,12,2024-10-22,22,118,646,764,NewQ_T,"-37.81457988, 144.94292398"
661720240814,66,2024-08-14,17,1641,1822,3463,QVN_T,"-37.81057846, 144.96444294"
841520250817,84,2025-08-17,15,888,1592,2480,ElFi_T,"-37.81798049, 144.96503383"
4020240316,4,2024-03-16,0,447,649,1096,Swa123_T,"-37.81487988, 144.9660878"
32320231025,3,2023-10-25,23,216,223,439,Swa295_T,"-37.81101524, 144.96429485"
701220250601,70,2025-06-01,12,153,174,327,Errol20_T,"-37.80456984, 144.94946228"
751020240121,75,2024-01-21,10,48,111,159,SprFli_T,"-37.81515276, 144.97467661"
81720240124,8,2024-01-24,17,212,384,596,WebBN_T,"-37.82293543, 144.9471751"
781820240909,78,2024-09-09,18,10,36,46,HarEsB_T,"-37.81471642, 144.9446508"
311420241222,31,2024-12-22,14,178,197,375,Lyg161_T,"-37.80169681, 144.96658911"
541520240824,54,2024-08-24,15,204,152,356,Swa607_T,"-37.804024, 144.96308399"
541120241004,54,2024-10-04,11,243,156,399,Swa607_T,"-37.804024, 144.96308399"
54020250613,54,2025-06-13,0,19,38,57,Swa607_T,"-37.804024, 144.96308399"
54620231223,54,2023-12-23,6,9,8,17,Swa607_T,"-37.804024, 144.96308399"
21020250327,21,2025-03-27,0,43,48,91,Bourke155_T,"-37.81267313, 144.96788288"
502220240710,50,2024-07-10,22,62,23,85,Lyg309_T,"-37.79808192, 144.96721013"
501920250405,50,2025-04-05,19,304,328,632,Lyg309_T,"-37.79808192, 144.96721013"
431520250624,43,2025-06-24,15,140,186,326,UM2_T,"-37.79844526, 144.96411782"
1311220240606,131,2024-06-06,12,158,187,345,King2_T,"-37.82009057, 144.95758725"
135820240205,135,2024-02-05,8,303,275,578,Spen161_T,"-37.8172861, 144.95319102"
1331320250923,133,2025-09-23,13,591,481,1072,Spen229_T,"-37.81531435, 144.95227769"
1081720240816,108,2024-08-16,17,376,232,608,261Will_T,"-37.81295822, 144.95678789"
87220250409,87,2025-04-09,2,0,1,1,Errol23_T,"-37.80454949, 144.94921863"
611720250601,61,2025-06-01,17,388,310,698,RMIT14_T,"-37.80767455, 144.96309114"
611420250709,61,2025-07-09,14,318,419,737,RMIT14_T,"-37.80767455, 144.96309114"
72820240104,72,2024-01-04,8,173,54,227,ACMI_T,"-37.81726338, 144.96872809"
721420240509,72,2024-05-09,14,147,341,488,ACMI_T,"-37.81726338, 144.96872809"
242120250726,24,2025-07-26,21,244,321,565,Col620_T,"-37.81887963, 144.95449198"
791420250106,79,2025-01-06,14,417,353,770,FliSS_T,"-37.81794046, 144.96616678"
79320240330,79,2024-03-30,3,48,57,105,FliSS_T,"-37.81794046, 144.96616678"
301020240307,30,2024-03-07,10,148,231,379,Lon189_T,"-37.8112185, 144.96656806"
201820250107,20,2025-01-07,18,356,214,570,LtB170_T,"-37.81172914, 144.9682466"
46420240206,46,2024-02-06,4,1,0,1,Pel147_T,"-37.80240719, 144.9615673"
511520250928,51,2025-09-28,15,127,141,268,Fra118_T,"-37.80841815, 144.95906316"
141320250606,141,2025-06-06,3,15,23,38,474Fl_T,"-37.81997273, 144.95834911"
1391420250226,139,2025-02-26,14,62,37,99,Signal1647_T,"-37.81959923, 144.9632832"
1362220241017,136,2024-10-17,22,1,10,11,BirFed1120_T,"-37.8184141, 144.97357915"
1611920241015,161,2024-10-15,19,129,93,222,BirArt1109_T,"-37.81851276, 144.97131336"
1231320241204,123,2024-12-04,13,30,7,37,BirBridge_T,"-37.81753741, 144.97329734"
49020240219,49,2024-02-19,0,72,100,172,Eli501_T,"-37.80730068, 144.95956055"
41720250608,4,2025-06-08,17,1891,1622,3513,Swa123_T,"-37.81487988, 144.9660878"
70420240201,70,2024-02-01,4,2,0,2,Errol20_T,"-37.80456984, 144.94946228"
31120240506,3,2024-05-06,11,659,815,1474,Swa295_T,"-37.81101524, 144.96429485"
81820240927,8,2024-09-27,18,216,205,421,WebBN_T,"-37.82293543, 144.9471751"
81320250206,8,2025-02-06,13,249,273,522,WebBN_T,"-37.82293543, 144.9471751"
752320250809,75,2025-08-09,23,5,20,25,SprFli_T,"-37.81515276, 144.97467661"
75420250126,75,2025-01-26,4,1,0,1,SprFli_T,"-37.81515276, 144.97467661"
41320240224,41,2024-02-24,3,70,93,163,Swa31,"-37.81668634, 144.96689733"
77420240515,77,2024-05-15,4,2,1,3,HarEsP_T,"-37.81441438, 144.94433026"
77420241223,77,2024-12-23,4,2,4,6,HarEsP_T,"-37.81441438, 144.94433026"
77620250422,77,2025-04-22,6,27,50,77,HarEsP_T,"-37.81441438, 144.94433026"
781220250920,78,2025-09-20,12,51,64,115,HarEsB_T,"-37.81471642, 144.9446508"
711720250928,71,2025-09-28,17,15,3,18,WestWP_T,"-37.81235775, 144.97136962"
592220240727,59,2024-07-27,22,259,174,433,RMIT_T,"-37.80825648, 144.96304859"
59020250101,59,2025-01-01,0,513,45,558,RMIT_T,"-37.80825648, 144.96304859"
28420231019,28,2023-10-19,4,4,38,42,VAC_T,"-37.82129925, 144.96879309"
401020240122,40,2024-01-22,10,139,174,313,Spr201_T,"-37.80999341, 144.97227587"
372020240214,37,2024-02-14,20,345,323,668,Lyg260_T,"-37.80107122, 144.96704554"
371620240404,37,2024-04-04,16,96,107,203,Lyg260_T,"-37.80107122, 144.96704554"
37720250808,37,2025-08-08,7,15,14,29,Lyg260_T,"-37.80107122, 144.96704554"
51320240430,5,2024-04-30,13,740,719,1459,PriNW_T,"-37.81874249, 144.96787656"
611420250706,61,2025-07-06,14,308,378,686,RMIT14_T,"-37.80767455, 144.96309114"
61420240202,61,2024-02-02,4,7,12,19,RMIT14_T,"-37.80767455, 144.96309114"
43220251016,43,2025-10-16,2,3,1,4,UM2_T,"-37.79844526, 144.96411782"
179420250710,179,2025-07-10,4,3,1,4,Pow61_T,"-37.82392385, 144.96299677"
179820250729,179,2025-07-29,8,64,22,86,Pow61_T,"-37.82392385, 144.96299677"
1651020241209,165,2024-12-09,10,23,39,62,Spen475_T,"-37.80953359, 144.94939004"
1821320250809,182,2025-08-09,13,222,257,479,King163_T,"-37.81627451, 144.95550503"
61620240423,61,2024-04-23,6,27,61,88,RMIT14_T,"-37.80767455, 144.96309114"
1661520250514,166,2025-05-14,15,62,57,119,Spen484_T,"-37.80896733, 144.94931703"
1651120250106,165,2025-01-06,11,14,12,26,Spen475_T,"-37.80953359, 144.94939004"
1671220241105,167,2024-11-05,12,15,33,48,Lat526_T,"-37.81304149, 144.95155955"
1401220240419,140,2024-04-19,12,101,61,162,Boyd2837_T,"-37.82590962, 144.96185972"
1401920241207,140,2024-12-07,19,94,79,173,Boyd2837_T,"-37.82590962, 144.96185972"
1620241227,1,2024-12-27,6,38,31,69,Bou292_T,"-37.81349441, 144.96515323"
861620250926,86,2025-09-26,16,34,48,82,574Qub_T,"-37.80309992, 144.94908064"
861520240419,86,2024-04-19,15,44,69,113,574Qub_T,"-37.80309992, 144.94908064"
86320241021,86,2024-10-21,3,0,1,1,574Qub_T,"-37.80309992, 144.94908064"
621020240216,62,2024-02-16,10,210,163,373,Lat224_T,"-37.80996494, 144.96216521"
621420240717,62,2024-07-17,14,201,200,401,Lat224_T,"-37.80996494, 144.96216521"
102120250515,10,2025-05-15,21,47,23,70,BouHbr_T,"-37.81876474, 144.94710545"
241520240923,24,2024-09-23,15,647,1227,1874,Col620_T,"-37.81887963, 144.95449198"
111420250816,11,2025-08-16,14,76,57,133,WatCit_T,"-37.81564989, 144.93970694"
242320250929,24,2025-09-29,23,70,129,199,Col620_T,"-37.81887963, 144.95449198"
761520241221,76,2024-12-21,15,32,29,61,KenMac_T,"-37.79453803, 144.93036194"
9820241010,9,2024-10-10,8,139,3424,3563,Col700_T,"-37.81982992, 144.95102555"
2320250811,2,2025-08-11,3,4,4,8,Bou283_T,"-37.81380668, 144.96516718"
532120250404,53,2025-04-04,21,228,283,511,Col254_T,"-37.81564191, 144.965499"
231820240606,23,2024-06-06,18,180,420,600,Col623_T,"-37.81909256, 144.95452748"
301020250206,30,2025-02-06,10,105,170,275,Lon189_T,"-37.8112185, 144.96656806"
46720240428,46,2024-04-28,7,11,8,19,Pel147_T,"-37.80240719, 144.9615673"
522120250810,52,2025-08-10,21,141,169,310,Eli263_T,"-37.81252157, 144.9619401"
142620241223,142,2024-12-23,6,48,37,85,Hammer1584_T,"-37.81970749, 144.96795734"
1301320250207,130,2025-02-07,13,78,40,118,Bou892T,"-37.8204637, 144.94126826"
164520241117,164,2024-11-17,5,2,0,2,Lat526_T,"-37.813005, 144.95160411"
123820250621,123,2025-06-21,8,34,17,51,BirBridge_T,"-37.81753741, 144.97329734"
1411220250522,141,2025-05-22,12,174,145,319,474Fl_T,"-37.81997273, 144.95834911"
491920240303,49,2024-03-03,19,193,185,378,Eli501_T,"-37.80730068, 144.95956055"
137620240605,137,2024-06-05,6,4,1,5,BouHbr2353_T,"-37.81894815, 144.94612292"
31720240604,3,2024-06-04,17,1054,1147,2201,Swa295_T,"-37.81101524, 144.96429485"
32320240610,3,2024-06-10,23,189,184,373,Swa295_T,"-37.81101524, 144.96429485"
661120231117,66,2023-11-17,11,583,722,1305,QVN_T,"-37.81057846, 144.96444294"
4020241031,4,2024-10-31,0,88,63,151,Swa123_T,"-37.81487988, 144.9660878"
8820250215,8,2025-02-15,8,59,91,150,WebBN_T,"-37.82293543, 144.9471751"
81120250926,8,2025-09-26,11,132,225,357,WebBN_T,"-37.82293543, 144.9471751"
412320240907,41,2024-09-07,23,108,115,223,Swa31,"-37.81668634, 144.96689733"
591420231029,59,2023-10-29,14,1069,546,1615,RMIT_T,"-37.80825648, 144.96304859"
291920240801,29,2024-08-01,19,92,157,249,AG_T,"-37.8199817, 144.96872865"
312020240111,31,2024-01-11,20,259,249,508,Lyg161_T,"-37.80169681, 144.96658911"
312320240208,31,2024-02-08,23,30,74,104,Lyg161_T,"-37.80169681, 144.96658911"
541520240108,54,2024-01-08,15,148,169,317,Swa607_T,"-37.804024, 144.96308399"
281520250627,28,2025-06-27,15,523,871,1394,VAC_T,"-37.82129925, 144.96879309"
47720241014,47,2024-10-14,7,132,267,399,Eli250_T,"-37.81258467, 144.9625775"
51120240817,5,2024-08-17,11,480,767,1247,PriNW_T,"-37.81874249, 144.96787656"
5520241102,5,2024-11-02,5,17,13,30,PriNW_T,"-37.81874249, 144.96787656"
37320240128,37,2024-01-28,3,4,2,6,Lyg260_T,"-37.80107122, 144.96704554"
501820250213,50,2025-02-13,18,150,194,344,Lyg309_T,"-37.79808192, 144.96721013"
10520231125,10,2023-11-25,5,6,10,16,BouHbr_T,"-37.81876474, 144.94710545"
722320250616,72,2025-06-16,23,13,26,39,ACMI_T,"-37.81726338, 144.96872809"
722120250111,72,2025-01-11,21,141,207,348,ACMI_T,"-37.81726338, 144.96872809"
721120250212,72,2025-02-12,11,187,148,335,ACMI_T,"-37.81726338, 144.96872809"
581120241018,58,2024-10-18,11,556,220,776,Bou688_T,"-37.81686075, 144.95358075"
351620250422,35,2025-04-22,16,1242,1130,2372,SouthB_T,"-37.82018685, 144.96508508"
2920231225,2,2023-12-25,9,45,57,102,Bou283_T,"-37.81380668, 144.96516718"
92320250128,9,2025-01-28,23,30,14,44,Col700_T,"-37.81982992, 144.95102555"
792320240707,79,2024-07-07,23,64,96,160,FliSS_T,"-37.81794046, 144.96616678"
301220240711,30,2024-07-11,12,390,528,918,Lon189_T,"-37.8112185, 144.96656806"
791420240315,79,2024-03-15,14,499,419,918,FliSS_T,"-37.81794046, 144.96616678"
301220251012,30,2025-10-12,12,279,468,747,Lon189_T,"-37.8112185, 144.96656806"
48820250816,48,2025-08-16,8,128,113,241,QVMQ_T,"-37.80631581, 144.95866697"
25020250713,25,2025-07-13,0,89,104,193,MCEC_T,"-37.82401776, 144.95604426"
251820231028,25,2023-10-28,18,1380,758,2138,MCEC_T,"-37.82401776, 144.95604426"
52820240322,52,2024-03-22,8,182,357,539,Eli263_T,"-37.81252157, 144.9619401"
461820250215,46,2025-02-15,18,21,52,73,Pel147_T,"-37.80240719, 144.9615673"
137820240412,137,2024-04-12,8,92,17,109,BouHbr2353_T,"-37.81894815, 144.94612292"
1391320240410,139,2024-04-10,13,62,81,143,Signal1647_T,"-37.81959923, 144.9632832"
142920241013,142,2024-10-13,9,545,387,932,Hammer1584_T,"-37.81970749, 144.96795734"
130820240417,130,2024-04-17,8,3,9,12,Bou892T,"-37.8204637, 144.94126826"
1611220250402,161,2025-04-02,12,149,193,342,BirArt1109_T,"-37.81851276, 144.97131336"
1091720241022,109,2024-10-22,17,544,293,837,LatWill_T,"-37.81193681, 144.95621105"
692120240925,69,2024-09-25,21,9,19,28,FLDegC_T,"-37.81687226, 144.96559144"
692220250201,69,2025-02-01,22,53,52,105,FLDegC_T,"-37.81687226, 144.96559144"
61820250706,6,2025-07-06,18,732,633,1365,FliS_T,"-37.81911705, 144.96558255"
41520250430,4,2025-04-30,15,1443,1211,2654,Swa123_T,"-37.81487988, 144.9660878"
701320240212,70,2024-02-12,13,113,125,238,Errol20_T,"-37.80456984, 144.94946228"
701120250311,70,2025-03-11,11,108,108,216,Errol20_T,"-37.80456984, 144.94946228"
42220250409,42,2025-04-09,2,7,1,8,UM1_T,"-37.80008566, 144.96386412"
14620241105,14,2024-11-05,6,61,40,101,SanBri_T,"-37.82011242, 144.96291897"
14420240113,14,2024-01-13,4,45,7,52,SanBri_T,"-37.82011242, 144.96291897"
71520250810,71,2025-08-10,5,9,8,17,WestWP_T,"-37.81235775, 144.97136962"
59020240713,59,2024-07-13,0,164,82,246,RMIT_T,"-37.80825648, 144.96304859"
541220240727,54,2024-07-27,12,117,99,216,Swa607_T,"-37.804024, 144.96308399"
291120250116,29,2025-01-16,11,464,369,833,AG_T,"-37.8199817, 144.96872865"
47920240921,47,2024-09-21,9,319,398,717,Eli250_T,"-37.81258467, 144.9625775"
211720231022,21,2023-10-22,17,424,393,817,Bourke155_T,"-37.81267313, 144.96788288"
371320250523,37,2025-05-23,13,127,130,257,Lyg260_T,"-37.80107122, 144.96704554"
872220250517,87,2025-05-17,22,60,26,86,Errol23_T,"-37.80454949, 144.94921863"
612220240313,61,2024-03-13,22,155,149,304,RMIT14_T,"-37.80767455, 144.96309114"
50820250720,50,2025-07-20,8,28,24,52,Lyg309_T,"-37.79808192, 144.96721013"
432020250809,43,2025-08-09,20,31,30,61,UM2_T,"-37.79844526, 144.96411782"
43020241129,43,2024-11-29,0,4,1,5,UM2_T,"-37.79844526, 144.96411782"
431720231116,43,2023-11-16,17,235,195,430,UM2_T,"-37.79844526, 144.96411782"
43120240614,43,2024-06-14,1,3,5,8,UM2_T,"-37.79844526, 144.96411782"
44320240718,44,2024-07-18,3,1,0,1,UM3_T,"-37.79698741, 144.96441306"
452320250204,45,2025-02-04,23,75,128,203,Swa148_T,"-37.81414075, 144.96609379"
451020240412,45,2024-04-12,10,359,425,784,Swa148_T,"-37.81414075, 144.96609379"
451220241120,45,2024-11-20,12,351,738,1089,Swa148_T,"-37.81414075, 144.96609379"
1351920251012,135,2025-10-12,19,50,48,98,Spen161_T,"-37.8172861, 144.95319102"
1311720250107,131,2025-01-07,17,158,140,298,King2_T,"-37.82009057, 144.95758725"
131420250326,131,2025-03-26,4,1,0,1,King2_T,"-37.82009057, 144.95758725"
135320241002,135,2024-10-02,3,20,5,25,Spen161_T,"-37.8172861, 144.95319102"
1351820250417,135,2025-04-17,18,350,466,816,Spen161_T,"-37.8172861, 144.95319102"
118720250206,118,2025-02-06,7,10,6,16,Fli114C_T,"-37.81632783, 144.97090512"
107320241108,107,2024-11-08,3,4,2,6,280Will_T,"-37.81246271, 144.95690188"
108420251016,108,2025-10-16,4,15,15,30,261Will_T,"-37.81295822, 144.95678789"
87820240520,87,2024-05-20,8,100,46,146,Errol23_T,"-37.80454949, 144.94921863"
611120240921,61,2024-09-21,11,239,345,584,RMIT14_T,"-37.80767455, 144.96309114"
182320250526,182,2025-05-26,3,14,11,25,King163_T,"-37.81627451, 144.95550503"
1651620240831,165,2024-08-31,16,46,23,69,Spen475_T,"-37.80953359, 144.94939004"
1651520241230,165,2024-12-30,15,35,38,73,Spen475_T,"-37.80953359, 144.94939004"
1651220250105,165,2025-01-05,12,19,26,45,Spen475_T,"-37.80953359, 144.94939004"
1811720250905,181,2025-09-05,17,1075,1412,2487,Eli368_T,"-37.81009465, 144.96143149"
1401020240615,140,2024-06-15,10,116,51,167,Boyd2837_T,"-37.82590962, 144.96185972"
1431220240908,143,2024-09-08,12,122,213,335,Spencer_T,"-37.821728, 144.95557015"
85020231202,85,2023-12-02,0,9,18,27,488Mac_T,"-37.79432415, 144.92973378"
851320240623,85,2024-06-23,13,80,89,169,488Mac_T,"-37.79432415, 144.92973378"
171620231023,17,2023-10-23,16,172,366,538,Col15_T,"-37.81362543, 144.97323591"
862020241025,86,2024-10-25,20,32,52,84,574Qub_T,"-37.80309992, 144.94908064"
111320240414,11,2024-04-14,13,117,137,254,WatCit_T,"-37.81564989, 144.93970694"
622320250806,62,2025-08-06,23,71,73,144,Lat224_T,"-37.80996494, 144.96216521"
861320250622,86,2025-06-22,13,56,51,107,574Qub_T,"-37.80309992, 144.94908064"
86220241211,86,2024-12-11,2,0,3,3,574Qub_T,"-37.80309992, 144.94908064"
121920241028,12,2024-10-28,19,183,197,380,NewQ_T,"-37.81457988, 144.94292398"
12920241129,12,2024-11-29,9,140,105,245,NewQ_T,"-37.81457988, 144.94292398"
242020240807,24,2024-08-07,20,234,474,708,Col620_T,"-37.81887963, 144.95449198"
722220241003,72,2024-10-03,22,81,147,228,ACMI_T,"-37.81726338, 144.96872809"
582020240917,58,2024-09-17,20,247,267,514,Bou688_T,"-37.81686075, 144.95358075"
58820250301,58,2025-03-01,8,287,101,388,Bou688_T,"-37.81686075, 144.95358075"
532120240818,53,2024-08-18,21,60,144,204,Col254_T,"-37.81564191, 144.965499"
301520240228,30,2024-02-28,15,177,344,521,Lon189_T,"-37.8112185, 144.96656806"
231020241110,23,2024-11-10,10,165,161,326,Col623_T,"-37.81909256, 144.95452748"
231820231021,23,2023-10-21,18,144,295,439,Col623_T,"-37.81909256, 144.95452748"
23220231105,23,2023-11-05,2,23,42,65,Col623_T,"-37.81909256, 144.95452748"
301420250429,30,2025-04-29,14,162,280,442,Lon189_T,"-37.8112185, 144.96656806"
48020240220,48,2024-02-20,0,6,19,25,QVMQ_T,"-37.80631581, 144.95866697"
1421820240101,142,2024-01-01,18,517,368,885,Hammer1584_T,"-37.81970749, 144.96795734"
130820250306,130,2025-03-06,8,17,12,29,Bou892T,"-37.8204637, 144.94126826"
1611020250831,161,2025-08-31,10,193,123,316,BirArt1109_T,"-37.81851276, 144.97131336"
1381320241023,138,2024-10-23,13,17,15,32,EntPark1671_T,"-37.81996544, 144.95981454"
1172020250924,117,2025-09-24,20,105,70,175,Fli114F_T,"-37.81629332, 144.97090877"
1231720240304,123,2024-03-04,17,25,28,53,BirBridge_T,"-37.81753741, 144.97329734"
141720240528,141,2024-05-28,7,43,38,81,474Fl_T,"-37.81997273, 144.95834911"
191720250427,19,2025-04-27,17,630,369,999,LtB210_T,"-37.81237202, 144.96550671"
191520231206,19,2023-12-06,15,361,538,899,LtB210_T,"-37.81237202, 144.96550671"
1802020250523,180,2025-05-23,20,3,5,8,Mac330_T,"-37.79497059, 144.93530329"
6920240308,6,2024-03-08,9,576,749,1325,FliS_T,"-37.81911705, 144.96558255"
84120250531,84,2025-05-31,1,102,156,258,ElFi_T,"-37.81798049, 144.96503383"
4320240731,4,2024-07-31,3,7,5,12,Swa123_T,"-37.81487988, 144.9660878"
41220250402,4,2025-04-02,12,2263,1403,3666,Swa123_T,"-37.81487988, 144.9660878"
751120240202,75,2024-02-02,11,49,66,115,SprFli_T,"-37.81515276, 144.97467661"
8820240701,8,2024-07-01,8,259,191,450,WebBN_T,"-37.82293543, 144.9471751"
78720250705,78,2025-07-05,7,16,24,40,HarEsB_T,"-37.81471642, 144.9446508"
771920231101,77,2023-11-01,19,207,152,359,HarEsP_T,"-37.81441438, 144.94433026"
78620250115,78,2025-01-15,6,10,16,26,HarEsB_T,"-37.81471642, 144.9446508"
281020240512,28,2024-05-12,10,804,522,1326,VAC_T,"-37.82129925, 144.96879309"
28920240705,28,2024-07-05,9,461,165,626,VAC_T,"-37.82129925, 144.96879309"
29320240919,29,2024-09-19,3,0,1,1,AG_T,"-37.8199817, 144.96872865"
281720250731,28,2025-07-31,17,424,869,1293,VAC_T,"-37.82129925, 144.96879309"
401620250514,40,2025-05-14,16,267,274,541,Spr201_T,"-37.80999341, 144.97227587"
402020240501,40,2024-05-01,20,104,64,168,Spr201_T,"-37.80999341, 144.97227587"
5820250409,5,2025-04-09,8,73,160,233,PriNW_T,"-37.81874249, 144.96787656"
442220240723,44,2024-07-23,22,33,12,45,UM3_T,"-37.79698741, 144.96441306"
44920241217,44,2024-12-17,9,19,34,53,UM3_T,"-37.79698741, 144.96441306"
432020250126,43,2025-01-26,20,27,15,42,UM2_T,"-37.79844526, 144.96411782"
132420250601,132,2025-06-01,4,10,7,17,King335_T,"-37.81267639, 144.95386444"
133720250904,133,2025-09-04,7,572,357,929,Spen229_T,"-37.81531435, 144.95227769"
118220240721,118,2024-07-21,2,2,2,4,Fli114C_T,"-37.81632783, 144.97090512"
871020250811,87,2025-08-11,10,117,107,224,Errol23_T,"-37.80454949, 144.94921863"
872020240405,87,2024-04-05,20,117,94,211,Errol23_T,"-37.80454949, 144.94921863"
85420240724,85,2024-07-24,4,1,0,1,488Mac_T,"-37.79432415, 144.92973378"
181520250730,18,2025-07-30,15,346,131,477,Col12_T,"-37.81344862, 144.97305353"
631620251005,63,2025-10-05,16,415,404,819,Bou231_T,"-37.81333081, 144.96675571"
111420231109,11,2023-11-09,14,107,75,182,WatCit_T,"-37.81564989, 144.93970694"
561620240621,56,2024-06-21,16,348,313,661,Lon364_T,"-37.81234775, 144.96153311"
121120240502,12,2024-05-02,11,77,75,152,NewQ_T,"-37.81457988, 144.94292398"
101020241102,10,2024-11-02,10,54,34,88,BouHbr_T,"-37.81876474, 144.94710545"
58520240215,58,2024-02-15,5,93,38,131,Bou688_T,"-37.81686075, 144.95358075"
351020250721,35,2025-07-21,10,556,474,1030,SouthB_T,"-37.82018685, 144.96508508"
561920250512,56,2025-05-12,19,322,341,663,Lon364_T,"-37.81234775, 144.96153311"
53120231203,53,2023-12-03,1,24,26,50,Col254_T,"-37.81564191, 144.965499"
271320240927,27,2024-09-27,13,193,172,365,Vic_T,"-37.80606888, 144.95644692"
271420241208,27,2024-12-08,14,239,173,412,Vic_T,"-37.80606888, 144.95644692"
27020240307,27,2024-03-07,0,27,2,29,Vic_T,"-37.80606888, 144.95644692"
301020240726,30,2024-07-26,10,90,173,263,Lon189_T,"-37.8112185, 144.96656806"
30620240212,30,2024-02-12,6,16,22,38,Lon189_T,"-37.8112185, 144.96656806"
143320240923,143,2024-09-23,3,17,6,23,Spencer_T,"-37.821728, 144.95557015"
1312220231023,131,2023-10-23,22,49,24,73,King2_T,"-37.82009057, 144.95758725"
1312220240406,131,2024-04-06,22,231,116,347,King2_T,"-37.82009057, 144.95758725"
1351720231018,135,2023-10-18,17,583,506,1089,Spen161_T,"-37.8172861, 144.95319102"
1352120240927,135,2024-09-27,21,163,182,345,Spen161_T,"-37.8172861, 144.95319102"
135820250712,135,2025-07-12,8,148,224,372,Spen161_T,"-37.8172861, 144.95319102"
1071420250327,107,2025-03-27,14,188,163,351,280Will_T,"-37.81246271, 144.95690188"
69920240404,69,2024-04-04,9,148,73,221,FLDegC_T,"-37.81687226, 144.96559144"
692220250506,69,2025-05-06,22,8,14,22,FLDegC_T,"-37.81687226, 144.96559144"
84020240522,84,2024-05-22,0,66,48,114,ElFi_T,"-37.81798049, 144.96503383"
841520250515,84,2025-05-15,15,899,1333,2232,ElFi_T,"-37.81798049, 144.96503383"
4120240307,4,2024-03-07,1,52,29,81,Swa123_T,"-37.81487988, 144.9660878"
701120240430,70,2024-04-30,11,87,95,182,Errol20_T,"-37.80456984, 144.94946228"
75120241002,75,2024-10-02,1,2,0,2,SprFli_T,"-37.81515276, 144.97467661"
752320250719,75,2025-07-19,23,34,11,45,SprFli_T,"-37.81515276, 144.97467661"
41320240814,41,2024-08-14,3,9,9,18,Swa31,"-37.81668634, 144.96689733"
422220241214,42,2024-12-14,22,22,18,40,UM1_T,"-37.80008566, 144.96386412"
711820240812,71,2024-08-12,18,22,19,41,WestWP_T,"-37.81235775, 144.97136962"
712220240823,71,2024-08-23,22,3,2,5,WestWP_T,"-37.81235775, 144.97136962"
591520240111,59,2024-01-11,15,363,537,900,RMIT_T,"-37.80825648, 144.96304859"
54820231226,54,2023-12-26,8,10,21,31,Swa607_T,"-37.804024, 144.96308399"
311820251013,31,2025-10-13,18,192,141,333,Lyg161_T,"-37.80169681, 144.96658911"
362020240322,36,2024-03-22,20,244,216,460,Que85_T,"-37.81652527, 144.96121062"
36520250716,36,2025-07-16,5,14,7,21,Que85_T,"-37.81652527, 144.96121062"
44720240411,44,2024-04-11,7,30,42,72,UM3_T,"-37.79698741, 144.96441306"
1082320250814,108,2025-08-14,23,61,65,126,261Will_T,"-37.81295822, 144.95678789"
1181720240809,118,2024-08-09,17,21,27,48,Fli114C_T,"-37.81632783, 144.97090512"
108120240208,108,2024-02-08,1,14,15,29,261Will_T,"-37.81295822, 144.95678789"
140820250617,140,2025-06-17,8,150,21,171,Boyd2837_T,"-37.82590962, 144.96185972"
132320250123,132,2025-01-23,3,1,7,8,King335_T,"-37.81267639, 144.95386444"
1351620240709,135,2024-07-09,16,211,243,454,Spen161_T,"-37.8172861, 144.95319102"
852120251001,85,2025-10-01,21,12,21,33,488Mac_T,"-37.79432415, 144.92973378"
17720250708,17,2025-07-08,7,380,97,477,Col15_T,"-37.81362543, 144.97323591"
68120250604,68,2025-06-04,1,1,1,2,FLDegN_T,"-37.8168479, 144.96559789"
181120251005,18,2025-10-05,11,55,61,116,Col12_T,"-37.81344862, 144.97305353"
12420231115,12,2023-11-15,4,3,4,7,NewQ_T,"-37.81457988, 144.94292398"
24820241120,24,2024-11-20,8,2335,356,2691,Col620_T,"-37.81887963, 144.95449198"
101520240805,10,2024-08-05,15,100,31,131,BouHbr_T,"-37.81876474, 144.94710545"
35220231018,35,2023-10-18,2,10,9,19,SouthB_T,"-37.82018685, 144.96508508"
2220240207,2,2024-02-07,2,1,6,7,Bou283_T,"-37.81380668, 144.96516718"
53520240720,53,2024-07-20,5,3,1,4,Col254_T,"-37.81564191, 144.965499"
302020250406,30,2025-04-06,20,210,405,615,Lon189_T,"-37.8112185, 144.96656806"
20120231203,20,2023-12-03,1,163,219,382,LtB170_T,"-37.81172914, 144.9682466"
52520241125,52,2024-11-25,5,5,5,10,Eli263_T,"-37.81252157, 144.9619401"
46820250714,46,2025-07-14,8,52,41,93,Pel147_T,"-37.80240719, 144.9615673"
511520250730,51,2025-07-30,15,85,86,171,Fra118_T,"-37.80841815, 144.95906316"
231720240813,23,2024-08-13,17,348,899,1247,Col623_T,"-37.81909256, 144.95452748"
232220240903,23,2024-09-03,22,40,106,146,Col623_T,"-37.81909256, 144.95452748"
23520241010,23,2024-10-10,5,30,16,46,Col623_T,"-37.81909256, 144.95452748"
491020231109,49,2023-11-09,10,146,195,341,Eli501_T,"-37.80730068, 144.95956055"
1621420241010,162,2024-10-10,14,456,703,1159,Eli489_T,"-37.80740397, 144.95987909"
1431520240910,143,2024-09-10,15,198,199,397,Spencer_T,"-37.821728, 144.95557015"
1341720240916,134,2024-09-16,17,680,513,1193,Spen201_T,"-37.81694221, 144.95303935"
135520250710,135,2025-07-10,5,13,27,40,Spen161_T,"-37.8172861, 144.95319102"
133620231024,133,2023-10-24,6,411,207,618,Spen229_T,"-37.81531435, 144.95227769"
1181820250421,118,2025-04-21,18,60,13,73,Fli114C_T,"-37.81632783, 144.97090512"
108720240303,108,2024-03-03,7,29,36,65,261Will_T,"-37.81295822, 144.95678789"
166020250205,166,2025-02-05,0,1,0,1,Spen484_T,"-37.80896733, 144.94931703"
682220240203,68,2024-02-03,22,87,35,122,FLDegN_T,"-37.8168479, 144.96559789"
85820241202,85,2024-12-02,8,134,54,188,488Mac_T,"-37.79432415, 144.92973378"
172020231020,17,2023-10-20,20,156,124,280,Col15_T,"-37.81362543, 144.97323591"
172320240711,17,2024-07-11,23,28,26,54,Col15_T,"-37.81362543, 144.97323591"
171920250109,17,2025-01-09,19,100,167,267,Col15_T,"-37.81362543, 144.97323591"
171420250922,17,2025-09-22,14,299,305,604,Col15_T,"-37.81362543, 144.97323591"
67020240913,67,2024-09-13,0,10,50,60,FLDegS_T,"-37.81688755, 144.96562569"
67020240611,67,2024-06-11,0,2,17,19,FLDegS_T,"-37.81688755, 144.96562569"
122020250721,12,2025-07-21,20,38,45,83,NewQ_T,"-37.81457988, 144.94292398"
72420241018,72,2024-10-18,4,9,8,17,ACMI_T,"-37.81726338, 144.96872809"
721820240620,72,2024-06-20,18,170,441,611,ACMI_T,"-37.81726338, 144.96872809"
721420240726,72,2024-07-26,14,222,344,566,ACMI_T,"-37.81726338, 144.96872809"
581520250613,58,2025-06-13,15,609,505,1114,Bou688_T,"-37.81686075, 144.95358075"
581120250906,58,2025-09-06,11,715,153,868,Bou688_T,"-37.81686075, 144.95358075"
9420240601,9,2024-06-01,4,3,4,7,Col700_T,"-37.81982992, 144.95102555"
9020231209,9,2023-12-09,0,35,30,65,Col700_T,"-37.81982992, 144.95102555"
46320231105,46,2023-11-05,3,2,1,3,Pel147_T,"-37.80240719, 144.9615673"
201720240227,20,2024-02-27,17,227,211,438,LtB170_T,"-37.81172914, 144.9682466"
461720250120,46,2025-01-20,17,49,59,108,Pel147_T,"-37.80240719, 144.9615673"
1801720250423,180,2025-04-23,17,42,85,127,Mac330_T,"-37.79497059, 144.93530329"
1371720250930,137,2025-09-30,17,15,187,202,BouHbr2353_T,"-37.81894815, 144.94612292"
1421420250318,142,2025-03-18,14,476,414,890,Hammer1584_T,"-37.81970749, 144.96795734"
117920241118,117,2024-11-18,9,154,130,284,Fli114F_T,"-37.81629332, 144.97090877"
117320250211,117,2025-02-11,3,4,1,5,Fli114F_T,"-37.81629332, 144.97090877"
49020240124,49,2024-01-24,0,73,56,129,Eli501_T,"-37.80730068, 144.95956055"
6220231231,6,2023-12-31,2,96,46,142,FliS_T,"-37.81911705, 144.96558255"
841120231120,84,2023-11-20,11,808,752,1560,ElFi_T,"-37.81798049, 144.96503383"
84820231204,84,2023-12-04,8,1328,398,1726,ElFi_T,"-37.81798049, 144.96503383"
6020250702,6,2025-07-02,0,38,41,79,FliS_T,"-37.81911705, 144.96558255"
4020241212,4,2024-12-12,0,76,124,200,Swa123_T,"-37.81487988, 144.9660878"
3420250820,3,2025-08-20,4,19,14,33,Swa295_T,"-37.81101524, 144.96429485"
751820240705,75,2024-07-05,18,42,205,247,SprFli_T,"-37.81515276, 144.97467661"
652320231210,65,2023-12-10,23,147,118,265,SwaCs_T,"-37.81569416, 144.9668064"
14520240104,14,2024-01-04,5,41,41,82,SanBri_T,"-37.82011242, 144.96291897"
542320250502,54,2025-05-02,23,67,71,138,Swa607_T,"-37.804024, 144.96308399"
52220240503,5,2024-05-03,22,579,1261,1840,PriNW_T,"-37.81874249, 144.96787656"
361320250211,36,2025-02-11,13,305,336,641,Que85_T,"-37.81652527, 144.96121062"
371220240229,37,2024-02-29,12,136,140,276,Lyg260_T,"-37.80107122, 144.96704554"
442320240811,44,2024-08-11,23,12,3,15,UM3_T,"-37.79698741, 144.96441306"
1622120250630,162,2025-06-30,21,21,41,62,Eli489_T,"-37.80740397, 144.95987909"
19520241203,19,2024-12-03,5,10,4,14,LtB210_T,"-37.81237202, 144.96550671"
191320241113,19,2024-11-13,13,371,366,737,LtB210_T,"-37.81237202, 144.96550671"
139920240228,139,2024-02-28,9,16,109,125,Signal1647_T,"-37.81959923, 144.9632832"
1421020250129,142,2025-01-29,10,240,180,420,Hammer1584_T,"-37.81970749, 144.96795734"
692220250227,69,2025-02-27,22,8,6,14,FLDegC_T,"-37.81687226, 144.96559144"
841820240714,84,2024-07-14,18,748,936,1684,ElFi_T,"-37.81798049, 144.96503383"
4520231114,4,2023-11-14,5,37,25,62,Swa123_T,"-37.81487988, 144.9660878"
41020240813,4,2024-08-13,10,703,495,1198,Swa123_T,"-37.81487988, 144.9660878"
8020250518,8,2025-05-18,0,1,1,2,WebBN_T,"-37.82293543, 144.9471751"
75820241211,75,2024-12-11,8,75,68,143,SprFli_T,"-37.81515276, 144.97467661"
752020250725,75,2025-07-25,20,9,10,19,SprFli_T,"-37.81515276, 144.97467661"
772120250220,77,2025-02-20,21,152,84,236,HarEsP_T,"-37.81441438, 144.94433026"
782020240706,78,2024-07-06,20,9,10,19,HarEsB_T,"-37.81471642, 144.9446508"
281220240409,28,2024-04-09,12,548,548,1096,VAC_T,"-37.82129925, 144.96879309"
292220231027,29,2023-10-27,22,59,141,200,AG_T,"-37.8199817, 144.96872865"
14720251014,14,2025-10-14,7,191,258,449,SanBri_T,"-37.82011242, 144.96291897"
542120250404,54,2025-04-04,21,184,188,372,Swa607_T,"-37.804024, 144.96308399"
541320250407,54,2025-04-07,13,59,65,124,Swa607_T,"-37.804024, 144.96308399"
542020240405,54,2024-04-05,20,128,143,271,Swa607_T,"-37.804024, 144.96308399"
471120240405,47,2024-04-05,11,556,734,1290,Eli250_T,"-37.81258467, 144.9625775"
211720241013,21,2024-10-13,17,359,306,665,Bourke155_T,"-37.81267313, 144.96788288"
118120231110,118,2023-11-10,1,0,3,3,Fli114C_T,"-37.81632783, 144.97090512"
872320241003,87,2024-10-03,23,6,14,20,Errol23_T,"-37.80454949, 144.94921863"
1082220231210,108,2023-12-10,22,49,57,106,261Will_T,"-37.81295822, 144.95678789"
61820240203,61,2024-02-03,8,83,176,259,RMIT14_T,"-37.80767455, 144.96309114"
502120251002,50,2025-10-02,21,118,67,185,Lyg309_T,"-37.79808192, 144.96721013"
441220250407,44,2025-04-07,12,113,110,223,UM3_T,"-37.79698741, 144.96441306"
118620241018,118,2024-10-18,6,4,0,4,Fli114C_T,"-37.81632783, 144.97090512"
85520240125,85,2024-01-25,5,4,3,7,488Mac_T,"-37.79432415, 144.92973378"
171720240228,17,2024-02-28,17,272,723,995,Col15_T,"-37.81362543, 144.97323591"
1320240701,1,2024-07-01,3,4,5,9,Bou292_T,"-37.81349441, 144.96515323"
632020240603,63,2024-06-03,20,86,153,239,Bou231_T,"-37.81333081, 144.96675571"
562120240722,56,2024-07-22,21,146,271,417,Lon364_T,"-37.81234775, 144.96153311"
862320240521,86,2024-05-21,23,2,8,10,574Qub_T,"-37.80309992, 144.94908064"
121220250214,12,2025-02-14,12,123,191,314,NewQ_T,"-37.81457988, 144.94292398"
242020250316,24,2025-03-16,20,470,365,835,Col620_T,"-37.81887963, 144.95449198"
72520240412,72,2024-04-12,5,9,16,25,ACMI_T,"-37.81726338, 144.96872809"
102020250301,10,2025-03-01,20,76,63,139,BouHbr_T,"-37.81876474, 144.94710545"
76220250701,76,2025-07-01,2,0,1,1,KenMac_T,"-37.79453803, 144.93036194"
721520250102,72,2025-01-02,15,412,666,1078,ACMI_T,"-37.81726338, 144.96872809"
35020241006,35,2024-10-06,0,305,362,667,SouthB_T,"-37.82018685, 144.96508508"
35920240818,35,2024-08-18,9,750,515,1265,SouthB_T,"-37.82018685, 144.96508508"
351020240116,35,2024-01-16,10,1235,627,1862,SouthB_T,"-37.82018685, 144.96508508"
582120231109,58,2023-11-09,21,261,276,537,Bou688_T,"-37.81686075, 144.95358075"
272220240709,27,2024-07-09,22,31,20,51,Vic_T,"-37.80606888, 144.95644692"
272020241115,27,2024-11-15,20,123,91,214,Vic_T,"-37.80606888, 144.95644692"
532120250810,53,2025-08-10,21,55,154,209,Col254_T,"-37.81564191, 144.965499"
9020250110,9,2025-01-10,0,7,18,25,Col700_T,"-37.81982992, 144.95102555"
532320241001,53,2024-10-01,23,20,29,49,Col254_T,"-37.81564191, 144.965499"
791820240703,79,2024-07-03,18,529,454,983,FliSS_T,"-37.81794046, 144.96616678"
79020240913,79,2024-09-13,0,99,113,212,FliSS_T,"-37.81794046, 144.96616678"
791320250911,79,2025-09-11,13,437,324,761,FliSS_T,"-37.81794046, 144.96616678"
791920250409,79,2025-04-09,19,338,388,726,FliSS_T,"-37.81794046, 144.96616678"
30220240314,30,2024-03-14,2,43,52,95,Lon189_T,"-37.8112185, 144.96656806"
251520240629,25,2024-06-29,15,702,693,1395,MCEC_T,"-37.82401776, 144.95604426"
117620250223,117,2025-02-23,6,10,5,15,Fli114F_T,"-37.81629332, 144.97090877"
1171020250915,117,2025-09-15,10,109,122,231,Fli114F_T,"-37.81629332, 144.97090877"
109820250923,109,2025-09-23,8,148,511,659,LatWill_T,"-37.81193681, 144.95621105"
19720250415,19,2025-04-15,7,20,16,36,LtB210_T,"-37.81237202, 144.96550671"
180820251009,180,2025-10-09,8,111,37,148,Mac330_T,"-37.79497059, 144.93530329"
1371920240710,137,2024-07-10,19,1,7,8,BouHbr2353_T,"-37.81894815, 144.94612292"
1392120250629,139,2025-06-29,21,1,4,5,Signal1647_T,"-37.81959923, 144.9632832"
1361920241115,136,2024-11-15,19,69,61,130,BirFed1120_T,"-37.8184141, 144.97357915"
661620240630,66,2024-06-30,16,1252,1442,2694,QVN_T,"-37.81057846, 144.96444294"
391120240724,39,2024-07-24,11,98,70,168,AlfPl_T,"-37.81379749, 144.96995745"
751020250726,75,2025-07-26,10,46,47,93,SprFli_T,"-37.81515276, 144.97467661"
751720250728,75,2025-07-28,17,44,36,80,SprFli_T,"-37.81515276, 144.97467661"
81320240803,8,2024-08-03,13,225,217,442,WebBN_T,"-37.82293543, 144.9471751"
751420240920,75,2024-09-20,14,46,52,98,SprFli_T,"-37.81515276, 144.97467661"
751720241107,75,2024-11-07,17,80,53,133,SprFli_T,"-37.81515276, 144.97467661"
712020241021,71,2024-10-21,20,2,6,8,WestWP_T,"-37.81235775, 144.97136962"
28820240927,28,2024-09-27,8,140,108,248,VAC_T,"-37.82129925, 144.96879309"
29720240621,29,2024-06-21,7,80,88,168,AG_T,"-37.8199817, 144.96872865"
291420240301,29,2024-03-01,14,183,215,398,AG_T,"-37.8199817, 144.96872865"
141720240628,14,2024-06-28,17,654,211,865,SanBri_T,"-37.82011242, 144.96291897"
542020240808,54,2024-08-08,20,119,192,311,Swa607_T,"-37.804024, 144.96308399"
371020241012,37,2024-10-12,10,63,68,131,Lyg260_T,"-37.80107122, 144.96704554"
442220240402,44,2024-04-02,22,15,12,27,UM3_T,"-37.79698741, 144.96441306"
451020240715,45,2024-07-15,10,350,290,640,Swa148_T,"-37.81414075, 144.96609379"
451720240717,45,2024-07-17,17,820,775,1595,Swa148_T,"-37.81414075, 144.96609379"
5720240711,5,2024-07-11,7,121,403,524,PriNW_T,"-37.81874249, 144.96787656"
52020241225,5,2024-12-25,20,1688,3863,5551,PriNW_T,"-37.81874249, 144.96787656"
21820240922,21,2024-09-22,8,53,26,79,Bourke155_T,"-37.81267313, 144.96788288"
212220250517,21,2025-05-17,22,315,340,655,Bourke155_T,"-37.81267313, 144.96788288"
872020241112,87,2024-11-12,20,57,55,112,Errol23_T,"-37.80454949, 144.94921863"
61020240704,61,2024-07-04,0,21,17,38,RMIT14_T,"-37.80767455, 144.96309114"
1841320250908,184,2025-09-08,13,996,1172,2168,Eli124_T,"-37.81512416, 144.96371988"
302020250221,30,2025-02-21,20,371,546,917,Lon189_T,"-37.8112185, 144.96656806"
25220250421,25,2025-04-21,2,9,16,25,MCEC_T,"-37.82401776, 144.95604426"
251320250610,25,2025-06-10,13,449,459,908,MCEC_T,"-37.82401776, 144.95604426"
302320250829,30,2025-08-29,23,324,367,691,Lon189_T,"-37.8112185, 144.96656806"
201320250604,20,2025-06-04,13,267,286,553,LtB170_T,"-37.81172914, 144.9682466"
25120240404,25,2024-04-04,1,24,22,46,MCEC_T,"-37.82401776, 144.95604426"
1361620241129,136,2024-11-29,16,157,44,201,BirFed1120_T,"-37.8184141, 144.97357915"
142120231124,142,2023-11-24,1,9,10,19,Hammer1584_T,"-37.81970749, 144.96795734"
1421720240815,142,2024-08-15,17,438,375,813,Hammer1584_T,"-37.81970749, 144.96795734"
1611520240921,161,2024-09-21,15,3435,271,3706,BirArt1109_T,"-37.81851276, 144.97131336"
1611020250114,161,2025-01-14,10,3801,86,3887,BirArt1109_T,"-37.81851276, 144.97131336"
49320250109,49,2025-01-09,3,28,13,41,Eli501_T,"-37.80730068, 144.95956055"
491620250902,49,2025-09-02,16,186,237,423,Eli501_T,"-37.80730068, 144.95956055"
1231220250206,123,2025-02-06,12,32,33,65,BirBridge_T,"-37.81753741, 144.97329734"
137820240109,137,2024-01-09,8,121,16,137,BouHbr2353_T,"-37.81894815, 144.94612292"
84320250704,84,2025-07-04,3,18,11,29,ElFi_T,"-37.81798049, 144.96503383"
701420250821,70,2025-08-21,14,122,102,224,Errol20_T,"-37.80456984, 144.94946228"
391620250522,39,2025-05-22,16,83,52,135,AlfPl_T,"-37.81379749, 144.96995745"
81620250710,8,2025-07-10,16,219,305,524,WebBN_T,"-37.82293543, 144.9471751"
782020250927,78,2025-09-27,20,4,8,12,HarEsB_T,"-37.81471642, 144.9446508"
77320240908,77,2024-09-08,3,5,0,5,HarEsP_T,"-37.81441438, 144.94433026"
78320240503,78,2024-05-03,3,1,0,1,HarEsB_T,"-37.81471642, 144.9446508"
142120231220,14,2023-12-20,21,940,563,1503,SanBri_T,"-37.82011242, 144.96291897"
71920240801,71,2024-08-01,9,28,18,46,WestWP_T,"-37.81235775, 144.97136962"
65920240520,65,2024-05-20,9,321,174,495,SwaCs_T,"-37.81569416, 144.9668064"
291020241201,29,2024-12-01,10,230,239,469,AG_T,"-37.8199817, 144.96872865"
31620250714,31,2025-07-14,6,6,6,12,Lyg161_T,"-37.80169681, 144.96658911"
281820240110,28,2024-01-10,18,574,652,1226,VAC_T,"-37.82129925, 144.96879309"
47720231222,47,2023-12-22,7,96,203,299,Eli250_T,"-37.81258467, 144.9625775"
47420240305,47,2024-03-05,4,13,30,43,Eli250_T,"-37.81258467, 144.9625775"
471920241114,47,2024-11-14,19,751,673,1424,Eli250_T,"-37.81258467, 144.9625775"
401320240305,40,2024-03-05,13,480,319,799,Spr201_T,"-37.80999341, 144.97227587"
401920240524,40,2024-05-24,19,179,261,440,Spr201_T,"-37.80999341, 144.97227587"
40920250926,40,2025-09-26,9,68,89,157,Spr201_T,"-37.80999341, 144.97227587"
51120250610,5,2025-06-10,11,572,778,1350,PriNW_T,"-37.81874249, 144.96787656"
51320251005,5,2025-10-05,13,1200,2130,3330,PriNW_T,"-37.81874249, 144.96787656"
211920240125,21,2024-01-25,19,435,462,897,Bourke155_T,"-37.81267313, 144.96788288"
371020241107,37,2024-11-07,10,57,52,109,Lyg260_T,"-37.80107122, 144.96704554"
431220250803,43,2025-08-03,12,41,94,135,UM2_T,"-37.79844526, 144.96411782"
451920250728,45,2025-07-28,19,186,532,718,Swa148_T,"-37.81414075, 144.96609379"
1351120241019,135,2024-10-19,11,600,564,1164,Spen161_T,"-37.8172861, 144.95319102"
132420250808,132,2025-08-08,4,8,5,13,King335_T,"-37.81267639, 144.95386444"
1182320241012,118,2024-10-12,23,7,3,10,Fli114C_T,"-37.81632783, 144.97090512"
1241520231203,124,2023-12-03,15,1,2,3,BirBridge_T,"-37.81757416, 144.97329934"
107420241120,107,2024-11-20,4,3,4,7,280Will_T,"-37.81246271, 144.95690188"
1081020231122,108,2023-11-22,10,266,464,730,261Will_T,"-37.81295822, 144.95678789"
1081120240212,108,2024-02-12,11,132,85,217,261Will_T,"-37.81295822, 144.95678789"
871320240527,87,2024-05-27,13,139,128,267,Errol23_T,"-37.80454949, 144.94921863"
611620250704,61,2025-07-04,16,314,376,690,RMIT14_T,"-37.80767455, 144.96309114"
1651920250531,165,2025-05-31,19,30,23,53,Spen475_T,"-37.80953359, 144.94939004"
140720250520,140,2025-05-20,7,80,21,101,Boyd2837_T,"-37.82590962, 144.96185972"
1401520250101,140,2025-01-01,15,92,52,144,Boyd2837_T,"-37.82590962, 144.96185972"
132520240626,132,2024-06-26,5,8,3,11,King335_T,"-37.81267639, 144.95386444"
69820250420,69,2025-04-20,8,37,10,47,FLDegC_T,"-37.81687226, 144.96559144"
84720231210,84,2023-12-10,7,116,136,252,ElFi_T,"-37.81798049, 144.96503383"
84120240228,84,2024-02-28,1,57,63,120,ElFi_T,"-37.81798049, 144.96503383"
70820250325,70,2025-03-25,8,82,75,157,Errol20_T,"-37.80456984, 144.94946228"
70820241213,70,2024-12-13,8,71,72,143,Errol20_T,"-37.80456984, 144.94946228"
701520250629,70,2025-06-29,15,129,127,256,Errol20_T,"-37.80456984, 144.94946228"
162620240725,162,2024-07-25,6,40,15,55,Eli489_T,"-37.80740397, 144.95987909"
1351320250904,135,2025-09-04,13,317,424,741,Spen161_T,"-37.8172861, 144.95319102"
1072220240121,107,2024-01-21,22,50,48,98,280Will_T,"-37.81246271, 144.95690188"
1072220250423,107,2025-04-23,22,55,37,92,280Will_T,"-37.81246271, 144.95690188"
133720250126,133,2025-01-26,7,156,247,403,Spen229_T,"-37.81531435, 144.95227769"
165220250831,165,2025-08-31,2,4,1,5,Spen475_T,"-37.80953359, 144.94939004"
172220240511,17,2024-05-11,22,184,118,302,Col15_T,"-37.81362543, 144.97323591"
11120231106,1,2023-11-06,11,1110,1096,2206,Bou292_T,"-37.81349441, 144.96515323"
182220240104,18,2024-01-04,22,7,10,17,Col12_T,"-37.81344862, 144.97305353"
562220231024,56,2023-10-24,22,100,65,165,Lon364_T,"-37.81234775, 144.96153311"
11120250629,11,2025-06-29,1,4,7,11,WatCit_T,"-37.81564989, 144.93970694"
121320250628,12,2025-06-28,13,283,403,686,NewQ_T,"-37.81457988, 144.94292398"
722320250918,72,2025-09-18,23,14,41,55,ACMI_T,"-37.81726338, 144.96872809"
72720250330,72,2025-03-30,7,34,45,79,ACMI_T,"-37.81726338, 144.96872809"
72320240825,72,2024-08-25,3,1,13,14,ACMI_T,"-37.81726338, 144.96872809"
72220240118,72,2024-01-18,2,9,12,21,ACMI_T,"-37.81726338, 144.96872809"
2120250421,2,2025-04-21,1,14,25,39,Bou283_T,"-37.81380668, 144.96516718"
2420240105,2,2024-01-05,4,2,11,13,Bou283_T,"-37.81380668, 144.96516718"
562120251013,56,2025-10-13,21,181,245,426,Lon364_T,"-37.81234775, 144.96153311"
9820240829,9,2024-08-29,8,124,3447,3571,Col700_T,"-37.81982992, 144.95102555"
271520250724,27,2025-07-24,15,146,133,279,Vic_T,"-37.80606888, 144.95644692"
531620251012,53,2025-10-12,16,544,456,1000,Col254_T,"-37.81564191, 144.965499"
531820240308,53,2024-03-08,18,571,332,903,Col254_T,"-37.81564191, 144.965499"
511420240811,51,2024-08-11,14,161,199,360,Fra118_T,"-37.80841815, 144.95906316"
511420231122,51,2023-11-22,14,96,120,216,Fra118_T,"-37.80841815, 144.95906316"
23420240624,23,2024-06-24,4,5,8,13,Col623_T,"-37.81909256, 144.95452748"
23220240923,23,2024-09-23,2,9,5,14,Col623_T,"-37.81909256, 144.95452748"
301820250825,30,2025-08-25,18,300,399,699,Lon189_T,"-37.8112185, 144.96656806"
301420240904,30,2024-09-04,14,247,338,585,Lon189_T,"-37.8112185, 144.96656806"
25420250528,25,2025-05-28,4,9,6,15,MCEC_T,"-37.82401776, 144.95604426"
462220240324,46,2024-03-24,22,23,27,50,Pel147_T,"-37.80240719, 144.9615673"
46220240527,46,2024-05-27,2,2,0,2,Pel147_T,"-37.80240719, 144.9615673"
201820250617,20,2025-06-17,18,451,300,751,LtB170_T,"-37.81172914, 144.9682466"
20520250704,20,2025-07-04,5,4,8,12,LtB170_T,"-37.81172914, 144.9682466"
141920231118,141,2023-11-18,9,101,82,183,474Fl_T,"-37.81997273, 144.95834911"
1391820250405,139,2025-04-05,18,55,90,145,Signal1647_T,"-37.81959923, 144.9632832"
1381320241031,138,2024-10-31,13,12,3,15,EntPark1671_T,"-37.81996544, 144.95981454"
1611620240825,161,2024-08-25,16,50,75,125,BirArt1109_T,"-37.81851276, 144.97131336"
1171120231112,117,2023-11-12,11,104,201,305,Fli114F_T,"-37.81629332, 144.97090877"
117320240627,117,2024-06-27,3,8,0,8,Fli114F_T,"-37.81629332, 144.97090877"
66020250508,66,2025-05-08,0,63,42,105,QVN_T,"-37.81057846, 144.96444294"
6220240116,6,2024-01-16,2,22,18,40,FliS_T,"-37.81911705, 144.96558255"
62020241113,6,2024-11-13,20,757,585,1342,FliS_T,"-37.81911705, 144.96558255"
842120231226,84,2023-12-26,21,754,1109,1863,ElFi_T,"-37.81798049, 144.96503383"
4820240402,4,2024-04-02,8,419,250,669,Swa123_T,"-37.81487988, 144.9660878"
392220250510,39,2025-05-10,22,21,30,51,AlfPl_T,"-37.81379749, 144.96995745"
8020241226,8,2024-12-26,0,5,2,7,WebBN_T,"-37.82293543, 144.9471751"
391320231125,39,2023-11-25,13,88,64,152,AlfPl_T,"-37.81379749, 144.96995745"
751120250505,75,2025-05-05,11,44,47,91,SprFli_T,"-37.81515276, 144.97467661"
78120240526,78,2024-05-26,1,4,2,6,HarEsB_T,"-37.81471642, 144.9446508"
782220240920,78,2024-09-20,22,11,17,28,HarEsB_T,"-37.81471642, 144.9446508"
59120250411,59,2025-04-11,1,18,11,29,RMIT_T,"-37.80825648, 144.96304859"
141820240321,14,2024-03-21,18,852,187,1039,SanBri_T,"-37.82011242, 144.96291897"
281220240401,28,2024-04-01,12,1015,1046,2061,VAC_T,"-37.82129925, 144.96879309"
281220250927,28,2025-09-27,12,516,748,1264,VAC_T,"-37.82129925, 144.96879309"
401020240605,40,2024-06-05,10,274,276,550,Spr201_T,"-37.80999341, 144.97227587"
40820241013,40,2024-10-13,8,52,50,102,Spr201_T,"-37.80999341, 144.97227587"
5920250507,5,2025-05-07,9,312,708,1020,PriNW_T,"-37.81874249, 144.96787656"
361820250915,36,2025-09-15,18,130,106,236,Que85_T,"-37.81652527, 144.96121062"
50720240701,50,2024-07-01,7,10,21,31,Lyg309_T,"-37.79808192, 144.96721013"
44020250716,44,2025-07-16,0,2,0,2,UM3_T,"-37.79698741, 144.96441306"
502120250906,50,2025-09-06,21,311,132,443,Lyg309_T,"-37.79808192, 144.96721013"
44820240312,44,2024-03-12,8,29,14,43,UM3_T,"-37.79698741, 144.96441306"
1311420240302,131,2024-03-02,14,197,130,327,King2_T,"-37.82009057, 144.95758725"
1311020250102,131,2025-01-02,10,62,151,213,King2_T,"-37.82009057, 144.95758725"
1351420241013,135,2024-10-13,14,468,455,923,Spen161_T,"-37.8172861, 144.95319102"
135420250306,135,2025-03-06,4,21,10,31,Spen161_T,"-37.8172861, 144.95319102"
118020250521,118,2025-05-21,0,0,1,1,Fli114C_T,"-37.81632783, 144.97090512"
1241320231104,124,2023-11-04,13,0,2,2,BirBridge_T,"-37.81757416, 144.97329934"
1081820251006,108,2025-10-06,18,544,198,742,261Will_T,"-37.81295822, 144.95678789"
87920250503,87,2025-05-03,9,136,109,245,Errol23_T,"-37.80454949, 144.94921863"
61620241224,61,2024-12-24,6,16,39,55,RMIT14_T,"-37.80767455, 144.96309114"
1662120241231,166,2024-12-31,21,28,70,98,Spen484_T,"-37.80896733, 144.94931703"
1621420240708,162,2024-07-08,14,306,362,668,Eli489_T,"-37.80740397, 144.95987909"
1432020250326,143,2025-03-26,20,136,109,245,Spencer_T,"-37.821728, 144.95557015"
1341620250915,134,2025-09-15,16,412,421,833,Spen201_T,"-37.81694221, 144.95303935"
1341820240805,134,2024-08-05,18,445,399,844,Spen201_T,"-37.81694221, 144.95303935"
171520231129,17,2023-11-29,15,255,296,551,Col15_T,"-37.81362543, 144.97323591"
172120250724,17,2025-07-24,21,105,91,196,Col15_T,"-37.81362543, 144.97323591"
12320240603,1,2024-06-03,23,28,47,75,Bou292_T,"-37.81349441, 144.96515323"
11420241022,1,2024-10-22,14,1133,1027,2160,Bou292_T,"-37.81349441, 144.96515323"
63020240701,63,2024-07-01,0,20,38,58,Bou231_T,"-37.81333081, 144.96675571"
68820250826,68,2025-08-26,8,201,166,367,FLDegN_T,"-37.8168479, 144.96559789"
181620240306,18,2024-03-06,16,644,125,769,Col12_T,"-37.81344862, 144.97305353"
861820240816,86,2024-08-16,18,47,53,100,574Qub_T,"-37.80309992, 144.94908064"
11820240527,11,2024-05-27,8,34,37,71,WatCit_T,"-37.81564989, 144.93970694"
12820240120,12,2024-01-20,8,102,88,190,NewQ_T,"-37.81457988, 144.94292398"
101520250720,10,2025-07-20,15,41,15,56,BouHbr_T,"-37.81876474, 144.94710545"
24920240930,24,2024-09-30,9,996,361,1357,Col620_T,"-37.81887963, 144.95449198"
24620250701,24,2025-07-01,6,503,187,690,Col620_T,"-37.81887963, 144.95449198"
581920240622,58,2024-06-22,19,407,319,726,Bou688_T,"-37.81686075, 144.95358075"
58120250817,58,2025-08-17,1,70,91,161,Bou688_T,"-37.81686075, 144.95358075"
271220231118,27,2023-11-18,12,254,208,462,Vic_T,"-37.80606888, 144.95644692"
2820250125,2,2025-01-25,8,67,55,122,Bou283_T,"-37.81380668, 144.96516718"
9920250314,9,2025-03-14,9,134,1299,1433,Col700_T,"-37.81982992, 144.95102555"
9820240520,9,2024-05-20,8,94,2461,2555,Col700_T,"-37.81982992, 144.95102555"
271220240807,27,2024-08-07,12,134,103,237,Vic_T,"-37.80606888, 144.95644692"
301720240418,30,2024-04-18,17,426,555,981,Lon189_T,"-37.8112185, 144.96656806"
53620250220,53,2025-02-20,6,30,44,74,Col254_T,"-37.81564191, 144.965499"
232220240126,23,2024-01-26,22,60,112,172,Col623_T,"-37.81909256, 144.95452748"
231920240416,23,2024-04-16,19,117,229,346,Col623_T,"-37.81909256, 144.95452748"
1671220250207,167,2025-02-07,12,80,75,155,Lat526_T,"-37.81304149, 144.95155955"
167320250908,167,2025-09-08,3,0,3,3,Lat526_T,"-37.81304149, 144.95155955"
140620240213,140,2024-02-13,6,31,9,40,Boyd2837_T,"-37.82590962, 144.96185972"
1311120250530,131,2025-05-30,11,93,98,191,King2_T,"-37.82009057, 144.95758725"
1321120251012,132,2025-10-12,11,178,104,282,King335_T,"-37.81267639, 144.95386444"
133020250717,133,2025-07-17,0,39,23,62,Spen229_T,"-37.81531435, 144.95227769"
1351820240720,135,2024-07-20,18,113,95,208,Spen161_T,"-37.8172861, 144.95319102"
1351220240906,135,2024-09-06,12,520,597,1117,Spen161_T,"-37.8172861, 144.95319102"
133820240716,133,2024-07-16,8,493,547,1040,Spen229_T,"-37.81531435, 144.95227769"
1331120240916,133,2024-09-16,11,355,377,732,Spen229_T,"-37.81531435, 144.95227769"
681120251001,68,2025-10-01,11,377,328,705,FLDegN_T,"-37.8168479, 144.96559789"
852220250827,85,2025-08-27,22,6,8,14,488Mac_T,"-37.79432415, 144.92973378"
171620240513,17,2024-05-13,16,192,374,566,Col15_T,"-37.81362543, 144.97323591"
17820250124,17,2025-01-24,8,728,150,878,Col15_T,"-37.81362543, 144.97323591"
671120241107,67,2024-11-07,11,393,449,842,FLDegS_T,"-37.81688755, 144.96562569"
681820250831,68,2025-08-31,18,93,65,158,FLDegN_T,"-37.8168479, 144.96559789"
1020250730,1,2025-07-30,0,7,28,35,Bou292_T,"-37.81349441, 144.96515323"
861920240404,86,2024-04-04,19,48,63,111,574Qub_T,"-37.80309992, 144.94908064"
121520240104,12,2024-01-04,15,206,229,435,NewQ_T,"-37.81457988, 144.94292398"
241320250221,24,2025-02-21,13,745,882,1627,Col620_T,"-37.81887963, 144.95449198"
58620240201,58,2024-02-01,6,241,58,299,Bou688_T,"-37.81686075, 144.95358075"
352320250618,35,2025-06-18,23,87,71,158,SouthB_T,"-37.82018685, 144.96508508"
271320240203,27,2024-02-03,13,227,126,353,Vic_T,"-37.80606888, 144.95644692"
2720250730,2,2025-07-30,7,47,73,120,Bou283_T,"-37.81380668, 144.96516718"
58720250831,58,2025-08-31,7,101,53,154,Bou688_T,"-37.81686075, 144.95358075"
91220240925,9,2024-09-25,12,383,344,727,Col700_T,"-37.81982992, 144.95102555"
791520250504,79,2025-05-04,15,452,423,875,FliSS_T,"-37.81794046, 144.96616678"
461520240106,46,2024-01-06,15,31,42,73,Pel147_T,"-37.80240719, 144.9615673"
231220250109,23,2025-01-09,12,464,534,998,Col623_T,"-37.81909256, 144.95452748"
191520240817,19,2024-08-17,15,579,642,1221,LtB210_T,"-37.81237202, 144.96550671"
1801320250422,180,2025-04-22,13,30,36,66,Mac330_T,"-37.79497059, 144.93530329"
137620250303,137,2025-03-03,6,4,1,5,BouHbr2353_T,"-37.81894815, 144.94612292"
141020240917,141,2024-09-17,0,7,13,20,474Fl_T,"-37.81997273, 144.95834911"
1411720241125,141,2024-11-25,17,130,83,213,474Fl_T,"-37.81997273, 144.95834911"
1421720240720,142,2024-07-20,17,140,115,255,Hammer1584_T,"-37.81970749, 144.96795734"
1642120250524,164,2025-05-24,21,36,49,85,Lat526_T,"-37.813005, 144.95160411"
1641120240901,164,2024-09-01,11,88,49,137,Lat526_T,"-37.813005, 144.95160411"
138620241026,138,2024-10-26,6,0,1,1,EntPark1671_T,"-37.81996544, 144.95981454"
691020240418,69,2024-04-18,10,239,124,363,FLDegC_T,"-37.81687226, 144.96559144"
691620250518,69,2025-05-18,16,212,180,392,FLDegC_T,"-37.81687226, 144.96559144"
61120250318,6,2025-03-18,11,902,574,1476,FliS_T,"-37.81911705, 144.96558255"
841620250806,84,2025-08-06,16,868,1593,2461,ElFi_T,"-37.81798049, 144.96503383"
702120240814,70,2024-08-14,21,60,78,138,Errol20_T,"-37.80456984, 144.94946228"
701620250110,70,2025-01-10,16,143,132,275,Errol20_T,"-37.80456984, 144.94946228"
31120240818,3,2024-08-18,11,874,938,1812,Swa295_T,"-37.81101524, 144.96429485"
31520250707,3,2025-07-07,15,1157,1377,2534,Swa295_T,"-37.81101524, 144.96429485"
39820250822,39,2025-08-22,8,84,111,195,AlfPl_T,"-37.81379749, 144.96995745"
752020241104,75,2024-11-04,20,12,16,28,SprFli_T,"-37.81515276, 144.97467661"
41720240407,41,2024-04-07,7,243,169,412,Swa31,"-37.81668634, 144.96689733"
591020250316,59,2025-03-16,10,36,17,53,RMIT_T,"-37.80825648, 144.96304859"
421720251012,42,2025-10-12,17,65,118,183,UM1_T,"-37.80008566, 144.96386412"
29520250318,29,2025-03-18,5,16,44,60,AG_T,"-37.8199817, 144.96872865"
311520241101,31,2024-11-01,15,166,153,319,Lyg161_T,"-37.80169681, 144.96658911"
751020240914,75,2024-09-14,10,22,24,46,SprFli_T,"-37.81515276, 144.97467661"
77520250918,77,2025-09-18,5,4,12,16,HarEsP_T,"-37.81441438, 144.94433026"
711620251007,71,2025-10-07,16,10,6,16,WestWP_T,"-37.81235775, 144.97136962"
291520241206,29,2024-12-06,15,224,314,538,AG_T,"-37.8199817, 144.96872865"
471320240318,47,2024-03-18,13,894,871,1765,Eli250_T,"-37.81258467, 144.9625775"
40220250124,40,2025-01-24,2,9,2,11,Spr201_T,"-37.80999341, 144.97227587"
311520250626,31,2025-06-26,15,114,100,214,Lyg161_T,"-37.80169681, 144.96658911"
371820240717,37,2024-07-17,18,97,90,187,Lyg260_T,"-37.80107122, 144.96704554"
37620240130,37,2024-01-30,6,7,6,13,Lyg260_T,"-37.80107122, 144.96704554"
43520250418,43,2025-04-18,5,3,3,6,UM2_T,"-37.79844526, 144.96411782"
442320240906,44,2024-09-06,23,10,3,13,UM3_T,"-37.79698741, 144.96441306"
441020250430,44,2025-04-30,10,75,99,174,UM3_T,"-37.79698741, 144.96441306"
431520240210,43,2024-02-10,15,50,39,89,UM2_T,"-37.79844526, 144.96411782"
51820250922,5,2025-09-22,18,624,798,1422,PriNW_T,"-37.81874249, 144.96787656"
5220240523,5,2024-05-23,2,6,18,24,PriNW_T,"-37.81874249, 144.96787656"
1621620250927,162,2025-09-27,16,259,506,765,Eli489_T,"-37.80740397, 144.95987909"
108020250223,108,2025-02-23,0,83,79,162,261Will_T,"-37.81295822, 144.95678789"
1321620231029,132,2023-10-29,16,175,186,361,King335_T,"-37.81267639, 144.95386444"
133020231018,133,2023-10-18,0,28,12,40,Spen229_T,"-37.81531435, 144.95227769"
108020231123,108,2023-11-23,0,27,19,46,261Will_T,"-37.81295822, 144.95678789"
87420240731,87,2024-07-31,4,1,1,2,Errol23_T,"-37.80454949, 144.94921863"
1652320250605,165,2025-06-05,23,7,3,10,Spen475_T,"-37.80953359, 144.94939004"
67920241104,67,2024-11-04,9,433,334,767,FLDegS_T,"-37.81688755, 144.96562569"
12220250202,1,2025-02-02,22,61,80,141,Bou292_T,"-37.81349441, 144.96515323"
121220250802,12,2025-08-02,12,284,260,544,NewQ_T,"-37.81457988, 144.94292398"
56820251001,56,2025-10-01,8,122,132,254,Lon364_T,"-37.81234775, 144.96153311"
58020250713,58,2025-07-13,0,106,138,244,Bou688_T,"-37.81686075, 144.95358075"
21620240223,2,2024-02-23,16,769,848,1617,Bou283_T,"-37.81380668, 144.96516718"
27120250218,27,2025-02-18,1,34,21,55,Vic_T,"-37.80606888, 144.95644692"
79220240718,79,2024-07-18,2,7,8,15,FliSS_T,"-37.81794046, 144.96616678"
462020231127,46,2023-11-27,20,30,40,70,Pel147_T,"-37.80240719, 144.9615673"
521720231118,52,2023-11-18,17,372,527,899,Eli263_T,"-37.81252157, 144.9619401"
1361120250303,136,2025-03-03,11,101,114,215,BirFed1120_T,"-37.8184141, 144.97357915"
1231620241121,123,2024-11-21,16,9,1,10,BirBridge_T,"-37.81753741, 144.97329734"
109920240209,109,2024-02-09,9,92,253,345,LatWill_T,"-37.81193681, 144.95621105"
301220250114,30,2025-01-14,12,308,499,807,Lon189_T,"-37.8112185, 144.96656806"
462120241115,46,2024-11-15,21,1,1,2,Pel147_T,"-37.80240719, 144.9615673"
202220250110,20,2025-01-10,22,248,499,747,LtB170_T,"-37.81172914, 144.9682466"
1361620240414,136,2024-04-14,16,115,359,474,BirFed1120_T,"-37.8184141, 144.97357915"
142120250503,142,2025-05-03,1,4,1,5,Hammer1584_T,"-37.81970749, 144.96795734"
1611220250911,161,2025-09-11,12,149,140,289,BirArt1109_T,"-37.81851276, 144.97131336"
1381220250203,138,2025-02-03,12,2,2,4,EntPark1671_T,"-37.81996544, 144.95981454"
1612120241225,161,2024-12-25,21,14,30,44,BirArt1109_T,"-37.81851276, 144.97131336"
1171620241222,117,2024-12-22,16,177,143,320,Fli114F_T,"-37.81629332, 144.97090877"
1371320250228,137,2025-02-28,13,29,50,79,BouHbr2353_T,"-37.81894815, 144.94612292"
1371420240131,137,2024-01-31,14,27,59,86,BouHbr2353_T,"-37.81894815, 144.94612292"
691820240415,69,2024-04-15,18,46,39,85,FLDegC_T,"-37.81687226, 144.96559144"
69820250627,69,2025-06-27,8,210,68,278,FLDegC_T,"-37.81687226, 144.96559144"
6820240417,6,2024-04-17,8,957,2319,3276,FliS_T,"-37.81911705, 144.96558255"
70820240428,70,2024-04-28,8,47,32,79,Errol20_T,"-37.80456984, 144.94946228"
70820250116,70,2025-01-16,8,71,65,136,Errol20_T,"-37.80456984, 144.94946228"
39520231018,39,2023-10-18,5,11,12,23,AlfPl_T,"-37.81379749, 144.96995745"
751220250504,75,2025-05-04,12,54,72,126,SprFli_T,"-37.81515276, 144.97467661"
75720240422,75,2024-04-22,7,36,33,69,SprFli_T,"-37.81515276, 144.97467661"
411420231217,41,2023-12-17,14,2559,2302,4861,Swa31,"-37.81668634, 144.96689733"
411420240526,41,2024-05-26,14,1653,1710,3363,Swa31,"-37.81668634, 144.96689733"
651420240318,65,2024-03-18,14,306,461,767,SwaCs_T,"-37.81569416, 144.9668064"
591120240303,59,2024-03-03,11,402,441,843,RMIT_T,"-37.80825648, 144.96304859"
711720240526,71,2024-05-26,17,4,4,8,WestWP_T,"-37.81235775, 144.97136962"
14120240722,14,2024-07-22,1,7,1,8,SanBri_T,"-37.82011242, 144.96291897"
31320240210,31,2024-02-10,3,3,1,4,Lyg161_T,"-37.80169681, 144.96658911"
54020250629,54,2025-06-29,0,23,35,58,Swa607_T,"-37.804024, 144.96308399"
542020240102,54,2024-01-02,20,44,43,87,Swa607_T,"-37.804024, 144.96308399"
47020250317,47,2025-03-17,0,85,86,171,Eli250_T,"-37.81258467, 144.9625775"
401720231128,40,2023-11-28,17,175,297,472,Spr201_T,"-37.80999341, 144.97227587"
45520231220,45,2023-12-20,5,10,21,31,Swa148_T,"-37.81414075, 144.96609379"
451520240225,45,2024-02-25,15,535,1484,2019,Swa148_T,"-37.81414075, 144.96609379"
5520231207,5,2023-12-07,5,51,68,119,PriNW_T,"-37.81874249, 144.96787656"
5120240117,5,2024-01-17,1,37,58,95,PriNW_T,"-37.81874249, 144.96787656"
21720250221,21,2025-02-21,7,31,30,61,Bourke155_T,"-37.81267313, 144.96788288"
361420241124,36,2024-11-24,14,103,94,197,Que85_T,"-37.81652527, 144.96121062"
131820250528,131,2025-05-28,8,130,42,172,King2_T,"-37.82009057, 144.95758725"
135820240102,135,2024-01-02,8,179,212,391,Spen161_T,"-37.8172861, 144.95319102"
107920240815,107,2024-08-15,9,80,186,266,280Will_T,"-37.81246271, 144.95690188"
108520250228,108,2025-02-28,5,19,82,101,261Will_T,"-37.81295822, 144.95678789"
87620240609,87,2024-06-09,6,2,4,6,Errol23_T,"-37.80454949, 144.94921863"
871620240115,87,2024-01-15,16,62,88,150,Errol23_T,"-37.80454949, 144.94921863"
1662120241024,166,2024-10-24,21,7,7,14,Spen484_T,"-37.80896733, 144.94931703"
181120250430,181,2025-04-30,1,89,73,162,Eli368_T,"-37.81009465, 144.96143149"
1811220250619,181,2025-06-19,12,676,836,1512,Eli368_T,"-37.81009465, 144.96143149"
1621220250402,162,2025-04-02,12,568,611,1179,Eli489_T,"-37.80740397, 144.95987909"
134820240509,134,2024-05-09,8,236,366,602,Spen201_T,"-37.81694221, 144.95303935"
1342320240518,134,2024-05-18,23,134,115,249,Spen201_T,"-37.81694221, 144.95303935"
134720240912,134,2024-09-12,7,340,288,628,Spen201_T,"-37.81694221, 144.95303935"
671320241025,67,2024-10-25,13,540,637,1177,FLDegS_T,"-37.81688755, 144.96562569"
171620250523,17,2025-05-23,16,134,276,410,Col15_T,"-37.81362543, 144.97323591"
632120250602,63,2025-06-02,21,25,116,141,Bou231_T,"-37.81333081, 144.96675571"
67320240502,67,2024-05-02,3,5,4,9,FLDegS_T,"-37.81688755, 144.96562569"
671420250712,67,2025-07-12,14,581,756,1337,FLDegS_T,"-37.81688755, 144.96562569"
542020250707,54,2025-07-07,20,124,124,248,Swa607_T,"-37.804024, 144.96308399"
401620240816,40,2024-08-16,16,154,218,372,Spr201_T,"-37.80999341, 144.97227587"
40020240407,40,2024-04-07,0,61,23,84,Spr201_T,"-37.80999341, 144.97227587"
36020250901,36,2025-09-01,0,5,7,12,Que85_T,"-37.81652527, 144.96121062"
37720250729,37,2025-07-29,7,20,15,35,Lyg260_T,"-37.80107122, 144.96704554"
451420240323,45,2024-03-23,14,763,1259,2022,Swa148_T,"-37.81414075, 144.96609379"
1071220240523,107,2024-05-23,12,211,194,405,280Will_T,"-37.81246271, 144.95690188"
108620250902,108,2025-09-02,6,41,235,276,261Will_T,"-37.81295822, 144.95678789"
1182020240612,118,2024-06-12,20,3,7,10,Fli114C_T,"-37.81632783, 144.97090512"
50320240721,50,2024-07-21,3,4,1,5,Lyg309_T,"-37.79808192, 144.96721013"
43420250722,43,2025-07-22,4,2,2,4,UM2_T,"-37.79844526, 144.96411782"
431120231118,43,2023-11-18,11,53,52,105,UM2_T,"-37.79844526, 144.96411782"
1791220251002,179,2025-10-02,12,55,61,116,Pow61_T,"-37.82392385, 144.96299677"
1671220250612,167,2025-06-12,12,34,54,88,Lat526_T,"-37.81304149, 144.95155955"
1621020241226,162,2024-12-26,10,189,313,502,Eli489_T,"-37.80740397, 144.95987909"
1432120250506,143,2025-05-06,21,151,125,276,Spencer_T,"-37.821728, 144.95557015"
1331120250330,133,2025-03-30,11,403,487,890,Spen229_T,"-37.81531435, 144.95227769"
1181920250108,118,2025-01-08,19,39,5,44,Fli114C_T,"-37.81632783, 144.97090512"
851020250414,85,2025-04-14,10,80,78,158,488Mac_T,"-37.79432415, 144.92973378"
171620240109,17,2024-01-09,16,187,402,589,Col15_T,"-37.81362543, 144.97323591"
63920250210,63,2025-02-10,9,204,222,426,Bou231_T,"-37.81333081, 144.96675571"
11620250105,11,2025-01-05,6,20,18,38,WatCit_T,"-37.81564989, 144.93970694"
56420231118,56,2023-11-18,4,74,23,97,Lon364_T,"-37.81234775, 144.96153311"
861620241123,86,2024-11-23,16,49,50,99,574Qub_T,"-37.80309992, 144.94908064"
241520241104,24,2024-11-04,15,525,795,1320,Col620_T,"-37.81887963, 144.95449198"
562020250505,56,2025-05-05,20,227,293,520,Lon364_T,"-37.81234775, 144.96153311"
721620240429,72,2024-04-29,16,114,420,534,ACMI_T,"-37.81726338, 144.96872809"
58520250606,58,2025-06-06,5,72,24,96,Bou688_T,"-37.81686075, 144.95358075"
561420250919,56,2025-09-19,14,368,256,624,Lon364_T,"-37.81234775, 144.96153311"
58720240323,58,2024-03-23,7,143,100,243,Bou688_T,"-37.81686075, 144.95358075"
53820250822,53,2025-08-22,8,343,254,597,Col254_T,"-37.81564191, 144.965499"
9520250210,9,2025-02-10,5,11,25,36,Col700_T,"-37.81982992, 144.95102555"
532320231116,53,2023-11-16,23,65,102,167,Col254_T,"-37.81564191, 144.965499"
79620240623,79,2024-06-23,6,43,46,89,FliSS_T,"-37.81794046, 144.96616678"
301820231118,30,2023-11-18,18,553,496,1049,Lon189_T,"-37.8112185, 144.96656806"
251820240518,25,2024-05-18,18,950,436,1386,MCEC_T,"-37.82401776, 144.95604426"
25620250105,25,2025-01-05,6,61,38,99,MCEC_T,"-37.82401776, 144.95604426"
52220240816,52,2024-08-16,2,6,19,25,Eli263_T,"-37.81252157, 144.9619401"
462120231228,46,2023-12-28,21,7,33,40,Pel147_T,"-37.80240719, 144.9615673"
52720240302,52,2024-03-02,7,23,20,43,Eli263_T,"-37.81252157, 144.9619401"
491020240729,49,2024-07-29,10,107,168,275,Eli501_T,"-37.80730068, 144.95956055"
109920251013,109,2025-10-13,9,89,320,409,LatWill_T,"-37.81193681, 144.95621105"
191220231204,19,2023-12-04,12,488,469,957,LtB210_T,"-37.81237202, 144.96550671"
48020240825,48,2024-08-25,0,26,44,70,QVMQ_T,"-37.80631581, 144.95866697"
141420250928,141,2025-09-28,4,24,18,42,474Fl_T,"-37.81997273, 144.95834911"
137920250612,137,2025-06-12,9,81,37,118,BouHbr2353_T,"-37.81894815, 144.94612292"
1361120240727,136,2024-07-27,11,98,40,138,BirFed1120_T,"-37.8184141, 144.97357915"
130820231230,130,2023-12-30,8,6,4,10,Bou892T,"-37.8204637, 144.94126826"
1381220250809,138,2025-08-09,12,5,10,15,EntPark1671_T,"-37.81996544, 144.95981454"
42220250831,4,2025-08-31,22,192,185,377,Swa123_T,"-37.81487988, 144.9660878"
751320241027,75,2024-10-27,13,26,34,60,SprFli_T,"-37.81515276, 144.97467661"
28920241203,28,2024-12-03,9,363,147,510,VAC_T,"-37.82129925, 144.96879309"
841720231214,84,2023-12-14,17,1205,2124,3329,ElFi_T,"-37.81798049, 144.96503383"
702320250808,70,2025-08-08,23,10,19,29,Errol20_T,"-37.80456984, 144.94946228"
3220250920,3,2025-09-20,2,137,130,267,Swa295_T,"-37.81101524, 144.96429485"
391220250712,39,2025-07-12,12,59,85,144,AlfPl_T,"-37.81379749, 144.96995745"
81320240208,8,2024-02-08,13,287,259,546,WebBN_T,"-37.82293543, 144.9471751"
141220240404,14,2024-04-04,12,340,158,498,SanBri_T,"-37.82011242, 144.96291897"
141120240121,14,2024-01-21,11,444,145,589,SanBri_T,"-37.82011242, 144.96291897"
59820240127,59,2024-01-27,8,80,91,171,RMIT_T,"-37.80825648, 144.96304859"
651020240508,65,2024-05-08,10,351,236,587,SwaCs_T,"-37.81569416, 144.9668064"
40320251005,40,2025-10-05,3,20,7,27,Spr201_T,"-37.80999341, 144.97227587"
312220250430,31,2025-04-30,22,36,92,128,Lyg161_T,"-37.80169681, 144.96658911"
362020250322,36,2025-03-22,20,189,203,392,Que85_T,"-37.81652527, 144.96121062"
472320250920,47,2025-09-20,23,261,276,537,Eli250_T,"-37.81258467, 144.9625775"
37720231022,37,2023-10-22,7,13,3,16,Lyg260_T,"-37.80107122, 144.96704554"
371320231110,37,2023-11-10,13,113,155,268,Lyg260_T,"-37.80107122, 144.96704554"
44320240511,44,2024-05-11,3,0,1,1,UM3_T,"-37.79698741, 144.96441306"
211420240524,21,2024-05-24,14,377,356,733,Bourke155_T,"-37.81267313, 144.96788288"
5820240210,5,2024-02-10,8,237,209,446,PriNW_T,"-37.81874249, 144.96787656"
52220240425,5,2024-04-25,22,365,493,858,PriNW_T,"-37.81874249, 144.96787656"
52120240819,5,2024-08-19,21,141,228,369,PriNW_T,"-37.81874249, 144.96787656"
1081120250116,108,2025-01-16,11,244,269,513,261Will_T,"-37.81295822, 144.95678789"
1341920241005,134,2024-10-05,19,361,467,828,Spen201_T,"-37.81694221, 144.95303935"
1311620240131,131,2024-01-31,16,107,89,196,King2_T,"-37.82009057, 144.95758725"
1241520240217,124,2024-02-17,15,2,1,3,BirBridge_T,"-37.81757416, 144.97329934"
141520240308,141,2024-03-08,5,9,13,22,474Fl_T,"-37.81997273, 144.95834911"
1361120240717,136,2024-07-17,11,33,42,75,BirFed1120_T,"-37.8184141, 144.97357915"
1231320240319,123,2024-03-19,13,57,20,77,BirBridge_T,"-37.81753741, 144.97329734"
1231620240406,123,2024-04-06,16,14,8,22,BirBridge_T,"-37.81753741, 144.97329734"
1302220240629,130,2024-06-29,22,0,1,1,Bou892T,"-37.8204637, 144.94126826"
19320240616,19,2024-06-16,3,44,77,121,LtB210_T,"-37.81237202, 144.96550671"
63120241203,63,2024-12-03,1,1,8,9,Bou231_T,"-37.81333081, 144.96675571"
182020241103,18,2024-11-03,20,3,7,10,Col12_T,"-37.81344862, 144.97305353"
62720240613,62,2024-06-13,7,58,64,122,Lat224_T,"-37.80996494, 144.96216521"
62320240927,62,2024-09-27,3,17,8,25,Lat224_T,"-37.80996494, 144.96216521"
861720241126,86,2024-11-26,17,41,77,118,574Qub_T,"-37.80309992, 144.94908064"
12220241209,12,2024-12-09,2,2,5,7,NewQ_T,"-37.81457988, 144.94292398"
10020250819,10,2025-08-19,0,1,2,3,BouHbr_T,"-37.81876474, 144.94710545"
242320240517,24,2024-05-17,23,213,348,561,Col620_T,"-37.81887963, 144.95449198"
721020241124,72,2024-11-24,10,76,33,109,ACMI_T,"-37.81726338, 144.96872809"
351220250724,35,2025-07-24,12,1743,1451,3194,SouthB_T,"-37.82018685, 144.96508508"
35220241208,35,2024-12-08,2,82,185,267,SouthB_T,"-37.82018685, 144.96508508"
761720240218,76,2024-02-18,17,51,32,83,KenMac_T,"-37.79453803, 144.93036194"
21820240630,2,2024-06-30,18,258,207,465,Bou283_T,"-37.81380668, 144.96516718"
91020240827,9,2024-08-27,10,222,642,864,Col700_T,"-37.81982992, 144.95102555"
91220240224,9,2024-02-24,12,155,152,307,Col700_T,"-37.81982992, 144.95102555"
791720240613,79,2024-06-13,17,558,445,1003,FliSS_T,"-37.81794046, 144.96616678"
541520240331,54,2024-03-31,15,99,135,234,Swa607_T,"-37.804024, 144.96308399"
401120240927,40,2024-09-27,11,109,154,263,Spr201_T,"-37.80999341, 144.97227587"
31820241208,31,2024-12-08,8,30,29,59,Lyg161_T,"-37.80169681, 144.96658911"
361220241118,36,2024-11-18,12,297,252,549,Que85_T,"-37.81652527, 144.96121062"
36220250809,36,2025-08-09,2,95,114,209,Que85_T,"-37.81652527, 144.96121062"
37020240806,37,2024-08-06,0,8,8,16,Lyg260_T,"-37.80107122, 144.96704554"
441920240617,44,2024-06-17,19,27,32,59,UM3_T,"-37.79698741, 144.96441306"
212320240810,21,2024-08-10,23,360,392,752,Bourke155_T,"-37.81267313, 144.96788288"
107120250305,107,2025-03-05,1,12,7,19,280Will_T,"-37.81246271, 144.95690188"
107420251009,107,2025-10-09,4,1,3,4,280Will_T,"-37.81246271, 144.95690188"
1071620240428,107,2024-04-28,16,96,105,201,280Will_T,"-37.81246271, 144.95690188"
1081020241201,108,2024-12-01,10,85,101,186,261Will_T,"-37.81295822, 144.95678789"
872320250205,87,2025-02-05,23,10,16,26,Errol23_T,"-37.80454949, 144.94921863"
612320240626,61,2024-06-26,23,205,53,258,RMIT14_T,"-37.80767455, 144.96309114"
43420250928,43,2025-09-28,4,0,1,1,UM2_T,"-37.79844526, 144.96411782"
166920250812,166,2025-08-12,9,34,41,75,Spen484_T,"-37.80896733, 144.94931703"
162720251012,162,2025-10-12,7,82,87,169,Eli489_T,"-37.80740397, 144.95987909"
167720240930,167,2024-09-30,7,3,27,30,Lat526_T,"-37.81304149, 144.95155955"
143120250105,143,2025-01-05,1,95,26,121,Spencer_T,"-37.821728, 144.95557015"
1301920250611,130,2025-06-11,19,17,29,46,Bou892T,"-37.8204637, 144.94126826"
164020250103,164,2025-01-03,0,7,25,32,Lat526_T,"-37.813005, 144.95160411"
1641720250411,164,2025-04-11,17,169,143,312,Lat526_T,"-37.813005, 144.95160411"
1641820250421,164,2025-04-21,18,96,89,185,Lat526_T,"-37.813005, 144.95160411"
671720240814,67,2024-08-14,17,396,769,1165,FLDegS_T,"-37.81688755, 144.96562569"
672220241031,67,2024-10-31,22,64,160,224,FLDegS_T,"-37.81688755, 144.96562569"
681720240408,68,2024-04-08,17,117,38,155,FLDegN_T,"-37.8168479, 144.96559789"
17420240621,17,2024-06-21,4,7,11,18,Col15_T,"-37.81362543, 144.97323591"
632120240602,63,2024-06-02,21,36,117,153,Bou231_T,"-37.81333081, 144.96675571"
671620240821,67,2024-08-21,16,314,653,967,FLDegS_T,"-37.81688755, 144.96562569"
18520250410,18,2025-04-10,5,2,18,20,Col12_T,"-37.81344862, 144.97305353"
18120250608,18,2025-06-08,1,0,1,1,Col12_T,"-37.81344862, 144.97305353"
63920250419,63,2025-04-19,9,104,214,318,Bou231_T,"-37.81333081, 144.96675571"
62720240406,62,2024-04-06,7,54,34,88,Lat224_T,"-37.80996494, 144.96216521"
86520231126,86,2023-11-26,5,1,2,3,574Qub_T,"-37.80309992, 144.94908064"
862020250109,86,2025-01-09,20,19,43,62,574Qub_T,"-37.80309992, 144.94908064"
72020231220,72,2023-12-20,0,17,15,32,ACMI_T,"-37.81726338, 144.96872809"
721720250515,72,2025-05-15,17,237,941,1178,ACMI_T,"-37.81726338, 144.96872809"
351220231224,35,2023-12-24,12,1222,1324,2546,SouthB_T,"-37.82018685, 144.96508508"
27520240621,27,2024-06-21,5,5,6,11,Vic_T,"-37.80606888, 144.95644692"
2520250416,2,2025-04-16,5,5,7,12,Bou283_T,"-37.81380668, 144.96516718"
53420240108,53,2024-01-08,4,0,4,4,Col254_T,"-37.81564191, 144.965499"
231820240511,23,2024-05-11,18,156,220,376,Col623_T,"-37.81909256, 144.95452748"
301120241205,30,2024-12-05,11,178,239,417,Lon189_T,"-37.8112185, 144.96656806"
791720250520,79,2025-05-20,17,611,713,1324,FliSS_T,"-37.81794046, 144.96616678"
46620241116,46,2024-11-16,6,2,4,6,Pel147_T,"-37.80240719, 144.9615673"
461320241118,46,2024-11-18,13,137,123,260,Pel147_T,"-37.80240719, 144.9615673"
492020240728,49,2024-07-28,20,115,119,234,Eli501_T,"-37.80730068, 144.95956055"
49420250603,49,2025-06-03,4,17,16,33,Eli501_T,"-37.80730068, 144.95956055"
19420240119,19,2024-01-19,4,12,33,45,LtB210_T,"-37.81237202, 144.96550671"
48220250211,48,2025-02-11,2,7,3,10,QVMQ_T,"-37.80631581, 144.95866697"
481520240113,48,2024-01-13,15,405,219,624,QVMQ_T,"-37.80631581, 144.95866697"
137720240609,137,2024-06-09,7,2,0,2,BouHbr2353_T,"-37.81894815, 144.94612292"
1421220240418,142,2024-04-18,12,424,278,702,Hammer1584_T,"-37.81970749, 144.96795734"
1231520240122,123,2024-01-22,15,49,36,85,BirBridge_T,"-37.81753741, 144.97329734"
1231520240720,123,2024-07-20,15,19,1,20,BirBridge_T,"-37.81753741, 144.97329734"
621420250406,62,2025-04-06,14,308,244,552,Lat224_T,"-37.80996494, 144.96216521"
562020231222,56,2023-12-22,20,325,362,687,Lon364_T,"-37.81234775, 144.96153311"
562120240419,56,2024-04-19,21,319,356,675,Lon364_T,"-37.81234775, 144.96153311"
561320250213,56,2025-02-13,13,396,400,796,Lon364_T,"-37.81234775, 144.96153311"
561820250306,56,2025-03-06,18,378,394,772,Lon364_T,"-37.81234775, 144.96153311"
24620241114,24,2024-11-14,6,362,154,516,Col620_T,"-37.81887963, 144.95449198"
101820240918,10,2024-09-18,18,64,53,117,BouHbr_T,"-37.81876474, 144.94710545"
121520250113,12,2025-01-13,15,129,118,247,NewQ_T,"-37.81457988, 144.94292398"
121520251003,12,2025-10-03,15,144,171,315,NewQ_T,"-37.81457988, 144.94292398"
581820240623,58,2024-06-23,18,425,331,756,Bou688_T,"-37.81686075, 144.95358075"
72720250511,72,2025-05-11,7,23,322,345,ACMI_T,"-37.81726338, 144.96872809"
351720250829,35,2025-08-29,17,1376,1126,2502,SouthB_T,"-37.82018685, 144.96508508"
48720240505,48,2024-05-05,7,19,44,63,QVMQ_T,"-37.80631581, 144.95866697"
201820231213,20,2023-12-13,18,380,205,585,LtB170_T,"-37.81172914, 144.9682466"
252020241116,25,2024-11-16,20,565,641,1206,MCEC_T,"-37.82401776, 144.95604426"
512020250922,51,2025-09-22,20,63,70,133,Fra118_T,"-37.80841815, 144.95906316"
142720240819,142,2024-08-19,7,108,91,199,Hammer1584_T,"-37.81970749, 144.96795734"
1642120250810,164,2025-08-10,21,28,55,83,Lat526_T,"-37.813005, 144.95160411"
1232020240316,123,2024-03-16,20,7,0,7,BirBridge_T,"-37.81753741, 144.97329734"
492220241012,49,2024-10-12,22,140,117,257,Eli501_T,"-37.80730068, 144.95956055"
661720240917,66,2024-09-17,17,1458,1647,3105,QVN_T,"-37.81057846, 144.96444294"
69720250316,69,2025-03-16,7,11,8,19,FLDegC_T,"-37.81687226, 144.96559144"
70820250902,70,2025-09-02,8,91,66,157,Errol20_T,"-37.80456984, 144.94946228"
391020241011,39,2024-10-11,10,80,70,150,AlfPl_T,"-37.81379749, 144.96995745"
391120250212,39,2025-02-12,11,145,95,240,AlfPl_T,"-37.81379749, 144.96995745"
75820240105,75,2024-01-05,8,18,14,32,SprFli_T,"-37.81515276, 144.97467661"
41920231212,41,2023-12-12,9,1601,495,2096,Swa31,"-37.81668634, 144.96689733"
8520240531,8,2024-05-31,5,6,5,11,WebBN_T,"-37.82293543, 144.9471751"
75020241011,75,2024-10-11,0,0,2,2,SprFli_T,"-37.81515276, 144.97467661"
65020231019,65,2023-10-19,0,17,25,42,SwaCs_T,"-37.81569416, 144.9668064"
422220240525,42,2024-05-25,22,37,61,98,UM1_T,"-37.80008566, 144.96386412"
711420250726,71,2025-07-26,14,11,8,19,WestWP_T,"-37.81235775, 144.97136962"
28220241221,28,2024-12-21,2,19,17,36,VAC_T,"-37.82129925, 144.96879309"
291720240824,29,2024-08-24,17,533,453,986,AG_T,"-37.8199817, 144.96872865"
291020240105,29,2024-01-05,10,138,253,391,AG_T,"-37.8199817, 144.96872865"
31920240306,31,2024-03-06,9,77,76,153,Lyg161_T,"-37.80169681, 144.96658911"
542020250420,54,2025-04-20,20,117,102,219,Swa607_T,"-37.804024, 144.96308399"
28420250715,28,2025-07-15,4,3,29,32,VAC_T,"-37.82129925, 144.96879309"
47620250622,47,2025-06-22,6,35,68,103,Eli250_T,"-37.81258467, 144.9625775"
501220250926,50,2025-09-26,12,217,286,503,Lyg309_T,"-37.79808192, 144.96721013"
50120240506,50,2024-05-06,1,5,6,11,Lyg309_T,"-37.79808192, 144.96721013"
45420240909,45,2024-09-09,4,1,10,11,Swa148_T,"-37.81414075, 144.96609379"
432220240118,43,2024-01-18,22,15,21,36,UM2_T,"-37.79844526, 144.96411782"
1351920231022,135,2023-10-22,19,134,175,309,Spen161_T,"-37.8172861, 144.95319102"
1351920231125,135,2023-11-25,19,315,321,636,Spen161_T,"-37.8172861, 144.95319102"
1351120240915,135,2024-09-15,11,369,330,699,Spen161_T,"-37.8172861, 144.95319102"
1331920240807,133,2024-08-07,19,355,241,596,Spen229_T,"-37.81531435, 144.95227769"
1331420250626,133,2025-06-26,14,495,442,937,Spen229_T,"-37.81531435, 144.95227769"
1182020250501,118,2025-05-01,20,3,2,5,Fli114C_T,"-37.81632783, 144.97090512"
118120240427,118,2024-04-27,1,1,2,3,Fli114C_T,"-37.81632783, 144.97090512"
1081620240521,108,2024-05-21,16,407,207,614,261Will_T,"-37.81295822, 144.95678789"
79920231114,79,2023-11-14,9,414,307,721,FliSS_T,"-37.81794046, 144.96616678"
53820240709,53,2024-07-09,8,250,152,402,Col254_T,"-37.81564191, 144.965499"
52620240827,52,2024-08-27,6,29,16,45,Eli263_T,"-37.81252157, 144.9619401"
180720250411,180,2025-04-11,7,47,16,63,Mac330_T,"-37.79497059, 144.93530329"
141920240626,141,2024-06-26,9,140,137,277,474Fl_T,"-37.81997273, 144.95834911"
66220250622,66,2025-06-22,2,74,92,166,QVN_T,"-37.81057846, 144.96444294"
692120231203,69,2023-12-03,21,47,35,82,FLDegC_T,"-37.81687226, 144.96559144"
6120240608,6,2024-06-08,1,102,78,180,FliS_T,"-37.81911705, 144.96558255"
841420250527,84,2025-05-27,14,757,1090,1847,ElFi_T,"-37.81798049, 144.96503383"
32220240522,3,2024-05-22,22,776,453,1229,Swa295_T,"-37.81101524, 144.96429485"
412020240630,41,2024-06-30,20,56,45,101,Swa31,"-37.81668634, 144.96689733"
411020240922,41,2024-09-22,10,64,106,170,Swa31,"-37.81668634, 144.96689733"
81020250819,8,2025-08-19,10,145,131,276,WebBN_T,"-37.82293543, 144.9471751"
771120250123,77,2025-01-23,11,155,77,232,HarEsP_T,"-37.81441438, 144.94433026"
772320250222,77,2025-02-22,23,60,58,118,HarEsP_T,"-37.81441438, 144.94433026"
781220251001,78,2025-10-01,12,27,44,71,HarEsB_T,"-37.81471642, 144.9446508"
291820240921,29,2024-09-21,18,124,245,369,AG_T,"-37.8199817, 144.96872865"
541820250514,54,2025-05-14,18,179,398,577,Swa607_T,"-37.804024, 144.96308399"
281420231028,28,2023-10-28,14,540,490,1030,VAC_T,"-37.82129925, 144.96879309"
47520240104,47,2024-01-04,5,20,42,62,Eli250_T,"-37.81258467, 144.9625775"
401120250911,40,2025-09-11,11,186,253,439,Spr201_T,"-37.80999341, 144.97227587"
541120241115,54,2024-11-15,11,129,88,217,Swa607_T,"-37.804024, 144.96308399"
361620250203,36,2025-02-03,16,162,178,340,Que85_T,"-37.81652527, 144.96121062"
361520231029,36,2023-10-29,15,79,90,169,Que85_T,"-37.81652527, 144.96121062"
61020240409,61,2024-04-09,0,23,8,31,RMIT14_T,"-37.80767455, 144.96309114"
441220240527,44,2024-05-27,12,80,98,178,UM3_T,"-37.79698741, 144.96441306"
52020250502,5,2025-05-02,20,437,644,1081,PriNW_T,"-37.81874249, 144.96787656"
1622020250329,162,2025-03-29,20,276,139,415,Eli489_T,"-37.80740397, 144.95987909"
132520231222,132,2023-12-22,5,7,4,11,King335_T,"-37.81267639, 144.95386444"
1311920241014,131,2024-10-14,19,65,78,143,King2_T,"-37.82009057, 144.95758725"
1351920240814,135,2024-08-14,19,129,157,286,Spen161_T,"-37.8172861, 144.95319102"
133220250121,133,2025-01-21,2,25,7,32,Spen229_T,"-37.81531435, 144.95227769"
1182120250214,118,2025-02-14,21,21,4,25,Fli114C_T,"-37.81632783, 144.97090512"
87920251011,87,2025-10-11,9,69,83,152,Errol23_T,"-37.80454949, 144.94921863"
871120250209,87,2025-02-09,11,126,120,246,Errol23_T,"-37.80454949, 144.94921863"
1811920250821,181,2025-08-21,19,971,992,1963,Eli368_T,"-37.81009465, 144.96143149"
165320241116,165,2024-11-16,3,2,1,3,Spen475_T,"-37.80953359, 144.94939004"
851820240714,85,2024-07-14,18,41,43,84,488Mac_T,"-37.79432415, 144.92973378"
172320250130,17,2025-01-30,23,26,19,45,Col15_T,"-37.81362543, 144.97323591"
1620250104,1,2025-01-04,6,19,12,31,Bou292_T,"-37.81349441, 144.96515323"
12120250425,1,2025-04-25,21,204,169,373,Bou292_T,"-37.81349441, 144.96515323"
67420250106,67,2025-01-06,4,2,5,7,FLDegS_T,"-37.81688755, 144.96562569"
682020250124,68,2025-01-24,20,205,142,347,FLDegN_T,"-37.8168479, 144.96559789"
1351620231227,135,2023-12-27,16,526,388,914,Spen161_T,"-37.8172861, 144.95319102"
1331620240529,133,2024-05-29,16,621,759,1380,Spen229_T,"-37.81531435, 144.95227769"
85420240229,85,2024-02-29,4,1,0,1,488Mac_T,"-37.79432415, 144.92973378"
181820251008,18,2025-10-08,18,391,77,468,Col12_T,"-37.81344862, 144.97305353"
11720250212,11,2025-02-12,7,72,79,151,WatCit_T,"-37.81564989, 144.93970694"
622220250718,62,2025-07-18,22,161,202,363,Lat224_T,"-37.80996494, 144.96216521"
122020240618,12,2024-06-18,20,89,104,193,NewQ_T,"-37.81457988, 144.94292398"
761620250605,76,2025-06-05,16,52,68,120,KenMac_T,"-37.79453803, 144.93036194"
2120250808,2,2025-08-08,1,20,30,50,Bou283_T,"-37.81380668, 144.96516718"
53320250830,53,2025-08-30,3,2,2,4,Col254_T,"-37.81564191, 144.965499"
301520231230,30,2023-12-30,15,334,531,865,Lon189_T,"-37.8112185, 144.96656806"
461720240518,46,2024-05-18,17,75,51,126,Pel147_T,"-37.80240719, 144.9615673"
462220250411,46,2025-04-11,22,2,1,3,Pel147_T,"-37.80240719, 144.9615673"
482120250822,48,2025-08-22,21,75,148,223,QVMQ_T,"-37.80631581, 144.95866697"
1372320241102,137,2024-11-02,23,60,20,80,BouHbr2353_T,"-37.81894815, 144.94612292"
1412120241016,141,2024-10-16,21,101,129,230,474Fl_T,"-37.81997273, 144.95834911"
1391020250530,139,2025-05-30,10,15,25,40,Signal1647_T,"-37.81959923, 144.9632832"
1362120250104,136,2025-01-04,21,5,48,53,BirFed1120_T,"-37.8184141, 144.97357915"
142620250327,142,2025-03-27,6,16,5,21,Hammer1584_T,"-37.81970749, 144.96795734"
142020240719,142,2024-07-19,0,7,0,7,Hammer1584_T,"-37.81970749, 144.96795734"
1612020240812,161,2024-08-12,20,1,1,2,BirArt1109_T,"-37.81851276, 144.97131336"
123020231019,123,2023-10-19,0,0,1,1,BirBridge_T,"-37.81753741, 144.97329734"
662120241022,66,2024-10-22,21,608,526,1134,QVN_T,"-37.81057846, 144.96444294"
691120240629,69,2024-06-29,11,145,101,246,FLDegC_T,"-37.81687226, 144.96559144"
6120240314,6,2024-03-14,1,52,28,80,FliS_T,"-37.81911705, 144.96558255"
391120241126,39,2024-11-26,11,134,79,213,AlfPl_T,"-37.81379749, 144.96995745"
81220240804,8,2024-08-04,12,164,200,364,WebBN_T,"-37.82293543, 144.9471751"
772020240222,77,2024-02-22,20,96,70,166,HarEsP_T,"-37.81441438, 144.94433026"
281820240731,28,2024-07-31,18,396,344,740,VAC_T,"-37.82129925, 144.96879309"
292220250127,29,2025-01-27,22,37,42,79,AG_T,"-37.8199817, 144.96872865"
312020250403,31,2025-04-03,20,176,185,361,Lyg161_T,"-37.80169681, 144.96658911"
452220250817,45,2025-08-17,22,90,227,317,Swa148_T,"-37.81414075, 144.96609379"
212320250709,21,2025-07-09,23,59,90,149,Bourke155_T,"-37.81267313, 144.96788288"
21120231107,21,2023-11-07,1,84,142,226,Bourke155_T,"-37.81267313, 144.96788288"
1082220240205,108,2024-02-05,22,83,60,143,261Will_T,"-37.81295822, 144.95678789"
871320231228,87,2023-12-28,13,107,104,211,Errol23_T,"-37.80454949, 144.94921863"
631820250902,63,2025-09-02,18,103,255,358,Bou231_T,"-37.81333081, 144.96675571"
62020231203,62,2023-12-03,0,120,34,154,Lat224_T,"-37.80996494, 144.96216521"
561720231029,56,2023-10-29,17,316,187,503,Lon364_T,"-37.81234775, 144.96153311"
861720231117,86,2023-11-17,17,35,59,94,574Qub_T,"-37.80309992, 144.94908064"
86820250520,86,2025-05-20,8,41,27,68,574Qub_T,"-37.80309992, 144.94908064"
111920241219,11,2024-12-19,19,110,92,202,WatCit_T,"-37.81564989, 144.93970694"
241420231229,24,2023-12-29,14,435,623,1058,Col620_T,"-37.81887963, 144.95449198"
241420250331,24,2025-03-31,14,522,804,1326,Col620_T,"-37.81887963, 144.95449198"
22220240927,2,2024-09-27,22,62,143,205,Bou283_T,"-37.81380668, 144.96516718"
272220241003,27,2024-10-03,22,53,41,94,Vic_T,"-37.80606888, 144.95644692"
79920240630,79,2024-06-30,9,146,152,298,FliSS_T,"-37.81794046, 144.96616678"
792320231018,79,2023-10-18,23,116,179,295,FliSS_T,"-37.81794046, 144.96616678"
511720240212,51,2024-02-12,17,113,88,201,Fra118_T,"-37.80841815, 144.95906316"
1372020240729,137,2024-07-29,20,4,2,6,BouHbr2353_T,"-37.81894815, 144.94612292"
1371720250311,137,2025-03-11,17,11,229,240,BouHbr2353_T,"-37.81894815, 144.94612292"
1421720240202,142,2024-02-02,17,470,518,988,Hammer1584_T,"-37.81970749, 144.96795734"
1611620240920,161,2024-09-20,16,144,179,323,BirArt1109_T,"-37.81851276, 144.97131336"
130720240604,130,2024-06-04,7,1,2,3,Bou892T,"-37.8204637, 144.94126826"
48820250824,48,2025-08-24,8,86,79,165,QVMQ_T,"-37.80631581, 144.95866697"
66220250614,66,2025-06-14,2,58,25,83,QVN_T,"-37.81057846, 144.96444294"
4920231102,4,2023-11-02,9,705,437,1142,Swa123_T,"-37.81487988, 144.9660878"
701220250325,70,2025-03-25,12,154,176,330,Errol20_T,"-37.80456984, 144.94946228"
751020250501,75,2025-05-01,10,31,37,68,SprFli_T,"-37.81515276, 144.97467661"
82120241101,8,2024-11-01,21,92,59,151,WebBN_T,"-37.82293543, 144.9471751"
751220250323,75,2025-03-23,12,62,32,94,SprFli_T,"-37.81515276, 144.97467661"
412020250214,41,2025-02-14,20,1259,1467,2726,Swa31,"-37.81668634, 144.96689733"
422020241009,42,2024-10-09,20,101,122,223,UM1_T,"-37.80008566, 144.96386412"
78320250915,78,2025-09-15,3,2,4,6,HarEsB_T,"-37.81471642, 144.9446508"
291820240205,29,2024-02-05,18,329,285,614,AG_T,"-37.8199817, 144.96872865"
59320251016,59,2025-10-16,3,12,8,20,RMIT_T,"-37.80825648, 144.96304859"
71620240518,71,2024-05-18,6,5,5,10,WestWP_T,"-37.81235775, 144.97136962"
471020240515,47,2024-05-15,10,343,514,857,Eli250_T,"-37.81258467, 144.9625775"
401220250917,40,2025-09-17,12,435,656,1091,Spr201_T,"-37.80999341, 144.97227587"
311920231231,31,2023-12-31,19,270,275,545,Lyg161_T,"-37.80169681, 144.96658911"
361220250929,36,2025-09-29,12,324,248,572,Que85_T,"-37.81652527, 144.96121062"
40320250115,40,2025-01-15,3,3,0,3,Spr201_T,"-37.80999341, 144.97227587"
61620240612,61,2024-06-12,6,32,52,84,RMIT14_T,"-37.80767455, 144.96309114"
501420250819,50,2025-08-19,14,206,132,338,Lyg309_T,"-37.79808192, 144.96721013"
502020250605,50,2025-06-05,20,183,124,307,Lyg309_T,"-37.79808192, 144.96721013"
50420240629,50,2024-06-29,4,7,3,10,Lyg309_T,"-37.79808192, 144.96721013"
442020240127,44,2024-01-27,20,3,3,6,UM3_T,"-37.79698741, 144.96441306"
872020250603,87,2025-06-03,20,44,58,102,Errol23_T,"-37.80454949, 144.94921863"
108120231228,108,2023-12-28,1,8,23,31,261Will_T,"-37.81295822, 144.95678789"
1822220250616,182,2025-06-16,22,97,46,143,King163_T,"-37.81627451, 144.95550503"
70120240611,70,2024-06-11,1,0,4,4,Errol20_T,"-37.80456984, 144.94946228"
1662120250610,166,2025-06-10,21,5,8,13,Spen484_T,"-37.80896733, 144.94931703"
1651920250515,165,2025-05-15,19,43,14,57,Spen475_T,"-37.80953359, 144.94939004"
1341920240401,134,2024-04-01,19,193,157,350,Spen201_T,"-37.81694221, 144.95303935"
1381020240608,138,2024-06-08,10,3,7,10,EntPark1671_T,"-37.81996544, 144.95981454"
130020240924,130,2024-09-24,0,0,1,1,Bou892T,"-37.8204637, 144.94126826"
48720251013,48,2025-10-13,7,105,195,300,QVMQ_T,"-37.80631581, 144.95866697"
117120231230,117,2023-12-30,1,45,18,63,Fli114F_T,"-37.81629332, 144.97090877"
117720240123,117,2024-01-23,7,156,86,242,Fli114F_T,"-37.81629332, 144.97090877"
1091520240220,109,2024-02-20,15,286,159,445,LatWill_T,"-37.81193681, 144.95621105"
137720250201,137,2025-02-01,7,9,15,24,BouHbr2353_T,"-37.81894815, 144.94612292"
1372320250627,137,2025-06-27,23,1,2,3,BouHbr2353_T,"-37.81894815, 144.94612292"
85620250429,85,2025-04-29,6,22,10,32,488Mac_T,"-37.79432415, 144.92973378"
11420240202,1,2024-02-02,14,1073,1131,2204,Bou292_T,"-37.81349441, 144.96515323"
1320240518,1,2024-05-18,3,12,15,27,Bou292_T,"-37.81349441, 144.96515323"
63220240523,63,2024-05-23,2,6,25,31,Bou231_T,"-37.81333081, 144.96675571"
681520250622,68,2025-06-22,15,270,259,529,FLDegN_T,"-37.8168479, 144.96559789"
861820240919,86,2024-09-19,18,47,65,112,574Qub_T,"-37.80309992, 144.94908064"
682120240306,68,2024-03-06,21,43,18,61,FLDegN_T,"-37.8168479, 144.96559789"
62620240818,62,2024-08-18,6,37,13,50,Lat224_T,"-37.80996494, 144.96216521"
562020240807,56,2024-08-07,20,274,330,604,Lon364_T,"-37.81234775, 144.96153311"
561420250316,56,2025-03-16,14,237,297,534,Lon364_T,"-37.81234775, 144.96153311"
24420241202,24,2024-12-02,4,7,14,21,Col620_T,"-37.81887963, 144.95449198"
11720250919,11,2025-09-19,7,48,43,91,WatCit_T,"-37.81564989, 144.93970694"
2120250326,2,2025-03-26,1,1,12,13,Bou283_T,"-37.81380668, 144.96516718"
2320250413,2,2025-04-13,3,29,40,69,Bou283_T,"-37.81380668, 144.96516718"
53720240112,53,2024-01-12,7,84,72,156,Col254_T,"-37.81564191, 144.965499"
271120240213,27,2024-02-13,11,147,119,266,Vic_T,"-37.80606888, 144.95644692"
30420241101,30,2024-11-01,4,36,97,133,Lon189_T,"-37.8112185, 144.96656806"
30520231101,30,2023-11-01,5,13,28,41,Lon189_T,"-37.8112185, 144.96656806"
231020250903,23,2025-09-03,10,222,219,441,Col623_T,"-37.81909256, 144.95452748"
512220240407,51,2024-04-07,22,40,37,77,Fra118_T,"-37.80841815, 144.95906316"
51720240924,51,2024-09-24,7,23,30,53,Fra118_T,"-37.80841815, 144.95906316"
251020241221,25,2024-12-21,10,261,472,733,MCEC_T,"-37.82401776, 144.95604426"
46120250110,46,2025-01-10,1,1,0,1,Pel147_T,"-37.80240719, 144.9615673"
201620240607,20,2024-06-07,16,189,223,412,LtB170_T,"-37.81172914, 144.9682466"
25220240904,25,2024-09-04,2,5,4,9,MCEC_T,"-37.82401776, 144.95604426"
51720241028,51,2024-10-28,7,23,16,39,Fra118_T,"-37.80841815, 144.95906316"
1391020240201,139,2024-02-01,10,96,71,167,Signal1647_T,"-37.81959923, 144.9632832"
1421520240125,142,2024-01-25,15,409,342,751,Hammer1584_T,"-37.81970749, 144.96795734"
62220240130,6,2024-01-30,22,381,284,665,FliS_T,"-37.81911705, 144.96558255"
841020250425,84,2025-04-25,10,1027,847,1874,ElFi_T,"-37.81798049, 144.96503383"
41320240730,4,2024-07-30,13,1285,1273,2558,Swa123_T,"-37.81487988, 144.9660878"
701720240828,70,2024-08-28,17,148,147,295,Errol20_T,"-37.80456984, 144.94946228"
70420241114,70,2024-11-14,4,1,0,1,Errol20_T,"-37.80456984, 144.94946228"
771120231203,77,2023-12-03,11,225,144,369,HarEsP_T,"-37.81441438, 144.94433026"
772220250211,77,2025-02-11,22,79,64,143,HarEsP_T,"-37.81441438, 144.94433026"
421520240609,42,2024-06-09,15,126,94,220,UM1_T,"-37.80008566, 144.96386412"
78520250728,78,2025-07-28,5,1,0,1,HarEsB_T,"-37.81471642, 144.9446508"
591720250628,59,2025-06-28,17,595,448,1043,RMIT_T,"-37.80825648, 144.96304859"
1402020240519,140,2024-05-19,20,8,13,21,Boyd2837_T,"-37.82590962, 144.96185972"
1081220250225,108,2025-02-25,12,684,601,1285,261Will_T,"-37.81295822, 144.95678789"
131520250807,131,2025-08-07,5,5,5,10,King2_T,"-37.82009057, 144.95758725"
1321620241107,132,2024-11-07,16,129,163,292,King335_T,"-37.81267639, 144.95386444"
135020240214,135,2024-02-14,0,34,34,68,Spen161_T,"-37.8172861, 144.95319102"
1351020250524,135,2025-05-24,10,603,520,1123,Spen161_T,"-37.8172861, 144.95319102"
1351620231020,135,2023-10-20,16,498,517,1015,Spen161_T,"-37.8172861, 144.95319102"
1331620240702,133,2024-07-02,16,551,767,1318,Spen229_T,"-37.81531435, 144.95227769"
1071720240721,107,2024-07-21,17,66,103,169,280Will_T,"-37.81246271, 144.95690188"
87620250514,87,2025-05-14,6,18,8,26,Errol23_T,"-37.80454949, 144.94921863"
179420250831,179,2025-08-31,4,5,0,5,Pow61_T,"-37.82392385, 144.96299677"
1651120250831,165,2025-08-31,11,20,26,46,Spen475_T,"-37.80953359, 144.94939004"
851320240520,85,2024-05-20,13,60,60,120,488Mac_T,"-37.79432415, 144.92973378"
851520250515,85,2025-05-15,15,86,95,181,488Mac_T,"-37.79432415, 144.92973378"
621120250920,62,2025-09-20,11,250,174,424,Lat224_T,"-37.80996494, 144.96216521"
861420250430,86,2025-04-30,14,38,55,93,574Qub_T,"-37.80309992, 144.94908064"
121020241213,12,2024-12-13,10,120,113,233,NewQ_T,"-37.81457988, 144.94292398"
121220241216,12,2024-12-16,12,77,120,197,NewQ_T,"-37.81457988, 144.94292398"
121320240904,12,2024-09-04,13,149,106,255,NewQ_T,"-37.81457988, 144.94292398"
102320250827,10,2025-08-27,23,19,20,39,BouHbr_T,"-37.81876474, 144.94710545"
101220250829,10,2025-08-29,12,98,69,167,BouHbr_T,"-37.81876474, 144.94710545"
721620240126,72,2024-01-26,16,293,510,803,ACMI_T,"-37.81726338, 144.96872809"
21920241106,2,2024-11-06,19,194,284,478,Bou283_T,"-37.81380668, 144.96516718"
91320250923,9,2025-09-23,13,454,441,895,Col700_T,"-37.81982992, 144.95102555"
511720241101,51,2024-11-01,17,94,84,178,Fra118_T,"-37.80841815, 144.95906316"
51420250706,51,2025-07-06,4,6,3,9,Fra118_T,"-37.80841815, 144.95906316"
1301820250228,130,2025-02-28,18,65,35,100,Bou892T,"-37.8204637, 144.94126826"
1231520250925,123,2025-09-25,15,27,17,44,BirBridge_T,"-37.81753741, 144.97329734"
1231020250317,123,2025-03-17,10,17,18,35,BirBridge_T,"-37.81753741, 144.97329734"
49520250421,49,2025-04-21,5,24,21,45,Eli501_T,"-37.80730068, 144.95956055"
491720250715,49,2025-07-15,17,261,250,511,Eli501_T,"-37.80730068, 144.95956055"
1172320240625,117,2024-06-25,23,28,14,42,Fli114F_T,"-37.81629332, 144.97090877"
491420240812,49,2024-08-12,14,234,239,473,Eli501_T,"-37.80730068, 144.95956055"
662220250628,66,2025-06-28,22,765,580,1345,QVN_T,"-37.81057846, 144.96444294"
662120250910,66,2025-09-10,21,634,530,1164,QVN_T,"-37.81057846, 144.96444294"
692120241003,69,2024-10-03,21,21,30,51,FLDegC_T,"-37.81687226, 144.96559144"
691220250612,69,2025-06-12,12,388,311,699,FLDegC_T,"-37.81687226, 144.96559144"
841320240209,84,2024-02-09,13,979,1186,2165,ElFi_T,"-37.81798049, 144.96503383"
84420240518,84,2024-05-18,4,43,41,84,ElFi_T,"-37.81798049, 144.96503383"
84920250617,84,2025-06-17,9,1124,319,1443,ElFi_T,"-37.81798049, 144.96503383"
42220250529,4,2025-05-29,22,283,417,700,Swa123_T,"-37.81487988, 144.9660878"
771720250830,77,2025-08-30,17,170,119,289,HarEsP_T,"-37.81441438, 144.94433026"
771820231118,77,2023-11-18,18,280,220,500,HarEsP_T,"-37.81441438, 144.94433026"
771020240102,77,2024-01-02,10,112,69,181,HarEsP_T,"-37.81441438, 144.94433026"
29720240812,29,2024-08-12,7,98,66,164,AG_T,"-37.8199817, 144.96872865"
291420250628,29,2025-06-28,14,303,413,716,AG_T,"-37.8199817, 144.96872865"
29120240504,29,2024-05-04,1,19,26,45,AG_T,"-37.8199817, 144.96872865"
54520250814,54,2025-08-14,5,7,4,11,Swa607_T,"-37.804024, 144.96308399"
54320240201,54,2024-02-01,3,1,11,12,Swa607_T,"-37.804024, 144.96308399"
211020231224,21,2023-12-24,10,169,152,321,Bourke155_T,"-37.81267313, 144.96788288"
361420231211,36,2023-12-11,14,201,188,389,Que85_T,"-37.81652527, 144.96121062"
361720240128,36,2024-01-28,17,62,77,139,Que85_T,"-37.81652527, 144.96121062"
372320240927,37,2024-09-27,23,126,105,231,Lyg260_T,"-37.80107122, 144.96704554"
501620240722,50,2024-07-22,16,190,128,318,Lyg309_T,"-37.79808192, 144.96721013"
502220240916,50,2024-09-16,22,27,22,49,Lyg309_T,"-37.79808192, 144.96721013"
452220250928,45,2025-09-28,22,82,242,324,Swa148_T,"-37.81414075, 144.96609379"
1182020240914,118,2024-09-14,20,9,2,11,Fli114C_T,"-37.81632783, 144.97090512"
107820250315,107,2025-03-15,8,32,83,115,280Will_T,"-37.81246271, 144.95690188"
871520250209,87,2025-02-09,15,106,87,193,Errol23_T,"-37.80454949, 144.94921863"
182020250808,182,2025-08-08,0,62,99,161,King163_T,"-37.81627451, 144.95550503"
1671520250823,167,2025-08-23,15,34,55,89,Lat526_T,"-37.81304149, 144.95155955"
1811320250912,181,2025-09-12,13,720,984,1704,Eli368_T,"-37.81009465, 144.96143149"
1401520240118,140,2024-01-18,15,60,66,126,Boyd2837_T,"-37.82590962, 144.96185972"
1341720231220,134,2023-12-20,17,517,444,961,Spen201_T,"-37.81694221, 144.95303935"
181920241118,18,2024-11-18,19,84,21,105,Col12_T,"-37.81344862, 144.97305353"
862120240619,86,2024-06-19,21,6,4,10,574Qub_T,"-37.80309992, 144.94908064"
62020231211,62,2023-12-11,0,51,18,69,Lat224_T,"-37.80996494, 144.96216521"
621720240609,62,2024-06-09,17,181,110,291,Lat224_T,"-37.80996494, 144.96216521"
62620240715,62,2024-07-15,6,114,36,150,Lat224_T,"-37.80996494, 144.96216521"
862020250328,86,2025-03-28,20,41,87,128,574Qub_T,"-37.80309992, 144.94908064"
241020250116,24,2025-01-16,10,833,361,1194,Col620_T,"-37.81887963, 144.95449198"
121520250623,12,2025-06-23,15,102,100,202,NewQ_T,"-37.81457988, 144.94292398"
35820240724,35,2024-07-24,8,561,1797,2358,SouthB_T,"-37.82018685, 144.96508508"
58020250506,58,2025-05-06,0,42,33,75,Bou688_T,"-37.81686075, 144.95358075"
531220240122,53,2024-01-22,12,950,896,1846,Col254_T,"-37.81564191, 144.965499"
51620250213,51,2025-02-13,6,20,24,44,Fra118_T,"-37.80841815, 144.95906316"
1361520250613,136,2025-06-13,15,77,57,134,BirFed1120_T,"-37.8184141, 144.97357915"
1391520240525,139,2024-05-25,15,74,60,134,Signal1647_T,"-37.81959923, 144.9632832"
1422220241120,142,2024-11-20,22,10,2,12,Hammer1584_T,"-37.81970749, 144.96795734"
1301920231223,130,2023-12-23,19,10,29,39,Bou892T,"-37.8204637, 144.94126826"
1611120250912,161,2025-09-12,11,68,66,134,BirArt1109_T,"-37.81851276, 144.97131336"
1171620250107,117,2025-01-07,16,182,251,433,Fli114F_T,"-37.81629332, 144.97090877"
491820240810,49,2024-08-10,18,247,244,491,Eli501_T,"-37.80730068, 144.95956055"
481620250404,48,2025-04-04,16,165,146,311,QVMQ_T,"-37.80631581, 144.95866697"
1371420240916,137,2024-09-16,14,18,39,57,BouHbr2353_T,"-37.81894815, 144.94612292"
4320250715,4,2025-07-15,3,20,8,28,Swa123_T,"-37.81487988, 144.9660878"
502120241209,50,2024-12-09,21,226,118,344,Lyg309_T,"-37.79808192, 144.96721013"
431720250606,43,2025-06-06,17,108,171,279,UM2_T,"-37.79844526, 144.96411782"
184820250917,184,2025-09-17,8,340,398,738,Eli124_T,"-37.81512416, 144.96371988"
1311520240610,131,2024-06-10,15,221,83,304,King2_T,"-37.82009057, 144.95758725"
1401020250122,140,2025-01-22,10,99,36,135,Boyd2837_T,"-37.82590962, 144.96185972"
1321520250504,132,2025-05-04,15,136,142,278,King335_T,"-37.81267639, 144.95386444"
1321220250719,132,2025-07-19,12,158,113,271,King335_T,"-37.81267639, 144.95386444"
134420240805,134,2024-08-05,4,39,25,64,Spen201_T,"-37.81694221, 144.95303935"
134720241215,134,2024-12-15,7,162,149,311,Spen201_T,"-37.81694221, 144.95303935"
135320250718,135,2025-07-18,3,20,11,31,Spen161_T,"-37.8172861, 144.95319102"
135020240403,135,2024-04-03,0,18,43,61,Spen161_T,"-37.8172861, 144.95319102"
118520241213,118,2024-12-13,5,0,1,1,Fli114C_T,"-37.81632783, 144.97090512"
118720250828,118,2025-08-28,7,16,7,23,Fli114C_T,"-37.81632783, 144.97090512"
1181520250919,118,2025-09-19,15,20,25,45,Fli114C_T,"-37.81632783, 144.97090512"
852320231029,85,2023-10-29,23,2,6,8,488Mac_T,"-37.79432415, 144.92973378"
852120240630,85,2024-06-30,21,5,7,12,488Mac_T,"-37.79432415, 144.92973378"
17020250530,17,2025-05-30,0,15,14,29,Col15_T,"-37.81362543, 144.97323591"
181620240925,18,2024-09-25,16,423,87,510,Col12_T,"-37.81344862, 144.97305353"
182320250829,18,2025-08-29,23,16,13,29,Col12_T,"-37.81344862, 144.97305353"
182220240511,18,2024-05-11,22,0,4,4,Col12_T,"-37.81344862, 144.97305353"
11920241129,11,2024-11-29,9,65,62,127,WatCit_T,"-37.81564989, 144.93970694"
621120250508,62,2025-05-08,11,178,119,297,Lat224_T,"-37.80996494, 144.96216521"
562120240515,56,2024-05-15,21,184,200,384,Lon364_T,"-37.81234775, 144.96153311"
12520240415,12,2024-04-15,5,7,5,12,NewQ_T,"-37.81457988, 144.94292398"
101220250821,10,2025-08-21,12,201,165,366,BouHbr_T,"-37.81876474, 144.94710545"
121820250917,12,2025-09-17,18,94,176,270,NewQ_T,"-37.81457988, 144.94292398"
72320250912,72,2025-09-12,3,0,6,6,ACMI_T,"-37.81726338, 144.96872809"
351220250326,35,2025-03-26,12,1272,1083,2355,SouthB_T,"-37.82018685, 144.96508508"
21420241218,2,2024-12-18,14,888,1064,1952,Bou283_T,"-37.81380668, 144.96516718"
2520240311,2,2024-03-11,5,2,5,7,Bou283_T,"-37.81380668, 144.96516718"
21220250716,2,2025-07-16,12,879,830,1709,Bou283_T,"-37.81380668, 144.96516718"
791220231201,79,2023-12-01,12,667,500,1167,FliSS_T,"-37.81794046, 144.96616678"
91420250523,9,2025-05-23,14,409,180,589,Col700_T,"-37.81982992, 144.95102555"
232320231128,23,2023-11-28,23,20,45,65,Col623_T,"-37.81909256, 144.95452748"
301020241120,30,2024-11-20,10,162,232,394,Lon189_T,"-37.8112185, 144.96656806"
252220250113,25,2025-01-13,22,161,226,387,MCEC_T,"-37.82401776, 144.95604426"
461720241129,46,2024-11-29,17,75,77,152,Pel147_T,"-37.80240719, 144.9615673"
51820250113,51,2025-01-13,8,51,52,103,Fra118_T,"-37.80841815, 144.95906316"
117820250131,117,2025-01-31,8,415,80,495,Fli114F_T,"-37.81629332, 144.97090877"
491720231111,49,2023-11-11,17,159,198,357,Eli501_T,"-37.80730068, 144.95956055"
191220240823,19,2024-08-23,12,503,396,899,LtB210_T,"-37.81237202, 144.96550671"
137920241110,137,2024-11-10,9,15,14,29,BouHbr2353_T,"-37.81894815, 144.94612292"
139420250101,139,2025-01-01,4,21,4,25,Signal1647_T,"-37.81959923, 144.9632832"
1391120250905,139,2025-09-05,11,61,31,92,Signal1647_T,"-37.81959923, 144.9632832"
1361920231218,136,2023-12-18,19,82,43,125,BirFed1120_T,"-37.8184141, 144.97357915"
1641220250608,164,2025-06-08,12,106,58,164,Lat526_T,"-37.813005, 144.95160411"
1611120241024,161,2024-10-24,11,111,167,278,BirArt1109_T,"-37.81851276, 144.97131336"
841920231111,84,2023-11-11,19,956,1008,1964,ElFi_T,"-37.81798049, 144.96503383"
4720241116,4,2024-11-16,7,121,75,196,Swa123_T,"-37.81487988, 144.9660878"
4520250212,4,2025-02-12,5,41,26,67,Swa123_T,"-37.81487988, 144.9660878"
701820250907,70,2025-09-07,18,137,151,288,Errol20_T,"-37.80456984, 144.94946228"
141120241010,14,2024-10-10,11,435,122,557,SanBri_T,"-37.82011242, 144.96291897"
591320240919,59,2024-09-19,13,1143,1010,2153,RMIT_T,"-37.80825648, 144.96304859"
541320240519,54,2024-05-19,13,190,109,299,Swa607_T,"-37.804024, 144.96308399"
29720250223,29,2025-02-23,7,60,108,168,AG_T,"-37.8199817, 144.96872865"
47920240110,47,2024-01-10,9,298,577,875,Eli250_T,"-37.81258467, 144.9625775"
401620250506,40,2025-05-06,16,186,241,427,Spr201_T,"-37.80999341, 144.97227587"
36620240606,36,2024-06-06,6,28,15,43,Que85_T,"-37.81652527, 144.96121062"
372320240211,37,2024-02-11,23,65,58,123,Lyg260_T,"-37.80107122, 144.96704554"
61120241230,61,2024-12-30,1,56,14,70,RMIT14_T,"-37.80767455, 144.96309114"
1401220231117,140,2023-11-17,12,92,49,141,Boyd2837_T,"-37.82590962, 144.96185972"
1322120250219,132,2025-02-19,21,101,140,241,King335_T,"-37.81267639, 144.95386444"
1352020240117,135,2024-01-17,20,202,190,392,Spen161_T,"-37.8172861, 144.95319102"
133520241116,133,2024-11-16,5,31,60,91,Spen229_T,"-37.81531435, 144.95227769"
118820240417,118,2024-04-17,8,29,14,43,Fli114C_T,"-37.81632783, 144.97090512"
118920231223,118,2023-12-23,9,3,6,9,Fli114C_T,"-37.81632783, 144.97090512"
871720240331,87,2024-03-31,17,41,57,98,Errol23_T,"-37.80454949, 144.94921863"
871920241101,87,2024-11-01,19,115,127,242,Errol23_T,"-37.80454949, 144.94921863"
67020250526,67,2025-05-26,0,11,7,18,FLDegS_T,"-37.81688755, 144.96562569"
1020240921,1,2024-09-21,0,53,76,129,Bou292_T,"-37.81349441, 144.96515323"
681120250312,68,2025-03-12,11,371,260,631,FLDegN_T,"-37.8168479, 144.96559789"
621520231129,62,2023-11-29,15,197,112,309,Lat224_T,"-37.80996494, 144.96216521"
121020240428,12,2024-04-28,10,276,367,643,NewQ_T,"-37.81457988, 144.94292398"
121120250623,12,2025-06-23,11,59,64,123,NewQ_T,"-37.81457988, 144.94292398"
721220231126,72,2023-11-26,12,331,380,711,ACMI_T,"-37.81726338, 144.96872809"
2920231018,2,2023-10-18,9,137,251,388,Bou283_T,"-37.81380668, 144.96516718"
581820231107,58,2023-11-07,18,676,296,972,Bou688_T,"-37.81686075, 144.95358075"
581620231216,58,2023-12-16,16,674,315,989,Bou688_T,"-37.81686075, 144.95358075"
58720250323,58,2025-03-23,7,71,52,123,Bou688_T,"-37.81686075, 144.95358075"
27820241108,27,2024-11-08,8,96,113,209,Vic_T,"-37.80606888, 144.95644692"
27320241223,27,2024-12-23,3,9,7,16,Vic_T,"-37.80606888, 144.95644692"
531120250217,53,2025-02-17,11,746,512,1258,Col254_T,"-37.81564191, 144.965499"
30720241018,30,2024-10-18,7,42,40,82,Lon189_T,"-37.8112185, 144.96656806"
191120240411,19,2024-04-11,11,361,212,573,LtB210_T,"-37.81237202, 144.96550671"
482120240812,48,2024-08-12,21,36,58,94,QVMQ_T,"-37.80631581, 144.95866697"
481720250302,48,2025-03-02,17,144,167,311,QVMQ_T,"-37.80631581, 144.95866697"
461220250126,46,2025-01-26,12,20,18,38,Pel147_T,"-37.80240719, 144.9615673"
1801020250627,180,2025-06-27,10,30,21,51,Mac330_T,"-37.79497059, 144.93530329"
19620250411,19,2025-04-11,6,17,11,28,LtB210_T,"-37.81237202, 144.96550671"
1371420241020,137,2024-10-20,14,12,21,33,BouHbr2353_T,"-37.81894815, 144.94612292"
1392020231124,139,2023-11-24,20,49,36,85,Signal1647_T,"-37.81959923, 144.9632832"
1612120250708,161,2025-07-08,21,3,2,5,BirArt1109_T,"-37.81851276, 144.97131336"
3120250619,3,2025-06-19,1,62,38,100,Swa295_T,"-37.81101524, 144.96429485"
39820240807,39,2024-08-07,8,127,112,239,AlfPl_T,"-37.81379749, 144.96995745"
781220250820,78,2025-08-20,12,53,57,110,HarEsB_T,"-37.81471642, 144.9446508"
781520241124,78,2024-11-24,15,27,56,83,HarEsB_T,"-37.81471642, 144.9446508"
421520250124,42,2025-01-24,15,106,107,213,UM1_T,"-37.80008566, 144.96386412"
291520240705,29,2024-07-05,15,222,366,588,AG_T,"-37.8199817, 144.96872865"
14220240405,14,2024-04-05,2,16,3,19,SanBri_T,"-37.82011242, 144.96291897"
311720240831,31,2024-08-31,17,289,187,476,Lyg161_T,"-37.80169681, 144.96658911"
281120231223,28,2023-12-23,11,505,456,961,VAC_T,"-37.82129925, 144.96879309"
40820240401,40,2024-04-01,8,25,37,62,Spr201_T,"-37.80999341, 144.97227587"
40820240505,40,2024-05-05,8,26,39,65,Spr201_T,"-37.80999341, 144.97227587"
40720241104,40,2024-11-04,7,109,69,178,Spr201_T,"-37.80999341, 144.97227587"
211220231201,21,2023-12-01,12,552,409,961,Bourke155_T,"-37.81267313, 144.96788288"
36620240529,36,2024-05-29,6,38,16,54,Que85_T,"-37.81652527, 144.96121062"
37820250420,37,2025-04-20,8,13,7,20,Lyg260_T,"-37.80107122, 144.96704554"
371320250531,37,2025-05-31,13,85,128,213,Lyg260_T,"-37.80107122, 144.96704554"
681720240105,68,2024-01-05,17,186,141,327,FLDegN_T,"-37.8168479, 144.96559789"
852220250102,85,2025-01-02,22,4,3,7,488Mac_T,"-37.79432415, 144.92973378"
631020240423,63,2024-04-23,10,190,260,450,Bou231_T,"-37.81333081, 144.96675571"
18020251002,18,2025-10-02,0,1,0,1,Col12_T,"-37.81344862, 144.97305353"
861620240226,86,2024-02-26,16,46,74,120,574Qub_T,"-37.80309992, 144.94908064"
111520240831,11,2024-08-31,15,90,91,181,WatCit_T,"-37.81564989, 144.93970694"
112220250227,11,2025-02-27,22,60,67,127,WatCit_T,"-37.81564989, 144.93970694"
621120241231,62,2024-12-31,11,129,77,206,Lat224_T,"-37.80996494, 144.96216521"
86020250923,86,2025-09-23,0,0,1,1,574Qub_T,"-37.80309992, 144.94908064"
11420250505,1,2025-05-05,14,959,948,1907,Bou292_T,"-37.81349441, 144.96515323"
122320240213,12,2024-02-13,23,52,44,96,NewQ_T,"-37.81457988, 144.94292398"
102120250411,10,2025-04-11,21,27,34,61,BouHbr_T,"-37.81876474, 144.94710545"
101120250513,10,2025-05-13,11,87,75,162,BouHbr_T,"-37.81876474, 144.94710545"
102320241026,10,2024-10-26,23,21,13,34,BouHbr_T,"-37.81876474, 144.94710545"
761220240408,76,2024-04-08,12,65,68,133,KenMac_T,"-37.79453803, 144.93036194"
761520240506,76,2024-05-06,15,57,82,139,KenMac_T,"-37.79453803, 144.93036194"
271320250617,27,2025-06-17,13,155,136,291,Vic_T,"-37.80606888, 144.95644692"
23720231025,23,2023-10-25,7,319,177,496,Col623_T,"-37.81909256, 144.95452748"
25520250119,25,2025-01-19,5,7,10,17,MCEC_T,"-37.82401776, 144.95604426"
201620250908,20,2025-09-08,16,112,162,274,LtB170_T,"-37.81172914, 144.9682466"
521220250113,52,2025-01-13,12,336,259,595,Eli263_T,"-37.81252157, 144.9619401"
139320231224,139,2023-12-24,3,6,1,7,Signal1647_T,"-37.81959923, 144.9632832"
1301420240708,130,2024-07-08,14,21,25,46,Bou892T,"-37.8204637, 144.94126826"
1171620240229,117,2024-02-29,16,175,353,528,Fli114F_T,"-37.81629332, 144.97090877"
1171320241005,117,2024-10-05,13,153,171,324,Fli114F_T,"-37.81629332, 144.97090877"
117020250106,117,2025-01-06,0,14,8,22,Fli114F_T,"-37.81629332, 144.97090877"
109120250529,109,2025-05-29,1,6,8,14,LatWill_T,"-37.81193681, 144.95621105"
1091820250531,109,2025-05-31,18,110,106,216,LatWill_T,"-37.81193681, 144.95621105"
1801420250814,180,2025-08-14,14,30,29,59,Mac330_T,"-37.79497059, 144.93530329"
1372320231215,137,2023-12-15,23,9,4,13,BouHbr2353_T,"-37.81894815, 144.94612292"
441820250822,44,2025-08-22,18,55,62,117,UM3_T,"-37.79698741, 144.96441306"
1351120240304,135,2024-03-04,11,358,407,765,Spen161_T,"-37.8172861, 144.95319102"
391120250202,39,2025-02-02,11,66,40,106,AlfPl_T,"-37.81379749, 144.96995745"
39820240314,39,2024-03-14,8,162,189,351,AlfPl_T,"-37.81379749, 144.96995745"
8520250909,8,2025-09-09,5,7,5,12,WebBN_T,"-37.82293543, 144.9471751"
81020240827,8,2024-08-27,10,112,103,215,WebBN_T,"-37.82293543, 144.9471751"
751920250326,75,2025-03-26,19,31,28,59,SprFli_T,"-37.81515276, 144.97467661"
751820231207,75,2023-12-07,18,84,73,157,SprFli_T,"-37.81515276, 144.97467661"
41520250115,41,2025-01-15,5,102,74,176,Swa31,"-37.81668634, 144.96689733"
77220241021,77,2024-10-21,2,4,6,10,HarEsP_T,"-37.81441438, 144.94433026"
781620240520,78,2024-05-20,16,23,132,155,HarEsB_T,"-37.81471642, 144.9446508"
291320240823,29,2024-08-23,13,236,303,539,AG_T,"-37.8199817, 144.96872865"
142220251005,14,2025-10-05,22,187,45,232,SanBri_T,"-37.82011242, 144.96291897"
542120250126,54,2025-01-26,21,58,57,115,Swa607_T,"-37.804024, 144.96308399"
28020251011,28,2025-10-11,0,74,27,101,VAC_T,"-37.82129925, 144.96879309"
281320241229,28,2024-12-29,13,1424,1227,2651,VAC_T,"-37.82129925, 144.96879309"
471220250827,47,2025-08-27,12,743,853,1596,Eli250_T,"-37.81258467, 144.9625775"
471420240606,47,2024-06-06,14,824,700,1524,Eli250_T,"-37.81258467, 144.9625775"
402320251011,40,2025-10-11,23,97,28,125,Spr201_T,"-37.80999341, 144.97227587"
311620250215,31,2025-02-15,16,178,200,378,Lyg161_T,"-37.80169681, 144.96658911"
371120251016,37,2025-10-16,11,77,87,164,Lyg260_T,"-37.80107122, 144.96704554"
441820240531,44,2024-05-31,18,45,65,110,UM3_T,"-37.79698741, 144.96441306"
51920250903,5,2025-09-03,19,548,937,1485,PriNW_T,"-37.81874249, 144.96787656"
211220231211,21,2023-12-11,12,466,382,848,Bourke155_T,"-37.81267313, 144.96788288"
1071920250724,107,2025-07-24,19,95,81,176,280Will_T,"-37.81246271, 144.95690188"
1071520231231,107,2023-12-31,15,73,116,189,280Will_T,"-37.81246271, 144.95690188"
611420240802,61,2024-08-02,14,547,580,1127,RMIT14_T,"-37.80767455, 144.96309114"
611320241221,61,2024-12-21,13,254,373,627,RMIT14_T,"-37.80767455, 144.96309114"
501920250903,50,2025-09-03,19,156,103,259,Lyg309_T,"-37.79808192, 144.96721013"
431620250208,43,2025-02-08,16,57,41,98,UM2_T,"-37.79844526, 144.96411782"
432220240808,43,2024-08-08,22,52,61,113,UM2_T,"-37.79844526, 144.96411782"
1312320250103,131,2025-01-03,23,127,54,181,King2_T,"-37.82009057, 144.95758725"
167520241108,167,2024-11-08,5,1,5,6,Lat526_T,"-37.81304149, 144.95155955"
1321520241230,132,2024-12-30,15,124,86,210,King335_T,"-37.81267639, 144.95386444"
1321720231203,132,2023-12-03,17,148,112,260,King335_T,"-37.81267639, 144.95386444"
1311820240219,131,2024-02-19,18,93,116,209,King2_T,"-37.82009057, 144.95758725"
135620250121,135,2025-01-21,6,100,88,188,Spen161_T,"-37.8172861, 144.95319102"
1332220241230,133,2024-12-30,22,281,274,555,Spen229_T,"-37.81531435, 144.95227769"
85120250830,85,2025-08-30,1,0,3,3,488Mac_T,"-37.79432415, 144.92973378"
17720231203,17,2023-12-03,7,29,18,47,Col15_T,"-37.81362543, 144.97323591"
171320240217,17,2024-02-17,13,253,223,476,Col15_T,"-37.81362543, 144.97323591"
11320240405,1,2024-04-05,13,1521,1377,2898,Bou292_T,"-37.81349441, 144.96515323"
682220240911,68,2024-09-11,22,21,3,24,FLDegN_T,"-37.8168479, 144.96559789"
112020240427,11,2024-04-27,20,29,49,78,WatCit_T,"-37.81564989, 144.93970694"
24420241228,24,2024-12-28,4,20,16,36,Col620_T,"-37.81887963, 144.95449198"
72720231106,72,2023-11-06,7,119,36,155,ACMI_T,"-37.81726338, 144.96872809"
121920251004,12,2025-10-04,19,168,118,286,NewQ_T,"-37.81457988, 144.94292398"
352220241126,35,2024-11-26,22,440,620,1060,SouthB_T,"-37.82018685, 144.96508508"
582120250209,58,2025-02-09,21,188,209,397,Bou688_T,"-37.81686075, 144.95358075"
58620240605,58,2024-06-05,6,240,67,307,Bou688_T,"-37.81686075, 144.95358075"
53620231112,53,2023-11-12,6,10,9,19,Col254_T,"-37.81564191, 144.965499"
1241420250201,124,2025-02-01,14,6,12,18,BirBridge_T,"-37.81757416, 144.97329934"
1071220241005,107,2024-10-05,12,128,194,322,280Will_T,"-37.81246271, 144.95690188"
1822120250614,182,2025-06-14,21,210,202,412,King163_T,"-37.81627451, 144.95550503"
1651420241231,165,2024-12-31,14,36,30,66,Spen475_T,"-37.80953359, 144.94939004"
1652120251016,165,2025-10-16,21,42,5,47,Spen475_T,"-37.80953359, 144.94939004"
1672120250202,167,2025-02-02,21,13,16,29,Lat526_T,"-37.81304149, 144.95155955"
1321720231022,132,2023-10-22,17,132,76,208,King335_T,"-37.81267639, 144.95386444"
1341320250518,134,2025-05-18,13,306,317,623,Spen201_T,"-37.81694221, 144.95303935"
852120241112,85,2024-11-12,21,14,7,21,488Mac_T,"-37.79432415, 144.92973378"
17320231205,17,2023-12-05,3,13,3,16,Col15_T,"-37.81362543, 144.97323591"
11720240528,1,2024-05-28,17,1083,715,1798,Bou292_T,"-37.81349441, 144.96515323"
121420240530,12,2024-05-30,14,100,98,198,NewQ_T,"-37.81457988, 144.94292398"
12820250319,12,2025-03-19,8,191,158,349,NewQ_T,"-37.81457988, 144.94292398"
24720250816,24,2025-08-16,7,178,187,365,Col620_T,"-37.81887963, 144.95449198"
581320240602,58,2024-06-02,13,549,251,800,Bou688_T,"-37.81686075, 144.95358075"
351720231122,35,2023-11-22,17,2513,1808,4321,SouthB_T,"-37.82018685, 144.96508508"
35920231209,35,2023-12-09,9,474,354,828,SouthB_T,"-37.82018685, 144.96508508"
76320240323,76,2024-03-23,3,1,0,1,KenMac_T,"-37.79453803, 144.93036194"
21720241113,2,2024-11-13,17,528,592,1120,Bou283_T,"-37.81380668, 144.96516718"
53920240426,53,2024-04-26,9,493,385,878,Col254_T,"-37.81564191, 144.965499"
232220240911,23,2024-09-11,22,32,170,202,Col623_T,"-37.81909256, 144.95452748"
511820231128,51,2023-11-28,18,99,73,172,Fra118_T,"-37.80841815, 144.95906316"
251020250807,25,2025-08-07,10,122,326,448,MCEC_T,"-37.82401776, 144.95604426"
25520251009,25,2025-10-09,5,34,40,74,MCEC_T,"-37.82401776, 144.95604426"
461820250829,46,2025-08-29,18,33,41,74,Pel147_T,"-37.80240719, 144.9615673"
201120250522,20,2025-05-22,11,163,156,319,LtB170_T,"-37.81172914, 144.9682466"
20120250623,20,2025-06-23,1,5,11,16,LtB170_T,"-37.81172914, 144.9682466"
201020240327,20,2024-03-27,10,111,90,201,LtB170_T,"-37.81172914, 144.9682466"
201520250909,20,2025-09-09,15,141,201,342,LtB170_T,"-37.81172914, 144.9682466"
251220231215,25,2023-12-15,12,584,1040,1624,MCEC_T,"-37.82401776, 144.95604426"
1362220240402,136,2024-04-02,22,1,0,1,BirFed1120_T,"-37.8184141, 144.97357915"
142120240813,142,2024-08-13,1,2,0,2,Hammer1584_T,"-37.81970749, 144.96795734"
1302220250422,130,2025-04-22,22,2,4,6,Bou892T,"-37.8204637, 144.94126826"
1231720241019,123,2024-10-19,17,14,2,16,BirBridge_T,"-37.81753741, 144.97329734"
1092220240921,109,2024-09-21,22,42,87,129,LatWill_T,"-37.81193681, 144.95621105"
1801020250524,180,2025-05-24,10,54,31,85,Mac330_T,"-37.79497059, 144.93530329"
1392320250531,139,2025-05-31,23,9,6,15,Signal1647_T,"-37.81959923, 144.9632832"
139120250901,139,2025-09-01,1,2,0,2,Signal1647_T,"-37.81959923, 144.9632832"
841420231106,84,2023-11-06,14,1271,1447,2718,ElFi_T,"-37.81798049, 144.96503383"
841220241203,84,2024-12-03,12,980,1182,2162,ElFi_T,"-37.81798049, 144.96503383"
1381020241220,138,2024-12-20,10,2,1,3,EntPark1671_T,"-37.81996544, 144.95981454"
130620231216,130,2023-12-16,6,1,4,5,Bou892T,"-37.8204637, 144.94126826"
117820240823,117,2024-08-23,8,211,105,316,Fli114F_T,"-37.81629332, 144.97090877"
69120240413,69,2024-04-13,1,5,1,6,FLDegC_T,"-37.81687226, 144.96559144"
61620240927,6,2024-09-27,16,1338,1156,2494,FliS_T,"-37.81911705, 144.96558255"
6220250522,6,2025-05-22,2,7,12,19,FliS_T,"-37.81911705, 144.96558255"
84220241230,84,2024-12-30,2,39,39,78,ElFi_T,"-37.81798049, 144.96503383"
4020240523,4,2024-05-23,0,50,49,99,Swa123_T,"-37.81487988, 144.9660878"
41620250610,4,2025-06-10,16,1275,1103,2378,Swa123_T,"-37.81487988, 144.9660878"
70220240119,70,2024-01-19,2,1,1,2,Errol20_T,"-37.80456984, 144.94946228"
702020241228,70,2024-12-28,20,112,97,209,Errol20_T,"-37.80456984, 144.94946228"
31220241230,3,2024-12-30,12,770,993,1763,Swa295_T,"-37.81101524, 144.96429485"
411220240209,41,2024-02-09,12,1750,1336,3086,Swa31,"-37.81668634, 144.96689733"
782120231119,78,2023-11-19,21,7,15,22,HarEsB_T,"-37.81471642, 144.9446508"
592120250614,59,2025-06-14,21,359,228,587,RMIT_T,"-37.80825648, 144.96304859"
71220250125,71,2025-01-25,2,12,4,16,WestWP_T,"-37.81235775, 144.97136962"
651820240324,65,2024-03-24,18,716,487,1203,SwaCs_T,"-37.81569416, 144.9668064"
291520250723,29,2025-07-23,15,163,220,383,AG_T,"-37.8199817, 144.96872865"
401520240714,40,2024-07-14,15,136,142,278,Spr201_T,"-37.80999341, 144.97227587"
36820240310,36,2024-03-10,8,32,28,60,Que85_T,"-37.81652527, 144.96121062"
611220251005,61,2025-10-05,12,200,384,584,RMIT14_T,"-37.80767455, 144.96309114"
441320240820,44,2024-08-20,13,99,113,212,UM3_T,"-37.79698741, 144.96441306"
44020241121,44,2024-11-21,0,0,1,1,UM3_T,"-37.79698741, 144.96441306"
451020240508,45,2024-05-08,10,299,289,588,Swa148_T,"-37.81414075, 144.96609379"
45920240206,45,2024-02-06,9,340,327,667,Swa148_T,"-37.81414075, 144.96609379"
21920240614,21,2024-06-14,9,98,145,243,Bourke155_T,"-37.81267313, 144.96788288"
1401820241120,140,2024-11-20,18,129,137,266,Boyd2837_T,"-37.82590962, 144.96185972"
1401020241123,140,2024-11-23,10,123,34,157,Boyd2837_T,"-37.82590962, 144.96185972"
162620250406,162,2025-04-06,6,42,22,64,Eli489_T,"-37.80740397, 144.95987909"
1082120250525,108,2025-05-25,21,92,96,188,261Will_T,"-37.81295822, 144.95678789"
1431820240722,143,2024-07-22,18,95,138,233,Spencer_T,"-37.821728, 144.95557015"
1311820241023,131,2024-10-23,18,164,211,375,King2_T,"-37.82009057, 144.95758725"
135220240406,135,2024-04-06,2,19,21,40,Spen161_T,"-37.8172861, 144.95319102"
1351920250217,135,2025-02-17,19,259,294,553,Spen161_T,"-37.8172861, 144.95319102"
107620241025,107,2024-10-25,6,14,24,38,280Will_T,"-37.81246271, 144.95690188"
133520240401,133,2024-04-01,5,27,61,88,Spen229_T,"-37.81531435, 144.95227769"
107520240912,107,2024-09-12,5,6,5,11,280Will_T,"-37.81246271, 144.95690188"
871120240514,87,2024-05-14,11,92,76,168,Errol23_T,"-37.80454949, 144.94921863"
167820250415,167,2025-04-15,8,35,95,130,Lat526_T,"-37.81304149, 144.95155955"
1920241120,1,2024-11-20,9,369,507,876,Bou292_T,"-37.81349441, 144.96515323"
62620250508,62,2025-05-08,6,54,12,66,Lat224_T,"-37.80996494, 144.96216521"
861920240228,86,2024-02-28,19,43,76,119,574Qub_T,"-37.80309992, 144.94908064"
111620250311,11,2025-03-11,16,46,34,80,WatCit_T,"-37.81564989, 144.93970694"
11020240111,11,2024-01-11,0,12,4,16,WatCit_T,"-37.81564989, 144.93970694"
24820231129,24,2023-11-29,8,2200,362,2562,Col620_T,"-37.81887963, 144.95449198"
101820240307,10,2024-03-07,18,75,50,125,BouHbr_T,"-37.81876474, 144.94710545"
101920240901,10,2024-09-01,19,13,16,29,BouHbr_T,"-37.81876474, 144.94710545"
24320250423,24,2025-04-23,3,20,15,35,Col620_T,"-37.81887963, 144.95449198"
48620240527,48,2024-05-27,6,27,22,49,QVMQ_T,"-37.80631581, 144.95866697"
481720231027,48,2023-10-27,17,144,148,292,QVMQ_T,"-37.80631581, 144.95866697"
481320231215,48,2023-12-15,13,365,281,646,QVMQ_T,"-37.80631581, 144.95866697"
461720240709,46,2024-07-09,17,99,66,165,Pel147_T,"-37.80240719, 144.9615673"
20520240910,20,2024-09-10,5,7,12,19,LtB170_T,"-37.81172914, 144.9682466"
1411820250404,141,2025-04-04,18,137,110,247,474Fl_T,"-37.81997273, 144.95834911"
139920250309,139,2025-03-09,9,27,31,58,Signal1647_T,"-37.81959923, 144.9632832"
1381220231214,138,2023-12-14,12,9,4,13,EntPark1671_T,"-37.81996544, 144.95981454"
1301620240419,130,2024-04-19,16,17,24,41,Bou892T,"-37.8204637, 144.94126826"
1171120240714,117,2024-07-14,11,120,152,272,Fli114F_T,"-37.81629332, 144.97090877"
49620240120,49,2024-01-20,6,49,28,77,Eli501_T,"-37.80730068, 144.95956055"
692020231118,69,2023-11-18,20,46,29,75,FLDegC_T,"-37.81687226, 144.96559144"
3120240326,3,2024-03-26,1,100,77,177,Swa295_T,"-37.81101524, 144.96429485"
3920250430,3,2025-04-30,9,292,339,631,Swa295_T,"-37.81101524, 144.96429485"
32020250521,3,2025-05-21,20,672,578,1250,Swa295_T,"-37.81101524, 144.96429485"
752120250724,75,2025-07-24,21,21,16,37,SprFli_T,"-37.81515276, 144.97467661"
411620240805,41,2024-08-05,16,230,197,427,Swa31,"-37.81668634, 144.96689733"
781820250814,78,2025-08-14,18,9,23,32,HarEsB_T,"-37.81471642, 144.9446508"
14220240223,14,2024-02-23,2,9,3,12,SanBri_T,"-37.82011242, 144.96291897"
711220250807,71,2025-08-07,12,33,22,55,WestWP_T,"-37.81235775, 144.97136962"
282120250717,28,2025-07-17,21,575,656,1231,VAC_T,"-37.82129925, 144.96879309"
47220240128,47,2024-01-28,2,109,79,188,Eli250_T,"-37.81258467, 144.9625775"
402320250907,40,2025-09-07,23,14,8,22,Spr201_T,"-37.80999341, 144.97227587"
402320240606,40,2024-06-06,23,31,7,38,Spr201_T,"-37.80999341, 144.97227587"
311420240221,31,2024-02-21,14,148,161,309,Lyg161_T,"-37.80169681, 144.96658911"
361020250323,36,2025-03-23,10,131,88,219,Que85_T,"-37.81652527, 144.96121062"
36620240710,36,2024-07-10,6,30,18,48,Que85_T,"-37.81652527, 144.96121062"
372320250625,37,2025-06-25,23,12,18,30,Lyg260_T,"-37.80107122, 144.96704554"
611620250712,61,2025-07-12,16,309,400,709,RMIT14_T,"-37.80767455, 144.96309114"
431320250319,43,2025-03-19,13,362,351,713,UM2_T,"-37.79844526, 144.96411782"
43320250614,43,2025-06-14,3,2,4,6,UM2_T,"-37.79844526, 144.96411782"
451120240804,45,2024-08-04,11,787,469,1256,Swa148_T,"-37.81414075, 144.96609379"
452320231207,45,2023-12-07,23,579,328,907,Swa148_T,"-37.81414075, 144.96609379"
1431720240505,143,2024-05-05,17,323,238,561,Spencer_T,"-37.821728, 144.95557015"
1352320250517,135,2025-05-17,23,94,132,226,Spen161_T,"-37.8172861, 144.95319102"
1331520241211,133,2024-12-11,15,573,710,1283,Spen229_T,"-37.81531435, 144.95227769"
182120250817,182,2025-08-17,1,109,111,220,King163_T,"-37.81627451, 144.95550503"
1662320250414,166,2025-04-14,23,6,5,11,Spen484_T,"-37.80896733, 144.94931703"
1651020250708,165,2025-07-08,10,18,28,46,Spen475_T,"-37.80953359, 144.94939004"
48820250609,48,2025-06-09,8,54,22,76,QVMQ_T,"-37.80631581, 144.95866697"
67520241210,67,2024-12-10,5,10,12,22,FLDegS_T,"-37.81688755, 144.96562569"
41020250605,41,2025-06-05,0,76,69,145,Swa31,"-37.81668634, 144.96689733"
82220240311,8,2024-03-11,22,23,28,51,WebBN_T,"-37.82293543, 144.9471751"
8820240528,8,2024-05-28,8,298,148,446,WebBN_T,"-37.82293543, 144.9471751"
65620240316,65,2024-03-16,6,12,25,37,SwaCs_T,"-37.81569416, 144.9668064"
59020240428,59,2024-04-28,0,146,72,218,RMIT_T,"-37.80825648, 144.96304859"
711620250326,71,2025-03-26,16,23,16,39,WestWP_T,"-37.81235775, 144.97136962"
141520250803,14,2025-08-03,15,402,158,560,SanBri_T,"-37.82011242, 144.96291897"
14820240706,14,2024-07-06,8,115,51,166,SanBri_T,"-37.82011242, 144.96291897"
311220241012,31,2024-10-12,12,224,147,371,Lyg161_T,"-37.80169681, 144.96658911"
542220251007,54,2025-10-07,22,70,86,156,Swa607_T,"-37.804024, 144.96308399"
45020240110,45,2024-01-10,0,41,93,134,Swa148_T,"-37.81414075, 144.96609379"
51720231026,5,2023-10-26,17,1308,1063,2371,PriNW_T,"-37.81874249, 144.96787656"
212220250525,21,2025-05-25,22,97,139,236,Bourke155_T,"-37.81267313, 144.96788288"
44720250929,44,2025-09-29,7,29,24,53,UM3_T,"-37.79698741, 144.96441306"
432320231226,43,2023-12-26,23,2,1,3,UM2_T,"-37.79844526, 144.96411782"
451620250803,45,2025-08-03,16,705,1231,1936,Swa148_T,"-37.81414075, 144.96609379"
133820250604,133,2025-06-04,8,393,430,823,Spen229_T,"-37.81531435, 144.95227769"
87020250812,87,2025-08-12,0,1,5,6,Errol23_T,"-37.80454949, 144.94921863"
87320250408,87,2025-04-08,3,1,0,1,Errol23_T,"-37.80454949, 144.94921863"
61620250810,61,2025-08-10,6,6,26,32,RMIT14_T,"-37.80767455, 144.96309114"
61620241120,61,2024-11-20,6,39,75,114,RMIT14_T,"-37.80767455, 144.96309114"
1661920250226,166,2025-02-26,19,97,78,175,Spen484_T,"-37.80896733, 144.94931703"
1651220250925,165,2025-09-25,12,31,45,76,Spen475_T,"-37.80953359, 144.94939004"
1811120250518,181,2025-05-18,11,452,937,1389,Eli368_T,"-37.81009465, 144.96143149"
181320251001,181,2025-10-01,3,27,25,52,Eli368_T,"-37.81009465, 144.96143149"
140820240426,140,2024-04-26,8,152,24,176,Boyd2837_T,"-37.82590962, 144.96185972"
132320240925,132,2024-09-25,3,2,2,4,King335_T,"-37.81267639, 144.95386444"
67520250520,67,2025-05-20,5,8,12,20,FLDegS_T,"-37.81688755, 144.96562569"
85320231230,85,2023-12-30,3,0,2,2,488Mac_T,"-37.79432415, 144.92973378"
17420240802,17,2024-08-02,4,9,7,16,Col15_T,"-37.81362543, 144.97323591"
181120231025,18,2023-10-25,11,170,243,413,Col12_T,"-37.81344862, 144.97305353"
62520231216,62,2023-12-16,5,24,38,62,Lat224_T,"-37.80996494, 144.96216521"
62020240727,62,2024-07-27,0,80,46,126,Lat224_T,"-37.80996494, 144.96216521"
621720241110,62,2024-11-10,17,327,354,681,Lat224_T,"-37.80996494, 144.96216521"
56620240202,56,2024-02-02,6,21,32,53,Lon364_T,"-37.81234775, 144.96153311"
671520241123,67,2024-11-23,15,341,509,850,FLDegS_T,"-37.81688755, 144.96562569"
241020240705,24,2024-07-05,10,892,420,1312,Col620_T,"-37.81887963, 144.95449198"
24020241126,24,2024-11-26,0,49,42,91,Col620_T,"-37.81887963, 144.95449198"
10520240607,10,2024-06-07,5,1,2,3,BouHbr_T,"-37.81876474, 144.94710545"
76920250711,76,2025-07-11,9,69,48,117,KenMac_T,"-37.79453803, 144.93036194"
351920240701,35,2024-07-01,19,532,778,1310,SouthB_T,"-37.82018685, 144.96508508"
761420231025,76,2023-10-25,14,36,52,88,KenMac_T,"-37.79453803, 144.93036194"
761820240220,76,2024-02-20,18,66,71,137,KenMac_T,"-37.79453803, 144.93036194"
91120250918,9,2025-09-18,11,303,368,671,Col700_T,"-37.81982992, 144.95102555"
23120231019,23,2023-10-19,1,17,17,34,Col623_T,"-37.81909256, 144.95452748"
231820240330,23,2024-03-30,18,81,132,213,Col623_T,"-37.81909256, 144.95452748"
511920240310,51,2024-03-10,19,132,59,191,Fra118_T,"-37.80841815, 144.95906316"
46720240705,46,2024-07-05,7,23,17,40,Pel147_T,"-37.80240719, 144.9615673"
46420231125,46,2023-11-25,4,2,1,3,Pel147_T,"-37.80240719, 144.9615673"
20220241211,20,2024-12-11,2,7,7,14,LtB170_T,"-37.81172914, 144.9682466"
52520250420,52,2025-04-20,5,11,15,26,Eli263_T,"-37.81252157, 144.9619401"
139120240324,139,2024-03-24,1,1,6,7,Signal1647_T,"-37.81959923, 144.9632832"
301020250127,30,2025-01-27,10,67,170,237,Lon189_T,"-37.8112185, 144.96656806"
301420250819,30,2025-08-19,14,220,394,614,Lon189_T,"-37.8112185, 144.96656806"
201920241030,20,2024-10-30,19,307,390,697,LtB170_T,"-37.81172914, 144.9682466"
25120250626,25,2025-06-26,1,6,3,9,MCEC_T,"-37.82401776, 144.95604426"
461820231125,46,2023-11-25,18,40,45,85,Pel147_T,"-37.80240719, 144.9615673"
52020240123,52,2024-01-23,0,7,18,25,Eli263_T,"-37.81252157, 144.9619401"
511820250411,51,2025-04-11,18,137,128,265,Fra118_T,"-37.80841815, 144.95906316"
51620231105,51,2023-11-05,6,9,17,26,Fra118_T,"-37.80841815, 144.95906316"
117120250409,117,2025-04-09,1,14,8,22,Fli114F_T,"-37.81629332, 144.97090877"
1092120231104,109,2023-11-04,21,54,61,115,LatWill_T,"-37.81193681, 144.95621105"
109720240121,109,2024-01-21,7,20,23,43,LatWill_T,"-37.81193681, 144.95621105"
191720250626,19,2025-06-26,17,796,427,1223,LtB210_T,"-37.81237202, 144.96550671"
191220241030,19,2024-10-30,12,566,445,1011,LtB210_T,"-37.81237202, 144.96550671"
48620241123,48,2024-11-23,6,35,50,85,QVMQ_T,"-37.80631581, 144.95866697"
48720250727,48,2025-07-27,7,37,24,61,QVMQ_T,"-37.80631581, 144.95866697"
1371620240922,137,2024-09-22,16,7,12,19,BouHbr2353_T,"-37.81894815, 144.94612292"
137720250227,137,2025-02-27,7,41,13,54,BouHbr2353_T,"-37.81894815, 144.94612292"
1372120250622,137,2025-06-22,21,2,1,3,BouHbr2353_T,"-37.81894815, 144.94612292"
139720250915,139,2025-09-15,7,19,140,159,Signal1647_T,"-37.81959923, 144.9632832"
1361220250119,136,2025-01-19,12,125,138,263,BirFed1120_T,"-37.8184141, 144.97357915"
1362320250310,136,2025-03-10,23,12,2,14,BirFed1120_T,"-37.8184141, 144.97357915"
142720231208,142,2023-12-08,7,160,115,275,Hammer1584_T,"-37.81970749, 144.96795734"
1231420250705,123,2025-07-05,14,48,18,66,BirBridge_T,"-37.81753741, 144.97329734"
164820250321,164,2025-03-21,8,95,34,129,Lat526_T,"-37.813005, 144.95160411"
138120240127,138,2024-01-27,1,1,0,1,EntPark1671_T,"-37.81996544, 144.95981454"
123520240105,123,2024-01-05,5,3,5,8,BirBridge_T,"-37.81753741, 144.97329734"
661120250718,66,2025-07-18,11,739,855,1594,QVN_T,"-37.81057846, 144.96444294"
4020240411,4,2024-04-11,0,126,175,301,Swa123_T,"-37.81487988, 144.9660878"
701920231130,70,2023-11-30,19,135,216,351,Errol20_T,"-37.80456984, 144.94946228"
70820250611,70,2025-06-11,8,74,56,130,Errol20_T,"-37.80456984, 144.94946228"
782120240530,78,2024-05-30,21,3,3,6,HarEsB_T,"-37.81471642, 144.9446508"
781120240701,78,2024-07-01,11,29,116,145,HarEsB_T,"-37.81471642, 144.9446508"
78020240708,78,2024-07-08,0,2,2,4,HarEsB_T,"-37.81471642, 144.9446508"
71920240111,71,2024-01-11,9,46,29,75,WestWP_T,"-37.81235775, 144.97136962"
71920250413,71,2025-04-13,9,5,1,6,WestWP_T,"-37.81235775, 144.97136962"
591820241026,59,2024-10-26,18,295,277,572,RMIT_T,"-37.80825648, 144.96304859"
65320231023,65,2023-10-23,3,1,2,3,SwaCs_T,"-37.81569416, 144.9668064"
54420250209,54,2025-02-09,4,6,4,10,Swa607_T,"-37.804024, 144.96308399"
401420240921,40,2024-09-21,14,165,162,327,Spr201_T,"-37.80999341, 144.97227587"
401220250531,40,2025-05-31,12,151,211,362,Spr201_T,"-37.80999341, 144.97227587"
311220250312,31,2025-03-12,12,154,122,276,Lyg161_T,"-37.80169681, 144.96658911"
372220240315,37,2024-03-15,22,193,264,457,Lyg260_T,"-37.80107122, 144.96704554"
441120240401,44,2024-04-01,11,4,13,17,UM3_T,"-37.79698741, 144.96441306"
441820240807,44,2024-08-07,18,78,112,190,UM3_T,"-37.79698741, 144.96441306"
1072020250407,107,2025-04-07,20,79,61,140,280Will_T,"-37.81246271, 144.95690188"
1072220250718,107,2025-07-18,22,69,46,115,280Will_T,"-37.81246271, 144.95690188"
1072320240608,107,2024-06-08,23,50,45,95,280Will_T,"-37.81246271, 144.95690188"
118920240229,118,2024-02-29,9,33,15,48,Fli114C_T,"-37.81632783, 144.97090512"
108420240603,108,2024-06-03,4,2,5,7,261Will_T,"-37.81295822, 144.95678789"
50020231213,50,2023-12-13,0,2,3,5,Lyg309_T,"-37.79808192, 144.96721013"
50520240229,50,2024-02-29,5,5,2,7,Lyg309_T,"-37.79808192, 144.96721013"
50420241119,50,2024-11-19,4,9,0,9,Lyg309_T,"-37.79808192, 144.96721013"
43320250511,43,2025-05-11,3,3,0,3,UM2_T,"-37.79844526, 144.96411782"
1662120250809,166,2025-08-09,21,6,5,11,Spen484_T,"-37.80896733, 144.94931703"
162520250420,162,2025-04-20,5,37,17,54,Eli489_T,"-37.80740397, 144.95987909"
1401920240101,140,2024-01-01,19,79,88,167,Boyd2837_T,"-37.82590962, 144.96185972"
140720240209,140,2024-02-09,7,81,20,101,Boyd2837_T,"-37.82590962, 144.96185972"
1431220250521,143,2025-05-21,12,139,238,377,Spencer_T,"-37.821728, 144.95557015"
1312220231028,131,2023-10-28,22,344,170,514,King2_T,"-37.82009057, 144.95758725"
131320231222,131,2023-12-22,3,36,40,76,King2_T,"-37.82009057, 144.95758725"
135720241005,135,2024-10-05,7,134,109,243,Spen161_T,"-37.8172861, 144.95319102"
133920231212,133,2023-12-12,9,408,443,851,Spen229_T,"-37.81531435, 144.95227769"
852320240606,85,2024-06-06,23,2,7,9,488Mac_T,"-37.79432415, 144.92973378"
85420240930,85,2024-09-30,4,1,0,1,488Mac_T,"-37.79432415, 144.92973378"
171520250412,17,2025-04-12,15,192,135,327,Col15_T,"-37.81362543, 144.97323591"
11420231230,1,2023-12-30,14,1628,1829,3457,Bou292_T,"-37.81349441, 144.96515323"
11420250513,1,2025-05-13,14,1080,916,1996,Bou292_T,"-37.81349441, 144.96515323"
18620240404,18,2024-04-04,6,1,22,23,Col12_T,"-37.81344862, 144.97305353"
181420240922,18,2024-09-22,14,73,60,133,Col12_T,"-37.81344862, 144.97305353"
671220240518,67,2024-05-18,12,413,495,908,FLDegS_T,"-37.81688755, 144.96562569"
562220231119,56,2023-11-19,22,115,103,218,Lon364_T,"-37.81234775, 144.96153311"
862020240205,86,2024-02-05,20,24,51,75,574Qub_T,"-37.80309992, 144.94908064"
11620231118,11,2023-11-18,6,12,10,22,WatCit_T,"-37.81564989, 144.93970694"
121220240320,12,2024-03-20,12,160,264,424,NewQ_T,"-37.81457988, 144.94292398"
2920231129,2,2023-11-29,9,147,215,362,Bou283_T,"-37.81380668, 144.96516718"
351520240131,35,2024-01-31,15,911,896,1807,SouthB_T,"-37.82018685, 144.96508508"
761320240130,76,2024-01-30,13,49,56,105,KenMac_T,"-37.79453803, 144.93036194"
76920240306,76,2024-03-06,9,78,74,152,KenMac_T,"-37.79453803, 144.93036194"
231720231021,23,2023-10-21,17,120,224,344,Col623_T,"-37.81909256, 144.95452748"
231720250407,23,2025-04-07,17,261,684,945,Col623_T,"-37.81909256, 144.95452748"
51920240411,51,2024-04-11,9,84,84,168,Fra118_T,"-37.80841815, 144.95906316"
191720240117,19,2024-01-17,17,558,439,997,LtB210_T,"-37.81237202, 144.96550671"
48620250111,48,2025-01-11,6,18,33,51,QVMQ_T,"-37.80631581, 144.95866697"
46620240623,46,2024-06-23,6,4,1,5,Pel147_T,"-37.80240719, 144.9615673"
202120231111,20,2023-11-11,21,324,553,877,LtB170_T,"-37.81172914, 144.9682466"
521320240719,52,2024-07-19,13,426,390,816,Eli263_T,"-37.81252157, 144.9619401"
142120250216,142,2025-02-16,1,2,3,5,Hammer1584_T,"-37.81970749, 144.96795734"
1361020231126,136,2023-11-26,10,67,46,113,BirFed1120_T,"-37.8184141, 144.97357915"
1362320240310,136,2024-03-10,23,8,6,14,BirFed1120_T,"-37.8184141, 144.97357915"
161820250209,161,2025-02-09,8,123,125,248,BirArt1109_T,"-37.81851276, 144.97131336"
164920250201,164,2025-02-01,9,67,32,99,Lat526_T,"-37.813005, 144.95160411"
161120250116,161,2025-01-16,1,0,3,3,BirArt1109_T,"-37.81851276, 144.97131336"
1231820241124,123,2024-11-24,18,12,2,14,BirBridge_T,"-37.81753741, 144.97329734"
130820240728,130,2024-07-28,8,1,1,2,Bou892T,"-37.8204637, 144.94126826"
6320250108,6,2025-01-08,3,16,22,38,FliS_T,"-37.81911705, 144.96558255"
31420231203,3,2023-12-03,14,1540,1678,3218,Swa295_T,"-37.81101524, 144.96429485"
81620240115,8,2024-01-15,16,164,269,433,WebBN_T,"-37.82293543, 144.9471751"
411220231229,41,2023-12-29,12,2041,1429,3470,Swa31,"-37.81668634, 144.96689733"
41420240310,41,2024-03-10,4,81,124,205,Swa31,"-37.81668634, 144.96689733"
8220250815,8,2025-08-15,2,1,0,1,WebBN_T,"-37.82293543, 144.9471751"
42520241204,42,2024-12-04,5,2,4,6,UM1_T,"-37.80008566, 144.96386412"
421920241212,42,2024-12-12,19,62,83,145,UM1_T,"-37.80008566, 144.96386412"
291420240430,29,2024-04-30,14,135,287,422,AG_T,"-37.8199817, 144.96872865"
711220241117,71,2024-11-17,12,15,10,25,WestWP_T,"-37.81235775, 144.97136962"
282320240720,28,2024-07-20,23,66,75,141,VAC_T,"-37.82129925, 144.96879309"
47220240913,47,2024-09-13,2,21,24,45,Eli250_T,"-37.81258467, 144.9625775"
36620250407,36,2025-04-07,6,45,10,55,Que85_T,"-37.81652527, 144.96121062"
361820250812,36,2025-08-12,18,160,141,301,Que85_T,"-37.81652527, 144.96121062"
361020250926,36,2025-09-26,10,88,107,195,Que85_T,"-37.81652527, 144.96121062"
37920250429,37,2025-04-29,9,31,40,71,Lyg260_T,"-37.80107122, 144.96704554"
37220240214,37,2024-02-14,2,3,4,7,Lyg260_T,"-37.80107122, 144.96704554"
49120250325,49,2025-03-25,1,37,59,96,Eli501_T,"-37.80730068, 144.95956055"
1231020240508,123,2024-05-08,10,9,4,13,BirBridge_T,"-37.81753741, 144.97329734"
1171320250115,117,2025-01-15,13,287,256,543,Fli114F_T,"-37.81629332, 144.97090877"
1091720241229,109,2024-12-29,17,46,75,121,LatWill_T,"-37.81193681, 144.95621105"
492220240226,49,2024-02-26,22,109,97,206,Eli501_T,"-37.80730068, 144.95956055"
191820241204,19,2024-12-04,18,695,537,1232,LtB210_T,"-37.81237202, 144.96550671"
48720240712,48,2024-07-12,7,48,44,92,QVMQ_T,"-37.80631581, 144.95866697"
137020240911,137,2024-09-11,0,1,1,2,BouHbr2353_T,"-37.81894815, 144.94612292"
137920250517,137,2025-05-17,9,2,7,9,BouHbr2353_T,"-37.81894815, 144.94612292"
6620241026,6,2024-10-26,6,86,64,150,FliS_T,"-37.81911705, 144.96558255"
84420240904,84,2024-09-04,4,9,16,25,ElFi_T,"-37.81798049, 144.96503383"
66720240205,66,2024-02-05,7,77,186,263,QVN_T,"-37.81057846, 144.96444294"
42020240314,4,2024-03-14,20,1072,977,2049,Swa123_T,"-37.81487988, 144.9660878"
392320241004,39,2024-10-04,23,4,1,5,AlfPl_T,"-37.81379749, 144.96995745"
751620240616,75,2024-06-16,16,19,48,67,SprFli_T,"-37.81515276, 144.97467661"
412220240930,41,2024-09-30,22,29,27,56,Swa31,"-37.81668634, 144.96689733"
42420250420,42,2025-04-20,4,1,5,6,UM1_T,"-37.80008566, 144.96386412"
591220240508,59,2024-05-08,12,1366,1641,3007,RMIT_T,"-37.80825648, 144.96304859"
59720231212,59,2023-12-12,7,134,106,240,RMIT_T,"-37.80825648, 144.96304859"
29220231023,29,2023-10-23,2,1,1,2,AG_T,"-37.8199817, 144.96872865"
54420240514,54,2024-05-14,4,5,1,6,Swa607_T,"-37.804024, 144.96308399"
542120240516,54,2024-05-16,21,100,173,273,Swa607_T,"-37.804024, 144.96308399"
361420240727,36,2024-07-27,14,92,99,191,Que85_T,"-37.81652527, 144.96121062"
442020240920,44,2024-09-20,20,9,13,22,UM3_T,"-37.79698741, 144.96441306"
50720231030,50,2023-10-30,7,14,45,59,Lyg309_T,"-37.79808192, 144.96721013"
133420250124,133,2025-01-24,4,20,34,54,Spen229_T,"-37.81531435, 144.95227769"
1181620240816,118,2024-08-16,16,17,25,42,Fli114C_T,"-37.81632783, 144.97090512"
107720240717,107,2024-07-17,7,23,57,80,280Will_T,"-37.81246271, 144.95690188"
107720240820,107,2024-08-20,7,21,63,84,280Will_T,"-37.81246271, 144.95690188"
1071720250911,107,2025-09-11,17,186,123,309,280Will_T,"-37.81246271, 144.95690188"
1081120250722,108,2025-07-22,11,224,209,433,261Will_T,"-37.81295822, 144.95678789"
871220240719,87,2024-07-19,12,160,156,316,Errol23_T,"-37.80454949, 144.94921863"
87620240816,87,2024-08-16,6,19,10,29,Errol23_T,"-37.80454949, 144.94921863"
872120240317,87,2024-03-17,21,37,20,57,Errol23_T,"-37.80454949, 144.94921863"
184920250731,184,2025-07-31,9,457,396,853,Eli124_T,"-37.81512416, 144.96371988"
1842120250915,184,2025-09-15,21,168,237,405,Eli124_T,"-37.81512416, 144.96371988"
166720250809,166,2025-08-09,7,3,13,16,Spen484_T,"-37.80896733, 144.94931703"
162520250516,162,2025-05-16,5,9,10,19,Eli489_T,"-37.80740397, 144.95987909"
251220240524,25,2024-05-24,12,570,644,1214,MCEC_T,"-37.82401776, 144.95604426"
251020240910,25,2024-09-10,10,160,323,483,MCEC_T,"-37.82401776, 144.95604426"
52320240910,52,2024-09-10,3,0,2,2,Eli263_T,"-37.81252157, 144.9619401"
136820250920,136,2025-09-20,8,114,68,182,BirFed1120_T,"-37.8184141, 144.97357915"
164820250520,164,2025-05-20,8,116,84,200,Lat526_T,"-37.813005, 144.95160411"
138720250513,138,2025-05-13,7,3,3,6,EntPark1671_T,"-37.81996544, 144.95981454"
1231220240415,123,2024-04-15,12,70,28,98,BirBridge_T,"-37.81753741, 144.97329734"
1231720250812,123,2025-08-12,17,3,6,9,BirBridge_T,"-37.81753741, 144.97329734"
141820240908,141,2024-09-08,8,48,38,86,474Fl_T,"-37.81997273, 144.95834911"
117920250125,117,2025-01-25,9,69,105,174,Fli114F_T,"-37.81629332, 144.97090877"
1171520240301,117,2024-03-01,15,151,155,306,Fli114F_T,"-37.81629332, 144.97090877"
109520250522,109,2025-05-22,5,9,21,30,LatWill_T,"-37.81193681, 144.95621105"
632120250421,63,2025-04-21,21,16,94,110,Bou231_T,"-37.81333081, 144.96675571"
501420240406,50,2024-04-06,14,339,351,690,Lyg309_T,"-37.79808192, 144.96721013"
45920251002,45,2025-10-02,9,195,279,474,Swa148_T,"-37.81414075, 144.96609379"
452020250202,45,2025-02-02,20,217,586,803,Swa148_T,"-37.81414075, 144.96609379"
51520240516,5,2024-05-16,15,978,882,1860,PriNW_T,"-37.81874249, 144.96787656"
1401120240524,140,2024-05-24,11,99,59,158,Boyd2837_T,"-37.82590962, 144.96185972"
1312120250412,131,2025-04-12,21,134,90,224,King2_T,"-37.82009057, 144.95758725"
132920240924,132,2024-09-24,9,149,90,239,King335_T,"-37.81267639, 144.95386444"
107620241206,107,2024-12-06,6,14,29,43,280Will_T,"-37.81246271, 144.95690188"
1331320240302,133,2024-03-02,13,481,469,950,Spen229_T,"-37.81531435, 144.95227769"
1331220240502,133,2024-05-02,12,509,539,1048,Spen229_T,"-37.81531435, 144.95227769"
1332120250419,133,2025-04-19,21,407,241,648,Spen229_T,"-37.81531435, 144.95227769"
1181920240818,118,2024-08-18,19,10,5,15,Fli114C_T,"-37.81632783, 144.97090512"
118320240101,118,2024-01-01,3,5,1,6,Fli114C_T,"-37.81632783, 144.97090512"
871120250926,87,2025-09-26,11,108,110,218,Errol23_T,"-37.80454949, 144.94921863"
1661920250115,166,2025-01-15,19,58,61,119,Spen484_T,"-37.80896733, 144.94931703"
179620250410,179,2025-04-10,6,14,10,24,Pow61_T,"-37.82392385, 144.96299677"
67720240508,67,2024-05-08,7,108,90,198,FLDegS_T,"-37.81688755, 144.96562569"
68720231128,68,2023-11-28,7,53,41,94,FLDegN_T,"-37.8168479, 144.96559789"
171320240521,17,2024-05-21,13,677,696,1373,Col15_T,"-37.81362543, 144.97323591"
171720241221,17,2024-12-21,17,209,159,368,Col15_T,"-37.81362543, 144.97323591"
681620250621,68,2025-06-21,16,309,366,675,FLDegN_T,"-37.8168479, 144.96559789"
63720250829,63,2025-08-29,7,52,82,134,Bou231_T,"-37.81333081, 144.96675571"
56420231108,56,2023-11-08,4,1,2,3,Lon364_T,"-37.81234775, 144.96153311"
861420231113,86,2023-11-13,14,29,41,70,574Qub_T,"-37.80309992, 144.94908064"
79620250522,79,2025-05-22,6,144,64,208,FliSS_T,"-37.81794046, 144.96616678"
25020231213,25,2023-12-13,0,20,22,42,MCEC_T,"-37.82401776, 144.95604426"
25820240117,25,2024-01-17,8,77,116,193,MCEC_T,"-37.82401776, 144.95604426"
25920240206,25,2024-02-06,9,175,374,549,MCEC_T,"-37.82401776, 144.95604426"
231320250629,23,2025-06-29,13,135,171,306,Col623_T,"-37.81909256, 144.95452748"
231320250211,23,2025-02-11,13,285,489,774,Col623_T,"-37.81909256, 144.95452748"
49020240730,49,2024-07-30,0,38,44,82,Eli501_T,"-37.80730068, 144.95956055"
109920231107,109,2023-11-07,9,61,61,122,LatWill_T,"-37.81193681, 144.95621105"
1091720240728,109,2024-07-28,17,51,93,144,LatWill_T,"-37.81193681, 144.95621105"
1091820240815,109,2024-08-15,18,262,138,400,LatWill_T,"-37.81193681, 144.95621105"
1091920241110,109,2024-11-10,19,56,104,160,LatWill_T,"-37.81193681, 144.95621105"
109320250307,109,2025-03-07,3,4,6,10,LatWill_T,"-37.81193681, 144.95621105"
1371820250207,137,2025-02-07,18,20,143,163,BouHbr2353_T,"-37.81894815, 144.94612292"
139220240921,139,2024-09-21,2,5,2,7,Signal1647_T,"-37.81959923, 144.9632832"
1361820240925,136,2024-09-25,18,32,16,48,BirFed1120_T,"-37.8184141, 144.97357915"
142220240316,142,2024-03-16,2,11,19,30,Hammer1584_T,"-37.81970749, 144.96795734"
1422320240711,142,2024-07-11,23,9,11,20,Hammer1584_T,"-37.81970749, 144.96795734"
1231820250226,123,2025-02-26,18,65,57,122,BirBridge_T,"-37.81753741, 144.97329734"
661120250924,66,2025-09-24,11,657,886,1543,QVN_T,"-37.81057846, 144.96444294"
66520241210,66,2024-12-10,5,6,19,25,QVN_T,"-37.81057846, 144.96444294"
4320240302,4,2024-03-02,3,69,72,141,Swa123_T,"-37.81487988, 144.9660878"
70820250404,70,2025-04-04,8,78,66,144,Errol20_T,"-37.80456984, 144.94946228"
701820250528,70,2025-05-28,18,143,186,329,Errol20_T,"-37.80456984, 144.94946228"
31620240212,3,2024-02-12,16,917,1130,2047,Swa295_T,"-37.81101524, 144.96429485"
31120250508,3,2025-05-08,11,570,676,1246,Swa295_T,"-37.81101524, 144.96429485"
31320250608,3,2025-06-08,13,1176,1273,2449,Swa295_T,"-37.81101524, 144.96429485"
8820240502,8,2024-05-02,8,319,193,512,WebBN_T,"-37.82293543, 144.9471751"
751820250309,75,2025-03-09,18,37,77,114,SprFli_T,"-37.81515276, 144.97467661"
78620250927,78,2025-09-27,6,17,11,28,HarEsB_T,"-37.81471642, 144.9446508"
71120240516,71,2024-05-16,1,2,0,2,WestWP_T,"-37.81235775, 144.97136962"
592320240202,59,2024-02-02,23,378,134,512,RMIT_T,"-37.80825648, 144.96304859"
29120241227,29,2024-12-27,1,43,24,67,AG_T,"-37.8199817, 144.96872865"
59320250311,59,2025-03-11,3,0,8,8,RMIT_T,"-37.80825648, 144.96304859"
28620250723,28,2025-07-23,6,229,89,318,VAC_T,"-37.82129925, 144.96879309"
281520241222,28,2024-12-22,15,1262,1207,2469,VAC_T,"-37.82129925, 144.96879309"
471020231102,47,2023-11-02,10,404,520,924,Eli250_T,"-37.81258467, 144.9625775"
37320241216,37,2024-12-16,3,2,3,5,Lyg260_T,"-37.80107122, 144.96704554"
371520250103,37,2025-01-03,15,89,118,207,Lyg260_T,"-37.80107122, 144.96704554"
441520240918,44,2024-09-18,15,142,86,228,UM3_T,"-37.79698741, 144.96441306"
212120231126,21,2023-11-26,21,231,383,614,Bourke155_T,"-37.81267313, 144.96788288"
21420250217,21,2025-02-17,4,4,11,15,Bourke155_T,"-37.81267313, 144.96788288"
1071920250213,107,2025-02-13,19,105,100,205,280Will_T,"-37.81246271, 144.95690188"
1071720250410,107,2025-04-10,17,229,168,397,280Will_T,"-37.81246271, 144.95690188"
1071720240617,107,2024-06-17,17,170,139,309,280Will_T,"-37.81246271, 144.95690188"
50620250404,50,2025-04-04,6,11,11,22,Lyg309_T,"-37.79808192, 144.96721013"
501220241118,50,2024-11-18,12,201,240,441,Lyg309_T,"-37.79808192, 144.96721013"
431220240914,43,2024-09-14,12,27,31,58,UM2_T,"-37.79844526, 144.96411782"
1661520251012,166,2025-10-12,15,71,67,138,Spen484_T,"-37.80896733, 144.94931703"
1671420250901,167,2025-09-01,14,57,62,119,Lat526_T,"-37.81304149, 144.95155955"
1671920250927,167,2025-09-27,19,14,31,45,Lat526_T,"-37.81304149, 144.95155955"
1651420241101,165,2024-11-01,14,58,54,112,Spen475_T,"-37.80953359, 144.94939004"
1652220250914,165,2025-09-14,22,6,2,8,Spen475_T,"-37.80953359, 144.94939004"
167820240821,167,2024-08-21,8,30,168,198,Lat526_T,"-37.81304149, 144.95155955"
1401520240509,140,2024-05-09,15,84,95,179,Boyd2837_T,"-37.82590962, 144.96185972"
1401720250402,140,2025-04-02,17,116,154,270,Boyd2837_T,"-37.82590962, 144.96185972"
1621720241006,162,2024-10-06,17,390,408,798,Eli489_T,"-37.80740397, 144.95987909"
134220251003,134,2025-10-03,2,21,7,28,Spen201_T,"-37.81694221, 144.95303935"
82020250715,8,2025-07-15,20,9,8,17,WebBN_T,"-37.82293543, 144.9471751"
281420231209,28,2023-12-09,14,716,846,1562,VAC_T,"-37.82129925, 144.96879309"
61920240325,61,2024-03-25,9,352,400,752,RMIT14_T,"-37.80767455, 144.96309114"
50120241125,50,2024-11-25,1,3,3,6,Lyg309_T,"-37.79808192, 144.96721013"
501520241231,50,2024-12-31,15,202,171,373,Lyg309_T,"-37.79808192, 144.96721013"
43620241022,43,2024-10-22,6,31,19,50,UM2_T,"-37.79844526, 144.96411782"
451020250912,45,2025-09-12,10,263,365,628,Swa148_T,"-37.81414075, 144.96609379"
1622320250315,162,2025-03-15,23,204,108,312,Eli489_T,"-37.80740397, 144.95987909"
1081920250602,108,2025-06-02,19,211,114,325,261Will_T,"-37.81295822, 144.95678789"
131520250730,131,2025-07-30,5,1,4,5,King2_T,"-37.82009057, 144.95758725"
1431120241021,143,2024-10-21,11,99,155,254,Spencer_T,"-37.821728, 144.95557015"
1331220250128,133,2025-01-28,12,555,540,1095,Spen229_T,"-37.81531435, 144.95227769"
133220231021,133,2023-10-21,2,28,12,40,Spen229_T,"-37.81531435, 144.95227769"
1181220241117,118,2024-11-17,12,14,15,29,Fli114C_T,"-37.81632783, 144.97090512"
166820250207,166,2025-02-07,8,26,47,73,Spen484_T,"-37.80896733, 144.94931703"
181720250721,181,2025-07-21,7,165,179,344,Eli368_T,"-37.81009465, 144.96143149"
851620250721,85,2025-07-21,16,53,67,120,488Mac_T,"-37.79432415, 144.92973378"
172320231022,17,2023-10-22,23,24,42,66,Col15_T,"-37.81362543, 144.97323591"
17320250227,17,2025-02-27,3,5,5,10,Col15_T,"-37.81362543, 144.97323591"
11820241105,1,2024-11-05,18,1032,670,1702,Bou292_T,"-37.81349441, 144.96515323"
681020250125,68,2025-01-25,10,380,359,739,FLDegN_T,"-37.8168479, 144.96559789"
631920250609,63,2025-06-09,19,35,154,189,Bou231_T,"-37.81333081, 144.96675571"
11120241017,11,2024-10-17,1,7,6,13,WatCit_T,"-37.81564989, 144.93970694"
86120241124,86,2024-11-24,1,0,5,5,574Qub_T,"-37.80309992, 144.94908064"
101620240915,10,2024-09-15,16,46,33,79,BouHbr_T,"-37.81876474, 144.94710545"
102320250716,10,2025-07-16,23,2,7,9,BouHbr_T,"-37.81876474, 144.94710545"
10420231230,10,2023-12-30,4,3,2,5,BouHbr_T,"-37.81876474, 144.94710545"
58920240819,58,2024-08-19,9,923,204,1127,Bou688_T,"-37.81686075, 144.95358075"
352120240608,35,2024-06-08,21,1065,1537,2602,SouthB_T,"-37.82018685, 144.96508508"
91620240710,9,2024-07-10,16,2333,147,2480,Col700_T,"-37.81982992, 144.95102555"
27020250823,27,2025-08-23,0,41,14,55,Vic_T,"-37.80606888, 144.95644692"
9320231229,9,2023-12-29,3,1,1,2,Col700_T,"-37.81982992, 144.95102555"
231120241226,23,2024-12-26,11,105,98,203,Col623_T,"-37.81909256, 144.95452748"
301220250323,30,2025-03-23,12,304,384,688,Lon189_T,"-37.8112185, 144.96656806"
19520240428,19,2024-04-28,5,11,13,24,LtB210_T,"-37.81237202, 144.96550671"
481720240716,48,2024-07-16,17,129,189,318,QVMQ_T,"-37.80631581, 144.95866697"
202320240215,20,2024-02-15,23,106,176,282,LtB170_T,"-37.81172914, 144.9682466"
251620241008,25,2024-10-08,16,763,465,1228,MCEC_T,"-37.82401776, 144.95604426"
51920250816,51,2025-08-16,9,72,46,118,Fra118_T,"-37.80841815, 144.95906316"
1391420240923,139,2024-09-23,14,61,69,130,Signal1647_T,"-37.81959923, 144.9632832"
139120241031,139,2024-10-31,1,3,2,5,Signal1647_T,"-37.81959923, 144.9632832"
1231420250209,123,2025-02-09,14,44,24,68,BirBridge_T,"-37.81753741, 144.97329734"
109920240106,109,2024-01-06,9,41,56,97,LatWill_T,"-37.81193681, 144.95621105"
179520250623,179,2025-06-23,5,5,1,6,Pow61_T,"-37.82392385, 144.96299677"
66120250329,66,2025-03-29,1,127,134,261,QVN_T,"-37.81057846, 144.96444294"
661220250518,66,2025-05-18,12,1643,1466,3109,QVN_T,"-37.81057846, 144.96444294"
841120240912,84,2024-09-12,11,687,638,1325,ElFi_T,"-37.81798049, 144.96503383"
841420241010,84,2024-10-10,14,1013,1345,2358,ElFi_T,"-37.81798049, 144.96503383"
4720250504,4,2025-05-04,7,96,75,171,Swa123_T,"-37.81487988, 144.9660878"
70220240912,70,2024-09-12,2,3,0,3,Errol20_T,"-37.80456984, 144.94946228"
8720231209,8,2023-12-09,7,25,27,52,WebBN_T,"-37.82293543, 144.9471751"
75020240804,75,2024-08-04,0,13,13,26,SprFli_T,"-37.81515276, 144.97467661"
8520250722,8,2025-07-22,5,0,1,1,WebBN_T,"-37.82293543, 144.9471751"
78420231117,78,2023-11-17,4,1,3,4,HarEsB_T,"-37.81471642, 144.9446508"
781920240107,78,2024-01-07,19,6,32,38,HarEsB_T,"-37.81471642, 144.9446508"
711220250516,71,2025-05-16,12,39,36,75,WestWP_T,"-37.81235775, 144.97136962"
592120231220,59,2023-12-20,21,335,218,553,RMIT_T,"-37.80825648, 144.96304859"
59220240612,59,2024-06-12,2,13,8,21,RMIT_T,"-37.80825648, 144.96304859"
401020240502,40,2024-05-02,10,220,240,460,Spr201_T,"-37.80999341, 144.97227587"
402020250622,40,2025-06-22,20,74,41,115,Spr201_T,"-37.80999341, 144.97227587"
312220231113,31,2023-11-13,22,42,59,101,Lyg161_T,"-37.80169681, 144.96658911"
36420250613,36,2025-06-13,4,2,5,7,Que85_T,"-37.81652527, 144.96121062"
36120240126,36,2024-01-26,1,38,32,70,Que85_T,"-37.81652527, 144.96121062"
371220241110,37,2024-11-10,12,102,109,211,Lyg260_T,"-37.80107122, 144.96704554"
37020240324,37,2024-03-24,0,93,62,155,Lyg260_T,"-37.80107122, 144.96704554"
431120240720,43,2024-07-20,11,41,49,90,UM2_T,"-37.79844526, 144.96411782"
43920241019,43,2024-10-19,9,36,30,66,UM2_T,"-37.79844526, 144.96411782"
432020250904,43,2025-09-04,20,43,104,147,UM2_T,"-37.79844526, 144.96411782"
44120250103,44,2025-01-03,1,0,1,1,UM3_T,"-37.79698741, 144.96441306"
441420250824,44,2025-08-24,14,61,50,111,UM3_T,"-37.79698741, 144.96441306"
51020240908,5,2024-09-08,10,498,782,1280,PriNW_T,"-37.81874249, 144.96787656"
1402020240304,140,2024-03-04,20,9,5,14,Boyd2837_T,"-37.82590962, 144.96185972"
162520241110,162,2024-11-10,5,29,27,56,Eli489_T,"-37.80740397, 144.95987909"
131320250925,131,2025-09-25,3,5,12,17,King2_T,"-37.82009057, 144.95758725"
132620250514,132,2025-05-14,6,23,22,45,King335_T,"-37.81267639, 144.95386444"
1321320241201,132,2024-12-01,13,165,125,290,King335_T,"-37.81267639, 144.95386444"
134120231106,134,2023-11-06,1,36,51,87,Spen201_T,"-37.81694221, 144.95303935"
134220240812,134,2024-08-12,2,20,11,31,Spen201_T,"-37.81694221, 144.95303935"
133820250708,133,2025-07-08,8,390,433,823,Spen229_T,"-37.81531435, 144.95227769"
133220240606,133,2024-06-06,2,12,14,26,Spen229_T,"-37.81531435, 144.95227769"
1331220240613,133,2024-06-13,12,445,449,894,Spen229_T,"-37.81531435, 144.95227769"
1081320250709,108,2025-07-09,13,567,501,1068,261Will_T,"-37.81295822, 144.95678789"
108720240206,108,2024-02-06,7,75,825,900,261Will_T,"-37.81295822, 144.95678789"
1821020250531,182,2025-05-31,10,135,130,265,King163_T,"-37.81627451, 144.95550503"
631020240604,63,2024-06-04,10,140,228,368,Bou231_T,"-37.81333081, 144.96675571"
68620250209,68,2025-02-09,6,7,1,8,FLDegN_T,"-37.8168479, 144.96559789"
1182120250206,118,2025-02-06,21,8,6,14,Fli114C_T,"-37.81632783, 144.97090512"
17620231209,17,2023-12-09,6,26,23,49,Col15_T,"-37.81362543, 144.97323591"
171420240827,17,2024-08-27,14,330,325,655,Col15_T,"-37.81362543, 144.97323591"
63020250803,63,2025-08-03,0,16,96,112,Bou231_T,"-37.81333081, 144.96675571"
1320250321,1,2025-03-21,3,4,10,14,Bou292_T,"-37.81349441, 144.96515323"
62320250315,62,2025-03-15,3,42,47,89,Lat224_T,"-37.80996494, 144.96216521"
102020250523,10,2025-05-23,20,35,33,68,BouHbr_T,"-37.81876474, 144.94710545"
76620250309,76,2025-03-09,6,2,1,3,KenMac_T,"-37.79453803, 144.93036194"
581420241201,58,2024-12-01,14,479,321,800,Bou688_T,"-37.81686075, 144.95358075"
11520240607,1,2024-06-07,15,1141,1047,2188,Bou292_T,"-37.81349441, 144.96515323"
63620240629,63,2024-06-29,6,6,21,27,Bou231_T,"-37.81333081, 144.96675571"
67620250514,67,2025-05-14,6,126,60,186,FLDegS_T,"-37.81688755, 144.96562569"
112120241126,11,2024-11-26,21,40,54,94,WatCit_T,"-37.81564989, 144.93970694"
62420250802,62,2025-08-02,4,30,29,59,Lat224_T,"-37.80996494, 144.96216521"
861920241117,86,2024-11-17,19,27,57,84,574Qub_T,"-37.80309992, 144.94908064"
861120250323,86,2025-03-23,11,73,75,148,574Qub_T,"-37.80309992, 144.94908064"
101120250804,10,2025-08-04,11,66,43,109,BouHbr_T,"-37.81876474, 144.94710545"
761020250111,76,2025-01-11,10,53,64,117,KenMac_T,"-37.79453803, 144.93036194"
761020250611,76,2025-06-11,10,62,38,100,KenMac_T,"-37.79453803, 144.93036194"
761220240121,76,2024-01-21,12,43,39,82,KenMac_T,"-37.79453803, 144.93036194"
76120240123,76,2024-01-23,1,2,2,4,KenMac_T,"-37.79453803, 144.93036194"
21720240517,2,2024-05-17,17,506,481,987,Bou283_T,"-37.81380668, 144.96516718"
351120250802,35,2025-08-02,11,1003,1007,2010,SouthB_T,"-37.82018685, 144.96508508"
58220240525,58,2024-05-25,2,28,64,92,Bou688_T,"-37.81686075, 144.95358075"
92020250108,9,2025-01-08,20,61,49,110,Col700_T,"-37.81982992, 144.95102555"
23220240629,23,2024-06-29,2,10,34,44,Col623_T,"-37.81909256, 144.95452748"
302020241119,30,2024-11-19,20,203,345,548,Lon189_T,"-37.8112185, 144.96656806"
301520250309,30,2025-03-09,15,233,508,741,Lon189_T,"-37.8112185, 144.96656806"
202220241024,20,2024-10-24,22,127,361,488,LtB170_T,"-37.81172914, 144.9682466"
201820231221,20,2023-12-21,18,444,269,713,LtB170_T,"-37.81172914, 144.9682466"
251520250110,25,2025-01-10,15,642,609,1251,MCEC_T,"-37.82401776, 144.95604426"
46020250508,46,2025-05-08,0,1,0,1,Pel147_T,"-37.80240719, 144.9615673"
511520241215,51,2024-12-15,15,136,127,263,Fra118_T,"-37.80841815, 144.95906316"
1171020231204,117,2023-12-04,10,93,116,209,Fli114F_T,"-37.81629332, 144.97090877"
117820241109,117,2024-11-09,8,64,53,117,Fli114F_T,"-37.81629332, 144.97090877"
492020231108,49,2023-11-08,20,150,111,261,Eli501_T,"-37.80730068, 144.95956055"
109220240324,109,2024-03-24,2,16,18,34,LatWill_T,"-37.81193681, 144.95621105"
1092220250214,109,2025-02-14,22,64,88,152,LatWill_T,"-37.81193681, 144.95621105"
192320241219,19,2024-12-19,23,187,264,451,LtB210_T,"-37.81237202, 144.96550671"
1801220250527,180,2025-05-27,12,22,17,39,Mac330_T,"-37.79497059, 144.93530329"
1371120250120,137,2025-01-20,11,9,52,61,BouHbr2353_T,"-37.81894815, 144.94612292"
139320240222,139,2024-02-22,3,1,1,2,Signal1647_T,"-37.81959923, 144.9632832"
1421820250531,142,2025-05-31,18,83,18,101,Hammer1584_T,"-37.81970749, 144.96795734"
1231120241228,123,2024-12-28,11,50,35,85,BirBridge_T,"-37.81753741, 144.97329734"
130920240203,130,2024-02-03,9,17,18,35,Bou892T,"-37.8204637, 144.94126826"
1621620241013,162,2024-10-13,16,378,556,934,Eli489_T,"-37.80740397, 144.95987909"
851720241116,85,2024-11-16,17,97,85,182,488Mac_T,"-37.79432415, 144.92973378"
1920240128,1,2024-01-28,9,218,258,476,Bou292_T,"-37.81349441, 144.96515323"
681620250327,68,2025-03-27,16,312,256,568,FLDegN_T,"-37.8168479, 144.96559789"
181720240212,18,2024-02-12,17,892,119,1011,Col12_T,"-37.81344862, 144.97305353"
682320250507,68,2025-05-07,23,2,3,5,FLDegN_T,"-37.8168479, 144.96559789"
62220250618,62,2025-06-18,2,16,12,28,Lat224_T,"-37.80996494, 144.96216521"
561420240817,56,2024-08-17,14,448,424,872,Lon364_T,"-37.81234775, 144.96153311"
24520231218,24,2023-12-18,5,64,65,129,Col620_T,"-37.81887963, 144.95449198"
12720240617,12,2024-06-17,7,60,35,95,NewQ_T,"-37.81457988, 144.94292398"
722120240614,72,2024-06-14,21,120,188,308,ACMI_T,"-37.81726338, 144.96872809"
242220251006,24,2025-10-06,22,163,359,522,Col620_T,"-37.81887963, 144.95449198"
581420231202,58,2023-12-02,14,493,298,791,Bou688_T,"-37.81686075, 144.95358075"
352120241218,35,2024-12-18,21,1160,2633,3793,SouthB_T,"-37.82018685, 144.96508508"
722020250331,72,2025-03-31,20,48,97,145,ACMI_T,"-37.81726338, 144.96872809"
2120250310,2,2025-03-10,1,14,49,63,Bou283_T,"-37.81380668, 144.96516718"
271820250328,27,2025-03-28,18,143,148,291,Vic_T,"-37.80606888, 144.95644692"
301420240714,30,2024-07-14,14,323,563,886,Lon189_T,"-37.8112185, 144.96656806"
791920240926,79,2024-09-26,19,368,348,716,FliSS_T,"-37.81794046, 144.96616678"
301820240309,30,2024-03-09,18,395,527,922,Lon189_T,"-37.8112185, 144.96656806"
531720241230,53,2024-12-30,17,512,387,899,Col254_T,"-37.81564191, 144.965499"
521420250627,52,2025-06-27,14,369,327,696,Eli263_T,"-37.81252157, 144.9619401"
23720251013,23,2025-10-13,7,278,154,432,Col623_T,"-37.81909256, 144.95452748"
461020231128,46,2023-11-28,10,44,61,105,Pel147_T,"-37.80240719, 144.9615673"
191320240711,19,2024-07-11,13,524,547,1071,LtB210_T,"-37.81237202, 144.96550671"
25720250130,25,2025-01-30,7,214,276,490,MCEC_T,"-37.82401776, 144.95604426"
25220250604,25,2025-06-04,2,1,6,7,MCEC_T,"-37.82401776, 144.95604426"
251620231025,25,2023-10-25,16,1183,502,1685,MCEC_T,"-37.82401776, 144.95604426"
202320240905,20,2024-09-05,23,67,114,181,LtB170_T,"-37.81172914, 144.9682466"
192320250728,19,2025-07-28,23,62,103,165,LtB210_T,"-37.81237202, 144.96550671"
139920240818,139,2024-08-18,9,26,17,43,Signal1647_T,"-37.81959923, 144.9632832"
1371020250523,137,2025-05-23,10,25,22,47,BouHbr2353_T,"-37.81894815, 144.94612292"
1361420250617,136,2025-06-17,14,50,51,101,BirFed1120_T,"-37.8184141, 144.97357915"
1392020231220,139,2023-12-20,20,106,34,140,Signal1647_T,"-37.81959923, 144.9632832"
1171320231125,117,2023-11-25,13,170,213,383,Fli114F_T,"-37.81629332, 144.97090877"
661720250814,66,2025-08-14,17,1501,1957,3458,QVN_T,"-37.81057846, 144.96444294"
69020250927,69,2025-09-27,0,16,20,36,FLDegC_T,"-37.81687226, 144.96559144"
6220250625,6,2025-06-25,2,14,5,19,FliS_T,"-37.81911705, 144.96558255"
6820250727,6,2025-07-27,8,192,153,345,FliS_T,"-37.81911705, 144.96558255"
4620250907,4,2025-09-07,6,48,63,111,Swa123_T,"-37.81487988, 144.9660878"
81820231205,8,2023-12-05,18,189,221,410,WebBN_T,"-37.82293543, 144.9471751"
751020240829,75,2024-08-29,10,40,35,75,SprFli_T,"-37.81515276, 144.97467661"
751020241201,75,2024-12-01,10,59,33,92,SprFli_T,"-37.81515276, 144.97467661"
75620250227,75,2025-02-27,6,11,7,18,SprFli_T,"-37.81515276, 144.97467661"
751520240210,75,2024-02-10,15,53,42,95,SprFli_T,"-37.81515276, 144.97467661"
412320250406,41,2025-04-06,23,142,232,374,Swa31,"-37.81668634, 144.96689733"
412320250812,41,2025-08-12,23,144,232,376,Swa31,"-37.81668634, 144.96689733"
591920250304,59,2025-03-04,19,333,825,1158,RMIT_T,"-37.80825648, 144.96304859"
711720231113,71,2023-11-13,17,51,24,75,WestWP_T,"-37.81235775, 144.97136962"
291320250915,29,2025-09-15,13,12,18,30,AG_T,"-37.8199817, 144.96872865"
40020250624,40,2025-06-24,0,5,2,7,Spr201_T,"-37.80999341, 144.97227587"
31420240301,31,2024-03-01,4,3,3,6,Lyg161_T,"-37.80169681, 144.96658911"
311920241214,31,2024-12-14,19,365,286,651,Lyg161_T,"-37.80169681, 144.96658911"
36620240702,36,2024-07-02,6,25,17,42,Que85_T,"-37.81652527, 144.96121062"
371120240327,37,2024-03-27,11,65,67,132,Lyg260_T,"-37.80107122, 144.96704554"
68220250518,68,2025-05-18,2,3,2,5,FLDegN_T,"-37.8168479, 144.96559789"
561120240304,56,2024-03-04,11,255,197,452,Lon364_T,"-37.81234775, 144.96153311"
111820240505,11,2024-05-05,18,107,107,214,WatCit_T,"-37.81564989, 144.93970694"
11920240812,11,2024-08-12,9,57,77,134,WatCit_T,"-37.81564989, 144.93970694"
121220240215,12,2024-02-15,12,187,243,430,NewQ_T,"-37.81457988, 144.94292398"
12920250819,12,2025-08-19,9,147,86,233,NewQ_T,"-37.81457988, 144.94292398"
721520250326,72,2025-03-26,15,121,364,485,ACMI_T,"-37.81726338, 144.96872809"
301520240307,30,2024-03-07,15,200,319,519,Lon189_T,"-37.8112185, 144.96656806"
79820240518,79,2024-05-18,8,106,112,218,FliSS_T,"-37.81794046, 144.96616678"
792320240611,79,2024-06-11,23,59,81,140,FliSS_T,"-37.81794046, 144.96616678"
791420251014,79,2025-10-14,14,341,310,651,FliSS_T,"-37.81794046, 144.96616678"
30220250324,30,2025-03-24,2,26,53,79,Lon189_T,"-37.8112185, 144.96656806"
30120250606,30,2025-06-06,1,70,59,129,Lon189_T,"-37.8112185, 144.96656806"
461720240701,46,2024-07-01,17,108,52,160,Pel147_T,"-37.80240719, 144.9615673"
25220231216,25,2023-12-16,2,43,64,107,MCEC_T,"-37.82401776, 144.95604426"
25420250502,25,2025-05-02,4,9,8,17,MCEC_T,"-37.82401776, 144.95604426"
52920241005,52,2024-10-05,9,154,107,261,Eli263_T,"-37.81252157, 144.9619401"
1411120250704,141,2025-07-04,11,163,75,238,474Fl_T,"-37.81997273, 144.95834911"
1391720250929,139,2025-09-29,17,311,50,361,Signal1647_T,"-37.81959923, 144.9632832"
1391720250109,139,2025-01-09,17,260,37,297,Signal1647_T,"-37.81959923, 144.9632832"
1421720240910,142,2024-09-10,17,580,363,943,Hammer1584_T,"-37.81970749, 144.96795734"
1361520231227,136,2023-12-27,15,113,465,578,BirFed1120_T,"-37.8184141, 144.97357915"
161520250929,161,2025-09-29,5,6,2,8,BirArt1109_T,"-37.81851276, 144.97131336"
1171320240211,117,2024-02-11,13,160,164,324,Fli114F_T,"-37.81629332, 144.97090877"
123920241209,123,2024-12-09,9,3,0,3,BirBridge_T,"-37.81753741, 144.97329734"
492020240425,49,2024-04-25,20,146,167,313,Eli501_T,"-37.80730068, 144.95956055"
1092220240715,109,2024-07-15,22,15,9,24,LatWill_T,"-37.81193681, 144.95621105"
109320241004,109,2024-10-04,3,8,4,12,LatWill_T,"-37.81193681, 144.95621105"
61020250121,6,2025-01-21,10,631,560,1191,FliS_T,"-37.81911705, 144.96558255"
701220240911,70,2024-09-11,12,213,248,461,Errol20_T,"-37.80456984, 144.94946228"
81620240831,8,2024-08-31,16,140,192,332,WebBN_T,"-37.82293543, 144.9471751"
41620240221,41,2024-02-21,6,477,227,704,Swa31,"-37.81668634, 144.96689733"
411720240411,41,2024-04-11,17,2149,2481,4630,Swa31,"-37.81668634, 144.96689733"
422220241102,42,2024-11-02,22,31,52,83,UM1_T,"-37.80008566, 144.96386412"
29820240226,29,2024-02-26,8,49,52,101,AG_T,"-37.8199817, 144.96872865"
141320240808,14,2024-08-08,13,327,166,493,SanBri_T,"-37.82011242, 144.96291897"
71820250712,71,2025-07-12,8,11,5,16,WestWP_T,"-37.81235775, 144.97136962"
71120240212,71,2024-02-12,1,1,4,5,WestWP_T,"-37.81235775, 144.97136962"
28420240413,28,2024-04-13,4,4,12,16,VAC_T,"-37.82129925, 144.96879309"
311920240203,31,2024-02-03,19,371,321,692,Lyg161_T,"-37.80169681, 144.96658911"
361620241231,36,2024-12-31,16,133,123,256,Que85_T,"-37.81652527, 144.96121062"
37420240621,37,2024-06-21,4,13,8,21,Lyg260_T,"-37.80107122, 144.96704554"
37520240906,37,2024-09-06,5,2,0,2,Lyg260_T,"-37.80107122, 144.96704554"
501620250419,50,2025-04-19,16,186,168,354,Lyg309_T,"-37.79808192, 144.96721013"
441520250105,44,2025-01-05,15,11,12,23,UM3_T,"-37.79698741, 144.96441306"
452020250919,45,2025-09-19,20,404,698,1102,Swa148_T,"-37.81414075, 144.96609379"
1621320250909,162,2025-09-09,13,629,689,1318,Eli489_T,"-37.80740397, 144.95987909"
1071320231116,107,2023-11-16,13,210,204,414,280Will_T,"-37.81246271, 144.95690188"
1322020241224,132,2024-12-24,20,114,143,257,King335_T,"-37.81267639, 144.95386444"
134520250305,134,2025-03-05,5,57,46,103,Spen201_T,"-37.81694221, 144.95303935"
131320250208,131,2025-02-08,3,38,72,110,King2_T,"-37.82009057, 144.95758725"
1351520240330,135,2024-03-30,15,1342,515,1857,Spen161_T,"-37.8172861, 144.95319102"
371820240430,37,2024-04-30,18,3,4,7,Lyg260_T,"-37.80107122, 144.96704554"
47920251001,47,2025-10-01,9,314,564,878,Eli250_T,"-37.81258467, 144.9625775"
47620240121,47,2024-01-21,6,32,114,146,Eli250_T,"-37.81258467, 144.9625775"
61120250125,61,2025-01-25,1,61,17,78,RMIT14_T,"-37.80767455, 144.96309114"
50320240609,50,2024-06-09,3,0,1,1,Lyg309_T,"-37.79808192, 144.96721013"
44620250208,44,2025-02-08,6,0,1,1,UM3_T,"-37.79698741, 144.96441306"
442320240318,44,2024-03-18,23,2,2,4,UM3_T,"-37.79698741, 144.96441306"
51920250627,5,2025-06-27,19,697,1114,1811,PriNW_T,"-37.81874249, 144.96787656"
212320241114,21,2024-11-14,23,161,168,329,Bourke155_T,"-37.81267313, 144.96788288"
211720240216,21,2024-02-16,17,536,593,1129,Bourke155_T,"-37.81267313, 144.96788288"
1311220240130,131,2024-01-30,12,149,161,310,King2_T,"-37.82009057, 144.95758725"
1312220250128,131,2025-01-28,22,52,39,91,King2_T,"-37.82009057, 144.95758725"
871020240121,87,2024-01-21,10,72,75,147,Errol23_T,"-37.80454949, 144.94921863"
182120250531,182,2025-05-31,1,117,133,250,King163_T,"-37.81627451, 144.95550503"
1661020250318,166,2025-03-18,10,29,31,60,Spen484_T,"-37.80896733, 144.94931703"
182820251016,182,2025-10-16,8,85,214,299,King163_T,"-37.81627451, 144.95550503"
17620250725,17,2025-07-25,6,115,38,153,Col15_T,"-37.81362543, 144.97323591"
171620250814,17,2025-08-14,16,265,437,702,Col15_T,"-37.81362543, 144.97323591"
11520231125,1,2023-11-25,15,1968,2126,4094,Bou292_T,"-37.81349441, 144.96515323"
181320240409,18,2024-04-09,13,283,210,493,Col12_T,"-37.81344862, 144.97305353"
86920250918,86,2025-09-18,9,60,49,109,574Qub_T,"-37.80309992, 144.94908064"
621120240220,62,2024-02-20,11,253,134,387,Lat224_T,"-37.80996494, 144.96216521"
62720240518,62,2024-05-18,7,30,33,63,Lat224_T,"-37.80996494, 144.96216521"
56320240604,56,2024-06-04,3,5,16,21,Lon364_T,"-37.81234775, 144.96153311"
24820240328,24,2024-03-28,8,1128,181,1309,Col620_T,"-37.81887963, 144.95449198"
11220250623,11,2025-06-23,2,1,2,3,WatCit_T,"-37.81564989, 144.93970694"
102120240124,10,2024-01-24,21,17,15,32,BouHbr_T,"-37.81876474, 144.94710545"
121320250716,12,2025-07-16,13,230,199,429,NewQ_T,"-37.81457988, 144.94292398"
721520241026,72,2024-10-26,15,347,506,853,ACMI_T,"-37.81726338, 144.96872809"
12220250215,12,2025-02-15,2,1,13,14,NewQ_T,"-37.81457988, 144.94292398"
352020240115,35,2024-01-15,20,877,1387,2264,SouthB_T,"-37.82018685, 144.96508508"
761020240213,76,2024-02-13,10,43,35,78,KenMac_T,"-37.79453803, 144.93036194"
21820250905,2,2025-09-05,18,775,622,1397,Bou283_T,"-37.81380668, 144.96516718"
21620241216,2,2024-12-16,16,444,450,894,Bou283_T,"-37.81380668, 144.96516718"
91720241227,9,2024-12-27,17,112,98,210,Col700_T,"-37.81982992, 144.95102555"
79220250302,79,2025-03-02,2,60,96,156,FliSS_T,"-37.81794046, 144.96616678"
521420250222,52,2025-02-22,14,339,298,637,Eli263_T,"-37.81252157, 144.9619401"
462120240916,46,2024-09-16,21,3,2,5,Pel147_T,"-37.80240719, 144.9615673"
461220250817,46,2025-08-17,12,154,188,342,Pel147_T,"-37.80240719, 144.9615673"
19620241111,19,2024-11-11,6,20,8,28,LtB210_T,"-37.81237202, 144.96550671"
48620240813,48,2024-08-13,6,35,44,79,QVMQ_T,"-37.80631581, 144.95866697"
251320240219,25,2024-02-19,13,680,728,1408,MCEC_T,"-37.82401776, 144.95604426"
1411120240404,141,2024-04-04,11,147,142,289,474Fl_T,"-37.81997273, 144.95834911"
141220251013,141,2025-10-13,2,7,13,20,474Fl_T,"-37.81997273, 144.95834911"
1421220250315,142,2025-03-15,12,330,508,838,Hammer1584_T,"-37.81970749, 144.96795734"
691620231028,69,2023-10-28,16,155,152,307,FLDegC_T,"-37.81687226, 144.96559144"
69220241223,69,2024-12-23,2,1,0,1,FLDegC_T,"-37.81687226, 144.96559144"
842220241210,84,2024-12-10,22,464,563,1027,ElFi_T,"-37.81798049, 144.96503383"
4620241019,4,2024-10-19,6,45,32,77,Swa123_T,"-37.81487988, 144.9660878"
70620241106,70,2024-11-06,6,16,9,25,Errol20_T,"-37.80456984, 144.94946228"
701920250509,70,2025-05-09,19,147,222,369,Errol20_T,"-37.80456984, 144.94946228"
701020250910,70,2025-09-10,10,87,103,190,Errol20_T,"-37.80456984, 144.94946228"
39720240829,39,2024-08-29,7,64,52,116,AlfPl_T,"-37.81379749, 144.96995745"
781320250220,78,2025-02-20,13,48,65,113,HarEsB_T,"-37.81471642, 144.9446508"
142120240728,14,2024-07-28,21,152,67,219,SanBri_T,"-37.82011242, 144.96291897"
711020250113,71,2025-01-13,10,16,20,36,WestWP_T,"-37.81235775, 144.97136962"
59520250923,59,2025-09-23,5,13,29,42,RMIT_T,"-37.80825648, 144.96304859"
65720240929,65,2024-09-29,7,61,74,135,SwaCs_T,"-37.81569416, 144.9668064"
1331520250114,133,2025-01-14,15,476,587,1063,Spen229_T,"-37.81531435, 144.95227769"
118820240306,118,2024-03-06,8,24,18,42,Fli114C_T,"-37.81632783, 144.97090512"
1241320250429,124,2025-04-29,13,7,7,14,BirBridge_T,"-37.81757416, 144.97329934"
1651520250705,165,2025-07-05,15,127,50,177,Spen475_T,"-37.80953359, 144.94939004"
1611220240824,161,2024-08-24,12,293,191,484,BirArt1109_T,"-37.81851276, 144.97131336"
49920250126,49,2025-01-26,9,195,212,407,Eli501_T,"-37.80730068, 144.95956055"
1172320250926,117,2025-09-26,23,101,52,153,Fli114F_T,"-37.81629332, 144.97090877"
109920240217,109,2024-02-17,9,22,28,50,LatWill_T,"-37.81193681, 144.95621105"
109920241106,109,2024-11-06,9,80,351,431,LatWill_T,"-37.81193681, 144.95621105"
17620231225,17,2023-12-25,6,6,8,14,Col15_T,"-37.81362543, 144.97323591"
671520240408,67,2024-04-08,15,290,459,749,FLDegS_T,"-37.81688755, 144.96562569"
121920240131,12,2024-01-31,19,234,279,513,NewQ_T,"-37.81457988, 144.94292398"
72320231214,72,2023-12-14,3,5,12,17,ACMI_T,"-37.81726338, 144.96872809"
721720250610,72,2025-06-10,17,181,863,1044,ACMI_T,"-37.81726338, 144.96872809"
72120251005,72,2025-10-05,1,10,16,26,ACMI_T,"-37.81726338, 144.96872809"
721320241108,72,2024-11-08,13,185,344,529,ACMI_T,"-37.81726338, 144.96872809"
35520241003,35,2024-10-03,5,97,53,150,SouthB_T,"-37.82018685, 144.96508508"
27720250322,27,2025-03-22,7,32,33,65,Vic_T,"-37.80606888, 144.95644692"
272120250407,27,2025-04-07,21,65,30,95,Vic_T,"-37.80606888, 144.95644692"
91620240529,9,2024-05-29,16,2438,155,2593,Col700_T,"-37.81982992, 144.95102555"
91120250529,9,2025-05-29,11,291,301,592,Col700_T,"-37.81982992, 144.95102555"
53920240315,53,2024-03-15,9,461,322,783,Col254_T,"-37.81564191, 144.965499"
48920250603,48,2025-06-03,9,110,113,223,QVMQ_T,"-37.80631581, 144.95866697"
51920241126,51,2024-11-26,9,47,71,118,Fra118_T,"-37.80841815, 144.95906316"
1392220250416,139,2025-04-16,22,10,8,18,Signal1647_T,"-37.81959923, 144.9632832"
136620240616,136,2024-06-16,6,1,0,1,BirFed1120_T,"-37.8184141, 144.97357915"
69120250715,69,2025-07-15,1,2,0,2,FLDegC_T,"-37.81687226, 144.96559144"
701020250807,70,2025-08-07,10,88,98,186,Errol20_T,"-37.80456984, 144.94946228"
70420240122,70,2024-01-22,4,1,0,1,Errol20_T,"-37.80456984, 144.94946228"
70320240826,70,2024-08-26,3,2,2,4,Errol20_T,"-37.80456984, 144.94946228"
81120241203,8,2024-12-03,11,95,210,305,WebBN_T,"-37.82293543, 144.9471751"
781120240201,78,2024-02-01,11,40,37,77,HarEsB_T,"-37.81471642, 144.9446508"
771320240613,77,2024-06-13,13,99,90,189,HarEsP_T,"-37.81441438, 144.94433026"
14120241230,14,2024-12-30,1,18,10,28,SanBri_T,"-37.82011242, 144.96291897"
71120241101,71,2024-11-01,1,18,8,26,WestWP_T,"-37.81235775, 144.97136962"
59220240620,59,2024-06-20,2,34,9,43,RMIT_T,"-37.80825648, 144.96304859"
59720240226,59,2024-02-26,7,192,100,292,RMIT_T,"-37.80825648, 144.96304859"
592220240417,59,2024-04-17,22,229,133,362,RMIT_T,"-37.80825648, 144.96304859"
291120241109,29,2024-11-09,11,330,337,667,AG_T,"-37.8199817, 144.96872865"
401920250722,40,2025-07-22,19,69,65,134,Spr201_T,"-37.80999341, 144.97227587"
401920240325,40,2024-03-25,19,108,88,196,Spr201_T,"-37.80999341, 144.97227587"
541020240602,54,2024-06-02,10,76,66,142,Swa607_T,"-37.804024, 144.96308399"
361820240223,36,2024-02-23,18,250,195,445,Que85_T,"-37.81652527, 144.96121062"
36420250923,36,2025-09-23,4,2,2,4,Que85_T,"-37.81652527, 144.96121062"
50820250910,50,2025-09-10,8,33,80,113,Lyg309_T,"-37.79808192, 144.96721013"
441020250629,44,2025-06-29,10,9,20,29,UM3_T,"-37.79698741, 144.96441306"
431320250121,43,2025-01-21,13,78,75,153,UM2_T,"-37.79844526, 144.96411782"
43220240709,43,2024-07-09,2,4,4,8,UM2_T,"-37.79844526, 144.96411782"
43320241002,43,2024-10-02,3,2,0,2,UM2_T,"-37.79844526, 144.96411782"
441020240328,44,2024-03-28,10,18,41,59,UM3_T,"-37.79698741, 144.96441306"
452020241005,45,2024-10-05,20,430,718,1148,Swa148_T,"-37.81414075, 144.96609379"
51220250624,5,2025-06-24,12,651,798,1449,PriNW_T,"-37.81874249, 144.96787656"
21620240229,21,2024-02-29,6,33,37,70,Bourke155_T,"-37.81267313, 144.96788288"
143220250130,143,2025-01-30,2,17,9,26,Spencer_T,"-37.821728, 144.95557015"
1322020240221,132,2024-02-21,20,181,178,359,King335_T,"-37.81267639, 144.95386444"
134620240908,134,2024-09-08,6,100,55,155,Spen201_T,"-37.81694221, 144.95303935"
1342220241128,134,2024-11-28,22,275,229,504,Spen201_T,"-37.81694221, 144.95303935"
1341320250508,134,2025-05-08,13,410,477,887,Spen201_T,"-37.81694221, 144.95303935"
1312020240628,131,2024-06-28,20,87,73,160,King2_T,"-37.82009057, 144.95758725"
131120250131,131,2025-01-31,1,10,9,19,King2_T,"-37.82009057, 144.95758725"
1331920241124,133,2024-11-24,19,422,377,799,Spen229_T,"-37.81531435, 144.95227769"
133620250114,133,2025-01-14,6,314,188,502,Spen229_T,"-37.81531435, 144.95227769"
118820240217,118,2024-02-17,8,5,4,9,Fli114C_T,"-37.81632783, 144.97090512"
1081220250625,108,2025-06-25,12,339,313,652,261Will_T,"-37.81295822, 144.95678789"
185420251001,185,2025-10-01,4,5,22,27,Eli197_T,"-37.81374643, 144.96276183"
1672020250118,167,2025-01-18,20,52,39,91,Lat526_T,"-37.81304149, 144.95155955"
671220250724,67,2025-07-24,12,473,783,1256,FLDegS_T,"-37.81688755, 144.96562569"
672320250912,67,2025-09-12,23,82,157,239,FLDegS_T,"-37.81688755, 144.96562569"
11820240426,1,2024-04-26,18,1060,732,1792,Bou292_T,"-37.81349441, 144.96515323"
671220240422,67,2024-04-22,12,452,581,1033,FLDegS_T,"-37.81688755, 144.96562569"
631820251008,63,2025-10-08,18,411,428,839,Bou231_T,"-37.81333081, 144.96675571"
11920250820,1,2025-08-20,19,685,445,1130,Bou292_T,"-37.81349441, 144.96515323"
121420240226,12,2024-02-26,14,123,105,228,NewQ_T,"-37.81457988, 144.94292398"
111520240815,11,2024-08-15,15,94,95,189,WatCit_T,"-37.81564989, 144.93970694"
62220240204,62,2024-02-04,2,45,18,63,Lat224_T,"-37.80996494, 144.96216521"
122320241110,12,2024-11-10,23,52,39,91,NewQ_T,"-37.81457988, 144.94292398"
121020251016,12,2025-10-16,10,174,181,355,NewQ_T,"-37.81457988, 144.94292398"
111720250314,11,2025-03-14,17,57,60,117,WatCit_T,"-37.81564989, 144.93970694"
24520250916,24,2025-09-16,5,69,33,102,Col620_T,"-37.81887963, 144.95449198"
101920250331,10,2025-03-31,19,51,39,90,BouHbr_T,"-37.81876474, 144.94710545"
762020250205,76,2025-02-05,20,22,31,53,KenMac_T,"-37.79453803, 144.93036194"
761320231113,76,2023-11-13,13,63,61,124,KenMac_T,"-37.79453803, 144.93036194"
76420240301,76,2024-03-01,4,0,1,1,KenMac_T,"-37.79453803, 144.93036194"
271520250914,27,2025-09-14,15,245,149,394,Vic_T,"-37.80606888, 144.95644692"
271120250405,27,2025-04-05,11,268,264,532,Vic_T,"-37.80606888, 144.95644692"
91020250803,9,2025-08-03,10,49,53,102,Col700_T,"-37.81982992, 144.95102555"
51520240310,51,2024-03-10,5,8,11,19,Fra118_T,"-37.80841815, 144.95906316"
52620240206,52,2024-02-06,6,38,18,56,Eli263_T,"-37.81252157, 144.9619401"
191720241029,19,2024-10-29,17,562,441,1003,LtB210_T,"-37.81237202, 144.96550671"
25220250716,25,2025-07-16,2,4,14,18,MCEC_T,"-37.82401776, 144.95604426"
48320231130,48,2023-11-30,3,6,13,19,QVMQ_T,"-37.80631581, 144.95866697"
1371720241223,137,2024-12-23,17,10,68,78,BouHbr2353_T,"-37.81894815, 144.94612292"
142720250112,142,2025-01-12,7,238,160,398,Hammer1584_T,"-37.81970749, 144.96795734"
1231720231227,123,2023-12-27,17,56,17,73,BirBridge_T,"-37.81753741, 144.97329734"
1301320240909,130,2024-09-09,13,51,68,119,Bou892T,"-37.8204637, 144.94126826"
1171420250302,117,2025-03-02,14,124,134,258,Fli114F_T,"-37.81629332, 144.97090877"
69320241105,69,2024-11-05,3,1,1,2,FLDegC_T,"-37.81687226, 144.96559144"
6420250708,6,2025-07-08,4,29,8,37,FliS_T,"-37.81911705, 144.96558255"
84220250911,84,2025-09-11,2,9,13,22,ElFi_T,"-37.81798049, 144.96503383"
4520241010,4,2024-10-10,5,24,13,37,Swa123_T,"-37.81487988, 144.9660878"
45320240215,45,2024-02-15,3,4,22,26,Swa148_T,"-37.81414075, 144.96609379"
5120250531,5,2025-05-31,1,62,79,141,PriNW_T,"-37.81874249, 144.96787656"
21620231213,21,2023-12-13,6,27,41,68,Bourke155_T,"-37.81267313, 144.96788288"
132620240211,132,2024-02-11,6,20,8,28,King335_T,"-37.81267639, 144.95386444"
132020241009,132,2024-10-09,0,30,38,68,King335_T,"-37.81267639, 144.95386444"
1341220240206,134,2024-02-06,12,378,346,724,Spen201_T,"-37.81694221, 144.95303935"
1352020240902,135,2024-09-02,20,86,112,198,Spen161_T,"-37.8172861, 144.95319102"
1331320240405,133,2024-04-05,13,516,563,1079,Spen229_T,"-37.81531435, 144.95227769"
1181020240830,118,2024-08-30,10,12,16,28,Fli114C_T,"-37.81632783, 144.97090512"
87720250526,87,2025-05-26,7,27,34,61,Errol23_T,"-37.80454949, 144.94921863"
166320250512,166,2025-05-12,3,0,1,1,Spen484_T,"-37.80896733, 144.94931703"
1792020250325,179,2025-03-25,20,58,53,111,Pow61_T,"-37.82392385, 144.96299677"
165820240925,165,2024-09-25,8,8,20,28,Spen475_T,"-37.80953359, 144.94939004"
1811520250725,181,2025-07-25,15,675,1032,1707,Eli368_T,"-37.81009465, 144.96143149"
1811220250731,181,2025-07-31,12,689,952,1641,Eli368_T,"-37.81009465, 144.96143149"
682120241228,68,2024-12-28,21,184,97,281,FLDegN_T,"-37.8168479, 144.96559789"
682120240521,68,2024-05-21,21,32,14,46,FLDegN_T,"-37.8168479, 144.96559789"
851320250104,85,2025-01-04,13,65,75,140,488Mac_T,"-37.79432415, 144.92973378"
85820250814,85,2025-08-14,8,134,46,180,488Mac_T,"-37.79432415, 144.92973378"
63720250112,63,2025-01-12,7,17,24,41,Bou231_T,"-37.81333081, 144.96675571"
622220250821,62,2025-08-21,22,189,218,407,Lat224_T,"-37.80996494, 144.96216521"
62220240109,62,2024-01-09,2,1,2,3,Lat224_T,"-37.80996494, 144.96216521"
622320250123,62,2025-01-23,23,58,44,102,Lat224_T,"-37.80996494, 144.96216521"
122220241014,12,2024-10-14,22,33,54,87,NewQ_T,"-37.81457988, 144.94292398"
122020240219,12,2024-02-19,20,300,287,587,NewQ_T,"-37.81457988, 144.94292398"
10820240328,10,2024-03-28,8,65,205,270,BouHbr_T,"-37.81876474, 144.94710545"
101920250530,10,2025-05-30,19,175,64,239,BouHbr_T,"-37.81876474, 144.94710545"
351020250617,35,2025-06-17,10,438,403,841,SouthB_T,"-37.82018685, 144.96508508"
352120250917,35,2025-09-17,21,221,336,557,SouthB_T,"-37.82018685, 144.96508508"
76920250830,76,2025-08-30,9,33,27,60,KenMac_T,"-37.79453803, 144.93036194"
35720250218,35,2025-02-18,7,553,829,1382,SouthB_T,"-37.82018685, 144.96508508"
9120241002,9,2024-10-02,1,2,1,3,Col700_T,"-37.81982992, 144.95102555"
92320231201,9,2023-12-01,23,55,48,103,Col700_T,"-37.81982992, 144.95102555"
791720240605,79,2024-06-05,17,640,496,1136,FliSS_T,"-37.81794046, 144.96616678"
25020250808,25,2025-08-08,0,32,41,73,MCEC_T,"-37.82401776, 144.95604426"
461120240216,46,2024-02-16,11,58,77,135,Pel147_T,"-37.80240719, 144.9615673"
462220240227,46,2024-02-27,22,23,30,53,Pel147_T,"-37.80240719, 144.9615673"
46620240512,46,2024-05-12,6,6,3,9,Pel147_T,"-37.80240719, 144.9615673"
20820240907,20,2024-09-07,8,24,27,51,LtB170_T,"-37.81172914, 144.9682466"
521420250723,52,2025-07-23,14,483,212,695,Eli263_T,"-37.81252157, 144.9619401"
1361520250510,136,2025-05-10,15,123,334,457,BirFed1120_T,"-37.8184141, 144.97357915"
1361620250827,136,2025-08-27,16,96,37,133,BirFed1120_T,"-37.8184141, 144.97357915"
1361520240207,136,2024-02-07,15,77,69,146,BirFed1120_T,"-37.8184141, 144.97357915"
1231120240528,123,2024-05-28,11,12,5,17,BirBridge_T,"-37.81753741, 144.97329734"
49120250402,49,2025-04-02,1,44,46,90,Eli501_T,"-37.80730068, 144.95956055"
1171420250328,117,2025-03-28,14,159,271,430,Fli114F_T,"-37.81629332, 144.97090877"
691220250117,69,2025-01-17,12,383,294,677,FLDegC_T,"-37.81687226, 144.96559144"
841420250415,84,2025-04-15,14,933,1345,2278,ElFi_T,"-37.81798049, 144.96503383"
841320250512,84,2025-05-12,13,894,1004,1898,ElFi_T,"-37.81798049, 144.96503383"
701620250525,70,2025-05-25,16,133,159,292,Errol20_T,"-37.80456984, 144.94946228"
701820240621,70,2024-06-21,18,139,175,314,Errol20_T,"-37.80456984, 144.94946228"
82020240302,8,2024-03-02,20,77,102,179,WebBN_T,"-37.82293543, 144.9471751"
138720241022,138,2024-10-22,7,3,8,11,EntPark1671_T,"-37.81996544, 144.95981454"
841720240508,84,2024-05-08,17,1119,2169,3288,ElFi_T,"-37.81798049, 144.96503383"
84620241119,84,2024-11-19,6,338,117,455,ElFi_T,"-37.81798049, 144.96503383"
42120240615,4,2024-06-15,21,1166,786,1952,Swa123_T,"-37.81487988, 144.9660878"
702120250607,70,2025-06-07,21,61,74,135,Errol20_T,"-37.80456984, 144.94946228"
77420231206,77,2023-12-06,4,6,8,14,HarEsP_T,"-37.81441438, 144.94433026"
65720240708,65,2024-07-08,7,278,95,373,SwaCs_T,"-37.81569416, 144.9668064"
651720241003,65,2024-10-03,17,1272,1554,2826,SwaCs_T,"-37.81569416, 144.9668064"
651320231130,65,2023-11-30,13,489,588,1077,SwaCs_T,"-37.81569416, 144.9668064"
281720240211,28,2024-02-11,17,414,1052,1466,VAC_T,"-37.82129925, 144.96879309"
281120240310,28,2024-03-10,11,703,452,1155,VAC_T,"-37.82129925, 144.96879309"
282020231021,28,2023-10-21,20,210,426,636,VAC_T,"-37.82129925, 144.96879309"
281520231223,28,2023-12-23,15,1028,1255,2283,VAC_T,"-37.82129925, 144.96879309"
28220250918,28,2025-09-18,2,5,8,13,VAC_T,"-37.82129925, 144.96879309"
401820240517,40,2024-05-17,18,129,190,319,Spr201_T,"-37.80999341, 144.97227587"
361120250327,36,2025-03-27,11,185,175,360,Que85_T,"-37.81652527, 144.96121062"
371120241119,37,2024-11-19,11,64,63,127,Lyg260_T,"-37.80107122, 144.96704554"
371120250809,37,2025-08-09,11,83,67,150,Lyg260_T,"-37.80107122, 144.96704554"
51420240416,5,2024-04-16,14,913,728,1641,PriNW_T,"-37.81874249, 144.96787656"
1072320250401,107,2025-04-01,23,32,30,62,280Will_T,"-37.81246271, 144.95690188"
1081320250820,108,2025-08-20,13,709,630,1339,261Will_T,"-37.81295822, 144.95678789"
611020250323,61,2025-03-23,10,258,461,719,RMIT14_T,"-37.80767455, 144.96309114"
87620240110,87,2024-01-10,6,23,9,32,Errol23_T,"-37.80454949, 144.94921863"
87620240721,87,2024-07-21,6,4,0,4,Errol23_T,"-37.80454949, 144.94921863"
87120241217,87,2024-12-17,1,2,0,2,Errol23_T,"-37.80454949, 144.94921863"
50220250429,50,2025-04-29,2,1,0,1,Lyg309_T,"-37.79808192, 144.96721013"
431820250626,43,2025-06-26,18,278,153,431,UM2_T,"-37.79844526, 144.96411782"
432020231206,43,2023-12-06,20,40,72,112,UM2_T,"-37.79844526, 144.96411782"
44720250310,44,2025-03-10,7,2,2,4,UM3_T,"-37.79698741, 144.96441306"
167420241213,167,2024-12-13,4,0,1,1,Lat526_T,"-37.81304149, 144.95155955"
132620251007,132,2025-10-07,6,28,14,42,King335_T,"-37.81267639, 144.95386444"
1331120231228,133,2023-12-28,11,442,439,881,Spen229_T,"-37.81531435, 144.95227769"
84220240525,84,2024-05-25,2,82,109,191,ElFi_T,"-37.81798049, 144.96503383"
31720240205,3,2024-02-05,17,990,1031,2021,Swa295_T,"-37.81101524, 144.96429485"
75820241115,75,2024-11-15,8,41,63,104,SprFli_T,"-37.81515276, 144.97467661"
771820240928,77,2024-09-28,18,280,117,397,HarEsP_T,"-37.81441438, 144.94433026"
29720250424,29,2025-04-24,7,78,107,185,AG_T,"-37.8199817, 144.96872865"
292220231122,29,2023-11-22,22,54,94,148,AG_T,"-37.8199817, 144.96872865"
542120250430,54,2025-04-30,21,102,115,217,Swa607_T,"-37.804024, 144.96308399"
54620240213,54,2024-02-13,6,39,10,49,Swa607_T,"-37.804024, 144.96308399"
54020240503,54,2024-05-03,0,14,29,43,Swa607_T,"-37.804024, 144.96308399"
40520240109,40,2024-01-09,5,5,7,12,Spr201_T,"-37.80999341, 144.97227587"
412220250310,41,2025-03-10,22,1064,608,1672,Swa31,"-37.81668634, 144.96689733"
411820240808,41,2024-08-08,18,202,193,395,Swa31,"-37.81668634, 144.96689733"
782320240405,78,2024-04-05,23,4,4,8,HarEsB_T,"-37.81471642, 144.9446508"
77520250307,77,2025-03-07,5,11,13,24,HarEsP_T,"-37.81441438, 144.94433026"
29020240314,29,2024-03-14,0,13,16,29,AG_T,"-37.8199817, 144.96872865"
591520241217,59,2024-12-17,15,258,387,645,RMIT_T,"-37.80825648, 144.96304859"
65720240501,65,2024-05-01,7,281,112,393,SwaCs_T,"-37.81569416, 144.9668064"
652320240105,65,2024-01-05,23,181,269,450,SwaCs_T,"-37.81569416, 144.9668064"
501320250401,50,2025-04-01,13,168,160,328,Lyg309_T,"-37.79808192, 144.96721013"
452120240522,45,2024-05-22,21,194,411,605,Swa148_T,"-37.81414075, 144.96609379"
451120240623,45,2024-06-23,11,640,370,1010,Swa148_T,"-37.81414075, 144.96609379"
51820241016,5,2024-10-16,18,945,810,1755,PriNW_T,"-37.81874249, 144.96787656"
5220250210,5,2025-02-10,2,10,10,20,PriNW_T,"-37.81874249, 144.96787656"
1431620250416,143,2025-04-16,16,159,225,384,Spencer_T,"-37.821728, 144.95557015"
131020240630,131,2024-06-30,0,149,117,266,King2_T,"-37.82009057, 144.95758725"
1351320240629,135,2024-06-29,13,486,259,745,Spen161_T,"-37.8172861, 144.95319102"
1181920250516,118,2025-05-16,19,6,12,18,Fli114C_T,"-37.81632783, 144.97090512"
1811820250830,181,2025-08-30,18,1015,1048,2063,Eli368_T,"-37.81009465, 144.96143149"
632220250707,63,2025-07-07,22,15,43,58,Bou231_T,"-37.81333081, 144.96675571"
68120240819,68,2024-08-19,1,2,0,2,FLDegN_T,"-37.8168479, 144.96559789"
621520240213,62,2024-02-13,15,252,145,397,Lat224_T,"-37.80996494, 144.96216521"
62520240628,62,2024-06-28,5,28,20,48,Lat224_T,"-37.80996494, 144.96216521"
861020241026,86,2024-10-26,10,73,59,132,574Qub_T,"-37.80309992, 144.94908064"
861220250113,86,2025-01-13,12,63,79,142,574Qub_T,"-37.80309992, 144.94908064"
721120240602,72,2024-06-02,11,152,234,386,ACMI_T,"-37.81726338, 144.96872809"
581120240206,58,2024-02-06,11,641,225,866,Bou688_T,"-37.81686075, 144.95358075"
2420240805,2,2024-08-05,4,6,2,8,Bou283_T,"-37.81380668, 144.96516718"
301420231224,30,2023-12-24,14,254,629,883,Lon189_T,"-37.8112185, 144.96656806"
53120240623,53,2024-06-23,1,13,51,64,Col254_T,"-37.81564191, 144.965499"
791420250124,79,2025-01-24,14,603,530,1133,FliSS_T,"-37.81794046, 144.96616678"
791120250130,79,2025-01-30,11,453,319,772,FliSS_T,"-37.81794046, 144.96616678"
30120241020,30,2024-10-20,1,284,257,541,Lon189_T,"-37.8112185, 144.96656806"
30420241024,30,2024-10-24,4,12,39,51,Lon189_T,"-37.8112185, 144.96656806"
25520240423,25,2024-04-23,5,18,18,36,MCEC_T,"-37.82401776, 144.95604426"
25020240617,25,2024-06-17,0,7,12,19,MCEC_T,"-37.82401776, 144.95604426"
251820241011,25,2024-10-11,18,2457,920,3377,MCEC_T,"-37.82401776, 144.95604426"
51120250306,51,2025-03-06,1,14,23,37,Fra118_T,"-37.80841815, 144.95906316"
137320250414,137,2025-04-14,3,0,1,1,BouHbr2353_T,"-37.81894815, 144.94612292"
701020250227,70,2025-02-27,10,92,88,180,Errol20_T,"-37.80456984, 144.94946228"
39620241217,39,2024-12-17,6,18,4,22,AlfPl_T,"-37.81379749, 144.96995745"
751520240617,75,2024-06-17,15,42,40,82,SprFli_T,"-37.81515276, 144.97467661"
751520250918,75,2025-09-18,15,45,40,85,SprFli_T,"-37.81515276, 144.97467661"
41120250522,41,2025-05-22,1,55,37,92,Swa31,"-37.81668634, 144.96689733"
411020241209,41,2024-12-09,10,1254,870,2124,Swa31,"-37.81668634, 144.96689733"
41820240321,41,2024-03-21,8,2059,474,2533,Swa31,"-37.81668634, 144.96689733"
421020250423,42,2025-04-23,10,122,91,213,UM1_T,"-37.80008566, 144.96386412"
422020250802,42,2025-08-02,20,42,41,83,UM1_T,"-37.80008566, 144.96386412"
421020240803,42,2024-08-03,10,50,62,112,UM1_T,"-37.80008566, 144.96386412"
291420241008,29,2024-10-08,14,34,10,44,AG_T,"-37.8199817, 144.96872865"
291520250101,29,2025-01-01,15,434,527,961,AG_T,"-37.8199817, 144.96872865"
14620240129,14,2024-01-29,6,82,80,162,SanBri_T,"-37.82011242, 144.96291897"
281420250213,28,2025-02-13,14,509,510,1019,VAC_T,"-37.82129925, 144.96879309"
401520240419,40,2024-04-19,15,238,196,434,Spr201_T,"-37.80999341, 144.97227587"
471520231122,47,2023-11-22,15,1071,943,2014,Eli250_T,"-37.81258467, 144.9625775"
43920231227,43,2023-12-27,9,19,12,31,UM2_T,"-37.79844526, 144.96411782"
43120240908,43,2024-09-08,1,7,2,9,UM2_T,"-37.79844526, 144.96411782"
45120231227,45,2023-12-27,1,18,55,73,Swa148_T,"-37.81414075, 144.96609379"
51020250206,5,2025-02-06,10,328,787,1115,PriNW_T,"-37.81874249, 144.96787656"
211420241231,21,2024-12-31,14,392,437,829,Bourke155_T,"-37.81267313, 144.96788288"
131120250605,131,2025-06-05,1,11,14,25,King2_T,"-37.82009057, 144.95758725"
1351920240113,135,2024-01-13,19,579,295,874,Spen161_T,"-37.8172861, 144.95319102"
118020250831,118,2025-08-31,0,0,5,5,Fli114C_T,"-37.81632783, 144.97090512"
1181720250927,118,2025-09-27,17,40,17,57,Fli114C_T,"-37.81632783, 144.97090512"
1241420231220,124,2023-12-20,14,1,1,2,BirBridge_T,"-37.81757416, 144.97329934"
1071120240818,107,2024-08-18,11,61,99,160,280Will_T,"-37.81246271, 144.95690188"
681920250502,68,2025-05-02,19,200,120,320,FLDegN_T,"-37.8168479, 144.96559789"
85820250123,85,2025-01-23,8,99,42,141,488Mac_T,"-37.79432415, 144.92973378"
682120241029,68,2024-10-29,21,79,38,117,FLDegN_T,"-37.8168479, 144.96559789"
631620240217,63,2024-02-17,16,425,427,852,Bou231_T,"-37.81333081, 144.96675571"
63520240318,63,2024-03-18,5,9,13,22,Bou231_T,"-37.81333081, 144.96675571"
121120240303,12,2024-03-03,11,150,176,326,NewQ_T,"-37.81457988, 144.94292398"
102120240809,10,2024-08-09,21,16,7,23,BouHbr_T,"-37.81876474, 144.94710545"
761420240904,76,2024-09-04,14,45,47,92,KenMac_T,"-37.79453803, 144.93036194"
271120250627,27,2025-06-27,11,150,141,291,Vic_T,"-37.80606888, 144.95644692"
91320240718,9,2024-07-18,13,471,508,979,Col700_T,"-37.81982992, 144.95102555"
130720250726,130,2025-07-26,7,13,9,22,Bou892T,"-37.8204637, 144.94126826"
161620250812,161,2025-08-12,6,37,21,58,BirArt1109_T,"-37.81851276, 144.97131336"
1171920250127,117,2025-01-27,19,67,166,233,Fli114F_T,"-37.81629332, 144.97090877"
491320240220,49,2024-02-20,13,309,478,787,Eli501_T,"-37.80730068, 144.95956055"
49220240101,49,2024-01-01,2,88,119,207,Eli501_T,"-37.80730068, 144.95956055"
49420240104,49,2024-01-04,4,12,25,37,Eli501_T,"-37.80730068, 144.95956055"
661220250621,66,2025-06-21,12,827,1115,1942,QVN_T,"-37.81057846, 144.96444294"
66720240913,66,2024-09-13,7,76,194,270,QVN_T,"-37.81057846, 144.96444294"
69020240127,69,2024-01-27,0,18,13,31,FLDegC_T,"-37.81687226, 144.96559144"
6620240414,6,2024-04-14,6,52,71,123,FliS_T,"-37.81911705, 144.96558255"
3720240427,3,2024-04-27,7,56,71,127,Swa295_T,"-37.81101524, 144.96429485"
751020231218,75,2023-12-18,10,41,33,74,SprFli_T,"-37.81515276, 144.97467661"
421920250403,42,2025-04-03,19,142,222,364,UM1_T,"-37.80008566, 144.96386412"
291120240220,29,2024-02-20,11,152,265,417,AG_T,"-37.8199817, 144.96872865"
712120231106,71,2023-11-06,21,5,8,13,WestWP_T,"-37.81235775, 144.97136962"
651520240608,65,2024-06-08,15,672,723,1395,SwaCs_T,"-37.81569416, 144.9668064"
54120250803,54,2025-08-03,1,22,14,36,Swa607_T,"-37.804024, 144.96308399"
29320241126,29,2024-11-26,3,3,3,6,AG_T,"-37.8199817, 144.96872865"
472320240619,47,2024-06-19,23,102,106,208,Eli250_T,"-37.81258467, 144.9625775"
401220240616,40,2024-06-16,12,101,245,346,Spr201_T,"-37.80999341, 144.97227587"
31720231027,31,2023-10-27,7,33,24,57,Lyg161_T,"-37.80169681, 144.96658911"
31320240315,31,2024-03-15,3,5,4,9,Lyg161_T,"-37.80169681, 144.96658911"
36620250224,36,2025-02-24,6,36,27,63,Que85_T,"-37.81652527, 144.96121062"
47320241008,47,2024-10-08,3,4,16,20,Eli250_T,"-37.81258467, 144.9625775"
431320250915,43,2025-09-15,13,258,281,539,UM2_T,"-37.79844526, 144.96411782"
44520240504,44,2024-05-04,5,1,0,1,UM3_T,"-37.79698741, 144.96441306"
211720231221,21,2023-12-21,17,681,543,1224,Bourke155_T,"-37.81267313, 144.96788288"
1432320240726,143,2024-07-26,23,149,187,336,Spencer_T,"-37.821728, 144.95557015"
132220241012,132,2024-10-12,2,28,11,39,King335_T,"-37.81267639, 144.95386444"
134520240607,134,2024-06-07,5,27,33,60,Spen201_T,"-37.81694221, 144.95303935"
118820240314,118,2024-03-14,8,47,16,63,Fli114C_T,"-37.81632783, 144.97090512"
1072320240114,107,2024-01-14,23,35,31,66,280Will_T,"-37.81246271, 144.95690188"
1081420250904,108,2025-09-04,14,453,201,654,261Will_T,"-37.81295822, 144.95678789"
87820240416,87,2024-04-16,8,103,52,155,Errol23_T,"-37.80454949, 144.94921863"
1811020251006,181,2025-10-06,10,387,628,1015,Eli368_T,"-37.81009465, 144.96143149"
184120251013,184,2025-10-13,1,18,47,65,Eli124_T,"-37.81512416, 144.96371988"
166020250303,166,2025-03-03,0,0,2,2,Spen484_T,"-37.80896733, 144.94931703"
17720250520,17,2025-05-20,7,431,95,526,Col15_T,"-37.81362543, 144.97323591"
11120231202,1,2023-12-02,11,711,744,1455,Bou292_T,"-37.81349441, 144.96515323"
682220241015,68,2024-10-15,22,14,8,22,FLDegN_T,"-37.8168479, 144.96559789"
62920250505,62,2025-05-05,9,62,93,155,Lat224_T,"-37.80996494, 144.96216521"
62620250611,62,2025-06-11,6,84,15,99,Lat224_T,"-37.80996494, 144.96216521"
62720250623,62,2025-06-23,7,51,36,87,Lat224_T,"-37.80996494, 144.96216521"
861420240913,86,2024-09-13,14,32,53,85,574Qub_T,"-37.80309992, 144.94908064"
111220240622,11,2024-06-22,12,119,118,237,WatCit_T,"-37.81564989, 144.93970694"
101020241025,10,2024-10-25,10,55,51,106,BouHbr_T,"-37.81876474, 144.94710545"
91120250322,9,2025-03-22,11,91,113,204,Col700_T,"-37.81982992, 144.95102555"
231820241122,23,2024-11-22,18,194,283,477,Col623_T,"-37.81909256, 144.95452748"
461420241125,46,2024-11-25,14,40,44,84,Pel147_T,"-37.80240719, 144.9615673"
25920250429,25,2025-04-29,9,153,287,440,MCEC_T,"-37.82401776, 144.95604426"
19920250514,19,2025-05-14,9,131,67,198,LtB210_T,"-37.81237202, 144.96550671"
191520250714,19,2025-07-14,15,529,519,1048,LtB210_T,"-37.81237202, 144.96550671"
1391420250121,139,2025-01-21,14,60,74,134,Signal1647_T,"-37.81959923, 144.9632832"
1611020240924,161,2024-09-24,10,71,111,182,BirArt1109_T,"-37.81851276, 144.97131336"
161920250118,161,2025-01-18,9,1214,227,1441,BirArt1109_T,"-37.81851276, 144.97131336"
1231620240311,123,2024-03-11,16,31,31,62,BirBridge_T,"-37.81753741, 144.97329734"
1232320250109,123,2025-01-09,23,0,1,1,BirBridge_T,"-37.81753741, 144.97329734"
109820240527,109,2024-05-27,8,67,596,663,LatWill_T,"-37.81193681, 144.95621105"
1321520241118,132,2024-11-18,15,160,189,349,King335_T,"-37.81267639, 144.95386444"
143120240624,143,2024-06-24,1,30,12,42,Spencer_T,"-37.821728, 144.95557015"
1321420240818,132,2024-08-18,14,192,175,367,King335_T,"-37.81267639, 144.95386444"
1341120231212,134,2023-12-12,11,218,308,526,Spen201_T,"-37.81694221, 144.95303935"
1342220240514,134,2024-05-14,22,134,109,243,Spen201_T,"-37.81694221, 144.95303935"
131520231126,131,2023-11-26,5,25,63,88,King2_T,"-37.82009057, 144.95758725"
872220250405,87,2025-04-05,22,48,34,82,Errol23_T,"-37.80454949, 144.94921863"
108620231217,108,2023-12-17,6,18,15,33,261Will_T,"-37.81295822, 144.95678789"
1811220250913,181,2025-09-13,12,645,1037,1682,Eli368_T,"-37.81009465, 144.96143149"
691020250926,69,2025-09-26,10,233,195,428,FLDegC_T,"-37.81687226, 144.96559144"
701120241207,70,2024-12-07,11,163,144,307,Errol20_T,"-37.80456984, 144.94946228"
391020250613,39,2025-06-13,10,70,57,127,AlfPl_T,"-37.81379749, 144.96995745"
75020240830,75,2024-08-30,0,3,5,8,SprFli_T,"-37.81515276, 144.97467661"
8920231116,8,2023-11-16,9,159,122,281,WebBN_T,"-37.82293543, 144.9471751"
29020250105,29,2025-01-05,0,32,49,81,AG_T,"-37.8199817, 144.96872865"
29920250306,29,2025-03-06,9,111,188,299,AG_T,"-37.8199817, 144.96872865"
401720250115,40,2025-01-15,17,153,297,450,Spr201_T,"-37.80999341, 144.97227587"
361820250828,36,2025-08-28,18,222,168,390,Que85_T,"-37.81652527, 144.96121062"
472320251016,47,2025-10-16,23,134,140,274,Eli250_T,"-37.81258467, 144.9625775"
471420240720,47,2024-07-20,14,591,783,1374,Eli250_T,"-37.81258467, 144.9625775"
501820241001,50,2024-10-01,18,160,240,400,Lyg309_T,"-37.79808192, 144.96721013"
442120240326,44,2024-03-26,21,21,16,37,UM3_T,"-37.79698741, 144.96441306"
21220240415,21,2024-04-15,2,10,24,34,Bourke155_T,"-37.81267313, 144.96788288"
211320250913,21,2025-09-13,13,417,535,952,Bourke155_T,"-37.81267313, 144.96788288"
1431320250128,143,2025-01-28,13,145,226,371,Spencer_T,"-37.821728, 144.95557015"
851020241114,85,2024-11-14,10,77,60,137,488Mac_T,"-37.79432415, 144.92973378"
1020241017,1,2024-10-17,0,23,33,56,Bou292_T,"-37.81349441, 144.96515323"
671920250324,67,2025-03-24,19,237,287,524,FLDegS_T,"-37.81688755, 144.96562569"
621920250922,62,2025-09-22,19,215,256,471,Lat224_T,"-37.80996494, 144.96216521"
631220250916,63,2025-09-16,12,562,786,1348,Bou231_T,"-37.81333081, 144.96675571"
561120240207,56,2024-02-07,11,239,183,422,Lon364_T,"-37.81234775, 144.96153311"
10120240813,10,2024-08-13,1,1,1,2,BouHbr_T,"-37.81876474, 144.94710545"
24720240124,24,2024-01-24,7,761,160,921,Col620_T,"-37.81887963, 144.95449198"
11120250820,11,2025-08-20,1,2,1,3,WatCit_T,"-37.81564989, 144.93970694"
35020231222,35,2023-12-22,0,243,427,670,SouthB_T,"-37.82018685, 144.96508508"
35220231225,35,2023-12-25,2,59,98,157,SouthB_T,"-37.82018685, 144.96508508"
72220250723,72,2025-07-23,2,2,2,4,ACMI_T,"-37.81726338, 144.96872809"
58820241213,58,2024-12-13,8,1273,161,1434,Bou688_T,"-37.81686075, 144.95358075"
9720240101,9,2024-01-01,7,20,11,31,Col700_T,"-37.81982992, 144.95102555"
53920240514,53,2024-05-14,9,426,341,767,Col254_T,"-37.81564191, 144.965499"
232120231229,23,2023-12-29,21,112,158,270,Col623_T,"-37.81909256, 144.95452748"
52920241031,52,2024-10-31,9,189,219,408,Eli263_T,"-37.81252157, 144.9619401"
462220240201,46,2024-02-01,22,22,22,44,Pel147_T,"-37.80240719, 144.9615673"
49520251007,49,2025-10-07,5,40,26,66,Eli501_T,"-37.80730068, 144.95956055"
252020241220,25,2024-12-20,20,1417,616,2033,MCEC_T,"-37.82401776, 144.95604426"
251020231031,25,2023-10-31,10,169,375,544,MCEC_T,"-37.82401776, 144.95604426"
202120250116,20,2025-01-16,21,200,404,604,LtB170_T,"-37.81172914, 144.9682466"
20920240418,20,2024-04-18,9,66,64,130,LtB170_T,"-37.81172914, 144.9682466"
141720231115,141,2023-11-15,7,63,57,120,474Fl_T,"-37.81997273, 144.95834911"
141320250601,141,2025-06-01,3,35,28,63,474Fl_T,"-37.81997273, 144.95834911"
142220250316,142,2025-03-16,2,7,6,13,Hammer1584_T,"-37.81970749, 144.96795734"
1301320241021,130,2024-10-21,13,87,61,148,Bou892T,"-37.8204637, 144.94126826"
1301520240531,130,2024-05-31,15,12,31,43,Bou892T,"-37.8204637, 144.94126826"
123620241210,123,2024-12-10,6,4,0,4,BirBridge_T,"-37.81753741, 144.97329734"
1091020250707,109,2025-07-07,10,67,101,168,LatWill_T,"-37.81193681, 144.95621105"
66420240126,66,2024-01-26,4,41,28,69,QVN_T,"-37.81057846, 144.96444294"
69520250916,69,2025-09-16,5,4,0,4,FLDegC_T,"-37.81687226, 144.96559144"
6720250119,6,2025-01-19,7,137,110,247,FliS_T,"-37.81911705, 144.96558255"
61920251009,6,2025-10-09,19,1007,659,1666,FliS_T,"-37.81911705, 144.96558255"
66720240120,66,2024-01-20,7,34,45,79,QVN_T,"-37.81057846, 144.96444294"
661720240401,66,2024-04-01,17,843,781,1624,QVN_T,"-37.81057846, 144.96444294"
702220250322,70,2025-03-22,22,69,110,179,Errol20_T,"-37.80456984, 144.94946228"
3120240421,3,2024-04-21,1,353,410,763,Swa295_T,"-37.81101524, 144.96429485"
81620240916,8,2024-09-16,16,149,252,401,WebBN_T,"-37.82293543, 144.9471751"
77120250629,77,2025-06-29,1,16,7,23,HarEsP_T,"-37.81441438, 144.94433026"
142020240625,14,2024-06-25,20,224,67,291,SanBri_T,"-37.82011242, 144.96291897"
711820250525,71,2025-05-25,18,4,7,11,WestWP_T,"-37.81235775, 144.97136962"
71720250614,71,2025-06-14,7,1,0,1,WestWP_T,"-37.81235775, 144.97136962"
65720240527,65,2024-05-27,7,184,75,259,SwaCs_T,"-37.81569416, 144.9668064"
541820240126,54,2024-01-26,18,85,73,158,Swa607_T,"-37.804024, 144.96308399"
40420241110,40,2024-11-10,4,3,2,5,Spr201_T,"-37.80999341, 144.97227587"
402220240319,40,2024-03-19,22,53,27,80,Spr201_T,"-37.80999341, 144.97227587"
372220240202,37,2024-02-02,22,197,204,401,Lyg260_T,"-37.80107122, 144.96704554"
43220250909,43,2025-09-09,2,0,2,2,UM2_T,"-37.79844526, 144.96411782"
45620250416,45,2025-04-16,6,27,68,95,Swa148_T,"-37.81414075, 144.96609379"
452020251015,45,2025-10-15,20,252,574,826,Swa148_T,"-37.81414075, 144.96609379"
21720250211,21,2025-02-11,7,46,47,93,Bourke155_T,"-37.81267313, 144.96788288"
143220250729,143,2025-07-29,2,22,5,27,Spencer_T,"-37.821728, 144.95557015"
140920250616,140,2025-06-16,9,84,25,109,Boyd2837_T,"-37.82590962, 144.96185972"
1322020250302,132,2025-03-02,20,137,151,288,King335_T,"-37.81267639, 144.95386444"
1321720241031,132,2024-10-31,17,185,168,353,King335_T,"-37.81267639, 144.95386444"
451520240820,45,2024-08-20,15,559,661,1220,Swa148_T,"-37.81414075, 144.96609379"
1241020250505,124,2025-05-05,10,7,8,15,BirBridge_T,"-37.81757416, 144.97329934"
118620241113,118,2024-11-13,6,1,2,3,Fli114C_T,"-37.81632783, 144.97090512"
1082220240110,108,2024-01-10,22,106,94,200,261Will_T,"-37.81295822, 144.95678789"
611620231204,61,2023-12-04,16,214,360,574,RMIT14_T,"-37.80767455, 144.96309114"
501920250527,50,2025-05-27,19,146,130,276,Lyg309_T,"-37.79808192, 144.96721013"
1352020240920,135,2024-09-20,20,117,122,239,Spen161_T,"-37.8172861, 144.95319102"
182220240207,18,2024-02-07,22,5,15,20,Col12_T,"-37.81344862, 144.97305353"
861520241013,86,2024-10-13,15,43,52,95,574Qub_T,"-37.80309992, 144.94908064"
111420250225,11,2025-02-25,14,58,65,123,WatCit_T,"-37.81564989, 144.93970694"
62820240919,62,2024-09-19,8,72,112,184,Lat224_T,"-37.80996494, 144.96216521"
862320250409,86,2025-04-09,23,3,8,11,574Qub_T,"-37.80309992, 144.94908064"
861120250418,86,2025-04-18,11,60,81,141,574Qub_T,"-37.80309992, 144.94908064"
86620250514,86,2025-05-14,6,9,7,16,574Qub_T,"-37.80309992, 144.94908064"
562320250819,56,2025-08-19,23,58,72,130,Lon364_T,"-37.81234775, 144.96153311"
101220241018,10,2024-10-18,12,125,63,188,BouHbr_T,"-37.81876474, 144.94710545"
241620240605,24,2024-06-05,16,594,1918,2512,Col620_T,"-37.81887963, 144.95449198"
72820250316,72,2025-03-16,8,21,97,118,ACMI_T,"-37.81726338, 144.96872809"
72320241109,72,2024-11-09,3,6,4,10,ACMI_T,"-37.81726338, 144.96872809"
58320250327,58,2025-03-27,3,7,11,18,Bou688_T,"-37.81686075, 144.95358075"
791320250816,79,2025-08-16,13,681,620,1301,FliSS_T,"-37.81794046, 144.96616678"
792320250902,79,2025-09-02,23,52,45,97,FliSS_T,"-37.81794046, 144.96616678"
91220250223,9,2025-02-23,12,59,65,124,Col700_T,"-37.81982992, 144.95102555"
511520240802,51,2024-08-02,15,89,88,177,Fra118_T,"-37.80841815, 144.95906316"
231520240527,23,2024-05-27,15,161,306,467,Col623_T,"-37.81909256, 144.95452748"
20320250709,20,2025-07-09,3,10,5,15,LtB170_T,"-37.81172914, 144.9682466"
251020240107,25,2024-01-07,10,187,420,607,MCEC_T,"-37.82401776, 144.95604426"
1422120250117,142,2025-01-17,21,77,101,178,Hammer1584_T,"-37.81970749, 144.96795734"
130820250915,130,2025-09-15,8,15,17,32,Bou892T,"-37.8204637, 144.94126826"
1611920250517,161,2025-05-17,19,2,0,2,BirArt1109_T,"-37.81851276, 144.97131336"
1171320250308,117,2025-03-08,13,212,213,425,Fli114F_T,"-37.81629332, 144.97090877"
491220240909,49,2024-09-09,12,220,293,513,Eli501_T,"-37.80730068, 144.95956055"
109220240419,109,2024-04-19,2,3,5,8,LatWill_T,"-37.81193681, 144.95621105"
66020240619,66,2024-06-19,0,57,48,105,QVN_T,"-37.81057846, 144.96444294"
72020241125,72,2024-11-25,0,12,15,27,ACMI_T,"-37.81726338, 144.96872809"
76520250217,76,2025-02-17,5,3,2,5,KenMac_T,"-37.79453803, 144.93036194"
91120241012,9,2024-10-12,11,105,140,245,Col700_T,"-37.81982992, 144.95102555"
91820240428,9,2024-04-28,18,68,57,125,Col700_T,"-37.81982992, 144.95102555"
301120231230,30,2023-12-30,11,160,294,454,Lon189_T,"-37.8112185, 144.96656806"
231220250310,23,2025-03-10,12,104,144,248,Col623_T,"-37.81909256, 144.95452748"
791420250910,79,2025-09-10,14,374,342,716,FliSS_T,"-37.81794046, 144.96616678"
251120250930,25,2025-09-30,11,312,657,969,MCEC_T,"-37.82401776, 144.95604426"
461920240624,46,2024-06-24,19,34,34,68,Pel147_T,"-37.80240719, 144.9615673"
251920250511,25,2025-05-11,19,312,278,590,MCEC_T,"-37.82401776, 144.95604426"
139720240417,139,2024-04-17,7,24,128,152,Signal1647_T,"-37.81959923, 144.9632832"
1421420240706,142,2024-07-06,14,654,669,1323,Hammer1584_T,"-37.81970749, 144.96795734"
1422320240305,142,2024-03-05,23,49,138,187,Hammer1584_T,"-37.81970749, 144.96795734"
130920240909,130,2024-09-09,9,46,36,82,Bou892T,"-37.8204637, 144.94126826"
117920231205,117,2023-12-05,9,249,142,391,Fli114F_T,"-37.81629332, 144.97090877"
691020250609,69,2025-06-09,10,276,171,447,FLDegC_T,"-37.81687226, 144.96559144"
841420240113,84,2024-01-13,14,979,1356,2335,ElFi_T,"-37.81798049, 144.96503383"
412120251016,41,2025-10-16,21,543,1179,1722,Swa31,"-37.81668634, 144.96689733"
41020241130,41,2024-11-30,0,111,224,335,Swa31,"-37.81668634, 144.96689733"
771720250216,77,2025-02-16,17,158,103,261,HarEsP_T,"-37.81441438, 144.94433026"
422320241225,42,2024-12-25,23,5,4,9,UM1_T,"-37.80008566, 144.96386412"
591620250911,59,2025-09-11,16,1211,1641,2852,RMIT_T,"-37.80825648, 144.96304859"
71420250914,71,2025-09-14,4,2,1,3,WestWP_T,"-37.81235775, 144.97136962"
712020240719,71,2024-07-19,20,16,16,32,WestWP_T,"-37.81235775, 144.97136962"
291220241108,29,2024-11-08,12,90,197,287,AG_T,"-37.8199817, 144.96872865"
401120241222,40,2024-12-22,11,103,194,297,Spr201_T,"-37.80999341, 144.97227587"
37120250124,37,2025-01-24,1,7,11,18,Lyg260_T,"-37.80107122, 144.96704554"
47720250531,47,2025-05-31,7,88,109,197,Eli250_T,"-37.81258467, 144.9625775"
611120231225,61,2023-12-25,11,51,79,130,RMIT14_T,"-37.80767455, 144.96309114"
611620241229,61,2024-12-29,16,221,325,546,RMIT14_T,"-37.80767455, 144.96309114"
502120231130,50,2023-11-30,21,259,171,430,Lyg309_T,"-37.79808192, 144.96721013"
441820251003,44,2025-10-03,18,67,69,136,UM3_T,"-37.79698741, 144.96441306"
43020240319,43,2024-03-19,0,4,10,14,UM2_T,"-37.79844526, 144.96411782"
1401420250319,140,2025-03-19,14,4,5,9,Boyd2837_T,"-37.82590962, 144.96185972"
1401320250616,140,2025-06-16,13,97,50,147,Boyd2837_T,"-37.82590962, 144.96185972"
1321020250811,132,2025-08-11,10,141,93,234,King335_T,"-37.81267639, 144.95386444"
108320231109,108,2023-11-09,3,4,2,6,261Will_T,"-37.81295822, 144.95678789"
87520240730,87,2024-07-30,5,5,2,7,Errol23_T,"-37.80454949, 144.94921863"
87920250121,87,2025-01-21,9,41,55,96,Errol23_T,"-37.80454949, 144.94921863"
1841020251013,184,2025-10-13,10,610,536,1146,Eli124_T,"-37.81512416, 144.96371988"
1662020250108,166,2025-01-08,20,26,21,47,Spen484_T,"-37.80896733, 144.94931703"
1651320240916,165,2024-09-16,13,42,43,85,Spen475_T,"-37.80953359, 144.94939004"
162520250601,162,2025-06-01,5,27,9,36,Eli489_T,"-37.80740397, 144.95987909"
1621520250817,162,2025-08-17,15,556,1150,1706,Eli489_T,"-37.80740397, 144.95987909"
182420250819,182,2025-08-19,4,9,11,20,King163_T,"-37.81627451, 144.95550503"
632220240511,63,2024-05-11,22,195,373,568,Bou231_T,"-37.81333081, 144.96675571"
631520250508,63,2025-05-08,15,259,368,627,Bou231_T,"-37.81333081, 144.96675571"
111620250416,11,2025-04-16,16,89,97,186,WatCit_T,"-37.81564989, 144.93970694"
561820250129,56,2025-01-29,18,315,289,604,Lon364_T,"-37.81234775, 144.96153311"
112220250807,11,2025-08-07,22,21,23,44,WatCit_T,"-37.81564989, 144.93970694"
12020240413,12,2024-04-13,0,64,50,114,NewQ_T,"-37.81457988, 144.94292398"
72220240713,72,2024-07-13,2,11,27,38,ACMI_T,"-37.81726338, 144.96872809"
72620240214,72,2024-02-14,6,60,53,113,ACMI_T,"-37.81726338, 144.96872809"
762020250722,76,2025-07-22,20,7,13,20,KenMac_T,"-37.79453803, 144.93036194"
762020231206,76,2023-12-06,20,18,36,54,KenMac_T,"-37.79453803, 144.93036194"
58420240925,58,2024-09-25,4,17,10,27,Bou688_T,"-37.81686075, 144.95358075"
22220250225,2,2025-02-25,22,36,120,156,Bou283_T,"-37.81380668, 144.96516718"
271820250527,27,2025-05-27,18,124,84,208,Vic_T,"-37.80606888, 144.95644692"
9820240305,9,2024-03-05,8,151,3720,3871,Col700_T,"-37.81982992, 144.95102555"
79020250116,79,2025-01-16,0,45,258,303,FliSS_T,"-37.81794046, 144.96616678"
51720240416,51,2024-04-16,7,37,42,79,Fra118_T,"-37.80841815, 144.95906316"
231120240828,23,2024-08-28,11,219,257,476,Col623_T,"-37.81909256, 144.95452748"
232020240712,23,2024-07-12,20,135,231,366,Col623_T,"-37.81909256, 144.95452748"
251820250727,25,2025-07-27,18,55,33,88,MCEC_T,"-37.82401776, 144.95604426"
49920240301,49,2024-03-01,9,183,240,423,Eli501_T,"-37.80730068, 144.95956055"
191520240109,19,2024-01-09,15,450,504,954,LtB210_T,"-37.81237202, 144.96550671"
201120250916,20,2025-09-16,11,150,143,293,LtB170_T,"-37.81172914, 144.9682466"
201420240609,20,2024-06-09,14,254,574,828,LtB170_T,"-37.81172914, 144.9682466"
20720240818,20,2024-08-18,7,10,10,20,LtB170_T,"-37.81172914, 144.9682466"
201220240915,20,2024-09-15,12,360,292,652,LtB170_T,"-37.81172914, 144.9682466"
141820240924,141,2024-09-24,8,127,137,264,474Fl_T,"-37.81997273, 144.95834911"
141920241006,141,2024-10-06,9,104,129,233,474Fl_T,"-37.81997273, 144.95834911"
1371520240311,137,2024-03-11,15,8,14,22,BouHbr2353_T,"-37.81894815, 144.94612292"
1371120251010,137,2025-10-10,11,34,65,99,BouHbr2353_T,"-37.81894815, 144.94612292"
1361320240825,136,2024-08-25,13,61,70,131,BirFed1120_T,"-37.8184141, 144.97357915"
1421920240429,142,2024-04-29,19,125,82,207,Hammer1584_T,"-37.81970749, 144.96795734"
1642020250519,164,2025-05-19,20,43,72,115,Lat526_T,"-37.813005, 144.95160411"
164520250817,164,2025-08-17,5,3,9,12,Lat526_T,"-37.813005, 144.95160411"
161520241206,161,2024-12-06,5,17,3,20,BirArt1109_T,"-37.81851276, 144.97131336"
1611720241216,161,2024-12-16,17,43,21,64,BirArt1109_T,"-37.81851276, 144.97131336"
66220250519,66,2025-05-19,2,23,8,31,QVN_T,"-37.81057846, 144.96444294"
661820250916,66,2025-09-16,18,836,1047,1883,QVN_T,"-37.81057846, 144.96444294"
62020250413,6,2025-04-13,20,605,601,1206,FliS_T,"-37.81911705, 144.96558255"
62020250716,6,2025-07-16,20,544,585,1129,FliS_T,"-37.81911705, 144.96558255"
841320250520,84,2025-05-20,13,964,1129,2093,ElFi_T,"-37.81798049, 144.96503383"
841720250523,84,2025-05-23,17,1105,1748,2853,ElFi_T,"-37.81798049, 144.96503383"
41520240207,4,2024-02-07,15,1560,1319,2879,Swa123_T,"-37.81487988, 144.9660878"
32020250129,3,2025-01-29,20,628,672,1300,Swa295_T,"-37.81101524, 144.96429485"
751520250627,75,2025-06-27,15,58,56,114,SprFli_T,"-37.81515276, 144.97467661"
411520240525,41,2024-05-25,15,1780,1765,3545,Swa31,"-37.81668634, 144.96689733"
782120240126,78,2024-01-26,21,12,13,25,HarEsB_T,"-37.81471642, 144.9446508"
78720250826,78,2025-08-26,7,17,10,27,HarEsB_T,"-37.81471642, 144.9446508"
78320250518,78,2025-05-18,3,0,2,2,HarEsB_T,"-37.81471642, 144.9446508"
291620240228,29,2024-02-28,16,13,49,62,AG_T,"-37.8199817, 144.96872865"
14020240723,14,2024-07-23,0,27,7,34,SanBri_T,"-37.82011242, 144.96291897"
141820240208,14,2024-02-08,18,482,156,638,SanBri_T,"-37.82011242, 144.96291897"
711520241223,71,2024-12-23,15,11,9,20,WestWP_T,"-37.81235775, 144.97136962"
592120240226,59,2024-02-26,21,376,261,637,RMIT_T,"-37.80825648, 144.96304859"
29920231204,29,2023-12-04,9,143,157,300,AG_T,"-37.8199817, 144.96872865"
401120250410,40,2025-04-10,11,206,293,499,Spr201_T,"-37.80999341, 144.97227587"
312320241028,31,2024-10-28,23,32,106,138,Lyg161_T,"-37.80169681, 144.96658911"
50420250904,50,2025-09-04,4,1,1,2,Lyg309_T,"-37.79808192, 144.96721013"
44820250304,44,2025-03-04,8,61,95,156,UM3_T,"-37.79698741, 144.96441306"
441720240511,44,2024-05-11,17,38,71,109,UM3_T,"-37.79698741, 144.96441306"
442020240119,44,2024-01-19,20,2,4,6,UM3_T,"-37.79698741, 144.96441306"
1321020250120,132,2025-01-20,10,114,47,161,King335_T,"-37.81267639, 144.95386444"
1082020250221,108,2025-02-21,20,182,136,318,261Will_T,"-37.81295822, 144.95678789"
1322320251003,132,2025-10-03,23,77,79,156,King335_T,"-37.81267639, 144.95386444"
131520240107,131,2024-01-07,5,11,40,51,King2_T,"-37.82009057, 144.95758725"
131220240131,131,2024-01-31,2,6,10,16,King2_T,"-37.82009057, 144.95758725"
1351920240313,135,2024-03-13,19,972,316,1288,Spen161_T,"-37.8172861, 144.95319102"
1181420250715,118,2025-07-15,14,14,15,29,Fli114C_T,"-37.81632783, 144.97090512"
1182220231211,118,2023-12-11,22,5,13,18,Fli114C_T,"-37.81632783, 144.97090512"
1821020250425,182,2025-04-25,10,124,177,301,King163_T,"-37.81627451, 144.95550503"
165520250411,165,2025-04-11,5,0,1,1,Spen475_T,"-37.80953359, 144.94939004"
1812020250427,181,2025-04-27,20,594,681,1275,Eli368_T,"-37.81009465, 144.96143149"
1621520240928,162,2024-09-28,15,360,714,1074,Eli489_T,"-37.80740397, 144.95987909"
171720240410,17,2024-04-10,17,322,861,1183,Col15_T,"-37.81362543, 144.97323591"
182120240326,18,2024-03-26,21,17,14,31,Col12_T,"-37.81344862, 144.97305353"
63120250926,63,2025-09-26,1,40,114,154,Bou231_T,"-37.81333081, 144.96675571"
12820240215,12,2024-02-15,8,166,141,307,NewQ_T,"-37.81457988, 144.94292398"
621920240214,62,2024-02-14,19,326,170,496,Lat224_T,"-37.80996494, 144.96216521"
582220240624,58,2024-06-24,22,116,117,233,Bou688_T,"-37.81686075, 144.95358075"
761620250424,76,2025-04-24,16,53,66,119,KenMac_T,"-37.79453803, 144.93036194"
351620250301,35,2025-03-01,16,1415,1900,3315,SouthB_T,"-37.82018685, 144.96508508"
72920251007,72,2025-10-07,9,338,96,434,ACMI_T,"-37.81726338, 144.96872809"
11220240623,11,2024-06-23,2,0,1,1,WatCit_T,"-37.81564989, 144.93970694"
22220241023,2,2024-10-23,22,79,109,188,Bou283_T,"-37.81380668, 144.96516718"
21820240131,2,2024-01-31,18,391,308,699,Bou283_T,"-37.81380668, 144.96516718"
92020250526,9,2025-05-26,20,55,55,110,Col700_T,"-37.81982992, 144.95102555"
231420240419,23,2024-04-19,14,148,328,476,Col623_T,"-37.81909256, 144.95452748"
19120231123,19,2023-11-23,1,53,44,97,LtB210_T,"-37.81237202, 144.96550671"
481520250818,48,2025-08-18,15,153,135,288,QVMQ_T,"-37.80631581, 144.95866697"
481720231226,48,2023-12-26,17,99,94,193,QVMQ_T,"-37.80631581, 144.95866697"
461420240609,46,2024-06-09,14,50,59,109,Pel147_T,"-37.80240719, 144.9615673"
20920240530,20,2024-05-30,9,48,56,104,LtB170_T,"-37.81172914, 144.9682466"
1412320240424,141,2024-04-24,23,56,79,135,474Fl_T,"-37.81997273, 144.95834911"
139520250922,139,2025-09-22,5,4,5,9,Signal1647_T,"-37.81959923, 144.9632832"
1371320250318,137,2025-03-18,13,47,103,150,BouHbr2353_T,"-37.81894815, 144.94612292"
1361720240810,136,2024-08-10,17,552,63,615,BirFed1120_T,"-37.8184141, 144.97357915"
1362020240917,136,2024-09-17,20,2,0,2,BirFed1120_T,"-37.8184141, 144.97357915"
1361820250128,136,2025-01-28,18,194,90,284,BirFed1120_T,"-37.8184141, 144.97357915"
1362220240720,136,2024-07-20,22,0,9,9,BirFed1120_T,"-37.8184141, 144.97357915"
164220241012,164,2024-10-12,2,2,3,5,Lat526_T,"-37.813005, 144.95160411"
184220250826,184,2025-08-26,2,10,17,27,Eli124_T,"-37.81512416, 144.96371988"
166220241114,166,2024-11-14,2,1,0,1,Spen484_T,"-37.80896733, 144.94931703"
165220241125,165,2024-11-25,2,4,0,4,Spen475_T,"-37.80953359, 144.94939004"
181020250429,181,2025-04-29,0,147,97,244,Eli368_T,"-37.81009465, 144.96143149"
681220240724,68,2024-07-24,12,392,238,630,FLDegN_T,"-37.8168479, 144.96559789"
67320240613,67,2024-06-13,3,1,2,3,FLDegS_T,"-37.81688755, 144.96562569"
181820250618,18,2025-06-18,18,84,73,157,Col12_T,"-37.81344862, 144.97305353"
622220231122,62,2023-11-22,22,175,88,263,Lat224_T,"-37.80996494, 144.96216521"
121020241109,12,2024-11-09,10,151,180,331,NewQ_T,"-37.81457988, 144.94292398"
12520250425,12,2025-04-25,5,10,5,15,NewQ_T,"-37.81457988, 144.94292398"
86020240415,86,2024-04-15,0,0,1,1,574Qub_T,"-37.80309992, 144.94908064"
122220250712,12,2025-07-12,22,30,33,63,NewQ_T,"-37.81457988, 144.94292398"
721720250714,72,2025-07-14,17,119,763,882,ACMI_T,"-37.81726338, 144.96872809"
722320250106,72,2025-01-06,23,14,39,53,ACMI_T,"-37.81726338, 144.96872809"
72420240922,72,2024-09-22,4,0,9,9,ACMI_T,"-37.81726338, 144.96872809"
2720241014,2,2024-10-14,7,42,66,108,Bou283_T,"-37.81380668, 144.96516718"
2420240916,2,2024-09-16,4,1,4,5,Bou283_T,"-37.81380668, 144.96516718"
79020231129,79,2023-11-29,0,72,71,143,FliSS_T,"-37.81794046, 144.96616678"
30420250108,30,2025-01-08,4,10,5,15,Lon189_T,"-37.8112185, 144.96656806"
52020250718,52,2025-07-18,0,30,5,35,Eli263_T,"-37.81252157, 144.9619401"
52220250721,52,2025-07-21,2,1,12,13,Eli263_T,"-37.81252157, 144.9619401"
52420250228,52,2025-02-28,4,1,14,15,Eli263_T,"-37.81252157, 144.9619401"
19920250408,19,2025-04-08,9,98,108,206,LtB210_T,"-37.81237202, 144.96550671"
141120241107,141,2024-11-07,1,12,14,26,474Fl_T,"-37.81997273, 144.95834911"
139620240405,139,2024-04-05,6,1,10,11,Signal1647_T,"-37.81959923, 144.9632832"
1421720250608,142,2025-06-08,17,224,105,329,Hammer1584_T,"-37.81970749, 144.96795734"
1361520240812,136,2024-08-12,15,61,49,110,BirFed1120_T,"-37.8184141, 144.97357915"
164520250427,164,2025-04-27,5,11,6,17,Lat526_T,"-37.813005, 144.95160411"
491720250611,49,2025-06-11,17,569,329,898,Eli501_T,"-37.80730068, 144.95956055"
117320250309,117,2025-03-09,3,17,11,28,Fli114F_T,"-37.81629332, 144.97090877"
191320250120,19,2025-01-20,13,445,495,940,LtB210_T,"-37.81237202, 144.96550671"
662220241111,66,2024-11-11,22,387,269,656,QVN_T,"-37.81057846, 144.96444294"
661820250217,66,2025-02-17,18,1083,1010,2093,QVN_T,"-37.81057846, 144.96444294"
6620250102,6,2025-01-02,6,101,108,209,FliS_T,"-37.81911705, 144.96558255"
701620250628,70,2025-06-28,16,165,178,343,Errol20_T,"-37.80456984, 144.94946228"
41220240927,4,2024-09-27,12,1792,1119,2911,Swa123_T,"-37.81487988, 144.9660878"
391220240228,39,2024-02-28,12,451,284,735,AlfPl_T,"-37.81379749, 144.96995745"
391220250531,39,2025-05-31,12,48,33,81,AlfPl_T,"-37.81379749, 144.96995745"
75920250513,75,2025-05-13,9,44,50,94,SprFli_T,"-37.81515276, 144.97467661"
39320241109,39,2024-11-09,3,1,0,1,AlfPl_T,"-37.81379749, 144.96995745"
781920240218,78,2024-02-18,19,37,41,78,HarEsB_T,"-37.81471642, 144.9446508"
14520240915,14,2024-09-15,5,35,33,68,SanBri_T,"-37.82011242, 144.96291897"
712320250514,71,2025-05-14,23,5,5,10,WestWP_T,"-37.81235775, 144.97136962"
652320240821,65,2024-08-21,23,142,78,220,SwaCs_T,"-37.81569416, 144.9668064"
542220250318,54,2025-03-18,22,75,103,178,Swa607_T,"-37.804024, 144.96308399"
402220250819,40,2025-08-19,22,25,22,47,Spr201_T,"-37.80999341, 144.97227587"
211420240309,21,2024-03-09,14,294,366,660,Bourke155_T,"-37.81267313, 144.96788288"
37520250604,37,2025-06-04,5,2,7,9,Lyg260_T,"-37.80107122, 144.96704554"
37020240211,37,2024-02-11,0,69,104,173,Lyg260_T,"-37.80107122, 144.96704554"
501720250203,50,2025-02-03,17,156,192,348,Lyg309_T,"-37.79808192, 144.96721013"
44720240126,44,2024-01-26,7,3,3,6,UM3_T,"-37.79698741, 144.96441306"
211320240509,21,2024-05-09,13,401,542,943,Bourke155_T,"-37.81267313, 144.96788288"
51220240522,5,2024-05-22,12,809,903,1712,PriNW_T,"-37.81874249, 144.96787656"
661620240726,66,2024-07-26,16,1469,1573,3042,QVN_T,"-37.81057846, 144.96444294"
4620250221,4,2025-02-21,6,167,99,266,Swa123_T,"-37.81487988, 144.9660878"
42120250612,4,2025-06-12,21,607,648,1255,Swa123_T,"-37.81487988, 144.9660878"
701820250502,70,2025-05-02,18,187,266,453,Errol20_T,"-37.80456984, 144.94946228"
77120231113,77,2023-11-13,1,6,3,9,HarEsP_T,"-37.81441438, 144.94433026"
711820241225,71,2024-12-25,18,4,3,7,WestWP_T,"-37.81235775, 144.97136962"
71920240610,71,2024-06-10,9,24,13,37,WestWP_T,"-37.81235775, 144.97136962"
31820241112,31,2024-11-12,8,68,73,141,Lyg161_T,"-37.80169681, 144.96658911"
471220240430,47,2024-04-30,12,634,814,1448,Eli250_T,"-37.81258467, 144.9625775"
402120231121,40,2023-11-21,21,101,44,145,Spr201_T,"-37.80999341, 144.97227587"
21120240406,21,2024-04-06,1,152,190,342,Bourke155_T,"-37.81267313, 144.96788288"
361020250122,36,2025-01-22,10,172,152,324,Que85_T,"-37.81652527, 144.96121062"
431020240509,43,2024-05-09,10,289,163,452,UM2_T,"-37.79844526, 144.96411782"
51220240115,5,2024-01-15,12,881,1065,1946,PriNW_T,"-37.81874249, 144.96787656"
1082320250909,108,2025-09-09,23,61,53,114,261Will_T,"-37.81295822, 144.95678789"
108420240524,108,2024-05-24,4,3,8,11,261Will_T,"-37.81295822, 144.95678789"
612120250311,61,2025-03-11,21,402,340,742,RMIT14_T,"-37.80767455, 144.96309114"
61020250907,61,2025-09-07,0,69,38,107,RMIT14_T,"-37.80767455, 144.96309114"
1812120250426,181,2025-04-26,21,762,698,1460,Eli368_T,"-37.81009465, 144.96143149"
185920250918,185,2025-09-18,9,307,544,851,Eli197_T,"-37.81374643, 144.96276183"
1672220241206,167,2024-12-06,22,8,17,25,Lat526_T,"-37.81304149, 144.95155955"
140920231222,140,2023-12-22,9,94,37,131,Boyd2837_T,"-37.82590962, 144.96185972"
852120240604,85,2024-06-04,21,12,7,19,488Mac_T,"-37.79432415, 144.92973378"
85820241029,85,2024-10-29,8,120,54,174,488Mac_T,"-37.79432415, 144.92973378"
172120250128,17,2025-01-28,21,80,93,173,Col15_T,"-37.81362543, 144.97323591"
631620240830,63,2024-08-30,16,323,391,714,Bou231_T,"-37.81333081, 144.96675571"
68920240923,68,2024-09-23,9,185,96,281,FLDegN_T,"-37.8168479, 144.96559789"
86420240229,86,2024-02-29,4,1,1,2,574Qub_T,"-37.80309992, 144.94908064"
861320241227,86,2024-12-27,13,48,56,104,574Qub_T,"-37.80309992, 144.94908064"
62120240530,62,2024-05-30,1,41,40,81,Lat224_T,"-37.80996494, 144.96216521"
242320250612,24,2025-06-12,23,163,231,394,Col620_T,"-37.81887963, 144.95449198"
72120250814,72,2025-08-14,1,1,4,5,ACMI_T,"-37.81726338, 144.96872809"
102320250421,10,2025-04-21,23,8,4,12,BouHbr_T,"-37.81876474, 144.94710545"
58620250406,58,2025-04-06,6,84,58,142,Bou688_T,"-37.81686075, 144.95358075"
21620231026,2,2023-10-26,16,678,659,1337,Bou283_T,"-37.81380668, 144.96516718"
351020250530,35,2025-05-30,10,566,562,1128,SouthB_T,"-37.82018685, 144.96508508"
58220240216,58,2024-02-16,2,20,37,57,Bou688_T,"-37.81686075, 144.95358075"
351020241118,35,2024-11-18,10,662,499,1161,SouthB_T,"-37.82018685, 144.96508508"
91920240505,9,2024-05-05,19,87,53,140,Col700_T,"-37.81982992, 144.95102555"
92020240810,9,2024-08-10,20,44,51,95,Col700_T,"-37.81982992, 144.95102555"
271520250525,27,2025-05-25,15,237,216,453,Vic_T,"-37.80606888, 144.95644692"
30120250206,30,2025-02-06,1,70,47,117,Lon189_T,"-37.8112185, 144.96656806"
30320231119,30,2023-11-19,3,116,212,328,Lon189_T,"-37.8112185, 144.96656806"
51020250315,51,2025-03-15,0,30,16,46,Fra118_T,"-37.80841815, 144.95906316"
51420240406,51,2024-04-06,4,12,8,20,Fra118_T,"-37.80841815, 144.95906316"
481620250317,48,2025-03-17,16,151,144,295,QVMQ_T,"-37.80631581, 144.95866697"
191620240719,19,2024-07-19,16,512,553,1065,LtB210_T,"-37.81237202, 144.96550671"
251720241122,25,2024-11-22,17,877,765,1642,MCEC_T,"-37.82401776, 144.95604426"
25120250807,25,2025-08-07,1,10,15,25,MCEC_T,"-37.82401776, 144.95604426"
201720240626,20,2024-06-26,17,334,229,563,LtB170_T,"-37.81172914, 144.9682466"
521220250704,52,2025-07-04,12,417,348,765,Eli263_T,"-37.81252157, 144.9619401"
52120241019,52,2024-10-19,1,98,79,177,Eli263_T,"-37.81252157, 144.9619401"
1411920250927,141,2025-09-27,19,114,252,366,474Fl_T,"-37.81997273, 144.95834911"
1371620231122,137,2023-11-22,16,24,264,288,BouHbr2353_T,"-37.81894815, 144.94612292"
137620250329,137,2025-03-29,6,0,1,1,BouHbr2353_T,"-37.81894815, 144.94612292"
1421120240722,142,2024-07-22,11,237,214,451,Hammer1584_T,"-37.81970749, 144.96795734"
123620250814,123,2025-08-14,6,7,1,8,BirBridge_T,"-37.81753741, 144.97329734"
1381420240215,138,2024-02-15,14,22,5,27,EntPark1671_T,"-37.81996544, 144.95981454"
1381020250419,138,2025-04-19,10,10,11,21,EntPark1671_T,"-37.81996544, 144.95981454"
492320240817,49,2024-08-17,23,131,112,243,Eli501_T,"-37.80730068, 144.95956055"
1092020250303,109,2025-03-03,20,76,145,221,LatWill_T,"-37.81193681, 144.95621105"
662220240127,66,2024-01-27,22,672,454,1126,QVN_T,"-37.81057846, 144.96444294"
66720250629,66,2025-06-29,7,16,48,64,QVN_T,"-37.81057846, 144.96444294"
70920250429,70,2025-04-29,9,70,71,141,Errol20_T,"-37.80456984, 144.94946228"
41720240503,41,2024-05-03,7,639,266,905,Swa31,"-37.81668634, 144.96689733"
141420231021,14,2023-10-21,14,444,230,674,SanBri_T,"-37.82011242, 144.96291897"
542020240310,54,2024-03-10,20,58,85,143,Swa607_T,"-37.804024, 144.96308399"
282020250828,28,2025-08-28,20,210,165,375,VAC_T,"-37.82129925, 144.96879309"
311620251010,31,2025-10-10,16,148,152,300,Lyg161_T,"-37.80169681, 144.96658911"
36920241119,36,2024-11-19,9,196,153,349,Que85_T,"-37.81652527, 144.96121062"
361320240202,36,2024-02-02,13,304,246,550,Que85_T,"-37.81652527, 144.96121062"
371020250815,37,2025-08-15,10,66,56,122,Lyg260_T,"-37.80107122, 144.96704554"
441620240209,44,2024-02-09,16,45,19,64,UM3_T,"-37.79698741, 144.96441306"
431220250718,43,2025-07-18,12,139,188,327,UM2_T,"-37.79844526, 144.96411782"
45920250310,45,2025-03-10,9,117,228,345,Swa148_T,"-37.81414075, 144.96609379"
108220250917,108,2025-09-17,2,5,8,13,261Will_T,"-37.81295822, 144.95678789"
108420250422,108,2025-04-22,4,5,11,16,261Will_T,"-37.81295822, 144.95678789"
611820250420,61,2025-04-20,18,463,302,765,RMIT14_T,"-37.80767455, 144.96309114"
184020250902,184,2025-09-02,0,23,13,36,Eli124_T,"-37.81512416, 144.96371988"
1791720250323,179,2025-03-23,17,80,68,148,Pow61_T,"-37.82392385, 144.96299677"
143920240901,143,2024-09-01,9,73,205,278,Spencer_T,"-37.821728, 144.95557015"
1311520240706,131,2024-07-06,15,193,161,354,King2_T,"-37.82009057, 144.95758725"
17720231107,17,2023-11-07,7,52,43,95,Col15_T,"-37.81362543, 144.97323591"
62320241015,62,2024-10-15,3,17,8,25,Lat224_T,"-37.80996494, 144.96216521"
62520250509,62,2025-05-09,5,9,5,14,Lat224_T,"-37.80996494, 144.96216521"
10020240930,10,2024-09-30,0,0,3,3,BouHbr_T,"-37.81876474, 144.94710545"
58720240226,58,2024-02-26,7,745,126,871,Bou688_T,"-37.81686075, 144.95358075"
271720240922,27,2024-09-22,17,154,90,244,Vic_T,"-37.80606888, 144.95644692"
27720231021,27,2023-10-21,7,32,29,61,Vic_T,"-37.80606888, 144.95644692"
1091720241004,109,2024-10-04,17,370,200,570,LatWill_T,"-37.81193681, 144.95621105"
692220250728,69,2025-07-28,22,9,5,14,FLDegC_T,"-37.81687226, 144.96559144"
61620240814,6,2024-08-14,16,1698,811,2509,FliS_T,"-37.81911705, 144.96558255"
62220241011,6,2024-10-11,22,753,596,1349,FliS_T,"-37.81911705, 144.96558255"
4320241025,4,2024-10-25,3,21,14,35,Swa123_T,"-37.81487988, 144.9660878"
391620250217,39,2025-02-17,16,84,74,158,AlfPl_T,"-37.81379749, 144.96995745"
31320241125,3,2024-11-25,13,656,659,1315,Swa295_T,"-37.81101524, 144.96429485"
771720250804,77,2025-08-04,17,257,114,371,HarEsP_T,"-37.81441438, 144.94433026"
59420250408,59,2025-04-08,4,5,10,15,RMIT_T,"-37.80825648, 144.96304859"
71820250928,71,2025-09-28,8,3,3,6,WestWP_T,"-37.81235775, 144.97136962"
28720250414,28,2025-04-14,7,360,135,495,VAC_T,"-37.82129925, 144.96879309"
31420240912,31,2024-09-12,4,4,6,10,Lyg161_T,"-37.80169681, 144.96658911"
362220250813,36,2025-08-13,22,27,57,84,Que85_T,"-37.81652527, 144.96121062"
371520250508,37,2025-05-08,15,57,92,149,Lyg260_T,"-37.80107122, 144.96704554"
471120250511,47,2025-05-11,11,664,706,1370,Eli250_T,"-37.81258467, 144.9625775"
50920240301,50,2024-03-01,9,74,137,211,Lyg309_T,"-37.79808192, 144.96721013"
43620240926,43,2024-09-26,6,35,16,51,UM2_T,"-37.79844526, 144.96411782"
431720241125,43,2024-11-25,17,142,144,286,UM2_T,"-37.79844526, 144.96411782"
43220240306,43,2024-03-06,2,0,1,1,UM2_T,"-37.79844526, 144.96411782"
140720250925,140,2025-09-25,7,97,22,119,Boyd2837_T,"-37.82590962, 144.96185972"
132120250128,132,2025-01-28,1,21,5,26,King335_T,"-37.81267639, 144.95386444"
132120231125,132,2023-11-25,1,39,18,57,King335_T,"-37.81267639, 144.95386444"
134320231114,134,2023-11-14,3,17,8,25,Spen201_T,"-37.81694221, 144.95303935"
135120240929,135,2024-09-29,1,59,34,93,Spen161_T,"-37.8172861, 144.95319102"
133120240922,133,2024-09-22,1,55,29,84,Spen229_T,"-37.81531435, 144.95227769"
1182320240606,118,2024-06-06,23,2,1,3,Fli114C_T,"-37.81632783, 144.97090512"
1241220240207,124,2024-02-07,12,0,1,1,BirBridge_T,"-37.81757416, 144.97329934"
1072220231130,107,2023-11-30,22,22,20,42,280Will_T,"-37.81246271, 144.95690188"
107520240111,107,2024-01-11,5,2,3,5,280Will_T,"-37.81246271, 144.95690188"
1081920250628,108,2025-06-28,19,109,161,270,261Will_T,"-37.81295822, 144.95678789"
871120250428,87,2025-04-28,11,120,111,231,Errol23_T,"-37.80454949, 144.94921863"
871020240303,87,2024-03-03,10,72,59,131,Errol23_T,"-37.80454949, 144.94921863"
166520250408,166,2025-04-08,5,1,2,3,Spen484_T,"-37.80896733, 144.94931703"
851720240714,85,2024-07-14,17,41,51,92,488Mac_T,"-37.79432415, 144.92973378"
671820250511,67,2025-05-11,18,215,271,486,FLDegS_T,"-37.81688755, 144.96562569"
18220250504,18,2025-05-04,2,3,5,8,Col12_T,"-37.81344862, 144.97305353"
621120240402,62,2024-04-02,11,132,81,213,Lat224_T,"-37.80996494, 144.96216521"
62720241202,62,2024-12-02,7,22,38,60,Lat224_T,"-37.80996494, 144.96216521"
58820231214,58,2023-12-14,8,1770,204,1974,Bou688_T,"-37.81686075, 144.95358075"
761620241220,76,2024-12-20,16,54,67,121,KenMac_T,"-37.79453803, 144.93036194"
581820250819,58,2025-08-19,18,513,587,1100,Bou688_T,"-37.81686075, 144.95358075"
91020240811,9,2024-08-11,10,65,60,125,Col700_T,"-37.81982992, 144.95102555"
53420240816,53,2024-08-16,4,2,4,6,Col254_T,"-37.81564191, 144.965499"
1621420240914,162,2024-09-14,14,435,754,1189,Eli489_T,"-37.80740397, 144.95987909"
1622120240716,162,2024-07-16,21,143,128,271,Eli489_T,"-37.80740397, 144.95987909"
1081520250219,108,2025-02-19,15,536,211,747,261Will_T,"-37.81295822, 144.95678789"
1322020240509,132,2024-05-09,20,80,74,154,King335_T,"-37.81267639, 144.95386444"
1341120231116,134,2023-11-16,11,307,369,676,Spen201_T,"-37.81694221, 144.95303935"
134120231218,134,2023-12-18,1,16,38,54,Spen201_T,"-37.81694221, 144.95303935"
107320241031,107,2024-10-31,3,5,1,6,280Will_T,"-37.81246271, 144.95690188"
1181820240403,118,2024-04-03,18,12,20,32,Fli114C_T,"-37.81632783, 144.97090512"
1662120241016,166,2024-10-16,21,8,5,13,Spen484_T,"-37.80896733, 144.94931703"
66320250414,66,2025-04-14,3,18,24,42,QVN_T,"-37.81057846, 144.96444294"
6220250609,6,2025-06-09,2,41,27,68,FliS_T,"-37.81911705, 144.96558255"
702220240325,70,2024-03-25,22,27,28,55,Errol20_T,"-37.80456984, 144.94946228"
8020250725,8,2025-07-25,0,1,0,1,WebBN_T,"-37.82293543, 144.9471751"
411020241225,41,2024-12-25,10,474,482,956,Swa31,"-37.81668634, 144.96689733"
42320240909,42,2024-09-09,3,0,1,1,UM1_T,"-37.80008566, 144.96386412"
292120251008,29,2025-10-08,21,62,99,161,AG_T,"-37.8199817, 144.96872865"
292020240511,29,2024-05-11,20,95,210,305,AG_T,"-37.8199817, 144.96872865"
291120240516,29,2024-05-16,11,1,2,3,AG_T,"-37.8199817, 144.96872865"
59120240427,59,2024-04-27,1,72,38,110,RMIT_T,"-37.80825648, 144.96304859"
651920240514,65,2024-05-14,19,166,207,373,SwaCs_T,"-37.81569416, 144.9668064"
31420240204,31,2024-02-04,4,9,3,12,Lyg161_T,"-37.80169681, 144.96658911"
471620250516,47,2025-05-16,16,1438,1187,2625,Eli250_T,"-37.81258467, 144.9625775"
401020250502,40,2025-05-02,10,164,157,321,Spr201_T,"-37.80999341, 144.97227587"
36320240121,36,2024-01-21,3,81,47,128,Que85_T,"-37.81652527, 144.96121062"
361220240811,36,2024-08-11,12,118,113,231,Que85_T,"-37.81652527, 144.96121062"
501020250304,50,2025-03-04,10,79,120,199,Lyg309_T,"-37.79808192, 144.96721013"
431120240125,43,2024-01-25,11,57,70,127,UM2_T,"-37.79844526, 144.96411782"
432120250326,43,2025-03-26,21,34,144,178,UM2_T,"-37.79844526, 144.96411782"
43020250922,43,2025-09-22,0,6,3,9,UM2_T,"-37.79844526, 144.96411782"
451420251012,45,2025-10-12,14,997,1294,2291,Swa148_T,"-37.81414075, 144.96609379"
451920240519,45,2024-05-19,19,339,495,834,Swa148_T,"-37.81414075, 144.96609379"
182020250826,182,2025-08-26,0,35,37,72,King163_T,"-37.81627451, 144.95550503"
1312020250413,131,2025-04-13,20,91,83,174,King2_T,"-37.82009057, 144.95758725"
143020240604,143,2024-06-04,0,31,18,49,Spencer_T,"-37.821728, 144.95557015"
1401720240824,140,2024-08-24,17,113,109,222,Boyd2837_T,"-37.82590962, 144.96185972"
1321620240131,132,2024-01-31,16,167,158,325,King335_T,"-37.81267639, 144.95386444"
1322120250412,132,2025-04-12,21,120,142,262,King335_T,"-37.81267639, 144.95386444"
1321620250503,132,2025-05-03,16,163,169,332,King335_T,"-37.81267639, 144.95386444"
1342220240126,134,2024-01-26,22,219,401,620,Spen201_T,"-37.81694221, 144.95303935"
134520231213,134,2023-12-13,5,52,68,120,Spen201_T,"-37.81694221, 144.95303935"
1332120241205,133,2024-12-05,21,489,327,816,Spen229_T,"-37.81531435, 144.95227769"
1181620250713,118,2025-07-13,16,39,14,53,Fli114C_T,"-37.81632783, 144.97090512"
1662020241213,166,2024-12-13,20,30,53,83,Spen484_T,"-37.80896733, 144.94931703"
672320251008,67,2025-10-08,23,19,22,41,FLDegS_T,"-37.81688755, 144.96562569"
1920240102,1,2024-01-02,9,315,387,702,Bou292_T,"-37.81349441, 144.96515323"
531920240508,53,2024-05-08,19,256,196,452,Col254_T,"-37.81564191, 144.965499"
9020231105,9,2023-11-05,0,11,13,24,Col700_T,"-37.81982992, 144.95102555"
232320241121,23,2024-11-21,23,42,90,132,Col623_T,"-37.81909256, 144.95452748"
521420250420,52,2025-04-20,14,402,334,736,Eli263_T,"-37.81252157, 144.9619401"
1371620250501,137,2025-05-01,16,15,206,221,BouHbr2353_T,"-37.81894815, 144.94612292"
1391020250625,139,2025-06-25,10,48,33,81,Signal1647_T,"-37.81959923, 144.9632832"
1392020240726,139,2024-07-26,20,23,21,44,Signal1647_T,"-37.81959923, 144.9632832"
130720250501,130,2025-05-01,7,19,12,31,Bou892T,"-37.8204637, 144.94126826"
164320240825,164,2024-08-25,3,2,3,5,Lat526_T,"-37.813005, 144.95160411"
117220240326,117,2024-03-26,2,8,0,8,Fli114F_T,"-37.81629332, 144.97090877"
1171520231102,117,2023-11-02,15,165,173,338,Fli114F_T,"-37.81629332, 144.97090877"
66320241029,66,2024-10-29,3,15,9,24,QVN_T,"-37.81057846, 144.96444294"
841920241120,84,2024-11-20,19,623,1190,1813,ElFi_T,"-37.81798049, 144.96503383"
711320250115,71,2025-01-15,13,8,18,26,WestWP_T,"-37.81235775, 144.97136962"
59820250801,59,2025-08-01,8,1456,214,1670,RMIT_T,"-37.80825648, 144.96304859"
292020240415,29,2024-04-15,20,31,101,132,AG_T,"-37.8199817, 144.96872865"
141920241019,14,2024-10-19,19,404,114,518,SanBri_T,"-37.82011242, 144.96291897"
28620250818,28,2025-08-18,6,115,66,181,VAC_T,"-37.82129925, 144.96879309"
40720250111,40,2025-01-11,7,24,16,40,Spr201_T,"-37.80999341, 144.97227587"
471120240726,47,2024-07-26,11,561,766,1327,Eli250_T,"-37.81258467, 144.9625775"
402020250821,40,2025-08-21,20,153,39,192,Spr201_T,"-37.80999341, 144.97227587"
36920250406,36,2025-04-06,9,104,43,147,Que85_T,"-37.81652527, 144.96121062"
43020240801,43,2024-08-01,0,34,4,38,UM2_T,"-37.79844526, 144.96411782"
431720250425,43,2025-04-25,17,35,27,62,UM2_T,"-37.79844526, 144.96411782"
1331220250424,133,2025-04-24,12,446,445,891,Spen229_T,"-37.81531435, 144.95227769"
1182320250322,118,2025-03-22,23,47,5,52,Fli114C_T,"-37.81632783, 144.97090512"
1181520240817,118,2024-08-17,15,34,71,105,Fli114C_T,"-37.81632783, 144.97090512"
1081720240115,108,2024-01-15,17,1392,214,1606,261Will_T,"-37.81295822, 144.95678789"
1081120250309,108,2025-03-09,11,131,83,214,261Will_T,"-37.81295822, 144.95678789"
87520240505,87,2024-05-05,5,2,1,3,Errol23_T,"-37.80454949, 144.94921863"
612320240531,61,2024-05-31,23,168,103,271,RMIT14_T,"-37.80767455, 144.96309114"
165520240902,165,2024-09-02,5,0,1,1,Spen475_T,"-37.80953359, 144.94939004"
1661120241107,166,2024-11-07,11,33,33,66,Spen484_T,"-37.80896733, 144.94931703"
1621520250621,162,2025-06-21,15,399,746,1145,Eli489_T,"-37.80740397, 144.95987909"
1311820250228,131,2025-02-28,18,75,105,180,King2_T,"-37.82009057, 144.95758725"
1431320250424,143,2025-04-24,13,178,239,417,Spencer_T,"-37.821728, 144.95557015"
143620250628,143,2025-06-28,6,15,34,49,Spencer_T,"-37.821728, 144.95557015"
132320241228,132,2024-12-28,3,14,1,15,King335_T,"-37.81267639, 144.95386444"
1311320240811,131,2024-08-11,13,121,126,247,King2_T,"-37.82009057, 144.95758725"
1320250223,1,2025-02-23,3,18,43,61,Bou292_T,"-37.81349441, 144.96515323"
18820241014,18,2024-10-14,8,99,1116,1215,Col12_T,"-37.81344862, 144.97305353"
181320250223,18,2025-02-23,13,45,29,74,Col12_T,"-37.81344862, 144.97305353"
182220250717,18,2025-07-17,22,4,3,7,Col12_T,"-37.81344862, 144.97305353"
86820240623,86,2024-06-23,8,3,2,5,574Qub_T,"-37.80309992, 144.94908064"
121020250211,12,2025-02-11,10,90,80,170,NewQ_T,"-37.81457988, 144.94292398"
121420250323,12,2025-03-23,14,909,278,1187,NewQ_T,"-37.81457988, 144.94292398"
63320250410,63,2025-04-10,3,1,2,3,Bou231_T,"-37.81333081, 144.96675571"
182320240121,18,2024-01-21,23,7,2,9,Col12_T,"-37.81344862, 144.97305353"
861120241007,86,2024-10-07,11,42,49,91,574Qub_T,"-37.80309992, 144.94908064"
86420250127,86,2025-01-27,4,0,2,2,574Qub_T,"-37.80309992, 144.94908064"
112320240811,11,2024-08-11,23,8,11,19,WatCit_T,"-37.81564989, 144.93970694"
112120250703,11,2025-07-03,21,13,15,28,WatCit_T,"-37.81564989, 144.93970694"
56120240102,56,2024-01-02,1,19,23,42,Lon364_T,"-37.81234775, 144.96153311"
241820241218,24,2024-12-18,18,819,1058,1877,Col620_T,"-37.81887963, 144.95449198"
11020251007,11,2025-10-07,0,3,5,8,WatCit_T,"-37.81564989, 144.93970694"
24920240101,24,2024-01-01,9,151,226,377,Col620_T,"-37.81887963, 144.95449198"
762020250110,76,2025-01-10,20,35,34,69,KenMac_T,"-37.79453803, 144.93036194"
9020250319,9,2025-03-19,0,11,10,21,Col700_T,"-37.81982992, 144.95102555"
512320241201,51,2024-12-01,23,14,15,29,Fra118_T,"-37.80841815, 144.95906316"
511320250416,51,2025-04-16,13,139,122,261,Fra118_T,"-37.80841815, 144.95906316"
481520240421,48,2024-04-21,15,633,380,1013,QVMQ_T,"-37.80631581, 144.95866697"
48320231104,48,2023-11-04,3,15,5,20,QVMQ_T,"-37.80631581, 144.95866697"
201820250713,20,2025-07-13,18,438,422,860,LtB170_T,"-37.81172914, 144.9682466"
201320250803,20,2025-08-03,13,274,378,652,LtB170_T,"-37.81172914, 144.9682466"
46520240215,46,2024-02-15,5,0,4,4,Pel147_T,"-37.80240719, 144.9615673"
19320250505,19,2025-05-05,3,7,13,20,LtB210_T,"-37.81237202, 144.96550671"
141720231211,141,2023-12-11,7,46,27,73,474Fl_T,"-37.81997273, 144.95834911"
136720250911,136,2025-09-11,7,75,115,190,BirFed1120_T,"-37.8184141, 144.97357915"
1392120240130,139,2024-01-30,21,15,27,42,Signal1647_T,"-37.81959923, 144.9632832"
139720240823,139,2024-08-23,7,16,70,86,Signal1647_T,"-37.81959923, 144.9632832"
1392120250221,139,2025-02-21,21,29,44,73,Signal1647_T,"-37.81959923, 144.9632832"
1391220250809,139,2025-08-09,12,64,54,118,Signal1647_T,"-37.81959923, 144.9632832"
1362020241013,136,2024-10-13,20,11,6,17,BirFed1120_T,"-37.8184141, 144.97357915"
142920240306,142,2024-03-06,9,173,218,391,Hammer1584_T,"-37.81970749, 144.96795734"
1231720250414,123,2025-04-14,17,64,36,100,BirBridge_T,"-37.81753741, 144.97329734"
117920240620,117,2024-06-20,9,254,130,384,Fli114F_T,"-37.81629332, 144.97090877"
49220241119,49,2024-11-19,2,39,35,74,Eli501_T,"-37.80730068, 144.95956055"
1801220251002,180,2025-10-02,12,35,25,60,Mac330_T,"-37.79497059, 144.93530329"
6620240222,6,2024-02-22,6,227,328,555,FliS_T,"-37.81911705, 144.96558255"
6020250201,6,2025-02-01,0,342,155,497,FliS_T,"-37.81911705, 144.96558255"
841320240623,84,2024-06-23,13,961,1149,2110,ElFi_T,"-37.81798049, 144.96503383"
701220250619,70,2025-06-19,12,158,168,326,Errol20_T,"-37.80456984, 144.94946228"
751220250130,75,2025-01-30,12,61,87,148,SprFli_T,"-37.81515276, 144.97467661"
41020240112,41,2024-01-12,0,143,107,250,Swa31,"-37.81668634, 144.96689733"
771620250811,77,2025-08-11,16,213,125,338,HarEsP_T,"-37.81441438, 144.94433026"
781920250330,78,2025-03-30,19,13,53,66,HarEsB_T,"-37.81471642, 144.9446508"
291620241006,29,2024-10-06,16,397,558,955,AG_T,"-37.8199817, 144.96872865"
291520250420,29,2025-04-20,15,710,609,1319,AG_T,"-37.8199817, 144.96872865"
71520250412,71,2025-04-12,5,3,6,9,WestWP_T,"-37.81235775, 144.97136962"
59520240606,59,2024-06-06,5,27,17,44,RMIT_T,"-37.80825648, 144.96304859"
651020240317,65,2024-03-17,10,98,104,202,SwaCs_T,"-37.81569416, 144.9668064"
28220250611,28,2025-06-11,2,15,4,19,VAC_T,"-37.82129925, 144.96879309"
281720231231,28,2023-12-31,17,669,1596,2265,VAC_T,"-37.82129925, 144.96879309"
40320240513,40,2024-05-13,3,4,0,4,Spr201_T,"-37.80999341, 144.97227587"
312120240103,31,2024-01-03,21,306,317,623,Lyg161_T,"-37.80169681, 144.96658911"
362220250315,36,2025-03-15,22,181,181,362,Que85_T,"-37.81652527, 144.96121062"
511020240320,51,2024-03-20,10,109,92,201,Fra118_T,"-37.80841815, 144.95906316"
511920240808,51,2024-08-08,19,57,69,126,Fra118_T,"-37.80841815, 144.95906316"
46820250922,46,2025-09-22,8,131,45,176,Pel147_T,"-37.80240719, 144.9615673"
49520240121,49,2024-01-21,5,19,21,40,Eli501_T,"-37.80730068, 144.95956055"
25920240819,25,2024-08-19,9,128,400,528,MCEC_T,"-37.82401776, 144.95604426"
1371220240707,137,2024-07-07,12,8,18,26,BouHbr2353_T,"-37.81894815, 144.94612292"
1302020241113,130,2024-11-13,20,8,14,22,Bou892T,"-37.8204637, 144.94126826"
1642120250412,164,2025-04-12,21,66,80,146,Lat526_T,"-37.813005, 144.95160411"
1611520240723,161,2024-07-23,15,121,95,216,BirArt1109_T,"-37.81851276, 144.97131336"
161920250801,161,2025-08-01,9,133,120,253,BirArt1109_T,"-37.81851276, 144.97131336"
69520241018,69,2024-10-18,5,8,8,16,FLDegC_T,"-37.81687226, 144.96559144"
6420250125,6,2025-01-25,4,35,44,79,FliS_T,"-37.81911705, 144.96558255"
841120240626,84,2024-06-26,11,910,754,1664,ElFi_T,"-37.81798049, 144.96503383"
841020240923,84,2024-09-23,10,834,596,1430,ElFi_T,"-37.81798049, 144.96503383"
41520240320,4,2024-03-20,15,1729,1419,3148,Swa123_T,"-37.81487988, 144.9660878"
4620241009,4,2024-10-09,6,111,37,148,Swa123_T,"-37.81487988, 144.9660878"
8220231124,8,2023-11-24,2,1,2,3,WebBN_T,"-37.82293543, 144.9471751"
75420250508,75,2025-05-08,4,0,1,1,SprFli_T,"-37.81515276, 144.97467661"
77220240909,77,2024-09-09,2,5,1,6,HarEsP_T,"-37.81441438, 144.94433026"
77620241228,77,2024-12-28,6,14,22,36,HarEsP_T,"-37.81441438, 144.94433026"
42320241227,42,2024-12-27,3,0,2,2,UM1_T,"-37.80008566, 144.96386412"
14020250203,14,2025-02-03,0,19,3,22,SanBri_T,"-37.82011242, 144.96291897"
291220240219,29,2024-02-19,12,257,455,712,AG_T,"-37.8199817, 144.96872865"
402320250330,40,2025-03-30,23,13,5,18,Spr201_T,"-37.80999341, 144.97227587"
402220231115,40,2023-11-15,22,248,22,270,Spr201_T,"-37.80999341, 144.97227587"
43920241124,43,2024-11-24,9,24,5,29,UM2_T,"-37.79844526, 144.96411782"
143520240831,143,2024-08-31,5,20,15,35,Spencer_T,"-37.821728, 144.95557015"
1341520250511,134,2025-05-11,15,365,354,719,Spen201_T,"-37.81694221, 144.95303935"
1311420240405,131,2024-04-05,14,135,111,246,King2_T,"-37.82009057, 144.95758725"
131620240724,131,2024-07-24,6,9,15,24,King2_T,"-37.82009057, 144.95758725"
135320251009,135,2025-10-09,3,11,13,24,Spen161_T,"-37.8172861, 144.95319102"
133520241029,133,2024-10-29,5,80,68,148,Spen229_T,"-37.81531435, 144.95227769"
871120250831,87,2025-08-31,11,107,115,222,Errol23_T,"-37.80454949, 144.94921863"
166520241204,166,2024-12-04,5,20,4,24,Spen484_T,"-37.80896733, 144.94931703"
81920240608,8,2024-06-08,19,41,38,79,WebBN_T,"-37.82293543, 144.9471751"
771120250324,77,2025-03-24,11,125,58,183,HarEsP_T,"-37.81441438, 144.94433026"
241520240606,24,2024-06-06,15,524,1151,1675,Col620_T,"-37.81887963, 144.95449198"
721220240325,72,2024-03-25,12,216,436,652,ACMI_T,"-37.81726338, 144.96872809"
721720250419,72,2025-04-19,17,327,612,939,ACMI_T,"-37.81726338, 144.96872809"
351220250421,35,2025-04-21,12,1788,1612,3400,SouthB_T,"-37.82018685, 144.96508508"
53020250111,53,2025-01-11,0,35,49,84,Col254_T,"-37.81564191, 144.965499"
92120240825,9,2024-08-25,21,24,19,43,Col700_T,"-37.81982992, 144.95102555"
79620250408,79,2025-04-08,6,164,69,233,FliSS_T,"-37.81794046, 144.96616678"
92320250827,9,2025-08-27,23,19,10,29,Col700_T,"-37.81982992, 144.95102555"
30620241205,30,2024-12-05,6,22,29,51,Lon189_T,"-37.8112185, 144.96656806"
301620241029,30,2024-10-29,16,189,354,543,Lon189_T,"-37.8112185, 144.96656806"
91920250419,9,2025-04-19,19,53,84,137,Col700_T,"-37.81982992, 144.95102555"
512320250726,51,2025-07-26,23,48,34,82,Fra118_T,"-37.80841815, 144.95906316"
482220240615,48,2024-06-15,22,48,111,159,QVMQ_T,"-37.80631581, 144.95866697"
252020250909,25,2025-09-09,20,261,240,501,MCEC_T,"-37.82401776, 144.95604426"
461720240406,46,2024-04-06,17,62,74,136,Pel147_T,"-37.80240719, 144.9615673"
52620250922,52,2025-09-22,6,29,25,54,Eli263_T,"-37.81252157, 144.9619401"
461120241201,46,2024-12-01,11,42,23,65,Pel147_T,"-37.80240719, 144.9615673"
139920250116,139,2025-01-16,9,72,147,219,Signal1647_T,"-37.81959923, 144.9632832"
137820240301,137,2024-03-01,8,83,27,110,BouHbr2353_T,"-37.81894815, 144.94612292"
1362320250808,136,2025-08-08,23,4,1,5,BirFed1120_T,"-37.8184141, 144.97357915"
1422320240615,142,2024-06-15,23,88,68,156,Hammer1584_T,"-37.81970749, 144.96795734"
49020240825,49,2024-08-25,0,91,62,153,Eli501_T,"-37.80730068, 144.95956055"
49320240318,49,2024-03-18,3,22,25,47,Eli501_T,"-37.80730068, 144.95956055"
1091820231031,109,2023-10-31,18,230,136,366,LatWill_T,"-37.81193681, 144.95621105"
1092020231201,109,2023-12-01,20,112,80,192,LatWill_T,"-37.81193681, 144.95621105"
192220250311,19,2025-03-11,22,182,307,489,LtB210_T,"-37.81237202, 144.96550671"
662320250304,66,2025-03-04,23,173,122,295,QVN_T,"-37.81057846, 144.96444294"
691720240501,69,2024-05-01,17,96,140,236,FLDegC_T,"-37.81687226, 144.96559144"
62020240930,6,2024-09-30,20,492,555,1047,FliS_T,"-37.81911705, 144.96558255"
841620240917,84,2024-09-17,16,914,1674,2588,ElFi_T,"-37.81798049, 144.96503383"
32120250727,3,2025-07-27,21,352,331,683,Swa295_T,"-37.81101524, 144.96429485"
391120241222,39,2024-12-22,11,45,14,59,AlfPl_T,"-37.81379749, 144.96995745"
782120231215,78,2023-12-15,21,15,12,27,HarEsB_T,"-37.81471642, 144.9446508"
41120241108,41,2024-11-08,1,57,73,130,Swa31,"-37.81668634, 144.96689733"
781520250727,78,2025-07-27,15,49,48,97,HarEsB_T,"-37.81471642, 144.9446508"
772120240421,77,2024-04-21,21,22,20,42,HarEsP_T,"-37.81441438, 144.94433026"
711420240811,71,2024-08-11,14,14,18,32,WestWP_T,"-37.81235775, 144.97136962"
282220240329,28,2024-03-29,22,931,158,1089,VAC_T,"-37.82129925, 144.96879309"
292020240818,29,2024-08-18,20,34,119,153,AG_T,"-37.8199817, 144.96872865"
29520231120,29,2023-11-20,5,4,19,23,AG_T,"-37.8199817, 144.96872865"
141420250121,14,2025-01-21,14,328,83,411,SanBri_T,"-37.82011242, 144.96291897"
141220240629,14,2024-06-29,12,174,73,247,SanBri_T,"-37.82011242, 144.96291897"
541320250503,54,2025-05-03,13,121,130,251,Swa607_T,"-37.804024, 144.96308399"
281220250806,28,2025-08-06,12,745,738,1483,VAC_T,"-37.82129925, 144.96879309"
28220251014,28,2025-10-14,2,6,7,13,VAC_T,"-37.82129925, 144.96879309"
471520250112,47,2025-01-12,15,453,532,985,Eli250_T,"-37.81258467, 144.9625775"
47420240323,47,2024-03-23,4,39,26,65,Eli250_T,"-37.81258467, 144.9625775"
31620231110,31,2023-11-10,6,12,9,21,Lyg161_T,"-37.80169681, 144.96658911"
211920241106,21,2024-11-06,19,253,295,548,Bourke155_T,"-37.81267313, 144.96788288"
21020250129,21,2025-01-29,0,25,54,79,Bourke155_T,"-37.81267313, 144.96788288"
372320250323,37,2025-03-23,23,27,22,49,Lyg260_T,"-37.80107122, 144.96704554"
43220250925,43,2025-09-25,2,1,2,3,UM2_T,"-37.79844526, 144.96411782"
451820240306,45,2024-03-06,18,561,785,1346,Swa148_T,"-37.81414075, 144.96609379"
451220240423,45,2024-04-23,12,638,744,1382,Swa148_T,"-37.81414075, 144.96609379"
44020240922,44,2024-09-22,0,12,2,14,UM3_T,"-37.79698741, 144.96441306"
1341320240412,134,2024-04-12,13,508,491,999,Spen201_T,"-37.81694221, 144.95303935"
1342120250210,134,2025-02-10,21,359,224,583,Spen201_T,"-37.81694221, 144.95303935"
1182120240405,118,2024-04-05,21,9,12,21,Fli114C_T,"-37.81632783, 144.97090512"
671720250112,67,2025-01-12,17,237,318,555,FLDegS_T,"-37.81688755, 144.96562569"
501020241030,50,2024-10-30,10,102,127,229,Lyg309_T,"-37.79808192, 144.96721013"
441320241011,44,2024-10-11,13,120,103,223,UM3_T,"-37.79698741, 144.96441306"
45920240216,45,2024-02-16,9,311,326,637,Swa148_T,"-37.81414075, 144.96609379"
162520241120,162,2024-11-20,5,13,16,29,Eli489_T,"-37.80740397, 144.95987909"
162520250101,162,2025-01-01,5,66,31,97,Eli489_T,"-37.80740397, 144.95987909"
143420240817,143,2024-08-17,4,31,9,40,Spencer_T,"-37.821728, 144.95557015"
143320250216,143,2025-02-16,3,33,8,41,Spencer_T,"-37.821728, 144.95557015"
1351020231119,135,2023-11-19,10,335,339,674,Spen161_T,"-37.8172861, 144.95319102"
107920241221,107,2024-12-21,9,60,74,134,280Will_T,"-37.81246271, 144.95690188"
1071320250312,107,2025-03-12,13,211,180,391,280Will_T,"-37.81246271, 144.95690188"
118820231211,118,2023-12-11,8,22,9,31,Fli114C_T,"-37.81632783, 144.97090512"
1241520250711,124,2025-07-11,15,4,3,7,BirBridge_T,"-37.81757416, 144.97329934"
87320250711,87,2025-07-11,3,1,1,2,Errol23_T,"-37.80454949, 144.94921863"
179420250910,179,2025-09-10,4,2,4,6,Pow61_T,"-37.82392385, 144.96299677"
67020250626,67,2025-06-26,0,12,12,24,FLDegS_T,"-37.81688755, 144.96562569"
681120250725,68,2025-07-25,11,377,367,744,FLDegN_T,"-37.8168479, 144.96559789"
851120250617,85,2025-06-17,11,73,56,129,488Mac_T,"-37.79432415, 144.92973378"
12220240427,1,2024-04-27,22,193,259,452,Bou292_T,"-37.81349441, 144.96515323"
631220241020,63,2024-10-20,12,304,376,680,Bou231_T,"-37.81333081, 144.96675571"
67120250104,67,2025-01-04,1,20,35,55,FLDegS_T,"-37.81688755, 144.96562569"
181520240611,18,2024-06-11,15,217,109,326,Col12_T,"-37.81344862, 144.97305353"
86120250115,86,2025-01-15,1,0,1,1,574Qub_T,"-37.80309992, 144.94908064"
111120250401,11,2025-04-01,11,54,59,113,WatCit_T,"-37.81564989, 144.93970694"
10520240814,10,2024-08-14,5,4,4,8,BouHbr_T,"-37.81876474, 144.94710545"
121020241231,12,2024-12-31,10,185,155,340,NewQ_T,"-37.81457988, 144.94292398"
721120240229,72,2024-02-29,11,176,287,463,ACMI_T,"-37.81726338, 144.96872809"
352020231220,35,2023-12-20,20,1734,2935,4669,SouthB_T,"-37.82018685, 144.96508508"
761320241106,76,2024-11-06,13,53,61,114,KenMac_T,"-37.79453803, 144.93036194"
2620250606,2,2025-06-06,6,16,24,40,Bou283_T,"-37.81380668, 144.96516718"
531420231121,53,2023-11-21,14,762,702,1464,Col254_T,"-37.81564191, 144.965499"
791320241222,79,2024-12-22,13,659,371,1030,FliSS_T,"-37.81794046, 144.96616678"
91520250106,9,2025-01-06,15,851,90,941,Col700_T,"-37.81982992, 144.95102555"
232020240918,23,2024-09-18,20,114,229,343,Col623_T,"-37.81909256, 144.95452748"
511020240624,51,2024-06-24,10,88,58,146,Fra118_T,"-37.80841815, 144.95906316"
1411420240414,141,2024-04-14,14,180,150,330,474Fl_T,"-37.81997273, 144.95834911"
1421720250910,142,2025-09-10,17,418,284,702,Hammer1584_T,"-37.81970749, 144.96795734"
1361520240802,136,2024-08-02,15,72,51,123,BirFed1120_T,"-37.8184141, 144.97357915"
142320240210,142,2024-02-10,3,6,2,8,Hammer1584_T,"-37.81970749, 144.96795734"
1301520250706,130,2025-07-06,15,63,58,121,Bou892T,"-37.8204637, 144.94126826"
1611020241020,161,2024-10-20,10,154,165,319,BirArt1109_T,"-37.81851276, 144.97131336"
1612120250112,161,2025-01-12,21,58,378,436,BirArt1109_T,"-37.81851276, 144.97131336"
117520240524,117,2024-05-24,5,8,6,14,Fli114F_T,"-37.81629332, 144.97090877"
109720250215,109,2025-02-15,7,19,21,40,LatWill_T,"-37.81193681, 144.95621105"
1091820240608,109,2024-06-08,18,78,153,231,LatWill_T,"-37.81193681, 144.95621105"
109920241116,109,2024-11-16,9,57,69,126,LatWill_T,"-37.81193681, 144.95621105"
66520240125,66,2024-01-25,5,15,25,40,QVN_T,"-37.81057846, 144.96444294"
692220240522,69,2024-05-22,22,34,13,47,FLDegC_T,"-37.81687226, 144.96559144"
6120231222,6,2023-12-22,1,119,65,184,FliS_T,"-37.81911705, 144.96558255"
6720240123,6,2024-01-23,7,480,762,1242,FliS_T,"-37.81911705, 144.96558255"
84220240706,84,2024-07-06,2,51,81,132,ElFi_T,"-37.81798049, 144.96503383"
6220250721,6,2025-07-21,2,9,7,16,FliS_T,"-37.81911705, 144.96558255"
42020240505,4,2024-05-05,20,590,374,964,Swa123_T,"-37.81487988, 144.9660878"
41920250112,4,2025-01-12,19,705,807,1512,Swa123_T,"-37.81487988, 144.9660878"
41420250708,4,2025-07-08,14,1325,973,2298,Swa123_T,"-37.81487988, 144.9660878"
851820240403,85,2024-04-03,18,61,96,157,488Mac_T,"-37.79432415, 144.92973378"
1120231112,1,2023-11-12,1,48,90,138,Bou292_T,"-37.81349441, 144.96515323"
11120241115,1,2024-11-15,11,974,927,1901,Bou292_T,"-37.81349441, 144.96515323"
861620250407,86,2025-04-07,16,57,52,109,574Qub_T,"-37.80309992, 144.94908064"
11920240822,11,2024-08-22,9,47,55,102,WatCit_T,"-37.81564989, 144.93970694"
62120231228,62,2023-12-28,1,15,10,25,Lat224_T,"-37.80996494, 144.96216521"
561620241215,56,2024-12-15,16,322,347,669,Lon364_T,"-37.81234775, 144.96153311"
24620240207,24,2024-02-07,6,333,159,492,Col620_T,"-37.81887963, 144.95449198"
561120250915,56,2025-09-15,11,297,224,521,Lon364_T,"-37.81234775, 144.96153311"
722220250605,72,2025-06-05,22,67,107,174,ACMI_T,"-37.81726338, 144.96872809"
72720231202,72,2023-12-02,7,130,38,168,ACMI_T,"-37.81726338, 144.96872809"
58820250108,58,2025-01-08,8,1382,168,1550,Bou688_T,"-37.81686075, 144.95358075"
531520250220,53,2025-02-20,15,691,512,1203,Col254_T,"-37.81564191, 144.965499"
92120250904,9,2025-09-04,21,61,57,118,Col700_T,"-37.81982992, 144.95102555"
511220241211,51,2024-12-11,12,57,77,134,Fra118_T,"-37.80841815, 144.95906316"
20320240616,20,2024-06-16,3,66,84,150,LtB170_T,"-37.81172914, 144.9682466"
46920241102,46,2024-11-02,9,39,21,60,Pel147_T,"-37.80240719, 144.9615673"
1412120231128,141,2023-11-28,21,86,91,177,474Fl_T,"-37.81997273, 144.95834911"
1411120231230,141,2023-12-30,11,132,261,393,474Fl_T,"-37.81997273, 144.95834911"
1411620240825,141,2024-08-25,16,135,57,192,474Fl_T,"-37.81997273, 144.95834911"
141620250828,141,2025-08-28,6,13,23,36,474Fl_T,"-37.81997273, 144.95834911"
139820240917,139,2024-09-17,8,29,486,515,Signal1647_T,"-37.81959923, 144.9632832"
139520250618,139,2025-06-18,5,2,1,3,Signal1647_T,"-37.81959923, 144.9632832"
1372120240803,137,2024-08-03,21,0,2,2,BouHbr2353_T,"-37.81894815, 144.94612292"
1392120231121,139,2023-11-21,21,38,20,58,Signal1647_T,"-37.81959923, 144.9632832"
142620240317,142,2024-03-17,6,19,24,43,Hammer1584_T,"-37.81970749, 144.96795734"
142320240601,142,2024-06-01,3,5,2,7,Hammer1584_T,"-37.81970749, 144.96795734"
1301120250824,130,2025-08-24,11,91,21,112,Bou892T,"-37.8204637, 144.94126826"
1611820240810,161,2024-08-10,18,91,3,94,BirArt1109_T,"-37.81851276, 144.97131336"
19020251012,19,2025-10-12,0,233,197,430,LtB210_T,"-37.81237202, 144.96550671"
19020241028,19,2024-10-28,0,79,122,201,LtB210_T,"-37.81237202, 144.96550671"
61820240229,61,2024-02-29,8,597,334,931,RMIT14_T,"-37.80767455, 144.96309114"
181620250510,181,2025-05-10,6,37,86,123,Eli368_T,"-37.81009465, 144.96143149"
1651120241012,165,2024-10-12,11,67,72,139,Spen475_T,"-37.80953359, 144.94939004"
1342120250822,134,2025-08-22,21,341,296,637,Spen201_T,"-37.81694221, 144.95303935"
1720240125,1,2024-01-25,7,73,124,197,Bou292_T,"-37.81349441, 144.96515323"
1520240425,1,2024-04-25,5,14,3,17,Bou292_T,"-37.81349441, 144.96515323"
11820250423,1,2025-04-23,18,873,616,1489,Bou292_T,"-37.81349441, 144.96515323"
631520250608,63,2025-06-08,15,355,438,793,Bou231_T,"-37.81333081, 144.96675571"
681720240504,68,2024-05-04,17,148,71,219,FLDegN_T,"-37.8168479, 144.96559789"
18620250221,18,2025-02-21,6,7,79,86,Col12_T,"-37.81344862, 144.97305353"
672220231213,67,2023-12-13,22,133,257,390,FLDegS_T,"-37.81688755, 144.96562569"
621320231031,62,2023-10-31,13,294,167,461,Lat224_T,"-37.80996494, 144.96216521"
561620250221,56,2025-02-21,16,303,295,598,Lon364_T,"-37.81234775, 144.96153311"
72020240115,72,2024-01-15,0,47,89,136,ACMI_T,"-37.81726338, 144.96872809"
352220231022,35,2023-10-22,22,186,355,541,SouthB_T,"-37.82018685, 144.96508508"
762020240518,76,2024-05-18,20,10,16,26,KenMac_T,"-37.79453803, 144.93036194"
29320250808,29,2025-08-08,3,0,7,7,AG_T,"-37.8199817, 144.96872865"
40120250107,40,2025-01-07,1,5,2,7,Spr201_T,"-37.80999341, 144.97227587"
311120240523,31,2024-05-23,11,102,114,216,Lyg161_T,"-37.80169681, 144.96658911"
312120241230,31,2024-12-30,21,216,293,509,Lyg161_T,"-37.80169681, 144.96658911"
36520241026,36,2024-10-26,5,5,7,12,Que85_T,"-37.81652527, 144.96121062"
37520240620,37,2024-06-20,5,3,7,10,Lyg260_T,"-37.80107122, 144.96704554"
501420241026,50,2024-10-26,14,358,274,632,Lyg309_T,"-37.79808192, 144.96721013"
451020241006,45,2024-10-06,10,429,294,723,Swa148_T,"-37.81414075, 144.96609379"
5620250502,5,2025-05-02,6,32,166,198,PriNW_T,"-37.81874249, 144.96787656"
36320240708,36,2024-07-08,3,2,0,2,Que85_T,"-37.81652527, 144.96121062"
1432020250220,143,2025-02-20,20,190,185,375,Spencer_T,"-37.821728, 144.95557015"
1431020250820,143,2025-08-20,10,93,160,253,Spencer_T,"-37.821728, 144.95557015"
131720250818,131,2025-08-18,7,57,30,87,King2_T,"-37.82009057, 144.95758725"
132720250412,132,2025-04-12,7,49,20,69,King335_T,"-37.81267639, 144.95386444"
134520250522,134,2025-05-22,5,27,44,71,Spen201_T,"-37.81694221, 144.95303935"
1352120240308,135,2024-03-08,21,187,177,364,Spen161_T,"-37.8172861, 144.95319102"
107420250119,107,2025-01-19,4,9,7,16,280Will_T,"-37.81246271, 144.95690188"
133620250728,133,2025-07-28,6,292,209,501,Spen229_T,"-37.81531435, 144.95227769"
1661520241211,166,2024-12-11,15,49,50,99,Spen484_T,"-37.80896733, 144.94931703"
1672220250325,167,2025-03-25,22,11,21,32,Lat526_T,"-37.81304149, 144.95155955"
1841620250826,184,2025-08-26,16,622,856,1478,Eli124_T,"-37.81512416, 144.96371988"
162320240818,162,2024-08-18,3,46,18,64,Eli489_T,"-37.80740397, 144.95987909"
631520240307,63,2024-03-07,15,363,415,778,Bou231_T,"-37.81333081, 144.96675571"
631220240522,63,2024-05-22,12,481,618,1099,Bou231_T,"-37.81333081, 144.96675571"
12320250422,1,2025-04-22,23,27,27,54,Bou292_T,"-37.81349441, 144.96515323"
862120241112,86,2024-11-12,21,6,23,29,574Qub_T,"-37.80309992, 144.94908064"
861820241206,86,2024-12-06,18,62,60,122,574Qub_T,"-37.80309992, 144.94908064"
621220240927,62,2024-09-27,12,152,127,279,Lat224_T,"-37.80996494, 144.96216521"
101020241110,10,2024-11-10,10,42,30,72,BouHbr_T,"-37.81876474, 144.94710545"
24220240111,24,2024-01-11,2,14,14,28,Col620_T,"-37.81887963, 144.95449198"
761220240426,76,2024-04-26,12,72,64,136,KenMac_T,"-37.79453803, 144.93036194"
91920240201,9,2024-02-01,19,280,72,352,Col700_T,"-37.81982992, 144.95102555"
79120240127,79,2024-01-27,1,99,101,200,FliSS_T,"-37.81794046, 144.96616678"
791320240612,79,2024-06-12,13,361,343,704,FliSS_T,"-37.81794046, 144.96616678"
23520240121,23,2024-01-21,5,11,29,40,Col623_T,"-37.81909256, 144.95452748"
30020241121,30,2024-11-21,0,88,95,183,Lon189_T,"-37.8112185, 144.96656806"
521120250911,52,2025-09-11,11,240,221,461,Eli263_T,"-37.81252157, 144.9619401"
461620250826,46,2025-08-26,16,79,153,232,Pel147_T,"-37.80240719, 144.9615673"
491120240828,49,2024-08-28,11,195,260,455,Eli501_T,"-37.80730068, 144.95956055"
25520250511,25,2025-05-11,5,9,9,18,MCEC_T,"-37.82401776, 144.95604426"
48920250526,48,2025-05-26,9,113,69,182,QVMQ_T,"-37.80631581, 144.95866697"
48220231209,48,2023-12-09,2,15,18,33,QVMQ_T,"-37.80631581, 144.95866697"
136620241124,136,2024-11-24,6,6,3,9,BirFed1120_T,"-37.8184141, 144.97357915"
1302220250118,130,2025-01-18,22,3,2,5,Bou892T,"-37.8204637, 144.94126826"
1301720250714,130,2025-07-14,17,39,46,85,Bou892T,"-37.8204637, 144.94126826"
53820241225,53,2024-12-25,8,38,22,60,Col254_T,"-37.81564191, 144.965499"
53720231207,53,2023-12-07,7,171,114,285,Col254_T,"-37.81564191, 144.965499"
511720241223,51,2024-12-23,17,89,84,173,Fra118_T,"-37.80841815, 144.95906316"
512020231211,51,2023-12-11,20,64,57,121,Fra118_T,"-37.80841815, 144.95906316"
231420231102,23,2023-11-02,14,214,367,581,Col623_T,"-37.81909256, 144.95452748"
191920231215,19,2023-12-15,19,927,672,1599,LtB210_T,"-37.81237202, 144.96550671"
19020240821,19,2024-08-21,0,36,53,89,LtB210_T,"-37.81237202, 144.96550671"
52020250728,52,2025-07-28,0,12,20,32,Eli263_T,"-37.81252157, 144.9619401"
521020231209,52,2023-12-09,10,196,132,328,Eli263_T,"-37.81252157, 144.9619401"
1391620231129,139,2023-11-29,16,139,36,175,Signal1647_T,"-37.81959923, 144.9632832"
1391020240116,139,2024-01-16,10,97,51,148,Signal1647_T,"-37.81959923, 144.9632832"
117120240204,117,2024-02-04,1,47,14,61,Fli114F_T,"-37.81629332, 144.97090877"
117120250925,117,2025-09-25,1,9,4,13,Fli114F_T,"-37.81629332, 144.97090877"
492020240823,49,2024-08-23,20,235,212,447,Eli501_T,"-37.80730068, 144.95956055"
491620241109,49,2024-11-09,16,235,426,661,Eli501_T,"-37.80730068, 144.95956055"
49820240530,49,2024-05-30,8,146,200,346,Eli501_T,"-37.80730068, 144.95956055"
671220240119,67,2024-01-19,12,505,456,961,FLDegS_T,"-37.81688755, 144.96562569"
85020240908,85,2024-09-08,0,3,5,8,488Mac_T,"-37.79432415, 144.92973378"
661420250404,66,2025-04-04,14,1227,1419,2646,QVN_T,"-37.81057846, 144.96444294"
84620240621,84,2024-06-21,6,188,90,278,ElFi_T,"-37.81798049, 144.96503383"
66920240305,66,2024-03-05,9,420,506,926,QVN_T,"-37.81057846, 144.96444294"
81120250731,8,2025-07-31,11,123,174,297,WebBN_T,"-37.82293543, 144.9471751"
78820231113,78,2023-11-13,8,123,64,187,HarEsB_T,"-37.81471642, 144.9446508"
41720240905,41,2024-09-05,7,55,55,110,Swa31,"-37.81668634, 144.96689733"
411420250510,41,2025-05-10,14,2026,1541,3567,Swa31,"-37.81668634, 144.96689733"
421720250831,42,2025-08-31,17,59,90,149,UM1_T,"-37.80008566, 144.96386412"
292020250508,29,2025-05-08,20,64,106,170,AG_T,"-37.8199817, 144.96872865"
29020250909,29,2025-09-09,0,9,8,17,AG_T,"-37.8199817, 144.96872865"
292120240817,29,2024-08-17,21,118,200,318,AG_T,"-37.8199817, 144.96872865"
142220250909,14,2025-09-09,22,78,36,114,SanBri_T,"-37.82011242, 144.96291897"
21120250708,21,2025-07-08,1,13,22,35,Bourke155_T,"-37.81267313, 144.96788288"
451620240623,45,2024-06-23,16,914,879,1793,Swa148_T,"-37.81414075, 144.96609379"
5320240913,5,2024-09-13,3,10,8,18,PriNW_T,"-37.81874249, 144.96787656"
211520250821,21,2025-08-21,15,302,343,645,Bourke155_T,"-37.81267313, 144.96788288"
1332220250125,133,2025-01-25,22,321,234,555,Spen229_T,"-37.81531435, 144.95227769"
132620250315,132,2025-03-15,6,26,12,38,King335_T,"-37.81267639, 144.95386444"
108620240102,108,2024-01-02,6,20,65,85,261Will_T,"-37.81295822, 144.95678789"
501620240704,50,2024-07-04,16,195,139,334,Lyg309_T,"-37.79808192, 144.96721013"
182220250509,182,2025-05-09,2,25,40,65,King163_T,"-37.81627451, 144.95550503"
1431220250129,143,2025-01-29,12,136,249,385,Spencer_T,"-37.821728, 144.95557015"
135620240225,135,2024-02-25,6,62,35,97,Spen161_T,"-37.8172861, 144.95319102"
68520250811,68,2025-08-11,5,2,2,4,FLDegN_T,"-37.8168479, 144.96559789"
85620240129,85,2024-01-29,6,25,8,33,488Mac_T,"-37.79432415, 144.92973378"
18520240205,18,2024-02-05,5,0,5,5,Col12_T,"-37.81344862, 144.97305353"
862320240425,86,2024-04-25,23,1,9,10,574Qub_T,"-37.80309992, 144.94908064"
11020240525,11,2024-05-25,0,8,16,24,WatCit_T,"-37.81564989, 144.93970694"
12720250808,12,2025-08-08,7,75,61,136,NewQ_T,"-37.81457988, 144.94292398"
681020240919,68,2024-09-19,10,186,134,320,FLDegN_T,"-37.8168479, 144.96559789"
241520241009,24,2024-10-09,15,594,1250,1844,Col620_T,"-37.81887963, 144.95449198"
31820251001,3,2025-10-01,18,1114,1506,2620,Swa295_T,"-37.81101524, 144.96429485"
31620250108,3,2025-01-08,16,884,1012,1896,Swa295_T,"-37.81101524, 144.96429485"
75120240113,75,2024-01-13,1,0,1,1,SprFli_T,"-37.81515276, 144.97467661"
751520240713,75,2024-07-13,15,47,51,98,SprFli_T,"-37.81515276, 144.97467661"
8920240609,8,2024-06-09,9,88,172,260,WebBN_T,"-37.82293543, 144.9471751"
39420231130,39,2023-11-30,4,12,20,32,AlfPl_T,"-37.81379749, 144.96995745"
41220250124,41,2025-01-24,2,60,66,126,Swa31,"-37.81668634, 144.96689733"
781620240716,78,2024-07-16,16,16,92,108,HarEsB_T,"-37.81471642, 144.9446508"
42120240522,42,2024-05-22,1,12,21,33,UM1_T,"-37.80008566, 144.96386412"
711220240315,71,2024-03-15,12,47,43,90,WestWP_T,"-37.81235775, 144.97136962"
651020231113,65,2023-11-13,10,295,126,421,SwaCs_T,"-37.81569416, 144.9668064"
471320231215,47,2023-12-15,13,1071,1157,2228,Eli250_T,"-37.81258467, 144.9625775"
401720241008,40,2024-10-08,17,189,308,497,Spr201_T,"-37.80999341, 144.97227587"
361520250330,36,2025-03-30,15,75,82,157,Que85_T,"-37.81652527, 144.96121062"
371520241122,37,2024-11-22,15,68,81,149,Lyg260_T,"-37.80107122, 144.96704554"
372120240321,37,2024-03-21,21,35,71,106,Lyg260_T,"-37.80107122, 144.96704554"
50520250506,50,2025-05-06,5,7,0,7,Lyg309_T,"-37.79808192, 144.96721013"
501420240930,50,2024-09-30,14,270,209,479,Lyg309_T,"-37.79808192, 144.96721013"
441220240718,44,2024-07-18,12,80,146,226,UM3_T,"-37.79698741, 144.96441306"
45320250103,45,2025-01-03,3,22,25,47,Swa148_T,"-37.81414075, 144.96609379"
52120250708,5,2025-07-08,21,350,387,737,PriNW_T,"-37.81874249, 144.96787656"
5920250628,5,2025-06-28,9,242,378,620,PriNW_T,"-37.81874249, 144.96787656"
182720250617,182,2025-06-17,7,53,53,106,King163_T,"-37.81627451, 144.95550503"
1321220240820,132,2024-08-20,12,150,162,312,King335_T,"-37.81267639, 144.95386444"
1352020231118,135,2023-11-18,20,209,218,427,Spen161_T,"-37.8172861, 144.95319102"
107620240118,107,2024-01-18,6,16,21,37,280Will_T,"-37.81246271, 144.95690188"
1181420240818,118,2024-08-18,14,20,76,96,Fli114C_T,"-37.81632783, 144.97090512"
108220231206,108,2023-12-06,2,12,12,24,261Will_T,"-37.81295822, 144.95678789"
1081020240726,108,2024-07-26,10,83,294,377,261Will_T,"-37.81295822, 144.95678789"
1662320250605,166,2025-06-05,23,8,1,9,Spen484_T,"-37.80896733, 144.94931703"
67720241213,67,2024-12-13,7,146,152,298,FLDegS_T,"-37.81688755, 144.96562569"
12020250524,1,2025-05-24,20,383,410,793,Bou292_T,"-37.81349441, 144.96515323"
68120250423,68,2025-04-23,1,3,1,4,FLDegN_T,"-37.8168479, 144.96559789"
18920241204,18,2024-12-04,9,160,658,818,Col12_T,"-37.81344862, 144.97305353"
18820250330,18,2025-03-30,8,24,16,40,Col12_T,"-37.81344862, 144.97305353"
112120250522,11,2025-05-22,21,53,51,104,WatCit_T,"-37.81564989, 144.93970694"
24920240920,24,2024-09-20,9,999,360,1359,Col620_T,"-37.81887963, 144.95449198"
101820231031,10,2023-10-31,18,73,31,104,BouHbr_T,"-37.81876474, 144.94710545"
722320240107,72,2024-01-07,23,25,38,63,ACMI_T,"-37.81726338, 144.96872809"
721220240117,72,2024-01-17,12,260,272,532,ACMI_T,"-37.81726338, 144.96872809"
721020240225,72,2024-02-25,10,126,178,304,ACMI_T,"-37.81726338, 144.96872809"
72020250624,72,2025-06-24,0,9,5,14,ACMI_T,"-37.81726338, 144.96872809"
2720231126,2,2023-11-26,7,19,33,52,Bou283_T,"-37.81380668, 144.96516718"
351620250802,35,2025-08-02,16,1929,1920,3849,SouthB_T,"-37.82018685, 144.96508508"
352020241117,35,2024-11-17,20,952,1317,2269,SouthB_T,"-37.82018685, 144.96508508"
27220241007,27,2024-10-07,2,4,2,6,Vic_T,"-37.80606888, 144.95644692"
531320240121,53,2024-01-21,13,632,552,1184,Col254_T,"-37.81564191, 144.965499"
9620240921,9,2024-09-21,6,15,28,43,Col700_T,"-37.81982992, 144.95102555"
91520240221,9,2024-02-21,15,1162,177,1339,Col700_T,"-37.81982992, 144.95102555"
53820250416,53,2025-04-16,8,389,277,666,Col254_T,"-37.81564191, 144.965499"
531320250604,53,2025-06-04,13,796,547,1343,Col254_T,"-37.81564191, 144.965499"
231020240808,23,2024-08-08,10,247,250,497,Col623_T,"-37.81909256, 144.95452748"
23920250809,23,2025-08-09,9,170,130,300,Col623_T,"-37.81909256, 144.95452748"
72920240816,72,2024-08-16,9,270,120,390,ACMI_T,"-37.81726338, 144.96872809"
721920250820,72,2025-08-20,19,92,223,315,ACMI_T,"-37.81726338, 144.96872809"
9920250505,9,2025-05-05,9,147,1458,1605,Col700_T,"-37.81982992, 144.95102555"
30920250316,30,2025-03-16,9,84,194,278,Lon189_T,"-37.8112185, 144.96656806"
51120241022,51,2024-10-22,1,9,8,17,Fra118_T,"-37.80841815, 144.95906316"
511920250119,51,2025-01-19,19,68,57,125,Fra118_T,"-37.80841815, 144.95906316"
23120240622,23,2024-06-22,1,7,40,47,Col623_T,"-37.81909256, 144.95452748"
231820250314,23,2025-03-14,18,240,441,681,Col623_T,"-37.81909256, 144.95452748"
19720240208,19,2024-02-08,7,33,14,47,LtB210_T,"-37.81237202, 144.96550671"
48520241016,48,2024-10-16,5,12,6,18,QVMQ_T,"-37.80631581, 144.95866697"
46120250809,46,2025-08-09,1,1,0,1,Pel147_T,"-37.80240719, 144.9615673"
1392120240810,139,2024-08-10,21,27,33,60,Signal1647_T,"-37.81959923, 144.9632832"
1391820240903,139,2024-09-03,18,66,35,101,Signal1647_T,"-37.81959923, 144.9632832"
1392120250725,139,2025-07-25,21,13,7,20,Signal1647_T,"-37.81959923, 144.9632832"
1421420250517,142,2025-05-17,14,98,122,220,Hammer1584_T,"-37.81970749, 144.96795734"
130720240408,130,2024-04-08,7,2,4,6,Bou892T,"-37.8204637, 144.94126826"
49120250705,49,2025-07-05,1,41,29,70,Eli501_T,"-37.80730068, 144.95956055"
662220250110,66,2025-01-10,22,737,415,1152,QVN_T,"-37.81057846, 144.96444294"
692220250325,69,2025-03-25,22,9,8,17,FLDegC_T,"-37.81687226, 144.96559144"
84220231112,84,2023-11-12,2,120,160,280,ElFi_T,"-37.81798049, 144.96503383"
8020250613,8,2025-06-13,0,0,2,2,WebBN_T,"-37.82293543, 144.9471751"
77620240101,77,2024-01-01,6,17,17,34,HarEsP_T,"-37.81441438, 144.94433026"
711120250507,71,2025-05-07,11,33,20,53,WestWP_T,"-37.81235775, 144.97136962"
71920250509,71,2025-05-09,9,14,13,27,WestWP_T,"-37.81235775, 144.97136962"
71520231103,71,2023-11-03,5,1,4,5,WestWP_T,"-37.81235775, 144.97136962"
65020240205,65,2024-02-05,0,34,26,60,SwaCs_T,"-37.81569416, 144.9668064"
471920250925,47,2025-09-25,19,895,763,1658,Eli250_T,"-37.81258467, 144.9625775"
47120240714,47,2024-07-14,1,109,96,205,Eli250_T,"-37.81258467, 144.9625775"
451020241213,45,2024-12-13,10,355,353,708,Swa148_T,"-37.81414075, 144.96609379"
107520241207,107,2024-12-07,5,11,3,14,280Will_T,"-37.81246271, 144.95690188"
107020250208,107,2025-02-08,0,22,30,52,280Will_T,"-37.81246271, 144.95690188"
108620250807,108,2025-08-07,6,34,244,278,261Will_T,"-37.81295822, 144.95678789"
61920250928,61,2025-09-28,9,75,183,258,RMIT14_T,"-37.80767455, 144.96309114"
501220240504,50,2024-05-04,12,246,307,553,Lyg309_T,"-37.79808192, 144.96721013"
501820240611,50,2024-06-11,18,128,127,255,Lyg309_T,"-37.79808192, 144.96721013"
50020241031,50,2024-10-31,0,10,5,15,Lyg309_T,"-37.79808192, 144.96721013"
162920250824,162,2025-08-24,9,363,329,692,Eli489_T,"-37.80740397, 144.95987909"
143520250106,143,2025-01-06,5,13,16,29,Spencer_T,"-37.821728, 144.95557015"
131220240504,131,2024-05-04,2,56,89,145,King2_T,"-37.82009057, 144.95758725"
1351620250701,135,2025-07-01,16,507,501,1008,Spen161_T,"-37.8172861, 144.95319102"
671620240916,67,2024-09-16,16,229,531,760,FLDegS_T,"-37.81688755, 144.96562569"
851520240531,85,2024-05-31,15,111,120,231,488Mac_T,"-37.79432415, 144.92973378"
17220231224,17,2023-12-24,2,10,9,19,Col15_T,"-37.81362543, 144.97323591"
172320250215,17,2025-02-15,23,32,59,91,Col15_T,"-37.81362543, 144.97323591"
631620231211,63,2023-12-11,16,280,362,642,Bou231_T,"-37.81333081, 144.96675571"
63020250708,63,2025-07-08,0,2,4,6,Bou231_T,"-37.81333081, 144.96675571"
111420241023,11,2024-10-23,14,95,59,154,WatCit_T,"-37.81564989, 144.93970694"
111320250610,11,2025-06-10,13,85,59,144,WatCit_T,"-37.81564989, 144.93970694"
621620240417,62,2024-04-17,16,249,152,401,Lat224_T,"-37.80996494, 144.96216521"
122320231119,12,2023-11-19,23,31,38,69,NewQ_T,"-37.81457988, 144.94292398"
272220240528,27,2024-05-28,22,63,23,86,Vic_T,"-37.80606888, 144.95644692"
301520250807,30,2025-08-07,15,179,340,519,Lon189_T,"-37.8112185, 144.96656806"
302220240614,30,2024-06-14,22,419,508,927,Lon189_T,"-37.8112185, 144.96656806"
302320231117,30,2023-11-17,23,353,450,803,Lon189_T,"-37.8112185, 144.96656806"
792120240428,79,2024-04-28,21,171,231,402,FliSS_T,"-37.81794046, 144.96616678"
201420250810,20,2025-08-10,14,282,492,774,LtB170_T,"-37.81172914, 144.9682466"
201620231218,20,2023-12-18,16,187,154,341,LtB170_T,"-37.81172914, 144.9682466"
202320240128,20,2024-01-28,23,133,121,254,LtB170_T,"-37.81172914, 144.9682466"
20520240823,20,2024-08-23,5,6,7,13,LtB170_T,"-37.81172914, 144.9682466"
251420231109,25,2023-11-09,14,506,566,1072,MCEC_T,"-37.82401776, 144.95604426"
251520240327,25,2024-03-27,15,608,505,1113,MCEC_T,"-37.82401776, 144.95604426"
137920250929,137,2025-09-29,9,30,19,49,BouHbr2353_T,"-37.81894815, 144.94612292"
1412220240813,141,2024-08-13,22,35,42,77,474Fl_T,"-37.81997273, 144.95834911"
1232220240117,123,2024-01-17,22,6,1,7,BirBridge_T,"-37.81753741, 144.97329734"
1301220250823,130,2025-08-23,12,84,59,143,Bou892T,"-37.8204637, 144.94126826"
1171520241223,117,2024-12-23,15,160,191,351,Fli114F_T,"-37.81629332, 144.97090877"
19520241229,19,2024-12-29,5,5,19,24,LtB210_T,"-37.81237202, 144.96550671"
692120250814,69,2025-08-14,21,25,25,50,FLDegC_T,"-37.81687226, 144.96559144"
61120240324,6,2024-03-24,11,502,674,1176,FliS_T,"-37.81911705, 144.96558255"
701220241206,70,2024-12-06,12,152,170,322,Errol20_T,"-37.80456984, 144.94946228"
391120250228,39,2025-02-28,11,93,60,153,AlfPl_T,"-37.81379749, 144.96995745"
75220240815,75,2024-08-15,2,0,1,1,SprFli_T,"-37.81515276, 144.97467661"
78220251012,78,2025-10-12,2,0,9,9,HarEsB_T,"-37.81471642, 144.9446508"
711420250710,71,2025-07-10,14,21,22,43,WestWP_T,"-37.81235775, 144.97136962"
14720240307,14,2024-03-07,7,214,256,470,SanBri_T,"-37.82011242, 144.96291897"
142320231126,14,2023-11-26,23,153,32,185,SanBri_T,"-37.82011242, 144.96291897"
312120241118,31,2024-11-18,21,93,167,260,Lyg161_T,"-37.80169681, 144.96658911"
54720250928,54,2025-09-28,7,17,11,28,Swa607_T,"-37.804024, 144.96308399"
40820231203,40,2023-12-03,8,32,22,54,Spr201_T,"-37.80999341, 144.97227587"
431120251011,43,2025-10-11,11,96,81,177,UM2_T,"-37.79844526, 144.96411782"
43220240122,43,2024-01-22,2,2,0,2,UM2_T,"-37.79844526, 144.96411782"
51120240730,5,2024-07-30,11,475,548,1023,PriNW_T,"-37.81874249, 144.96787656"
1241320240111,124,2024-01-11,13,1,6,7,BirBridge_T,"-37.81757416, 144.97329934"
107420241208,107,2024-12-08,4,16,4,20,280Will_T,"-37.81246271, 144.95690188"
1181220240823,118,2024-08-23,12,24,28,52,Fli114C_T,"-37.81632783, 144.97090512"
161020240814,161,2024-08-14,0,0,1,1,BirArt1109_T,"-37.81851276, 144.97131336"
1091120250722,109,2025-07-22,11,75,68,143,LatWill_T,"-37.81193681, 144.95621105"
61920240223,6,2024-02-23,19,1053,998,2051,FliS_T,"-37.81911705, 144.96558255"
6620241225,6,2024-12-25,6,38,42,80,FliS_T,"-37.81911705, 144.96558255"
66820240214,66,2024-02-14,8,243,537,780,QVN_T,"-37.81057846, 144.96444294"
4720240909,4,2024-09-09,7,143,117,260,Swa123_T,"-37.81487988, 144.9660878"
701920231019,70,2023-10-19,19,133,216,349,Errol20_T,"-37.80456984, 144.94946228"
701820240828,70,2024-08-28,18,152,166,318,Errol20_T,"-37.80456984, 144.94946228"
661020231206,66,2023-12-06,10,410,472,882,QVN_T,"-37.81057846, 144.96444294"
691920231022,69,2023-10-22,19,37,26,63,FLDegC_T,"-37.81687226, 144.96559144"
69420250915,69,2025-09-15,4,5,1,6,FLDegC_T,"-37.81687226, 144.96559144"
6020250106,6,2025-01-06,0,120,55,175,FliS_T,"-37.81911705, 144.96558255"
662120240410,66,2024-04-10,21,646,488,1134,QVN_T,"-37.81057846, 144.96444294"
661820240504,66,2024-05-04,18,1159,1367,2526,QVN_T,"-37.81057846, 144.96444294"
701020240218,70,2024-02-18,10,102,90,192,Errol20_T,"-37.80456984, 144.94946228"
3420250828,3,2025-08-28,4,12,20,32,Swa295_T,"-37.81101524, 144.96429485"
391320241108,39,2024-11-08,13,168,121,289,AlfPl_T,"-37.81379749, 144.96995745"
81420231217,8,2023-12-17,14,163,311,474,WebBN_T,"-37.82293543, 144.9471751"
82020240731,8,2024-07-31,20,21,24,45,WebBN_T,"-37.82293543, 144.9471751"
391220231212,39,2023-12-12,12,381,220,601,AlfPl_T,"-37.81379749, 144.96995745"
41120250104,41,2025-01-04,1,141,190,331,Swa31,"-37.81668634, 144.96689733"
411120241203,41,2024-12-03,11,1330,1110,2440,Swa31,"-37.81668634, 144.96689733"
771520240217,77,2024-02-17,15,267,118,385,HarEsP_T,"-37.81441438, 144.94433026"
141420250304,14,2025-03-04,14,319,149,468,SanBri_T,"-37.82011242, 144.96291897"
14120241204,14,2024-12-04,1,11,9,20,SanBri_T,"-37.82011242, 144.96291897"
59920250627,59,2025-06-27,9,413,249,662,RMIT_T,"-37.80825648, 144.96304859"
651520240825,65,2024-08-25,15,1158,1275,2433,SwaCs_T,"-37.81569416, 144.9668064"
28020250401,28,2025-04-01,0,21,9,30,VAC_T,"-37.82129925, 144.96879309"
311220241107,31,2024-11-07,12,210,205,415,Lyg161_T,"-37.80169681, 144.96658911"
361020250831,36,2025-08-31,10,90,88,178,Que85_T,"-37.81652527, 144.96121062"
371320240309,37,2024-03-09,13,105,113,218,Lyg260_T,"-37.80107122, 144.96704554"
37320240705,37,2024-07-05,3,12,13,25,Lyg260_T,"-37.80107122, 144.96704554"
441020241009,44,2024-10-09,10,59,95,154,UM3_T,"-37.79698741, 144.96441306"
1401620240720,140,2024-07-20,16,102,95,197,Boyd2837_T,"-37.82590962, 144.96185972"
1341420240920,134,2024-09-20,14,432,442,874,Spen201_T,"-37.81694221, 144.95303935"
1311820240927,131,2024-09-27,18,174,115,289,King2_T,"-37.82009057, 144.95758725"
135520240216,135,2024-02-16,5,12,17,29,Spen161_T,"-37.8172861, 144.95319102"
133320231117,133,2023-11-17,3,7,8,15,Spen229_T,"-37.81531435, 144.95227769"
1241420250506,124,2025-05-06,14,2,7,9,BirBridge_T,"-37.81757416, 144.97329934"
107820231205,107,2023-12-05,8,88,249,337,280Will_T,"-37.81246271, 144.95690188"
166720241016,166,2024-10-16,7,11,21,32,Spen484_T,"-37.80896733, 144.94931703"
1652020250111,165,2025-01-11,20,36,40,76,Spen475_T,"-37.80953359, 144.94939004"
165720250221,165,2025-02-21,7,12,38,50,Spen475_T,"-37.80953359, 144.94939004"
162020250207,162,2025-02-07,0,71,36,107,Eli489_T,"-37.80740397, 144.95987909"
671020250308,67,2025-03-08,10,369,339,708,FLDegS_T,"-37.81688755, 144.96562569"
681920240227,68,2024-02-27,19,124,86,210,FLDegN_T,"-37.8168479, 144.96559789"
17820250918,17,2025-09-18,8,1529,218,1747,Col15_T,"-37.81362543, 144.97323591"
67020240420,67,2024-04-20,0,47,71,118,FLDegS_T,"-37.81688755, 144.96562569"
461220231105,46,2023-11-05,12,44,39,83,Pel147_T,"-37.80240719, 144.9615673"
521420240911,52,2024-09-11,14,373,207,580,Eli263_T,"-37.81252157, 144.9619401"
191420250731,19,2025-07-31,14,432,353,785,LtB210_T,"-37.81237202, 144.96550671"
141220241029,141,2024-10-29,2,7,5,12,474Fl_T,"-37.81997273, 144.95834911"
139220250712,139,2025-07-12,2,2,1,3,Signal1647_T,"-37.81959923, 144.9632832"
130020250710,130,2025-07-10,0,2,0,2,Bou892T,"-37.8204637, 144.94126826"
1231120240406,123,2024-04-06,11,15,3,18,BirBridge_T,"-37.81753741, 144.97329734"
1172020231022,117,2023-10-22,20,76,75,151,Fli114F_T,"-37.81629332, 144.97090877"
109620240807,109,2024-08-07,6,16,77,93,LatWill_T,"-37.81193681, 144.95621105"
662020250601,66,2025-06-01,20,974,656,1630,QVN_T,"-37.81057846, 144.96444294"
69020241013,69,2024-10-13,0,4,5,9,FLDegC_T,"-37.81687226, 144.96559144"
691420241108,69,2024-11-08,14,231,218,449,FLDegC_T,"-37.81687226, 144.96559144"
6920240824,6,2024-08-24,9,453,383,836,FliS_T,"-37.81911705, 144.96558255"
841320240804,84,2024-08-04,13,1064,1270,2334,ElFi_T,"-37.81798049, 144.96503383"
4620241104,4,2024-11-04,6,55,31,86,Swa123_T,"-37.81487988, 144.9660878"
39720240813,39,2024-08-13,7,89,54,143,AlfPl_T,"-37.81379749, 144.96995745"
391620240919,39,2024-09-19,16,83,49,132,AlfPl_T,"-37.81379749, 144.96995745"
3220240317,3,2024-03-17,2,308,204,512,Swa295_T,"-37.81101524, 144.96429485"
3320241113,3,2024-11-13,3,27,17,44,Swa295_T,"-37.81101524, 144.96429485"
75920240220,75,2024-02-20,9,54,47,101,SprFli_T,"-37.81515276, 144.97467661"
78520250918,78,2025-09-18,5,1,0,1,HarEsB_T,"-37.81471642, 144.9446508"
71020240131,71,2024-01-31,0,1,1,2,WestWP_T,"-37.81235775, 144.97136962"
541720250530,54,2025-05-30,17,172,431,603,Swa607_T,"-37.804024, 144.96308399"
401220240425,40,2024-04-25,12,100,163,263,Spr201_T,"-37.80999341, 144.97227587"
31720250501,31,2025-05-01,7,32,26,58,Lyg161_T,"-37.80169681, 144.96658911"
371620250602,37,2025-06-02,16,71,101,172,Lyg260_T,"-37.80107122, 144.96704554"
61920240918,61,2024-09-18,9,471,445,916,RMIT14_T,"-37.80767455, 144.96309114"
451320250906,45,2025-09-06,13,567,1077,1644,Swa148_T,"-37.81414075, 144.96609379"
52120240906,5,2024-09-06,21,798,415,1213,PriNW_T,"-37.81874249, 144.96787656"
51920231106,5,2023-11-06,19,954,1085,2039,PriNW_T,"-37.81874249, 144.96787656"
211620240223,21,2024-02-23,16,422,381,803,Bourke155_T,"-37.81267313, 144.96788288"
1431320241121,143,2024-11-21,13,169,246,415,Spencer_T,"-37.821728, 144.95557015"
1401120240715,140,2024-07-15,11,65,56,121,Boyd2837_T,"-37.82590962, 144.96185972"
1321820240426,132,2024-04-26,18,156,170,326,King335_T,"-37.81267639, 144.95386444"
1341520231202,134,2023-12-02,15,293,268,561,Spen201_T,"-37.81694221, 144.95303935"
107820250514,107,2025-05-14,8,87,264,351,280Will_T,"-37.81246271, 144.95690188"
133620241219,133,2024-12-19,6,358,221,579,Spen229_T,"-37.81531435, 144.95227769"
1792120250531,179,2025-05-31,21,63,60,123,Pow61_T,"-37.82392385, 144.96299677"
1661120250728,166,2025-07-28,11,38,44,82,Spen484_T,"-37.80896733, 144.94931703"
1671720241115,167,2024-11-15,17,37,74,111,Lat526_T,"-37.81304149, 144.95155955"
671520240530,67,2024-05-30,15,241,464,705,FLDegS_T,"-37.81688755, 144.96562569"
171820250722,17,2025-07-22,18,133,266,399,Col15_T,"-37.81362543, 144.97323591"
671220250406,67,2025-04-06,12,374,437,811,FLDegS_T,"-37.81688755, 144.96562569"
67320240804,67,2024-08-04,3,10,28,38,FLDegS_T,"-37.81688755, 144.96562569"
67120250215,67,2025-02-15,1,32,49,81,FLDegS_T,"-37.81688755, 144.96562569"
111620231219,11,2023-12-19,16,66,55,121,WatCit_T,"-37.81564989, 144.93970694"
111720240320,11,2024-03-20,17,167,94,261,WatCit_T,"-37.81564989, 144.93970694"
67520250605,67,2025-06-05,5,9,7,16,FLDegS_T,"-37.81688755, 144.96562569"
62720240812,62,2024-08-12,7,56,60,116,Lat224_T,"-37.80996494, 144.96216521"
56220250510,56,2025-05-10,2,36,20,56,Lon364_T,"-37.81234775, 144.96153311"
611120251009,61,2025-10-09,11,369,600,969,RMIT14_T,"-37.80767455, 144.96309114"
1652220250318,165,2025-03-18,22,21,11,32,Spen475_T,"-37.80953359, 144.94939004"
165720250518,165,2025-05-18,7,5,11,16,Spen475_T,"-37.80953359, 144.94939004"
1671220250305,167,2025-03-05,12,60,106,166,Lat526_T,"-37.81304149, 144.95155955"
131420250713,131,2025-07-13,4,28,75,103,King2_T,"-37.82009057, 144.95758725"
131920250821,131,2025-08-21,9,119,108,227,King2_T,"-37.82009057, 144.95758725"
1311820240124,131,2024-01-24,18,110,106,216,King2_T,"-37.82009057, 144.95758725"
631520240220,63,2024-02-20,15,337,365,702,Bou231_T,"-37.81333081, 144.96675571"
67120250509,67,2025-05-09,1,11,14,25,FLDegS_T,"-37.81688755, 144.96562569"
18720240615,18,2024-06-15,7,3,8,11,Col12_T,"-37.81344862, 144.97305353"
18420231110,18,2023-11-10,4,0,3,3,Col12_T,"-37.81344862, 144.97305353"
621320240926,62,2024-09-26,13,385,162,547,Lat224_T,"-37.80996494, 144.96216521"
62220241231,62,2024-12-31,2,15,3,18,Lat224_T,"-37.80996494, 144.96216521"
62020250711,62,2025-07-11,0,44,28,72,Lat224_T,"-37.80996494, 144.96216521"
56920240114,56,2024-01-14,9,203,63,266,Lon364_T,"-37.81234775, 144.96153311"
122120250713,12,2025-07-13,21,19,33,52,NewQ_T,"-37.81457988, 144.94292398"
121120240709,12,2024-07-09,11,30,43,73,NewQ_T,"-37.81457988, 144.94292398"
56420250804,56,2025-08-04,4,2,3,5,Lon364_T,"-37.81234775, 144.96153311"
24120241104,24,2024-11-04,1,35,35,70,Col620_T,"-37.81887963, 144.95449198"
76620250126,76,2025-01-26,6,4,1,5,KenMac_T,"-37.79453803, 144.93036194"
35820250220,35,2025-02-20,8,599,1903,2502,SouthB_T,"-37.82018685, 144.96508508"
76020250416,76,2025-04-16,0,0,1,1,KenMac_T,"-37.79453803, 144.93036194"
761720231108,76,2023-11-08,17,34,48,82,KenMac_T,"-37.79453803, 144.93036194"
79720240731,79,2024-07-31,7,205,127,332,FliSS_T,"-37.81794046, 144.96616678"
791820240116,79,2024-01-16,18,672,552,1224,FliSS_T,"-37.81794046, 144.96616678"
511820240204,51,2024-02-04,18,66,78,144,Fra118_T,"-37.80841815, 144.95906316"
231920250207,23,2025-02-07,19,85,162,247,Col623_T,"-37.81909256, 144.95452748"
482220250514,48,2025-05-14,22,13,12,25,QVMQ_T,"-37.80631581, 144.95866697"
191820231112,19,2023-11-12,18,670,479,1149,LtB210_T,"-37.81237202, 144.96550671"
461420231212,46,2023-12-12,14,60,73,133,Pel147_T,"-37.80240719, 144.9615673"
20620241222,20,2024-12-22,6,11,11,22,LtB170_T,"-37.81172914, 144.9682466"
461420240831,46,2024-08-31,14,80,68,148,Pel147_T,"-37.80240719, 144.9615673"
1411520250603,141,2025-06-03,15,180,57,237,474Fl_T,"-37.81997273, 144.95834911"
1372020240108,137,2024-01-08,20,13,11,24,BouHbr2353_T,"-37.81894815, 144.94612292"
1391720240326,139,2024-03-26,17,305,43,348,Signal1647_T,"-37.81959923, 144.9632832"
1421920250731,142,2025-07-31,19,5,1,6,Hammer1584_T,"-37.81970749, 144.96795734"
1302120240630,130,2024-06-30,21,0,1,1,Bou892T,"-37.8204637, 144.94126826"
1171020240225,117,2024-02-25,10,88,104,192,Fli114F_T,"-37.81629332, 144.97090877"
1232220250505,123,2025-05-05,22,1,0,1,BirBridge_T,"-37.81753741, 144.97329734"
1092020240820,109,2024-08-20,20,146,110,256,LatWill_T,"-37.81193681, 144.95621105"
661420250420,66,2025-04-20,14,1467,1723,3190,QVN_T,"-37.81057846, 144.96444294"
691420240401,69,2024-04-01,14,230,234,464,FLDegC_T,"-37.81687226, 144.96559144"
4020240507,4,2024-05-07,0,26,36,62,Swa123_T,"-37.81487988, 144.9660878"
4120241221,4,2024-12-21,1,183,251,434,Swa123_T,"-37.81487988, 144.9660878"
31320250301,3,2025-03-01,13,1105,1155,2260,Swa295_T,"-37.81101524, 144.96429485"
122320250204,12,2025-02-04,23,43,39,82,NewQ_T,"-37.81457988, 144.94292398"
35620250823,35,2025-08-23,6,91,65,156,SouthB_T,"-37.82018685, 144.96508508"
581120240510,58,2024-05-10,11,600,286,886,Bou688_T,"-37.81686075, 144.95358075"
35720240825,35,2024-08-25,7,221,150,371,SouthB_T,"-37.82018685, 144.96508508"
35420250828,35,2025-08-28,4,4,1,5,SouthB_T,"-37.82018685, 144.96508508"
531420240102,53,2024-01-02,14,777,712,1489,Col254_T,"-37.81564191, 144.965499"
27820250719,27,2025-07-19,8,59,50,109,Vic_T,"-37.80606888, 144.95644692"
531620250217,53,2025-02-17,16,539,448,987,Col254_T,"-37.81564191, 144.965499"
51920241005,51,2024-10-05,9,80,83,163,Fra118_T,"-37.80841815, 144.95906316"
511020250717,51,2025-07-17,10,90,91,181,Fra118_T,"-37.80841815, 144.95906316"
512320240617,51,2024-06-17,23,6,7,13,Fra118_T,"-37.80841815, 144.95906316"
481720240525,48,2024-05-25,17,156,164,320,QVMQ_T,"-37.80631581, 144.95866697"
481220241108,48,2024-11-08,12,317,252,569,QVMQ_T,"-37.80631581, 144.95866697"
52020250908,52,2025-09-08,0,18,31,49,Eli263_T,"-37.81252157, 144.9619401"
117720241211,117,2024-12-11,7,117,69,186,Fli114F_T,"-37.81629332, 144.97090877"
491420250528,49,2025-05-28,14,243,277,520,Eli501_T,"-37.80730068, 144.95956055"
109720251010,109,2025-10-10,7,29,176,205,LatWill_T,"-37.81193681, 144.95621105"
491720240118,49,2024-01-18,17,238,160,398,Eli501_T,"-37.80730068, 144.95956055"
692220240410,69,2024-04-10,22,7,9,16,FLDegC_T,"-37.81687226, 144.96559144"
692020250523,69,2025-05-23,20,78,73,151,FLDegC_T,"-37.81687226, 144.96559144"
75720241008,75,2024-10-08,7,35,39,74,SprFli_T,"-37.81515276, 144.97467661"
39020240105,39,2024-01-05,0,19,33,52,AlfPl_T,"-37.81379749, 144.96995745"
78420240727,78,2024-07-27,4,1,1,2,HarEsB_T,"-37.81471642, 144.9446508"
77620251013,77,2025-10-13,6,19,35,54,HarEsP_T,"-37.81441438, 144.94433026"
771720240407,77,2024-04-07,17,174,133,307,HarEsP_T,"-37.81441438, 144.94433026"
711220250616,71,2025-06-16,12,19,30,49,WestWP_T,"-37.81235775, 144.97136962"
541520250426,54,2025-04-26,15,97,59,156,Swa607_T,"-37.804024, 144.96308399"
281120250516,28,2025-05-16,11,644,410,1054,VAC_T,"-37.82129925, 144.96879309"
109920231219,109,2023-12-19,9,71,216,287,LatWill_T,"-37.81193681, 144.95621105"
1801520250606,180,2025-06-06,15,40,31,71,Mac330_T,"-37.79497059, 144.93530329"
67520250131,67,2025-01-31,5,12,12,24,FLDegS_T,"-37.81688755, 144.96562569"
68120240121,68,2024-01-21,1,7,2,9,FLDegN_T,"-37.8168479, 144.96559789"
681820240123,68,2024-01-23,18,185,99,284,FLDegN_T,"-37.8168479, 144.96559789"
171320250409,17,2025-04-09,13,668,620,1288,Col15_T,"-37.81362543, 144.97323591"
12220240303,12,2024-03-03,2,6,13,19,NewQ_T,"-37.81457988, 144.94292398"
861920250430,86,2025-04-30,19,37,38,75,574Qub_T,"-37.80309992, 144.94908064"
62620240619,62,2024-06-19,6,96,30,126,Lat224_T,"-37.80996494, 144.96216521"
56820240509,56,2024-05-09,8,115,133,248,Lon364_T,"-37.81234775, 144.96153311"
561520240813,56,2024-08-13,15,312,272,584,Lon364_T,"-37.81234775, 144.96153311"
56220250105,56,2025-01-05,2,35,52,87,Lon364_T,"-37.81234775, 144.96153311"
111120250804,11,2025-08-04,11,48,45,93,WatCit_T,"-37.81564989, 144.93970694"
721620240108,72,2024-01-08,16,82,381,463,ACMI_T,"-37.81726338, 144.96872809"
102120250107,10,2025-01-07,21,36,32,68,BouHbr_T,"-37.81876474, 144.94710545"
10620250720,10,2025-07-20,6,0,1,1,BouHbr_T,"-37.81876474, 144.94710545"
2420240210,2,2024-02-10,4,2,15,17,Bou283_T,"-37.81380668, 144.96516718"
27520240204,27,2024-02-04,5,19,4,23,Vic_T,"-37.80606888, 144.95644692"
271320240522,27,2024-05-22,13,110,93,203,Vic_T,"-37.80606888, 144.95644692"
9020240518,9,2024-05-18,0,7,12,19,Col700_T,"-37.81982992, 144.95102555"
79620250130,79,2025-01-30,6,146,48,194,FliSS_T,"-37.81794046, 144.96616678"
511420250117,51,2025-01-17,14,110,128,238,Fra118_T,"-37.80841815, 144.95906316"
511220240710,51,2024-07-10,12,116,89,205,Fra118_T,"-37.80841815, 144.95906316"
621520250913,62,2025-09-13,15,366,291,657,Lat224_T,"-37.80996494, 144.96216521"
561720240831,56,2024-08-31,17,378,453,831,Lon364_T,"-37.81234775, 144.96153311"
111220231202,11,2023-12-02,12,59,23,82,WatCit_T,"-37.81564989, 144.93970694"
101120241114,10,2024-11-14,11,103,66,169,BouHbr_T,"-37.81876474, 144.94710545"
581320240316,58,2024-03-16,13,718,323,1041,Bou688_T,"-37.81686075, 144.95358075"
351520240811,35,2024-08-11,15,1532,2192,3724,SouthB_T,"-37.82018685, 144.96508508"
2920240516,2,2024-05-16,9,150,253,403,Bou283_T,"-37.81380668, 144.96516718"
2920240921,2,2024-09-21,9,214,238,452,Bou283_T,"-37.81380668, 144.96516718"
21320241128,2,2024-11-28,13,938,1079,2017,Bou283_T,"-37.81380668, 144.96516718"
271020241228,27,2024-12-28,10,145,137,282,Vic_T,"-37.80606888, 144.95644692"
91020241113,9,2024-11-13,10,174,446,620,Col700_T,"-37.81982992, 144.95102555"
23020250202,23,2025-02-02,0,13,45,58,Col623_T,"-37.81909256, 144.95452748"
9120250423,9,2025-04-23,1,0,8,8,Col700_T,"-37.81982992, 144.95102555"
52420241222,52,2024-12-22,4,42,19,61,Eli263_T,"-37.81252157, 144.9619401"
231820250720,23,2025-07-20,18,126,209,335,Col623_T,"-37.81909256, 144.95452748"
461020240127,46,2024-01-27,10,34,30,64,Pel147_T,"-37.80240719, 144.9615673"
192020240904,19,2024-09-04,20,379,527,906,LtB210_T,"-37.81237202, 144.96550671"
251420240729,25,2024-07-29,14,335,301,636,MCEC_T,"-37.82401776, 144.95604426"
1391620241125,139,2024-11-25,16,81,23,104,Signal1647_T,"-37.81959923, 144.9632832"
1301320250909,130,2025-09-09,13,94,72,166,Bou892T,"-37.8204637, 144.94126826"
1381320250315,138,2025-03-15,13,11,10,21,EntPark1671_T,"-37.81996544, 144.95981454"
1231020250603,123,2025-06-03,10,15,67,82,BirBridge_T,"-37.81753741, 144.97329734"
1231420250911,123,2025-09-11,14,41,22,63,BirBridge_T,"-37.81753741, 144.97329734"
1301620240515,130,2024-05-15,16,13,19,32,Bou892T,"-37.8204637, 144.94126826"
1171420240916,117,2024-09-16,14,100,135,235,Fli114F_T,"-37.81629332, 144.97090877"
117720241115,117,2024-11-15,7,94,52,146,Fli114F_T,"-37.81629332, 144.97090877"
1091020240818,109,2024-08-18,10,89,61,150,LatWill_T,"-37.81193681, 144.95621105"
109120240511,109,2024-05-11,1,24,23,47,LatWill_T,"-37.81193681, 144.95621105"
18320240524,18,2024-05-24,3,1,0,1,Col12_T,"-37.81344862, 144.97305353"
67020250319,67,2025-03-19,0,12,17,29,FLDegS_T,"-37.81688755, 144.96562569"
861920240918,86,2024-09-18,19,40,51,91,574Qub_T,"-37.80309992, 144.94908064"
86920241020,86,2024-10-20,9,39,32,71,574Qub_T,"-37.80309992, 144.94908064"
861720250125,86,2025-01-25,17,39,36,75,574Qub_T,"-37.80309992, 144.94908064"
111320240309,11,2024-03-09,13,47,28,75,WatCit_T,"-37.81564989, 144.93970694"
861020250819,86,2025-08-19,10,49,34,83,574Qub_T,"-37.80309992, 144.94908064"
111220250818,11,2025-08-18,12,111,88,199,WatCit_T,"-37.81564989, 144.93970694"
351420241003,35,2024-10-03,14,1257,1520,2777,SouthB_T,"-37.82018685, 144.96508508"
91720240824,9,2024-08-24,17,127,80,207,Col700_T,"-37.81982992, 144.95102555"
91920250806,9,2025-08-06,19,171,51,222,Col700_T,"-37.81982992, 144.95102555"
461320250125,46,2025-01-25,13,25,15,40,Pel147_T,"-37.80240719, 144.9615673"
20020240205,20,2024-02-05,0,17,41,58,LtB170_T,"-37.81172914, 144.9682466"
52720250921,52,2025-09-21,7,30,17,47,Eli263_T,"-37.81252157, 144.9619401"
521620240615,52,2024-06-15,16,350,446,796,Eli263_T,"-37.81252157, 144.9619401"
1411120250513,141,2025-05-13,11,135,84,219,474Fl_T,"-37.81997273, 144.95834911"
1421120250719,142,2025-07-19,11,383,404,787,Hammer1584_T,"-37.81970749, 144.96795734"
130620231206,130,2023-12-06,6,2,2,4,Bou892T,"-37.8204637, 144.94126826"
1611820250915,161,2025-09-15,18,98,97,195,BirArt1109_T,"-37.81851276, 144.97131336"
1642320250820,164,2025-08-20,23,11,23,34,Lat526_T,"-37.813005, 144.95160411"
117520250715,117,2025-07-15,5,14,9,23,Fli114F_T,"-37.81629332, 144.97090877"
491920250223,49,2025-02-23,19,192,174,366,Eli501_T,"-37.80730068, 144.95956055"
481320250910,48,2025-09-10,13,157,141,298,QVMQ_T,"-37.80631581, 144.95866697"
36020250123,36,2025-01-23,0,15,13,28,Que85_T,"-37.81652527, 144.96121062"
611920250618,61,2025-06-18,19,227,223,450,RMIT14_T,"-37.80767455, 144.96309114"
452320250715,45,2025-07-15,23,50,138,188,Swa148_T,"-37.81414075, 144.96609379"
5220251015,5,2025-10-15,2,22,19,41,PriNW_T,"-37.81874249, 144.96787656"
51520241109,5,2024-11-09,15,1172,1225,2397,PriNW_T,"-37.81874249, 144.96787656"
5720240530,5,2024-05-30,7,177,432,609,PriNW_T,"-37.81874249, 144.96787656"
182320250820,182,2025-08-20,3,17,12,29,King163_T,"-37.81627451, 144.95550503"
1311620241219,131,2024-12-19,16,120,148,268,King2_T,"-37.82009057, 144.95758725"
132320241021,132,2024-10-21,3,7,10,17,King335_T,"-37.81267639, 144.95386444"
132520250626,132,2025-06-26,5,8,9,17,King335_T,"-37.81267639, 144.95386444"
134920250314,134,2025-03-14,9,372,591,963,Spen201_T,"-37.81694221, 144.95303935"
1342020250807,134,2025-08-07,20,326,256,582,Spen201_T,"-37.81694221, 144.95303935"
135820240501,135,2024-05-01,8,371,422,793,Spen161_T,"-37.8172861, 144.95319102"
167920240923,167,2024-09-23,9,15,71,86,Lat526_T,"-37.81304149, 144.95155955"
1811920250803,181,2025-08-03,19,861,818,1679,Eli368_T,"-37.81009465, 144.96143149"
682020250720,68,2025-07-20,20,81,52,133,FLDegN_T,"-37.8168479, 144.96559789"
181920231205,18,2023-12-05,19,153,38,191,Col12_T,"-37.81344862, 144.97305353"
862320250616,86,2025-06-16,23,2,6,8,574Qub_T,"-37.80309992, 144.94908064"
721720231206,72,2023-12-06,17,527,1136,1663,ACMI_T,"-37.81726338, 144.96872809"
24320250614,24,2025-06-14,3,17,39,56,Col620_T,"-37.81887963, 144.95449198"
24820250715,24,2025-07-15,8,2406,305,2711,Col620_T,"-37.81887963, 144.95449198"
76920240830,76,2024-08-30,9,58,64,122,KenMac_T,"-37.79453803, 144.93036194"
27820240626,27,2024-06-26,8,63,99,162,Vic_T,"-37.80606888, 144.95644692"
271420240905,27,2024-09-05,14,105,97,202,Vic_T,"-37.80606888, 144.95644692"
91520240514,9,2024-05-14,15,1075,176,1251,Col700_T,"-37.81982992, 144.95102555"
791620250109,79,2025-01-09,16,580,621,1201,FliSS_T,"-37.81794046, 144.96616678"
301420240103,30,2024-01-03,14,268,437,705,Lon189_T,"-37.8112185, 144.96656806"
231720240519,23,2024-05-19,17,118,168,286,Col623_T,"-37.81909256, 144.95452748"
30620251006,30,2025-10-06,6,12,24,36,Lon189_T,"-37.8112185, 144.96656806"
461020241111,46,2024-11-11,10,64,33,97,Pel147_T,"-37.80240719, 144.9615673"
461720241225,46,2024-12-25,17,45,19,64,Pel147_T,"-37.80240719, 144.9615673"
46620250512,46,2025-05-12,6,0,1,1,Pel147_T,"-37.80240719, 144.9615673"
191720251013,19,2025-10-13,17,515,375,890,LtB210_T,"-37.81237202, 144.96550671"
137920240628,137,2024-06-28,9,68,39,107,BouHbr2353_T,"-37.81894815, 144.94612292"
1391220240618,139,2024-06-18,12,86,99,185,Signal1647_T,"-37.81959923, 144.9632832"
1361920241002,136,2024-10-02,19,0,2,2,BirFed1120_T,"-37.8184141, 144.97357915"
142020240216,142,2024-02-16,0,21,8,29,Hammer1584_T,"-37.81970749, 144.96795734"
1231620250628,123,2025-06-28,16,61,24,85,BirBridge_T,"-37.81753741, 144.97329734"
75920231214,75,2023-12-14,9,52,39,91,SprFli_T,"-37.81515276, 144.97467661"
78320231108,78,2023-11-08,3,0,1,1,HarEsB_T,"-37.81471642, 144.9446508"
781820240523,78,2024-05-23,18,10,17,27,HarEsB_T,"-37.81471642, 144.9446508"
65220231213,65,2023-12-13,2,9,3,12,SwaCs_T,"-37.81569416, 144.9668064"
77920251002,77,2025-10-02,9,46,88,134,HarEsP_T,"-37.81441438, 144.94433026"
402020240310,40,2024-03-10,20,78,78,156,Spr201_T,"-37.80999341, 144.97227587"
36620240407,36,2024-04-07,6,22,6,28,Que85_T,"-37.81652527, 144.96121062"
37620250915,37,2025-09-15,6,4,5,9,Lyg260_T,"-37.80107122, 144.96704554"
37820240818,37,2024-08-18,8,36,26,62,Lyg260_T,"-37.80107122, 144.96704554"
441720240330,44,2024-03-30,17,20,18,38,UM3_T,"-37.79698741, 144.96441306"
43520250916,43,2025-09-16,5,4,3,7,UM2_T,"-37.79844526, 144.96411782"
441620240528,44,2024-05-28,16,143,62,205,UM3_T,"-37.79698741, 144.96441306"
51120250210,5,2025-02-10,11,108,220,328,PriNW_T,"-37.81874249, 144.96787656"
134320250104,134,2025-01-04,3,26,14,40,Spen201_T,"-37.81694221, 144.95303935"
1332020250603,133,2025-06-03,20,297,227,524,Spen229_T,"-37.81531435, 144.95227769"
118720250802,118,2025-08-02,7,4,1,5,Fli114C_T,"-37.81632783, 144.97090512"
118020231228,118,2023-12-28,0,1,3,4,Fli114C_T,"-37.81632783, 144.97090512"
1081820231103,108,2023-11-03,18,424,185,609,261Will_T,"-37.81295822, 144.95678789"
108920241106,108,2024-11-06,9,203,1041,1244,261Will_T,"-37.81295822, 144.95678789"
501920240421,50,2024-04-21,19,203,202,405,Lyg309_T,"-37.79808192, 144.96721013"
179920250425,179,2025-04-25,9,68,39,107,Pow61_T,"-37.82392385, 144.96299677"
1171220240325,117,2024-03-25,12,213,227,440,Fli114F_T,"-37.81629332, 144.97090877"
1232020240817,123,2024-08-17,20,1,0,1,BirBridge_T,"-37.81753741, 144.97329734"
19020250119,19,2025-01-19,0,187,227,414,LtB210_T,"-37.81237202, 144.96550671"
671720241105,67,2024-11-05,17,231,345,576,FLDegS_T,"-37.81688755, 144.96562569"
68520240424,68,2024-04-24,5,3,1,4,FLDegN_T,"-37.8168479, 144.96559789"
63920240704,63,2024-07-04,9,145,150,295,Bou231_T,"-37.81333081, 144.96675571"
671120241203,67,2024-12-03,11,390,444,834,FLDegS_T,"-37.81688755, 144.96562569"
182120250612,18,2025-06-12,21,14,14,28,Col12_T,"-37.81344862, 144.97305353"
861520240927,86,2024-09-27,15,33,43,76,574Qub_T,"-37.80309992, 144.94908064"
861820250315,86,2025-03-15,18,77,45,122,574Qub_T,"-37.80309992, 144.94908064"
622320241029,62,2024-10-29,23,88,51,139,Lat224_T,"-37.80996494, 144.96216521"
56620250730,56,2025-07-30,6,20,25,45,Lon364_T,"-37.81234775, 144.96153311"
22220240408,2,2024-04-08,22,14,53,67,Bou283_T,"-37.81380668, 144.96516718"
581120231211,58,2023-12-11,11,728,230,958,Bou688_T,"-37.81686075, 144.95358075"
91220241021,9,2024-10-21,12,535,526,1061,Col700_T,"-37.81982992, 144.95102555"
511020250103,51,2025-01-03,10,90,108,198,Fra118_T,"-37.80841815, 144.95906316"
51720240331,51,2024-03-31,7,11,17,28,Fra118_T,"-37.80841815, 144.95906316"
511020240415,51,2024-04-15,10,83,66,149,Fra118_T,"-37.80841815, 144.95906316"
51420240825,51,2024-08-25,4,1,5,6,Fra118_T,"-37.80841815, 144.95906316"
482120250812,48,2025-08-12,21,53,70,123,QVMQ_T,"-37.80631581, 144.95866697"
301920251007,30,2025-10-07,19,257,400,657,Lon189_T,"-37.8112185, 144.96656806"
481520231218,48,2023-12-18,15,141,116,257,QVMQ_T,"-37.80631581, 144.95866697"
522020240303,52,2024-03-03,20,190,193,383,Eli263_T,"-37.81252157, 144.9619401"
141120240522,141,2024-05-22,1,14,12,26,474Fl_T,"-37.81997273, 144.95834911"
1071220240411,107,2024-04-11,12,151,180,331,280Will_T,"-37.81246271, 144.95690188"
108620251014,108,2025-10-14,6,29,243,272,261Will_T,"-37.81295822, 144.95678789"
118920241214,118,2024-12-14,9,8,23,31,Fli114C_T,"-37.81632783, 144.97090512"
611520240630,61,2024-06-30,15,358,481,839,RMIT14_T,"-37.80767455, 144.96309114"
611720241206,61,2024-12-06,17,419,448,867,RMIT14_T,"-37.80767455, 144.96309114"
43520250625,43,2025-06-25,5,4,0,4,UM2_T,"-37.79844526, 144.96411782"
1822020250424,182,2025-04-24,20,255,296,551,King163_T,"-37.81627451, 144.95550503"
1312020250204,131,2025-02-04,20,58,71,129,King2_T,"-37.82009057, 144.95758725"
1401920231120,140,2023-11-20,19,99,82,181,Boyd2837_T,"-37.82590962, 144.96185972"
134520251010,134,2025-10-10,5,55,52,107,Spen201_T,"-37.81694221, 144.95303935"
131720240821,131,2024-08-21,7,61,33,94,King2_T,"-37.82009057, 144.95758725"
131520240910,131,2024-09-10,5,1,6,7,King2_T,"-37.82009057, 144.95758725"
84420250228,84,2025-02-28,4,20,38,58,ElFi_T,"-37.81798049, 144.96503383"
41120231113,4,2023-11-13,11,1674,1258,2932,Swa123_T,"-37.81487988, 144.9660878"
701120231115,70,2023-11-15,11,105,107,212,Errol20_T,"-37.80456984, 144.94946228"
75720240717,75,2024-07-17,7,38,23,61,SprFli_T,"-37.81515276, 144.97467661"
752120250922,75,2025-09-22,21,7,10,17,SprFli_T,"-37.81515276, 144.97467661"
781520250520,78,2025-05-20,15,25,93,118,HarEsB_T,"-37.81471642, 144.9446508"
412320240717,41,2024-07-17,23,36,30,66,Swa31,"-37.81668634, 144.96689733"
421520241107,42,2024-11-07,15,222,251,473,UM1_T,"-37.80008566, 144.96386412"
781020250912,78,2025-09-12,10,19,27,46,HarEsB_T,"-37.81471642, 144.9446508"
712220240918,71,2024-09-18,22,2,3,5,WestWP_T,"-37.81235775, 144.97136962"
711120250228,71,2025-02-28,11,31,28,59,WestWP_T,"-37.81235775, 144.97136962"
59620240711,59,2024-07-11,6,47,55,102,RMIT_T,"-37.80825648, 144.96304859"
592220240804,59,2024-08-04,22,219,146,365,RMIT_T,"-37.80825648, 144.96304859"
281220240419,28,2024-04-19,12,555,843,1398,VAC_T,"-37.82129925, 144.96879309"
28620240726,28,2024-07-26,6,97,40,137,VAC_T,"-37.82129925, 144.96879309"
291320240307,29,2024-03-07,13,282,452,734,AG_T,"-37.8199817, 144.96872865"
141520250924,14,2025-09-24,15,426,105,531,SanBri_T,"-37.82011242, 144.96291897"
282020250425,28,2025-04-25,20,71,97,168,VAC_T,"-37.82129925, 144.96879309"
471520241105,47,2024-11-05,15,725,783,1508,Eli250_T,"-37.81258467, 144.9625775"
471720231130,47,2023-11-30,17,1398,935,2333,Eli250_T,"-37.81258467, 144.9625775"
211320241206,21,2024-12-06,13,297,310,607,Bourke155_T,"-37.81267313, 144.96788288"
441720241218,44,2024-12-18,17,75,45,120,UM3_T,"-37.79698741, 144.96441306"
451520231020,45,2023-10-20,15,369,682,1051,Swa148_T,"-37.81414075, 144.96609379"
5720240806,5,2024-08-06,7,169,470,639,PriNW_T,"-37.81874249, 144.96787656"
172120250602,17,2025-06-02,21,48,51,99,Col15_T,"-37.81362543, 144.97323591"
68320240620,68,2024-06-20,3,1,0,1,FLDegN_T,"-37.8168479, 144.96559789"
11720250117,11,2025-01-17,7,62,44,106,WatCit_T,"-37.81564989, 144.93970694"
561920240512,56,2024-05-12,19,241,309,550,Lon364_T,"-37.81234775, 144.96153311"
121420251004,12,2025-10-04,14,283,274,557,NewQ_T,"-37.81457988, 144.94292398"
101120250322,10,2025-03-22,11,67,36,103,BouHbr_T,"-37.81876474, 144.94710545"
721720250403,72,2025-04-03,17,454,1038,1492,ACMI_T,"-37.81726338, 144.96872809"
21620240423,2,2024-04-23,16,496,536,1032,Bou283_T,"-37.81380668, 144.96516718"
2520250724,2,2025-07-24,5,15,9,24,Bou283_T,"-37.81380668, 144.96516718"
117620250528,117,2025-05-28,6,58,34,92,Fli114F_T,"-37.81629332, 144.97090877"
481320250508,48,2025-05-08,13,460,212,672,QVMQ_T,"-37.80631581, 144.95866697"
61020240513,6,2024-05-13,10,403,362,765,FliS_T,"-37.81911705, 144.96558255"
662220231120,66,2023-11-20,22,332,181,513,QVN_T,"-37.81057846, 144.96444294"
41520240112,4,2024-01-12,15,1324,1253,2577,Swa123_T,"-37.81487988, 144.9660878"
70220250228,70,2025-02-28,2,0,1,1,Errol20_T,"-37.80456984, 144.94946228"
70120250430,70,2025-04-30,1,1,12,13,Errol20_T,"-37.80456984, 144.94946228"
751720240705,75,2024-07-05,17,102,123,225,SprFli_T,"-37.81515276, 144.97467661"
75820250418,75,2025-04-18,8,12,20,32,SprFli_T,"-37.81515276, 144.97467661"
421220250914,42,2025-09-14,12,97,58,155,UM1_T,"-37.80008566, 144.96386412"
772320250519,77,2025-05-19,23,15,13,28,HarEsP_T,"-37.81441438, 144.94433026"
781820250408,78,2025-04-08,18,5,36,41,HarEsB_T,"-37.81471642, 144.9446508"
292120250605,29,2025-06-05,21,50,63,113,AG_T,"-37.8199817, 144.96872865"
291720240514,29,2024-05-14,17,16,76,92,AG_T,"-37.8199817, 144.96872865"
14120250507,14,2025-05-07,1,17,4,21,SanBri_T,"-37.82011242, 144.96291897"
711020231108,71,2023-11-08,10,18,23,41,WestWP_T,"-37.81235775, 144.97136962"
282120240516,28,2024-05-16,21,527,347,874,VAC_T,"-37.82129925, 144.96879309"
281120240506,28,2024-05-06,11,448,360,808,VAC_T,"-37.82129925, 144.96879309"
36520231030,36,2023-10-30,5,20,6,26,Que85_T,"-37.81652527, 144.96121062"
37120240731,37,2024-07-31,1,6,4,10,Lyg260_T,"-37.80107122, 144.96704554"
471320240418,47,2024-04-18,13,708,923,1631,Eli250_T,"-37.81258467, 144.9625775"
87620240221,87,2024-02-21,6,25,14,39,Errol23_T,"-37.80454949, 144.94921863"
61220231129,61,2023-11-29,2,23,6,29,RMIT14_T,"-37.80767455, 144.96309114"
50620231217,50,2023-12-17,6,6,12,18,Lyg309_T,"-37.79808192, 144.96721013"
43620240428,43,2024-04-28,6,3,5,8,UM2_T,"-37.79844526, 144.96411782"
45020231231,45,2023-12-31,0,85,174,259,Swa148_T,"-37.81414075, 144.96609379"
211720250130,21,2025-01-30,17,428,345,773,Bourke155_T,"-37.81267313, 144.96788288"
1311820240901,131,2024-09-01,18,66,39,105,King2_T,"-37.82009057, 144.95758725"
131220241115,131,2024-11-15,2,7,18,25,King2_T,"-37.82009057, 144.95758725"
1431120250729,143,2025-07-29,11,88,145,233,Spencer_T,"-37.821728, 144.95557015"
143620250809,143,2025-08-09,6,25,22,47,Spencer_T,"-37.821728, 144.95557015"
132220240710,132,2024-07-10,2,8,6,14,King335_T,"-37.81267639, 144.95386444"
1341020240326,134,2024-03-26,10,295,262,557,Spen201_T,"-37.81694221, 144.95303935"
1071520250818,107,2025-08-18,15,117,118,235,280Will_T,"-37.81246271, 144.95690188"
1331520250710,133,2025-07-10,15,557,628,1185,Spen229_T,"-37.81531435, 144.95227769"
133120250916,133,2025-09-16,1,25,12,37,Spen229_T,"-37.81531435, 144.95227769"
118620250120,118,2025-01-20,6,5,2,7,Fli114C_T,"-37.81632783, 144.97090512"
1082020231217,108,2023-12-17,20,117,139,256,261Will_T,"-37.81295822, 144.95678789"
70220240610,70,2024-06-10,2,0,3,3,Errol20_T,"-37.80456984, 144.94946228"
179620250601,179,2025-06-01,6,6,6,12,Pow61_T,"-37.82392385, 144.96299677"
17520240403,17,2024-04-03,5,42,18,60,Col15_T,"-37.81362543, 144.97323591"
67020231121,67,2023-11-21,0,11,8,19,FLDegS_T,"-37.81688755, 144.96562569"
121220240622,12,2024-06-22,12,219,238,457,NewQ_T,"-37.81457988, 144.94292398"
111720250216,11,2025-02-16,17,146,110,256,WatCit_T,"-37.81564989, 144.93970694"
56720240912,56,2024-09-12,7,86,74,160,Lon364_T,"-37.81234775, 144.96153311"
101020250302,10,2025-03-02,10,27,17,44,BouHbr_T,"-37.81876474, 144.94710545"
10720250316,10,2025-03-16,7,7,6,13,BouHbr_T,"-37.81876474, 144.94710545"
23620251014,23,2025-10-14,6,122,77,199,Col623_T,"-37.81909256, 144.95452748"
232220240318,23,2024-03-18,22,30,86,116,Col623_T,"-37.81909256, 144.95452748"
461120240313,46,2024-03-13,11,119,175,294,Pel147_T,"-37.80240719, 144.9615673"
492120240727,49,2024-07-27,21,151,117,268,Eli501_T,"-37.80730068, 144.95956055"
25520241112,25,2024-11-12,5,27,29,56,MCEC_T,"-37.82401776, 144.95604426"
252120250225,25,2025-02-25,21,255,209,464,MCEC_T,"-37.82401776, 144.95604426"
251720240820,25,2024-08-20,17,1289,410,1699,MCEC_T,"-37.82401776, 144.95604426"
201420250508,20,2025-05-08,14,146,202,348,LtB170_T,"-37.81172914, 144.9682466"
1801220250906,180,2025-09-06,12,69,41,110,Mac330_T,"-37.79497059, 144.93530329"
191120250919,19,2025-09-19,11,314,243,557,LtB210_T,"-37.81237202, 144.96550671"
1362320231223,136,2023-12-23,23,20,13,33,BirFed1120_T,"-37.8184141, 144.97357915"
164620250816,164,2025-08-16,6,13,9,22,Lat526_T,"-37.813005, 144.95160411"
1381620250109,138,2025-01-09,16,12,9,21,EntPark1671_T,"-37.81996544, 144.95981454"
117420240303,117,2024-03-03,4,9,3,12,Fli114F_T,"-37.81629332, 144.97090877"
1091920250220,109,2025-02-20,19,88,113,201,LatWill_T,"-37.81193681, 144.95621105"
66820250819,66,2025-08-19,8,211,549,760,QVN_T,"-37.81057846, 144.96444294"
661020241024,66,2024-10-24,10,393,569,962,QVN_T,"-37.81057846, 144.96444294"
691420250408,69,2025-04-08,14,220,262,482,FLDegC_T,"-37.81687226, 144.96559144"
62220240330,6,2024-03-30,22,879,596,1475,FliS_T,"-37.81911705, 144.96558255"
6920240507,6,2024-05-07,9,567,1007,1574,FliS_T,"-37.81911705, 144.96558255"
70120250807,70,2025-08-07,1,2,3,5,Errol20_T,"-37.80456984, 144.94946228"
3820250514,3,2025-05-14,8,224,252,476,Swa295_T,"-37.81101524, 144.96429485"
41220241117,41,2024-11-17,2,135,348,483,Swa31,"-37.81668634, 144.96689733"
772320250127,77,2025-01-27,23,32,16,48,HarEsP_T,"-37.81441438, 144.94433026"
29220241109,29,2024-11-09,2,4,19,23,AG_T,"-37.8199817, 144.96872865"
711520250706,71,2025-07-06,15,11,4,15,WestWP_T,"-37.81235775, 144.97136962"
71020231024,71,2023-10-24,0,0,2,2,WestWP_T,"-37.81235775, 144.97136962"
652220240212,65,2024-02-12,22,63,116,179,SwaCs_T,"-37.81569416, 144.9668064"
28320240912,28,2024-09-12,3,2,14,16,VAC_T,"-37.82129925, 144.96879309"
36520240216,36,2024-02-16,5,14,5,19,Que85_T,"-37.81652527, 144.96121062"
362320251005,36,2025-10-05,23,24,23,47,Que85_T,"-37.81652527, 144.96121062"
362220240609,36,2024-06-09,22,170,103,273,Que85_T,"-37.81652527, 144.96121062"
47320240127,47,2024-01-27,3,66,54,120,Eli250_T,"-37.81258467, 144.9625775"
611220250202,61,2025-02-02,12,493,403,896,RMIT14_T,"-37.80767455, 144.96309114"
43720250507,43,2025-05-07,7,59,37,96,UM2_T,"-37.79844526, 144.96411782"
45620240114,45,2024-01-14,6,40,45,85,Swa148_T,"-37.81414075, 144.96609379"
1321920250928,132,2025-09-28,19,137,132,269,King335_T,"-37.81267639, 144.95386444"
132220240514,132,2024-05-14,2,3,5,8,King335_T,"-37.81267639, 144.95386444"
1311020240629,131,2024-06-29,10,40,58,98,King2_T,"-37.82009057, 144.95758725"
1352320240429,135,2024-04-29,23,17,28,45,Spen161_T,"-37.8172861, 144.95319102"
135820250214,135,2025-02-14,8,274,372,646,Spen161_T,"-37.8172861, 144.95319102"
133020250327,133,2025-03-27,0,43,34,77,Spen229_T,"-37.81531435, 144.95227769"
133020250406,133,2025-04-06,0,89,65,154,Spen229_T,"-37.81531435, 144.95227769"
133120250612,133,2025-06-12,1,31,5,36,Spen229_T,"-37.81531435, 144.95227769"
1331720240625,133,2024-06-25,17,588,576,1164,Spen229_T,"-37.81531435, 144.95227769"
871420250825,87,2025-08-25,14,91,91,182,Errol23_T,"-37.80454949, 144.94921863"
87920250304,87,2025-03-04,9,60,52,112,Errol23_T,"-37.80454949, 144.94921863"
1651620241125,165,2024-11-25,16,50,47,97,Spen475_T,"-37.80953359, 144.94939004"
162220250625,162,2025-06-25,2,12,14,26,Eli489_T,"-37.80740397, 144.95987909"
851220241117,85,2024-11-17,12,69,85,154,488Mac_T,"-37.79432415, 144.92973378"
6420240507,6,2024-05-07,4,29,8,37,FliS_T,"-37.81911705, 144.96558255"
841420241105,84,2024-11-05,14,858,1086,1944,ElFi_T,"-37.81798049, 144.96503383"
84720250225,84,2025-02-25,7,748,238,986,ElFi_T,"-37.81798049, 144.96503383"
41920240329,4,2024-03-29,19,1857,1078,2935,Swa123_T,"-37.81487988, 144.9660878"
701620241103,70,2024-11-03,16,120,118,238,Errol20_T,"-37.80456984, 144.94946228"
70120241117,70,2024-11-17,1,14,12,26,Errol20_T,"-37.80456984, 144.94946228"
3220240621,3,2024-06-21,2,78,51,129,Swa295_T,"-37.81101524, 144.96429485"
752320250607,75,2025-06-07,23,16,6,22,SprFli_T,"-37.81515276, 144.97467661"
75520231213,75,2023-12-13,5,18,5,23,SprFli_T,"-37.81515276, 144.97467661"
391420240328,39,2024-03-28,14,102,154,256,AlfPl_T,"-37.81379749, 144.96995745"
411320251004,41,2025-10-04,13,2755,2009,4764,Swa31,"-37.81668634, 144.96689733"
77820250330,77,2025-03-30,8,81,90,171,HarEsP_T,"-37.81441438, 144.94433026"
781720250105,78,2025-01-05,17,29,39,68,HarEsB_T,"-37.81471642, 144.9446508"
292220241105,29,2024-11-05,22,55,34,89,AG_T,"-37.8199817, 144.96872865"
291420240119,29,2024-01-19,14,305,461,766,AG_T,"-37.8199817, 144.96872865"
281220240626,28,2024-06-26,12,724,752,1476,VAC_T,"-37.82129925, 144.96879309"
29020250925,29,2025-09-25,0,3,27,30,AG_T,"-37.8199817, 144.96872865"
362320240119,36,2024-01-19,23,117,151,268,Que85_T,"-37.81652527, 144.96121062"
501220240323,50,2024-03-23,12,251,307,558,Lyg309_T,"-37.79808192, 144.96721013"
502020250205,50,2025-02-05,20,182,131,313,Lyg309_T,"-37.79808192, 144.96721013"
501120250626,50,2025-06-26,11,140,167,307,Lyg309_T,"-37.79808192, 144.96721013"
5820250730,5,2025-07-30,8,498,928,1426,PriNW_T,"-37.81874249, 144.96787656"
1431620250104,143,2025-01-04,16,121,172,293,Spencer_T,"-37.821728, 144.95557015"
1311920250807,131,2025-08-07,19,68,99,167,King2_T,"-37.82009057, 144.95758725"
132520240521,132,2024-05-21,5,7,7,14,King335_T,"-37.81267639, 144.95386444"
135320250328,135,2025-03-28,3,25,16,41,Spen161_T,"-37.8172861, 144.95319102"
1071520240421,107,2024-04-21,15,89,108,197,280Will_T,"-37.81246271, 144.95690188"
107520240904,107,2024-09-04,5,2,6,8,280Will_T,"-37.81246271, 144.95690188"
167820250511,167,2025-05-11,8,22,34,56,Lat526_T,"-37.81304149, 144.95155955"
1622320250813,162,2025-08-13,23,85,46,131,Eli489_T,"-37.80740397, 144.95987909"
1621620250115,162,2025-01-15,16,305,309,614,Eli489_T,"-37.80740397, 144.95987909"
162720240906,162,2024-09-06,7,140,114,254,Eli489_T,"-37.80740397, 144.95987909"
851120240219,85,2024-02-19,11,78,85,163,488Mac_T,"-37.79432415, 144.92973378"
851320240313,85,2024-03-13,13,83,59,142,488Mac_T,"-37.79432415, 144.92973378"
12220240411,1,2024-04-11,22,165,171,336,Bou292_T,"-37.81349441, 144.96515323"
681620250717,68,2025-07-17,16,246,234,480,FLDegN_T,"-37.8168479, 144.96559789"
681820240511,68,2024-05-11,18,99,20,119,FLDegN_T,"-37.8168479, 144.96559789"
12920240904,12,2024-09-04,9,97,77,174,NewQ_T,"-37.81457988, 144.94292398"
241920250305,24,2025-03-05,19,303,618,921,Col620_T,"-37.81887963, 144.95449198"
24420250613,24,2025-06-13,4,16,28,44,Col620_T,"-37.81887963, 144.95449198"
10820250718,10,2025-07-18,8,59,119,178,BouHbr_T,"-37.81876474, 144.94710545"
122220250401,12,2025-04-01,22,115,83,198,NewQ_T,"-37.81457988, 144.94292398"
761520240823,76,2024-08-23,15,61,98,159,KenMac_T,"-37.79453803, 144.93036194"
35820240326,35,2024-03-26,8,831,2329,3160,SouthB_T,"-37.82018685, 144.96508508"
72620250517,72,2025-05-17,6,10,14,24,ACMI_T,"-37.81726338, 144.96872809"
72320250523,72,2025-05-23,3,0,6,6,ACMI_T,"-37.81726338, 144.96872809"
582120250726,58,2025-07-26,21,442,183,625,Bou688_T,"-37.81686075, 144.95358075"
581420241020,58,2024-10-20,14,571,339,910,Bou688_T,"-37.81686075, 144.95358075"
271220241101,27,2024-11-01,12,196,139,335,Vic_T,"-37.80606888, 144.95644692"
301120240608,30,2024-06-08,11,226,272,498,Lon189_T,"-37.8112185, 144.96656806"
9120250604,9,2025-06-04,1,7,6,13,Col700_T,"-37.81982992, 144.95102555"
531120240607,53,2024-06-07,11,536,488,1024,Col254_T,"-37.81564191, 144.965499"
91320250503,9,2025-05-03,13,110,130,240,Col700_T,"-37.81982992, 144.95102555"
532320250802,53,2025-08-02,23,68,187,255,Col254_T,"-37.81564191, 144.965499"
511820250507,51,2025-05-07,18,126,153,279,Fra118_T,"-37.80841815, 144.95906316"
23120250312,23,2025-03-12,1,9,12,21,Col623_T,"-37.81909256, 144.95452748"
23720250927,23,2025-09-27,7,52,60,112,Col623_T,"-37.81909256, 144.95452748"
231120231108,23,2023-11-08,11,197,251,448,Col623_T,"-37.81909256, 144.95452748"
481220250115,48,2025-01-15,12,251,189,440,QVMQ_T,"-37.80631581, 144.95866697"
1372220250208,137,2025-02-08,22,51,8,59,BouHbr2353_T,"-37.81894815, 144.94612292"
1412320250625,141,2025-06-25,23,10,134,144,474Fl_T,"-37.81997273, 144.95834911"
1231720241001,123,2024-10-01,17,18,7,25,BirBridge_T,"-37.81753741, 144.97329734"
117420231208,117,2023-12-08,4,3,4,7,Fli114F_T,"-37.81629332, 144.97090877"
109520240326,109,2024-03-26,5,14,20,34,LatWill_T,"-37.81193681, 144.95621105"
662120240926,66,2024-09-26,21,947,624,1571,QVN_T,"-37.81057846, 144.96444294"
66320250303,66,2025-03-03,3,6,10,16,QVN_T,"-37.81057846, 144.96444294"
61420231114,6,2023-11-14,14,716,617,1333,FliS_T,"-37.81911705, 144.96558255"
70720240814,70,2024-08-14,7,42,23,65,Errol20_T,"-37.80456984, 144.94946228"
3520231216,3,2023-12-16,5,60,63,123,Swa295_T,"-37.81101524, 144.96429485"
412320250409,41,2025-04-09,23,469,459,928,Swa31,"-37.81668634, 144.96689733"
421620241022,42,2024-10-22,16,120,222,342,UM1_T,"-37.80008566, 144.96386412"
71620231123,71,2023-11-23,6,9,4,13,WestWP_T,"-37.81235775, 144.97136962"
28720231227,28,2023-12-27,7,52,37,89,VAC_T,"-37.82129925, 144.96879309"
28120240316,28,2024-03-16,1,34,19,53,VAC_T,"-37.82129925, 144.96879309"
28120240703,28,2024-07-03,1,10,2,12,VAC_T,"-37.82129925, 144.96879309"
29520250901,29,2025-09-01,5,5,9,14,AG_T,"-37.8199817, 144.96872865"
29520250220,29,2025-02-20,5,13,32,45,AG_T,"-37.8199817, 144.96872865"
541420250203,54,2025-02-03,14,61,62,123,Swa607_T,"-37.804024, 144.96308399"
311220240423,31,2024-04-23,12,218,164,382,Lyg161_T,"-37.80169681, 144.96658911"
401320231210,40,2023-12-10,13,157,419,576,Spr201_T,"-37.80999341, 144.97227587"
36020250806,36,2025-08-06,0,6,7,13,Que85_T,"-37.81652527, 144.96121062"
212320240820,21,2024-08-20,23,39,76,115,Bourke155_T,"-37.81267313, 144.96788288"
362020231023,36,2023-10-23,20,69,82,151,Que85_T,"-37.81652527, 144.96121062"
5020250331,5,2025-03-31,0,40,51,91,PriNW_T,"-37.81874249, 144.96787656"
1241520250917,124,2025-09-17,15,2,3,5,BirBridge_T,"-37.81757416, 144.97329934"
61720240314,61,2024-03-14,7,195,160,355,RMIT14_T,"-37.80767455, 144.96309114"
50320240816,50,2024-08-16,3,5,0,5,Lyg309_T,"-37.79808192, 144.96721013"
165220241012,165,2024-10-12,2,2,4,6,Spen475_T,"-37.80953359, 144.94939004"
135320240302,135,2024-03-02,3,18,15,33,Spen161_T,"-37.8172861, 144.95319102"
135220240812,135,2024-08-12,2,7,12,19,Spen161_T,"-37.8172861, 144.95319102"
63820241125,63,2024-11-25,8,123,118,241,Bou231_T,"-37.81333081, 144.96675571"
631420250120,63,2025-01-20,14,353,420,773,Bou231_T,"-37.81333081, 144.96675571"
62120240916,62,2024-09-16,1,22,23,45,Lat224_T,"-37.80996494, 144.96216521"
12920250525,12,2025-05-25,9,158,153,311,NewQ_T,"-37.81457988, 144.94292398"
24820240428,24,2024-04-28,8,218,238,456,Col620_T,"-37.81887963, 144.95449198"
11420250730,1,2025-07-30,14,1066,917,1983,Bou292_T,"-37.81349441, 144.96515323"
721720240311,72,2024-03-11,17,138,299,437,ACMI_T,"-37.81726338, 144.96872809"
1361020240611,136,2024-06-11,10,27,26,53,BirFed1120_T,"-37.8184141, 144.97357915"
1611620240626,161,2024-06-26,16,560,140,700,BirArt1109_T,"-37.81851276, 144.97131336"
1611420240727,161,2024-07-27,14,36,17,53,BirArt1109_T,"-37.81851276, 144.97131336"
161820250402,161,2025-04-02,8,150,251,401,BirArt1109_T,"-37.81851276, 144.97131336"
1092320240313,109,2024-03-13,23,343,53,396,LatWill_T,"-37.81193681, 144.95621105"
6920250903,6,2025-09-03,9,573,1065,1638,FliS_T,"-37.81911705, 144.96558255"
41820240905,4,2024-09-05,18,930,801,1731,Swa123_T,"-37.81487988, 144.9660878"
4520240914,4,2024-09-14,5,17,23,40,Swa123_T,"-37.81487988, 144.9660878"
4920250213,4,2025-02-13,9,774,428,1202,Swa123_T,"-37.81487988, 144.9660878"
701820240812,70,2024-08-12,18,131,169,300,Errol20_T,"-37.80456984, 144.94946228"
701720250717,70,2025-07-17,17,176,180,356,Errol20_T,"-37.80456984, 144.94946228"
70120251014,70,2025-10-14,1,0,1,1,Errol20_T,"-37.80456984, 144.94946228"
69520240520,69,2024-05-20,5,0,4,4,FLDegC_T,"-37.81687226, 144.96559144"
752320240502,75,2024-05-02,23,23,10,33,SprFli_T,"-37.81515276, 144.97467661"
81220250520,8,2025-05-20,12,245,441,686,WebBN_T,"-37.82293543, 144.9471751"
78620240124,78,2024-01-24,6,10,11,21,HarEsB_T,"-37.81471642, 144.9446508"
781320240809,78,2024-08-09,13,38,65,103,HarEsB_T,"-37.81471642, 144.9446508"
42220240918,42,2024-09-18,2,7,2,9,UM1_T,"-37.80008566, 144.96386412"
591120240716,59,2024-07-16,11,694,647,1341,RMIT_T,"-37.80825648, 144.96304859"
40120231102,40,2023-11-02,1,4,2,6,Spr201_T,"-37.80999341, 144.97227587"
501020231202,50,2023-12-02,10,163,194,357,Lyg309_T,"-37.79808192, 144.96721013"
211520241227,21,2024-12-27,15,342,453,795,Bourke155_T,"-37.81267313, 144.96788288"
1341820240503,134,2024-05-03,18,412,451,863,Spen201_T,"-37.81694221, 144.95303935"
1071520240808,107,2024-08-08,15,95,105,200,280Will_T,"-37.81246271, 144.95690188"
1331320250119,133,2025-01-19,13,408,396,804,Spen229_T,"-37.81531435, 144.95227769"
1652320251011,165,2025-10-11,23,10,2,12,Spen475_T,"-37.80953359, 144.94939004"
1672220250826,167,2025-08-26,22,8,14,22,Lat526_T,"-37.81304149, 144.95155955"
67420240218,67,2024-02-18,4,15,10,25,FLDegS_T,"-37.81688755, 144.96562569"
68920240104,68,2024-01-04,9,137,116,253,FLDegN_T,"-37.8168479, 144.96559789"
671920240409,67,2024-04-09,19,265,284,549,FLDegS_T,"-37.81688755, 144.96562569"
682320250128,68,2025-01-28,23,8,3,11,FLDegN_T,"-37.8168479, 144.96559789"
681020241126,68,2024-11-26,10,200,161,361,FLDegN_T,"-37.8168479, 144.96559789"
18620250110,18,2025-01-10,6,8,51,59,Col12_T,"-37.81344862, 144.97305353"
631920231205,63,2023-12-05,19,249,328,577,Bou231_T,"-37.81333081, 144.96675571"
56820250407,56,2025-04-07,8,130,179,309,Lon364_T,"-37.81234775, 144.96153311"
241420240512,24,2024-05-12,14,430,680,1110,Col620_T,"-37.81887963, 144.95449198"
561620250613,56,2025-06-13,16,356,405,761,Lon364_T,"-37.81234775, 144.96153311"
72620250612,72,2025-06-12,6,65,16,81,ACMI_T,"-37.81726338, 144.96872809"
35220241218,35,2024-12-18,2,15,21,36,SouthB_T,"-37.82018685, 144.96508508"
511420240914,51,2024-09-14,14,105,138,243,Fra118_T,"-37.80841815, 144.95906316"
51220231229,51,2023-12-29,2,3,5,8,Fra118_T,"-37.80841815, 144.95906316"
25320240420,25,2024-04-20,3,5,11,16,MCEC_T,"-37.82401776, 144.95604426"
251720251008,25,2025-10-08,17,1442,606,2048,MCEC_T,"-37.82401776, 144.95604426"
461220240420,46,2024-04-20,12,72,71,143,Pel147_T,"-37.80240719, 144.9615673"
461720250205,46,2025-02-05,17,48,71,119,Pel147_T,"-37.80240719, 144.9615673"
19320250907,19,2025-09-07,3,44,78,122,LtB210_T,"-37.81237202, 144.96550671"
1411020231114,141,2023-11-14,10,140,101,241,474Fl_T,"-37.81997273, 144.95834911"
139820250512,139,2025-05-12,8,13,491,504,Signal1647_T,"-37.81959923, 144.9632832"
1421220250410,142,2025-04-10,12,624,545,1169,Hammer1584_T,"-37.81970749, 144.96795734"
1232220250712,123,2025-07-12,22,4,2,6,BirBridge_T,"-37.81753741, 144.97329734"
130520250227,130,2025-02-27,5,0,1,1,Bou892T,"-37.8204637, 144.94126826"
1612220250720,161,2025-07-20,22,1,0,1,BirArt1109_T,"-37.81851276, 144.97131336"
164120241116,164,2024-11-16,1,6,9,15,Lat526_T,"-37.813005, 144.95160411"
138020250712,138,2025-07-12,0,1,1,2,EntPark1671_T,"-37.81996544, 144.95981454"
1092120241126,109,2024-11-26,21,65,95,160,LatWill_T,"-37.81193681, 144.95621105"
692320240922,69,2024-09-22,23,1,1,2,FLDegC_T,"-37.81687226, 144.96559144"
62220231028,6,2023-10-28,22,793,589,1382,FliS_T,"-37.81911705, 144.96558255"
84820241006,84,2024-10-06,8,215,191,406,ElFi_T,"-37.81798049, 144.96503383"
39920240625,39,2024-06-25,9,128,118,246,AlfPl_T,"-37.81379749, 144.96995745"
82020241007,8,2024-10-07,20,43,62,105,WebBN_T,"-37.82293543, 144.9471751"
412020241224,41,2024-12-24,20,1530,1978,3508,Swa31,"-37.81668634, 144.96689733"
411420240207,41,2024-02-07,14,1454,1488,2942,Swa31,"-37.81668634, 144.96689733"
77920240424,77,2024-04-24,9,88,142,230,HarEsP_T,"-37.81441438, 144.94433026"
591520250424,59,2025-04-24,15,251,401,652,RMIT_T,"-37.80825648, 144.96304859"
712120250127,71,2025-01-27,21,1,4,5,WestWP_T,"-37.81235775, 144.97136962"
712020240701,71,2024-07-01,20,12,9,21,WestWP_T,"-37.81235775, 144.97136962"
28820250313,28,2025-03-13,8,742,300,1042,VAC_T,"-37.82129925, 144.96879309"
40420231127,40,2023-11-27,4,2,4,6,Spr201_T,"-37.80999341, 144.97227587"
471720240930,47,2024-09-30,17,1241,876,2117,Eli250_T,"-37.81258467, 144.9625775"
611220250814,61,2025-08-14,12,692,832,1524,RMIT14_T,"-37.80767455, 144.96309114"
501520240707,50,2024-07-07,15,322,274,596,Lyg309_T,"-37.79808192, 144.96721013"
451320241230,45,2024-12-30,13,652,905,1557,Swa148_T,"-37.81414075, 144.96609379"
5420250628,5,2025-06-28,4,22,20,42,PriNW_T,"-37.81874249, 144.96787656"
21620231223,21,2023-12-23,6,30,33,63,Bourke155_T,"-37.81267313, 144.96788288"
1822320250723,182,2025-07-23,23,69,52,121,King163_T,"-37.81627451, 144.95550503"
1312320240315,131,2024-03-15,23,178,85,263,King2_T,"-37.82009057, 144.95758725"
1432020240507,143,2024-05-07,20,157,129,286,Spencer_T,"-37.821728, 144.95557015"
1432220250414,143,2025-04-14,22,62,74,136,Spencer_T,"-37.821728, 144.95557015"
1322120240220,132,2024-02-20,21,130,119,249,King335_T,"-37.81267639, 144.95386444"
1321120240323,132,2024-03-23,11,156,117,273,King335_T,"-37.81267639, 144.95386444"
1321620240423,132,2024-04-23,16,139,158,297,King335_T,"-37.81267639, 144.95386444"
135620240407,135,2024-04-07,6,57,47,104,Spen161_T,"-37.8172861, 144.95319102"
1331920250909,133,2025-09-09,19,395,371,766,Spen229_T,"-37.81531435, 144.95227769"
133220240415,133,2024-04-15,2,4,7,11,Spen229_T,"-37.81531435, 144.95227769"
1332020250211,133,2025-02-11,20,428,312,740,Spen229_T,"-37.81531435, 144.95227769"
1181520240316,118,2024-03-16,15,25,23,48,Fli114C_T,"-37.81632783, 144.97090512"
871720250331,87,2025-03-31,17,107,89,196,Errol23_T,"-37.80454949, 144.94921863"
1672020241223,167,2024-12-23,20,39,54,93,Lat526_T,"-37.81304149, 144.95155955"
1812320250919,181,2025-09-19,23,454,407,861,Eli368_T,"-37.81009465, 144.96143149"
852220241111,85,2024-11-11,22,2,8,10,488Mac_T,"-37.79432415, 144.92973378"
671220240327,67,2024-03-27,12,605,692,1297,FLDegS_T,"-37.81688755, 144.96562569"
11120240312,11,2024-03-12,1,3,5,8,WatCit_T,"-37.81564989, 144.93970694"
18620240422,18,2024-04-22,6,2,36,38,Col12_T,"-37.81344862, 144.97305353"
182120250903,18,2025-09-03,21,31,17,48,Col12_T,"-37.81344862, 144.97305353"
122320240126,12,2024-01-26,23,108,57,165,NewQ_T,"-37.81457988, 144.94292398"
68320250408,68,2025-04-08,3,1,0,1,FLDegN_T,"-37.8168479, 144.96559789"
56620250425,56,2025-04-25,6,16,20,36,Lon364_T,"-37.81234775, 144.96153311"
10220240114,10,2024-01-14,2,1,7,8,BouHbr_T,"-37.81876474, 144.94710545"
722220240915,72,2024-09-15,22,51,22,73,ACMI_T,"-37.81726338, 144.96872809"
102020250912,10,2025-09-12,20,37,42,79,BouHbr_T,"-37.81876474, 144.94710545"
35720250208,35,2025-02-08,7,260,223,483,SouthB_T,"-37.82018685, 144.96508508"
761320250311,76,2025-03-11,13,38,40,78,KenMac_T,"-37.79453803, 144.93036194"
76420250409,76,2025-04-09,4,0,1,1,KenMac_T,"-37.79453803, 144.93036194"
27220240826,27,2024-08-26,2,13,2,15,Vic_T,"-37.80606888, 144.95644692"
581920250614,58,2025-06-14,19,432,254,686,Bou688_T,"-37.81686075, 144.95358075"
91420231118,9,2023-11-18,14,111,87,198,Col700_T,"-37.81982992, 144.95102555"
791120240806,79,2024-08-06,11,353,271,624,FliSS_T,"-37.81794046, 144.96616678"
23120250423,23,2025-04-23,1,1,9,10,Col623_T,"-37.81909256, 144.95452748"
481620250108,48,2025-01-08,16,153,234,387,QVMQ_T,"-37.80631581, 144.95866697"
481220240427,48,2024-04-27,12,763,383,1146,QVMQ_T,"-37.80631581, 144.95866697"
25120240810,25,2024-08-10,1,45,39,84,MCEC_T,"-37.82401776, 144.95604426"
25420250512,25,2025-05-12,4,3,3,6,MCEC_T,"-37.82401776, 144.95604426"
461020250427,46,2025-04-27,10,33,34,67,Pel147_T,"-37.80240719, 144.9615673"
202320250529,20,2025-05-29,23,59,147,206,LtB170_T,"-37.81172914, 144.9682466"
192120250428,19,2025-04-28,21,216,310,526,LtB210_T,"-37.81237202, 144.96550671"
141320250627,141,2025-06-27,3,13,6,19,474Fl_T,"-37.81997273, 144.95834911"
137820250809,137,2025-08-09,8,3,9,12,BouHbr2353_T,"-37.81894815, 144.94612292"
1361520250701,136,2025-07-01,15,56,55,111,BirFed1120_T,"-37.8184141, 144.97357915"
142220250411,142,2025-04-11,2,2,0,2,Hammer1584_T,"-37.81970749, 144.96795734"
1301320240814,130,2024-08-14,13,34,42,76,Bou892T,"-37.8204637, 144.94126826"
1381520241018,138,2024-10-18,15,5,4,9,EntPark1671_T,"-37.81996544, 144.95981454"
491720241007,49,2024-10-07,17,224,202,426,Eli501_T,"-37.80730068, 144.95956055"
49620231026,49,2023-10-26,6,36,41,77,Eli501_T,"-37.80730068, 144.95956055"
1352020250610,135,2025-06-10,20,108,136,244,Spen161_T,"-37.8172861, 144.95319102"
1081020250818,108,2025-08-18,10,235,381,616,261Will_T,"-37.81295822, 144.95678789"
87920241226,87,2024-12-26,9,31,38,69,Errol23_T,"-37.80454949, 144.94921863"
179720250221,179,2025-02-21,7,46,23,69,Pow61_T,"-37.82392385, 144.96299677"
166620241229,166,2024-12-29,6,4,6,10,Spen484_T,"-37.80896733, 144.94931703"
1661220250223,166,2025-02-23,12,57,53,110,Spen484_T,"-37.80896733, 144.94931703"
1671120241117,167,2024-11-17,11,28,82,110,Lat526_T,"-37.81304149, 144.95155955"
662320231021,66,2023-10-21,23,516,398,914,QVN_T,"-37.81057846, 144.96444294"
661720250729,66,2025-07-29,17,1511,1699,3210,QVN_T,"-37.81057846, 144.96444294"
6120240910,6,2024-09-10,1,14,10,24,FliS_T,"-37.81911705, 144.96558255"
61420241206,6,2024-12-06,14,939,754,1693,FliS_T,"-37.81911705, 144.96558255"
6620250120,6,2025-01-20,6,166,344,510,FliS_T,"-37.81911705, 144.96558255"
841320240219,84,2024-02-19,13,1176,1352,2528,ElFi_T,"-37.81798049, 144.96503383"
4720240727,4,2024-07-27,7,73,41,114,Swa123_T,"-37.81487988, 144.9660878"
4820250624,4,2025-06-24,8,585,298,883,Swa123_T,"-37.81487988, 144.9660878"
3120250929,3,2025-09-29,1,43,31,74,Swa295_T,"-37.81101524, 144.96429485"
392020241217,39,2024-12-17,20,17,14,31,AlfPl_T,"-37.81379749, 144.96995745"
32320241016,3,2024-10-16,23,185,176,361,Swa295_T,"-37.81101524, 144.96429485"
8920250201,8,2025-02-01,9,123,174,297,WebBN_T,"-37.82293543, 144.9471751"
8320250202,8,2025-02-02,3,1,0,1,WebBN_T,"-37.82293543, 144.9471751"
82320240207,8,2024-02-07,23,10,17,27,WebBN_T,"-37.82293543, 144.9471751"
41320240316,41,2024-03-16,3,81,142,223,Swa31,"-37.81668634, 144.96689733"
511520240327,51,2024-03-27,15,110,100,210,Fra118_T,"-37.80841815, 144.95906316"
231220240517,23,2024-05-17,12,264,348,612,Col623_T,"-37.81909256, 144.95452748"
521520231120,52,2023-11-20,15,445,357,802,Eli263_T,"-37.81252157, 144.9619401"
462020251012,46,2025-10-12,20,9,3,12,Pel147_T,"-37.80240719, 144.9615673"
492220251012,49,2025-10-12,22,136,90,226,Eli501_T,"-37.80730068, 144.95956055"
192220240717,19,2024-07-17,22,129,222,351,LtB210_T,"-37.81237202, 144.96550671"
251020250730,25,2025-07-30,10,130,300,430,MCEC_T,"-37.82401776, 144.95604426"
251320240419,25,2024-04-19,13,778,658,1436,MCEC_T,"-37.82401776, 144.95604426"
25020240522,25,2024-05-22,0,18,18,36,MCEC_T,"-37.82401776, 144.95604426"
1371020250314,137,2025-03-14,10,17,33,50,BouHbr2353_T,"-37.81894815, 144.94612292"
1232020231224,123,2023-12-24,20,38,41,79,BirBridge_T,"-37.81753741, 144.97329734"
117820250314,117,2025-03-14,8,264,119,383,Fli114F_T,"-37.81629332, 144.97090877"
391920240328,39,2024-03-28,19,73,39,112,AlfPl_T,"-37.81379749, 144.96995745"
422220250627,42,2025-06-27,22,16,16,32,UM1_T,"-37.80008566, 144.96386412"
291120240723,29,2024-07-23,11,130,246,376,AG_T,"-37.8199817, 144.96872865"
14520231123,14,2023-11-23,5,48,29,77,SanBri_T,"-37.82011242, 144.96291897"
59220250222,59,2025-02-22,2,30,8,38,RMIT_T,"-37.80825648, 144.96304859"
282120250430,28,2025-04-30,21,151,150,301,VAC_T,"-37.82129925, 144.96879309"
281620240107,28,2024-01-07,16,305,636,941,VAC_T,"-37.82129925, 144.96879309"
401520250202,40,2025-02-02,15,188,71,259,Spr201_T,"-37.80999341, 144.97227587"
47320240327,47,2024-03-27,3,34,13,47,Eli250_T,"-37.81258467, 144.9625775"
611620250918,61,2025-09-18,16,529,651,1180,RMIT14_T,"-37.80767455, 144.96309114"
442020241008,44,2024-10-08,20,35,22,57,UM3_T,"-37.79698741, 144.96441306"
431520240115,43,2024-01-15,15,88,100,188,UM2_T,"-37.79844526, 144.96411782"
43620240815,43,2024-08-15,6,29,9,38,UM2_T,"-37.79844526, 144.96411782"
52220250828,5,2025-08-28,22,1247,450,1697,PriNW_T,"-37.81874249, 144.96787656"
1431120250411,143,2025-04-11,11,138,250,388,Spencer_T,"-37.821728, 144.95557015"
1401320240410,140,2024-04-10,13,80,76,156,Boyd2837_T,"-37.82590962, 144.96185972"
1432220240420,143,2024-04-20,22,260,166,426,Spencer_T,"-37.821728, 144.95557015"
108320250114,108,2025-01-14,3,6,5,11,261Will_T,"-37.81295822, 144.95678789"
1071520231024,107,2023-10-24,15,127,127,254,280Will_T,"-37.81246271, 144.95690188"
131620250525,131,2025-05-25,6,29,41,70,King2_T,"-37.82009057, 144.95758725"
1321320250511,132,2025-05-11,13,151,129,280,King335_T,"-37.81267639, 144.95386444"
132920231202,132,2023-12-02,9,20,14,34,King335_T,"-37.81267639, 144.95386444"
135820250828,135,2025-08-28,8,270,424,694,Spen161_T,"-37.8172861, 144.95319102"
1331320241224,133,2024-12-24,13,470,486,956,Spen229_T,"-37.81531435, 144.95227769"
1181620250506,118,2025-05-06,16,7,37,44,Fli114C_T,"-37.81632783, 144.97090512"
108120250718,108,2025-07-18,1,13,17,30,261Will_T,"-37.81295822, 144.95678789"
1081320231108,108,2023-11-08,13,560,597,1157,261Will_T,"-37.81295822, 144.95678789"
872120240707,87,2024-07-07,21,10,18,28,Errol23_T,"-37.80454949, 144.94921863"
182320250725,182,2025-07-25,3,16,11,27,King163_T,"-37.81627451, 144.95550503"
721720240730,72,2024-07-30,17,148,833,981,ACMI_T,"-37.81726338, 144.96872809"
72220241214,72,2024-12-14,2,17,41,58,ACMI_T,"-37.81726338, 144.96872809"
72320251008,72,2025-10-08,3,2,2,4,ACMI_T,"-37.81726338, 144.96872809"
241920250829,24,2025-08-29,19,416,551,967,Col620_T,"-37.81887963, 144.95449198"
352320250523,35,2025-05-23,23,202,838,1040,SouthB_T,"-37.82018685, 144.96508508"
761920241214,76,2024-12-14,19,47,40,87,KenMac_T,"-37.79453803, 144.93036194"
532320240624,53,2024-06-24,23,13,30,43,Col254_T,"-37.81564191, 144.965499"
27120250814,27,2025-08-14,1,5,9,14,Vic_T,"-37.80606888, 144.95644692"
531320250924,53,2025-09-24,13,845,728,1573,Col254_T,"-37.81564191, 144.965499"
23420251003,23,2025-10-03,4,5,9,14,Col623_T,"-37.81909256, 144.95452748"
482020250728,48,2025-07-28,20,81,130,211,QVMQ_T,"-37.80631581, 144.95866697"
481620240223,48,2024-02-23,16,193,181,374,QVMQ_T,"-37.80631581, 144.95866697"
201220241210,20,2024-12-10,12,383,330,713,LtB170_T,"-37.81172914, 144.9682466"
201620240313,20,2024-03-13,16,162,221,383,LtB170_T,"-37.81172914, 144.9682466"
137820240910,137,2024-09-10,8,131,24,155,BouHbr2353_T,"-37.81894815, 144.94612292"
137720250114,137,2025-01-14,7,81,8,89,BouHbr2353_T,"-37.81894815, 144.94612292"
141920240505,141,2024-05-05,9,115,73,188,474Fl_T,"-37.81997273, 144.95834911"
1391320251004,139,2025-10-04,13,65,82,147,Signal1647_T,"-37.81959923, 144.9632832"
1371220231129,137,2023-11-29,12,47,88,135,BouHbr2353_T,"-37.81894815, 144.94612292"
136720240221,136,2024-02-21,7,76,100,176,BirFed1120_T,"-37.8184141, 144.97357915"
142520240126,142,2024-01-26,5,11,4,15,Hammer1584_T,"-37.81970749, 144.96795734"
123520241229,123,2024-12-29,5,1,1,2,BirBridge_T,"-37.81753741, 144.97329734"
138720250322,138,2025-03-22,7,4,3,7,EntPark1671_T,"-37.81996544, 144.95981454"
1171020250804,117,2025-08-04,10,83,93,176,Fli114F_T,"-37.81629332, 144.97090877"
49620241216,49,2024-12-16,6,33,34,67,Eli501_T,"-37.80730068, 144.95956055"
49420241218,49,2024-12-18,4,14,15,29,Eli501_T,"-37.80730068, 144.95956055"
66020250309,66,2025-03-09,0,340,301,641,QVN_T,"-37.81057846, 144.96444294"
6320240508,6,2024-05-08,3,4,6,10,FliS_T,"-37.81911705, 144.96558255"
70720250504,70,2025-05-04,7,13,7,20,Errol20_T,"-37.80456984, 144.94946228"
3620240606,3,2024-06-06,6,55,102,157,Swa295_T,"-37.81101524, 144.96429485"
3220241205,3,2024-12-05,2,34,15,49,Swa295_T,"-37.81101524, 144.96429485"
39420250509,39,2025-05-09,4,4,2,6,AlfPl_T,"-37.81379749, 144.96995745"
751220240607,75,2024-06-07,12,42,44,86,SprFli_T,"-37.81515276, 144.97467661"
82120240117,8,2024-01-17,21,73,64,137,WebBN_T,"-37.82293543, 144.9471751"
781520250324,78,2025-03-24,15,34,74,108,HarEsB_T,"-37.81471642, 144.9446508"
291920231128,29,2023-11-28,19,241,257,498,AG_T,"-37.8199817, 144.96872865"
14920240911,14,2024-09-11,9,325,261,586,SanBri_T,"-37.82011242, 144.96291897"
311120240704,31,2024-07-04,11,106,84,190,Lyg161_T,"-37.80169681, 144.96658911"
541520231117,54,2023-11-17,15,92,133,225,Swa607_T,"-37.804024, 144.96308399"
281520250506,28,2025-05-06,15,414,695,1109,VAC_T,"-37.82129925, 144.96879309"
47620250829,47,2025-08-29,6,28,128,156,Eli250_T,"-37.81258467, 144.9625775"
401820250929,40,2025-09-29,18,84,95,179,Spr201_T,"-37.80999341, 144.97227587"
401920251016,40,2025-10-16,19,82,72,154,Spr201_T,"-37.80999341, 144.97227587"
37120240619,37,2024-06-19,1,1,3,4,Lyg260_T,"-37.80107122, 144.96704554"
45320250812,45,2025-08-12,3,5,15,20,Swa148_T,"-37.81414075, 144.96609379"
52120250204,5,2025-02-04,21,740,683,1423,PriNW_T,"-37.81874249, 144.96787656"
21320251013,21,2025-10-13,3,1,1,2,Bourke155_T,"-37.81267313, 144.96788288"
1072120250920,107,2025-09-20,21,68,77,145,280Will_T,"-37.81246271, 144.95690188"
1071820240713,107,2024-07-13,18,52,77,129,280Will_T,"-37.81246271, 144.95690188"
108120250410,108,2025-04-10,1,20,7,27,261Will_T,"-37.81295822, 144.95678789"
611420231209,61,2023-12-09,14,176,320,496,RMIT14_T,"-37.80767455, 144.96309114"
1651120250315,165,2025-03-15,11,35,50,85,Spen475_T,"-37.80953359, 144.94939004"
1671520250910,167,2025-09-10,15,57,78,135,Lat526_T,"-37.81304149, 144.95155955"
1841020250711,184,2025-07-11,10,609,520,1129,Eli124_T,"-37.81512416, 144.96371988"
171120231018,17,2023-10-18,11,394,295,689,Col15_T,"-37.81362543, 144.97323591"
11220240613,1,2024-06-13,12,1056,968,2024,Bou292_T,"-37.81349441, 144.96515323"
18820240614,18,2024-06-14,8,69,809,878,Col12_T,"-37.81344862, 144.97305353"
62120231231,62,2023-12-31,1,23,12,35,Lat224_T,"-37.80996494, 144.96216521"
56120240310,56,2024-03-10,1,87,124,211,Lon364_T,"-37.81234775, 144.96153311"
111320250912,11,2025-09-12,13,92,88,180,WatCit_T,"-37.81564989, 144.93970694"
101420241108,10,2024-11-08,14,79,41,120,BouHbr_T,"-37.81876474, 144.94710545"
121020240412,12,2024-04-12,10,121,135,256,NewQ_T,"-37.81457988, 144.94292398"
721820231216,72,2023-12-16,18,424,739,1163,ACMI_T,"-37.81726338, 144.96872809"
76920250814,76,2025-08-14,9,62,41,103,KenMac_T,"-37.79453803, 144.93036194"
761620240122,76,2024-01-22,16,51,62,113,KenMac_T,"-37.79453803, 144.93036194"
76020240214,76,2024-02-14,0,0,1,1,KenMac_T,"-37.79453803, 144.93036194"
21220241026,2,2024-10-26,12,857,703,1560,Bou283_T,"-37.81380668, 144.96516718"
27020240728,27,2024-07-28,0,24,10,34,Vic_T,"-37.80606888, 144.95644692"
301220240901,30,2024-09-01,12,295,377,672,Lon189_T,"-37.8112185, 144.96656806"
30420231018,30,2023-10-18,4,5,13,18,Lon189_T,"-37.8112185, 144.96656806"
532320250717,53,2025-07-17,23,157,37,194,Col254_T,"-37.81564191, 144.965499"
23920240812,23,2024-08-12,9,382,195,577,Col623_T,"-37.81909256, 144.95452748"
511720250912,51,2025-09-12,17,127,103,230,Fra118_T,"-37.80841815, 144.95906316"
462320240120,46,2024-01-20,23,17,14,31,Pel147_T,"-37.80240719, 144.9615673"
49520241010,49,2024-10-10,5,29,20,49,Eli501_T,"-37.80730068, 144.95956055"
49620231121,49,2023-11-21,6,45,51,96,Eli501_T,"-37.80730068, 144.95956055"
48320231120,48,2023-11-20,3,11,4,15,QVMQ_T,"-37.80631581, 144.95866697"
25920240406,25,2024-04-06,9,181,350,531,MCEC_T,"-37.82401776, 144.95604426"
201320231130,20,2023-11-30,13,321,284,605,LtB170_T,"-37.81172914, 144.9682466"
521120250901,52,2025-09-01,11,214,192,406,Eli263_T,"-37.81252157, 144.9619401"
137820250904,137,2025-09-04,8,91,20,111,BouHbr2353_T,"-37.81894815, 144.94612292"
1391420240112,139,2024-01-12,14,29,38,67,Signal1647_T,"-37.81959923, 144.9632832"
1301220241117,130,2024-11-17,12,37,17,54,Bou892T,"-37.8204637, 144.94126826"
130020250122,130,2025-01-22,0,1,1,2,Bou892T,"-37.8204637, 144.94126826"
142820240728,142,2024-07-28,8,117,72,189,Hammer1584_T,"-37.81970749, 144.96795734"
109120250129,109,2025-01-29,1,11,16,27,LatWill_T,"-37.81193681, 144.95621105"
1091020250508,109,2025-05-08,10,100,191,291,LatWill_T,"-37.81193681, 144.95621105"
661820250305,66,2025-03-05,18,1562,1698,3260,QVN_T,"-37.81057846, 144.96444294"
691320231121,69,2023-11-21,13,229,220,449,FLDegC_T,"-37.81687226, 144.96559144"
41320240317,4,2024-03-17,13,2834,1424,4258,Swa123_T,"-37.81487988, 144.9660878"
41820241223,4,2024-12-23,18,1822,1654,3476,Swa123_T,"-37.81487988, 144.9660878"
41520250226,41,2025-02-26,5,87,85,172,Swa31,"-37.81668634, 144.96689733"
781320240129,78,2024-01-29,13,30,65,95,HarEsB_T,"-37.81471642, 144.9446508"
78020240501,78,2024-05-01,0,12,4,16,HarEsB_T,"-37.81471642, 144.9446508"
292320240409,29,2024-04-09,23,28,47,75,AG_T,"-37.8199817, 144.96872865"
711320240610,71,2024-06-10,13,15,13,28,WestWP_T,"-37.81235775, 144.97136962"
65620231224,65,2023-12-24,6,25,34,59,SwaCs_T,"-37.81569416, 144.9668064"
292320250711,29,2025-07-11,23,39,49,88,AG_T,"-37.8199817, 144.96872865"
402020250415,40,2025-04-15,20,109,76,185,Spr201_T,"-37.80999341, 144.97227587"
541820240221,54,2024-02-21,18,137,294,431,Swa607_T,"-37.804024, 144.96308399"
401620250315,40,2025-03-15,16,84,156,240,Spr201_T,"-37.80999341, 144.97227587"
361420250218,36,2025-02-18,14,190,245,435,Que85_T,"-37.81652527, 144.96121062"
371220240405,37,2024-04-05,12,124,97,221,Lyg260_T,"-37.80107122, 144.96704554"
441520250915,44,2025-09-15,15,102,98,200,UM3_T,"-37.79698741, 144.96441306"
431620240225,43,2024-02-25,16,112,78,190,UM2_T,"-37.79844526, 144.96411782"
5520250921,5,2025-09-21,5,27,30,57,PriNW_T,"-37.81874249, 144.96787656"
451320241008,45,2024-10-08,13,676,824,1500,Swa148_T,"-37.81414075, 144.96609379"
131820250925,131,2025-09-25,8,166,67,233,King2_T,"-37.82009057, 144.95758725"
140820240721,140,2024-07-21,8,55,16,71,Boyd2837_T,"-37.82590962, 144.96185972"
1341220240801,134,2024-08-01,12,473,386,859,Spen201_T,"-37.81694221, 144.95303935"
672020250307,67,2025-03-07,20,310,454,764,FLDegS_T,"-37.81688755, 144.96562569"
17820240713,17,2024-07-13,8,85,49,134,Col15_T,"-37.81362543, 144.97323591"
11920231230,1,2023-12-30,19,1650,1024,2674,Bou292_T,"-37.81349441, 144.96515323"
672320240304,67,2024-03-04,23,23,31,54,FLDegS_T,"-37.81688755, 144.96562569"
671620240805,67,2024-08-05,16,298,526,824,FLDegS_T,"-37.81688755, 144.96562569"
181120240301,18,2024-03-01,11,195,210,405,Col12_T,"-37.81344862, 144.97305353"
181220240908,18,2024-09-08,12,67,56,123,Col12_T,"-37.81344862, 144.97305353"
181720241006,18,2024-10-06,17,77,31,108,Col12_T,"-37.81344862, 144.97305353"
671920240521,67,2024-05-21,19,200,285,485,FLDegS_T,"-37.81688755, 144.96562569"
561120240725,56,2024-07-25,11,263,143,406,Lon364_T,"-37.81234775, 144.96153311"
121620241113,12,2024-11-13,16,135,203,338,NewQ_T,"-37.81457988, 144.94292398"
721920240102,72,2024-01-02,19,52,65,117,ACMI_T,"-37.81726338, 144.96872809"
721520240930,72,2024-09-30,15,190,402,592,ACMI_T,"-37.81726338, 144.96872809"
101220250527,10,2025-05-27,12,166,132,298,BouHbr_T,"-37.81876474, 144.94710545"
76020250207,76,2025-02-07,0,4,2,6,KenMac_T,"-37.79453803, 144.93036194"
58820231118,58,2023-11-18,8,339,109,448,Bou688_T,"-37.81686075, 144.95358075"
76520240512,76,2024-05-12,5,1,1,2,KenMac_T,"-37.79453803, 144.93036194"
271820241209,27,2024-12-09,18,101,56,157,Vic_T,"-37.80606888, 144.95644692"
531120240512,53,2024-05-12,11,562,465,1027,Col254_T,"-37.81564191, 144.965499"
91020240906,9,2024-09-06,10,169,483,652,Col700_T,"-37.81982992, 144.95102555"
301420250517,30,2025-05-17,14,234,519,753,Lon189_T,"-37.8112185, 144.96656806"
301620240531,30,2024-05-31,16,270,333,603,Lon189_T,"-37.8112185, 144.96656806"
302120240510,30,2024-05-10,21,362,458,820,Lon189_T,"-37.8112185, 144.96656806"
79520240725,79,2024-07-25,5,20,26,46,FliSS_T,"-37.81794046, 144.96616678"
231920250416,23,2025-04-16,19,100,240,340,Col623_T,"-37.81909256, 144.95452748"
481520250320,48,2025-03-20,15,285,174,459,QVMQ_T,"-37.80631581, 144.95866697"
302120250811,30,2025-08-11,21,199,335,534,Lon189_T,"-37.8112185, 144.96656806"
48120231231,48,2023-12-31,1,13,26,39,QVMQ_T,"-37.80631581, 144.95866697"
461220240309,46,2024-03-09,12,63,51,114,Pel147_T,"-37.80240719, 144.9615673"
46120240119,46,2024-01-19,1,0,3,3,Pel147_T,"-37.80240719, 144.9615673"
1371220250301,137,2025-03-01,12,19,37,56,BouHbr2353_T,"-37.81894815, 144.94612292"
1421520240715,142,2024-07-15,15,70,23,93,Hammer1584_T,"-37.81970749, 144.96795734"
1611220241023,161,2024-10-23,12,219,218,437,BirArt1109_T,"-37.81851276, 144.97131336"
1611920250310,161,2025-03-10,19,3830,1240,5070,BirArt1109_T,"-37.81851276, 144.97131336"
1381720241121,138,2024-11-21,17,12,7,19,EntPark1671_T,"-37.81996544, 144.95981454"
1171420240821,117,2024-08-21,14,138,176,314,Fli114F_T,"-37.81629332, 144.97090877"
492120241103,49,2024-11-03,21,133,110,243,Eli501_T,"-37.80730068, 144.95956055"
49920241205,49,2024-12-05,9,226,253,479,Eli501_T,"-37.80730068, 144.95956055"
19120241106,19,2024-11-06,1,36,53,89,LtB210_T,"-37.81237202, 144.96550671"
692120240528,69,2024-05-28,21,13,6,19,FLDegC_T,"-37.81687226, 144.96559144"
691320250319,69,2025-03-19,13,311,302,613,FLDegC_T,"-37.81687226, 144.96559144"
62220231209,6,2023-12-09,22,1309,737,2046,FliS_T,"-37.81911705, 144.96558255"
62320240617,6,2024-06-17,23,135,84,219,FliS_T,"-37.81911705, 144.96558255"
70420231201,70,2023-12-01,4,2,0,2,Errol20_T,"-37.80456984, 144.94946228"
3420250802,3,2025-08-02,4,34,20,54,Swa295_T,"-37.81101524, 144.96429485"
77020241002,77,2024-10-02,0,16,1,17,HarEsP_T,"-37.81441438, 144.94433026"
77320240718,77,2024-07-18,3,3,0,3,HarEsP_T,"-37.81441438, 144.94433026"
29920250513,29,2025-05-13,9,107,125,232,AG_T,"-37.8199817, 144.96872865"
14020250928,14,2025-09-28,0,121,32,153,SanBri_T,"-37.82011242, 144.96291897"
71320240611,71,2024-06-11,3,13,3,16,WestWP_T,"-37.81235775, 144.97136962"
711320240706,71,2024-07-06,13,12,9,21,WestWP_T,"-37.81235775, 144.97136962"
65420240419,65,2024-04-19,4,3,5,8,SwaCs_T,"-37.81569416, 144.9668064"
54620250903,54,2025-09-03,6,8,13,21,Swa607_T,"-37.804024, 144.96308399"
54320231211,54,2023-12-11,3,8,6,14,Swa607_T,"-37.804024, 144.96308399"
40220240522,40,2024-05-22,2,3,2,5,Spr201_T,"-37.80999341, 144.97227587"
311620240124,31,2024-01-24,16,146,115,261,Lyg161_T,"-37.80169681, 144.96658911"
31820250526,31,2025-05-26,8,53,41,94,Lyg161_T,"-37.80169681, 144.96658911"
312120240922,31,2024-09-22,21,179,181,360,Lyg161_T,"-37.80169681, 144.96658911"
361920241103,36,2024-11-03,19,76,63,139,Que85_T,"-37.81652527, 144.96121062"
47920250818,47,2025-08-18,9,277,489,766,Eli250_T,"-37.81258467, 144.9625775"
442320250302,44,2025-03-02,23,8,4,12,UM3_T,"-37.79698741, 144.96441306"
44520250926,44,2025-09-26,5,5,0,5,UM3_T,"-37.79698741, 144.96441306"
452020241031,45,2024-10-31,20,310,633,943,Swa148_T,"-37.81414075, 144.96609379"
132920241115,132,2024-11-15,9,153,86,239,King335_T,"-37.81267639, 144.95386444"
1321620241229,132,2024-12-29,16,84,137,221,King335_T,"-37.81267639, 144.95386444"
132720250103,132,2025-01-03,7,34,17,51,King335_T,"-37.81267639, 144.95386444"
1352220231212,135,2023-12-12,22,127,137,264,Spen161_T,"-37.8172861, 144.95319102"
1081620250730,108,2025-07-30,16,1110,245,1355,261Will_T,"-37.81295822, 144.95678789"
1791920250727,179,2025-07-27,19,39,49,88,Pow61_T,"-37.82392385, 144.96299677"
165520250316,165,2025-03-16,5,8,5,13,Spen475_T,"-37.80953359, 144.94939004"
172020231123,17,2023-11-23,20,183,153,336,Col15_T,"-37.81362543, 144.97323591"
171120250327,17,2025-03-27,11,396,318,714,Col15_T,"-37.81362543, 144.97323591"
63520240927,63,2024-09-27,5,1,8,9,Bou231_T,"-37.81333081, 144.96675571"
672120241006,67,2024-10-06,21,111,293,404,FLDegS_T,"-37.81688755, 144.96562569"
681820250425,68,2025-04-25,18,104,69,173,FLDegN_T,"-37.8168479, 144.96559789"
12220240121,12,2024-01-21,2,7,21,28,NewQ_T,"-37.81457988, 144.94292398"
11920250915,1,2025-09-15,19,550,440,990,Bou292_T,"-37.81349441, 144.96515323"
111520240910,11,2024-09-10,15,71,71,142,WatCit_T,"-37.81564989, 144.93970694"
682320240510,68,2024-05-10,23,24,12,36,FLDegN_T,"-37.8168479, 144.96559789"
621520231119,62,2023-11-19,15,336,164,500,Lat224_T,"-37.80996494, 144.96216521"
24120241216,24,2024-12-16,1,26,16,42,Col620_T,"-37.81887963, 144.95449198"
722320240218,72,2024-02-18,23,142,2839,2981,ACMI_T,"-37.81726338, 144.96872809"
11320250111,11,2025-01-11,3,1,0,1,WatCit_T,"-37.81564989, 144.93970694"
36020240127,36,2024-01-27,0,109,140,249,Que85_T,"-37.81652527, 144.96121062"
442220250902,44,2025-09-02,22,16,35,51,UM3_T,"-37.79698741, 144.96441306"
442320231114,44,2023-11-14,23,7,0,7,UM3_T,"-37.79698741, 144.96441306"
451620240416,45,2024-04-16,16,510,828,1338,Swa148_T,"-37.81414075, 144.96609379"
211120240418,21,2024-04-18,11,311,254,565,Bourke155_T,"-37.81267313, 144.96788288"
1431520241101,143,2024-11-01,15,219,263,482,Spencer_T,"-37.821728, 144.95557015"
1311920240506,131,2024-05-06,19,47,55,102,King2_T,"-37.82009057, 144.95758725"
133120240408,133,2024-04-08,1,26,8,34,Spen229_T,"-37.81531435, 144.95227769"
1081420250819,108,2025-08-19,14,499,376,875,261Will_T,"-37.81295822, 144.95678789"
108520240108,108,2024-01-08,5,9,25,34,261Will_T,"-37.81295822, 144.95678789"
871120240226,87,2024-02-26,11,74,83,157,Errol23_T,"-37.80454949, 144.94921863"
871020240525,87,2024-05-25,10,112,108,220,Errol23_T,"-37.80454949, 144.94921863"
182220250716,182,2025-07-16,2,13,17,30,King163_T,"-37.81627451, 144.95550503"
67620231024,67,2023-10-24,6,94,40,134,FLDegS_T,"-37.81688755, 144.96562569"
671920240425,67,2024-04-25,19,256,393,649,FLDegS_T,"-37.81688755, 144.96562569"
671820240208,67,2024-02-08,18,273,295,568,FLDegS_T,"-37.81688755, 144.96562569"
181120250226,18,2025-02-26,11,217,225,442,Col12_T,"-37.81344862, 144.97305353"
1620250426,1,2025-04-26,6,12,15,27,Bou292_T,"-37.81349441, 144.96515323"
56520240113,56,2024-01-13,5,47,16,63,Lon364_T,"-37.81234775, 144.96153311"
241420240416,24,2024-04-16,14,514,802,1316,Col620_T,"-37.81887963, 144.95449198"
101620250822,10,2025-08-22,16,150,57,207,BouHbr_T,"-37.81876474, 144.94710545"
582020250901,58,2025-09-01,20,171,185,356,Bou688_T,"-37.81686075, 144.95358075"
2020250301,2,2025-03-01,0,26,102,128,Bou283_T,"-37.81380668, 144.96516718"
91520240530,9,2024-05-30,15,976,191,1167,Col700_T,"-37.81982992, 144.95102555"
271820241113,27,2024-11-13,18,161,127,288,Vic_T,"-37.80606888, 144.95644692"
30020240830,30,2024-08-30,0,94,84,178,Lon189_T,"-37.8112185, 144.96656806"
791220241223,79,2024-12-23,12,627,460,1087,FliSS_T,"-37.81794046, 144.96616678"
79820231028,79,2023-10-28,8,172,132,304,FliSS_T,"-37.81794046, 144.96616678"
531420240905,53,2024-09-05,14,578,489,1067,Col254_T,"-37.81564191, 144.965499"
79820250128,79,2025-01-28,8,717,300,1017,FliSS_T,"-37.81794046, 144.96616678"
25420240406,25,2024-04-06,4,10,11,21,MCEC_T,"-37.82401776, 144.95604426"
1411720240627,141,2024-06-27,17,167,248,415,474Fl_T,"-37.81997273, 144.95834911"
1411520250715,141,2025-07-15,15,184,138,322,474Fl_T,"-37.81997273, 144.95834911"
1421820240910,142,2024-09-10,18,353,175,528,Hammer1584_T,"-37.81970749, 144.96795734"
1381420250206,138,2025-02-06,14,12,9,21,EntPark1671_T,"-37.81996544, 144.95981454"
1091120250822,109,2025-08-22,11,106,103,209,LatWill_T,"-37.81193681, 144.95621105"
109620250912,109,2025-09-12,6,16,78,94,LatWill_T,"-37.81193681, 144.95621105"
661620240906,66,2024-09-06,16,1059,1199,2258,QVN_T,"-37.81057846, 144.96444294"
691020240221,69,2024-02-21,10,194,139,333,FLDegC_T,"-37.81687226, 144.96559144"
69320240421,69,2024-04-21,3,4,1,5,FLDegC_T,"-37.81687226, 144.96559144"
691620250714,69,2025-07-14,16,141,177,318,FLDegC_T,"-37.81687226, 144.96559144"
41420240129,4,2024-01-29,14,1674,1235,2909,Swa123_T,"-37.81487988, 144.9660878"
32220231205,3,2023-12-05,22,580,416,996,Swa295_T,"-37.81101524, 144.96429485"
81720241230,8,2024-12-30,17,257,172,429,WebBN_T,"-37.82293543, 144.9471751"
1431220240718,143,2024-07-18,12,215,356,571,Spencer_T,"-37.821728, 144.95557015"
131820240804,131,2024-08-04,8,25,49,74,King2_T,"-37.82009057, 144.95758725"
135420250324,135,2025-03-24,4,38,21,59,Spen161_T,"-37.8172861, 144.95319102"
671720240703,67,2024-07-03,17,341,742,1083,FLDegS_T,"-37.81688755, 144.96562569"
171620231214,17,2023-12-14,16,319,533,852,Col15_T,"-37.81362543, 144.97323591"
17220240427,17,2024-04-27,2,9,4,13,Col15_T,"-37.81362543, 144.97323591"
171420241129,17,2024-11-29,14,318,270,588,Col15_T,"-37.81362543, 144.97323591"
18320250227,18,2025-02-27,3,5,4,9,Col12_T,"-37.81344862, 144.97305353"
86220240323,86,2024-03-23,2,0,1,1,574Qub_T,"-37.80309992, 144.94908064"
86620240421,86,2024-04-21,6,3,7,10,574Qub_T,"-37.80309992, 144.94908064"
56020241121,56,2024-11-21,0,37,29,66,Lon364_T,"-37.81234775, 144.96153311"
12120250928,12,2025-09-28,1,4,4,8,NewQ_T,"-37.81457988, 144.94292398"
241020250201,24,2025-02-01,10,488,327,815,Col620_T,"-37.81887963, 144.95449198"
722120241020,72,2024-10-20,21,31,48,79,ACMI_T,"-37.81726338, 144.96872809"
352320250316,35,2025-03-16,23,154,318,472,SouthB_T,"-37.82018685, 144.96508508"
35120250705,35,2025-07-05,1,73,95,168,SouthB_T,"-37.82018685, 144.96508508"
35520251010,35,2025-10-10,5,41,29,70,SouthB_T,"-37.82018685, 144.96508508"
351820241211,35,2024-12-11,18,1766,1770,3536,SouthB_T,"-37.82018685, 144.96508508"
35020231206,35,2023-12-06,0,133,159,292,SouthB_T,"-37.82018685, 144.96508508"
21120250415,2,2025-04-15,11,496,543,1039,Bou283_T,"-37.81380668, 144.96516718"
27720250121,27,2025-01-21,7,55,45,100,Vic_T,"-37.80606888, 144.95644692"
272320250910,27,2025-09-10,23,17,11,28,Vic_T,"-37.80606888, 144.95644692"
531220250701,53,2025-07-01,12,799,578,1377,Col254_T,"-37.81564191, 144.965499"
301320240720,30,2024-07-20,13,314,499,813,Lon189_T,"-37.8112185, 144.96656806"
30620240802,30,2024-08-02,6,20,20,40,Lon189_T,"-37.8112185, 144.96656806"
91920250403,9,2025-04-03,19,275,103,378,Col700_T,"-37.81982992, 144.95102555"
23320250604,23,2025-06-04,3,3,9,12,Col623_T,"-37.81909256, 144.95452748"
481420241202,48,2024-12-02,14,155,112,267,QVMQ_T,"-37.80631581, 144.95866697"
252220231023,25,2023-10-23,22,117,134,251,MCEC_T,"-37.82401776, 144.95604426"
522120240302,52,2024-03-02,21,456,298,754,Eli263_T,"-37.81252157, 144.9619401"
1411920250911,141,2025-09-11,19,78,74,152,474Fl_T,"-37.81997273, 144.95834911"
1391920240812,139,2024-08-12,19,16,18,34,Signal1647_T,"-37.81959923, 144.9632832"
1421620240419,142,2024-04-19,16,334,297,631,Hammer1584_T,"-37.81970749, 144.96795734"
1422320240530,142,2024-05-30,23,17,20,37,Hammer1584_T,"-37.81970749, 144.96795734"
1421220240218,142,2024-02-18,12,615,940,1555,Hammer1584_T,"-37.81970749, 144.96795734"
164820241106,164,2024-11-06,8,100,92,192,Lat526_T,"-37.813005, 144.95160411"
1171320240201,117,2024-02-01,13,220,157,377,Fli114F_T,"-37.81629332, 144.97090877"
117620250321,117,2025-03-21,6,55,25,80,Fli114F_T,"-37.81629332, 144.97090877"
1171020250820,117,2025-08-20,10,130,126,256,Fli114F_T,"-37.81629332, 144.97090877"
1092220240328,109,2024-03-28,22,77,91,168,LatWill_T,"-37.81193681, 144.95621105"
691220241015,69,2024-10-15,12,233,221,454,FLDegC_T,"-37.81687226, 144.96559144"
69520250405,69,2025-04-05,5,1,1,2,FLDegC_T,"-37.81687226, 144.96559144"
691420250424,69,2025-04-24,14,361,331,692,FLDegC_T,"-37.81687226, 144.96559144"
41420231107,4,2023-11-07,14,1337,1136,2473,Swa123_T,"-37.81487988, 144.9660878"
391820250308,39,2025-03-08,18,58,90,148,AlfPl_T,"-37.81379749, 144.96995745"
75420240723,75,2024-07-23,4,2,0,2,SprFli_T,"-37.81515276, 144.97467661"
81820240824,8,2024-08-24,18,182,98,280,WebBN_T,"-37.82293543, 144.9471751"
411420250912,41,2025-09-12,14,1379,1734,3113,Swa31,"-37.81668634, 144.96689733"
771020241001,77,2024-10-01,10,62,42,104,HarEsP_T,"-37.81441438, 144.94433026"
281020240321,28,2024-03-21,10,728,232,960,VAC_T,"-37.82129925, 144.96879309"
291920241026,29,2024-10-26,19,1453,2279,3732,AG_T,"-37.8199817, 144.96872865"
54220241130,54,2024-11-30,2,5,9,14,Swa607_T,"-37.804024, 144.96308399"
28620250415,28,2025-04-15,6,228,87,315,VAC_T,"-37.82129925, 144.96879309"
212120250409,21,2025-04-09,21,256,322,578,Bourke155_T,"-37.81267313, 144.96788288"
752320251010,75,2025-10-10,23,19,16,35,SprFli_T,"-37.81515276, 144.97467661"
411520240927,41,2024-09-27,15,409,307,716,Swa31,"-37.81668634, 144.96689733"
781420240911,78,2024-09-11,14,12,51,63,HarEsB_T,"-37.81471642, 144.9446508"
77820241122,77,2024-11-22,8,149,131,280,HarEsP_T,"-37.81441438, 144.94433026"
78220240906,78,2024-09-06,2,0,1,1,HarEsB_T,"-37.81471642, 144.9446508"
141620250325,14,2025-03-25,16,721,173,894,SanBri_T,"-37.82011242, 144.96291897"
142120250820,14,2025-08-20,21,22,6,28,SanBri_T,"-37.82011242, 144.96291897"
142020240514,14,2024-05-14,20,175,101,276,SanBri_T,"-37.82011242, 144.96291897"
592220241106,59,2024-11-06,22,124,126,250,RMIT_T,"-37.80825648, 144.96304859"
652120231127,65,2023-11-27,21,103,230,333,SwaCs_T,"-37.81569416, 144.9668064"
31320250106,31,2025-01-06,3,8,2,10,Lyg161_T,"-37.80169681, 144.96658911"
471320250514,47,2025-05-14,13,860,1002,1862,Eli250_T,"-37.81258467, 144.9625775"
611520241118,61,2024-11-18,15,531,519,1050,RMIT14_T,"-37.80767455, 144.96309114"
451320240922,45,2024-09-22,13,948,1288,2236,Swa148_T,"-37.81414075, 144.96609379"
442220240125,44,2024-01-25,22,3,9,12,UM3_T,"-37.79698741, 144.96441306"
5320240609,5,2024-06-09,3,21,39,60,PriNW_T,"-37.81874249, 144.96787656"
140920250505,140,2025-05-05,9,100,42,142,Boyd2837_T,"-37.82590962, 144.96185972"
1321420241221,132,2024-12-21,14,164,120,284,King335_T,"-37.81267639, 144.95386444"
1311720250308,131,2025-03-08,17,150,107,257,King2_T,"-37.82009057, 144.95758725"
1341020231027,134,2023-10-27,10,275,367,642,Spen201_T,"-37.81694221, 144.95303935"
1341320240818,134,2024-08-18,13,368,387,755,Spen201_T,"-37.81694221, 144.95303935"
135820240223,135,2024-02-23,8,282,416,698,Spen161_T,"-37.8172861, 144.95319102"
1071720250209,107,2025-02-09,17,65,85,150,280Will_T,"-37.81246271, 144.95690188"
133320250120,133,2025-01-20,3,10,25,35,Spen229_T,"-37.81531435, 144.95227769"
133320240502,133,2024-05-02,3,2,12,14,Spen229_T,"-37.81531435, 144.95227769"
871820250601,87,2025-06-01,18,82,78,160,Errol23_T,"-37.80454949, 144.94921863"
1811620250922,181,2025-09-22,16,797,1314,2111,Eli368_T,"-37.81009465, 144.96143149"
1622320250713,162,2025-07-13,23,50,48,98,Eli489_T,"-37.80740397, 144.95987909"
1622120250821,162,2025-08-21,21,234,156,390,Eli489_T,"-37.80740397, 144.95987909"
681620240707,68,2024-07-07,16,143,78,221,FLDegN_T,"-37.8168479, 144.96559789"
851820250413,85,2025-04-13,18,51,52,103,488Mac_T,"-37.79432415, 144.92973378"
172020240629,17,2024-06-29,20,144,129,273,Col15_T,"-37.81362543, 144.97323591"
11220231201,1,2023-12-01,12,1141,1261,2402,Bou292_T,"-37.81349441, 144.96515323"
681320250420,68,2025-04-20,13,421,299,720,FLDegN_T,"-37.8168479, 144.96559789"
562220250307,56,2025-03-07,22,181,288,469,Lon364_T,"-37.81234775, 144.96153311"
56620250330,56,2025-03-30,6,18,16,34,Lon364_T,"-37.81234775, 144.96153311"
111620250930,11,2025-09-30,16,86,74,160,WatCit_T,"-37.81564989, 144.93970694"
721320231125,72,2023-11-25,13,390,477,867,ACMI_T,"-37.81726338, 144.96872809"
76820240916,76,2024-09-16,8,96,37,133,KenMac_T,"-37.79453803, 144.93036194"
761420250525,76,2025-05-25,14,35,50,85,KenMac_T,"-37.79453803, 144.93036194"
352320240928,35,2024-09-28,23,460,730,1190,SouthB_T,"-37.82018685, 144.96508508"
35120231130,35,2023-11-30,1,27,46,73,SouthB_T,"-37.82018685, 144.96508508"
721320250824,72,2025-08-24,13,221,634,855,ACMI_T,"-37.81726338, 144.96872809"
581620250604,58,2025-06-04,16,610,1058,1668,Bou688_T,"-37.81686075, 144.95358075"
58420250814,58,2025-08-14,4,15,7,22,Bou688_T,"-37.81686075, 144.95358075"
22120231126,2,2023-11-26,21,112,219,331,Bou283_T,"-37.81380668, 144.96516718"
2420240226,2,2024-02-26,4,0,4,4,Bou283_T,"-37.81380668, 144.96516718"
53720250611,53,2025-06-11,7,135,82,217,Col254_T,"-37.81564191, 144.965499"
511020241001,51,2024-10-01,10,94,87,181,Fra118_T,"-37.80841815, 144.95906316"
232220240221,23,2024-02-21,22,17,62,79,Col623_T,"-37.81909256, 144.95452748"
521020240526,52,2024-05-26,10,174,134,308,Eli263_T,"-37.81252157, 144.9619401"
102020241223,10,2024-12-23,20,27,32,59,BouHbr_T,"-37.81876474, 144.94710545"
24320250905,24,2025-09-05,3,29,14,43,Col620_T,"-37.81887963, 144.95449198"
352220250331,35,2025-03-31,22,227,355,582,SouthB_T,"-37.82018685, 144.96508508"
351420250626,35,2025-06-26,14,770,866,1636,SouthB_T,"-37.82018685, 144.96508508"
762320240914,76,2024-09-14,23,0,5,5,KenMac_T,"-37.79453803, 144.93036194"
271420240223,27,2024-02-23,14,167,142,309,Vic_T,"-37.80606888, 144.95644692"
272120240519,27,2024-05-19,21,46,36,82,Vic_T,"-37.80606888, 144.95644692"
582120250418,58,2025-04-18,21,320,273,593,Bou688_T,"-37.81686075, 144.95358075"
30320250609,30,2025-06-09,3,101,131,232,Lon189_T,"-37.8112185, 144.96656806"
79420240321,79,2024-03-21,4,6,6,12,FliSS_T,"-37.81794046, 144.96616678"
91620250103,9,2025-01-03,16,216,55,271,Col700_T,"-37.81982992, 144.95102555"
521220250910,52,2025-09-10,12,397,315,712,Eli263_T,"-37.81252157, 144.9619401"
461720241003,46,2024-10-03,17,115,172,287,Pel147_T,"-37.80240719, 144.9615673"
1392020240115,139,2024-01-15,20,58,46,104,Signal1647_T,"-37.81959923, 144.9632832"
1391820250622,139,2025-06-22,18,29,16,45,Signal1647_T,"-37.81959923, 144.9632832"
1421120240417,142,2024-04-17,11,260,215,475,Hammer1584_T,"-37.81970749, 144.96795734"
1421820240603,142,2024-06-03,18,136,68,204,Hammer1584_T,"-37.81970749, 144.96795734"
142920241029,142,2024-10-29,9,157,201,358,Hammer1584_T,"-37.81970749, 144.96795734"
138620240216,138,2024-02-16,6,0,1,1,EntPark1671_T,"-37.81996544, 144.95981454"
117720250415,117,2025-04-15,7,151,55,206,Fli114F_T,"-37.81629332, 144.97090877"
1231420240331,123,2024-03-31,14,42,33,75,BirBridge_T,"-37.81753741, 144.97329734"
1172120231218,117,2023-12-18,21,112,100,212,Fli114F_T,"-37.81629332, 144.97090877"
66420240221,66,2024-02-21,4,14,20,34,QVN_T,"-37.81057846, 144.96444294"
692320250308,69,2025-03-08,23,28,31,59,FLDegC_T,"-37.81687226, 144.96559144"
6920240602,6,2024-06-02,9,416,325,741,FliS_T,"-37.81911705, 144.96558255"
841420250222,84,2025-02-22,14,960,1281,2241,ElFi_T,"-37.81798049, 144.96503383"
70920250303,70,2025-03-03,9,78,69,147,Errol20_T,"-37.80456984, 144.94946228"
39420250413,39,2025-04-13,4,2,1,3,AlfPl_T,"-37.81379749, 144.96995745"
392320250428,39,2025-04-28,23,1,1,2,AlfPl_T,"-37.81379749, 144.96995745"
391420250503,39,2025-05-03,14,50,48,98,AlfPl_T,"-37.81379749, 144.96995745"
751320240304,75,2024-03-04,13,66,57,123,SprFli_T,"-37.81515276, 144.97467661"
75720240327,75,2024-03-27,7,34,22,56,SprFli_T,"-37.81515276, 144.97467661"
421220250331,42,2025-03-31,12,561,857,1418,UM1_T,"-37.80008566, 144.96386412"
42020240915,42,2024-09-15,0,13,9,22,UM1_T,"-37.80008566, 144.96386412"
771520231031,77,2023-10-31,15,133,101,234,HarEsP_T,"-37.81441438, 144.94433026"
281320250529,28,2025-05-29,13,394,508,902,VAC_T,"-37.82129925, 144.96879309"
282120240112,28,2024-01-12,21,235,1005,1240,VAC_T,"-37.82129925, 144.96879309"
281320240115,28,2024-01-15,13,726,652,1378,VAC_T,"-37.82129925, 144.96879309"
281820240205,28,2024-02-05,18,386,603,989,VAC_T,"-37.82129925, 144.96879309"
472320241213,47,2024-12-13,23,397,302,699,Eli250_T,"-37.81258467, 144.9625775"
401920250126,40,2025-01-26,19,60,78,138,Spr201_T,"-37.80999341, 144.97227587"
361620240928,36,2024-09-28,16,85,74,159,Que85_T,"-37.81652527, 144.96121062"
372320250504,37,2025-05-04,23,57,49,106,Lyg260_T,"-37.80107122, 144.96704554"
372020240417,37,2024-04-17,20,58,52,110,Lyg260_T,"-37.80107122, 144.96704554"
87520240227,87,2024-02-27,5,5,5,10,Errol23_T,"-37.80454949, 144.94921863"
61520250610,61,2025-06-10,5,2,5,7,RMIT14_T,"-37.80767455, 144.96309114"
50220250515,50,2025-05-15,2,9,0,9,Lyg309_T,"-37.79808192, 144.96721013"
45620231107,45,2023-11-07,6,20,32,52,Swa148_T,"-37.81414075, 144.96609379"
162520250506,162,2025-05-06,5,19,5,24,Eli489_T,"-37.80740397, 144.95987909"
361320241022,36,2024-10-22,13,283,365,648,Que85_T,"-37.81652527, 144.96121062"
36820240405,36,2024-04-05,8,147,126,273,Que85_T,"-37.81652527, 144.96121062"
432220250222,43,2025-02-22,22,13,10,23,UM2_T,"-37.79844526, 144.96411782"
451120250112,45,2025-01-12,11,499,529,1028,Swa148_T,"-37.81414075, 144.96609379"
52120241113,5,2024-11-13,21,360,481,841,PriNW_T,"-37.81874249, 144.96787656"
133920231116,133,2023-11-16,9,520,508,1028,Spen229_T,"-37.81531435, 144.95227769"
124920250302,124,2025-03-02,9,0,1,1,BirBridge_T,"-37.81757416, 144.97329934"
87620231215,87,2023-12-15,6,16,16,32,Errol23_T,"-37.80454949, 144.94921863"
611720240108,61,2024-01-08,17,152,288,440,RMIT14_T,"-37.80767455, 144.96309114"
184720250820,184,2025-08-20,7,143,143,286,Eli124_T,"-37.81512416, 144.96371988"
1661520250831,166,2025-08-31,15,68,73,141,Spen484_T,"-37.80896733, 144.94931703"
1791020251015,179,2025-10-15,10,40,25,65,Pow61_T,"-37.82392385, 144.96299677"
1652120241009,165,2024-10-09,21,30,20,50,Spen475_T,"-37.80953359, 144.94939004"
1671520241012,167,2024-10-12,15,11,24,35,Lat526_T,"-37.81304149, 144.95155955"
1671820250521,167,2025-05-21,18,16,34,50,Lat526_T,"-37.81304149, 144.95155955"
134020250809,134,2025-08-09,0,144,82,226,Spen201_T,"-37.81694221, 144.95303935"
1322220240214,132,2024-02-14,22,81,125,206,King335_T,"-37.81267639, 144.95386444"
1311820241222,131,2024-12-22,18,150,88,238,King2_T,"-37.82009057, 144.95758725"
67720240810,67,2024-08-10,7,62,45,107,FLDegS_T,"-37.81688755, 144.96562569"
68720240404,68,2024-04-04,7,29,14,43,FLDegN_T,"-37.8168479, 144.96559789"
68720241223,68,2024-12-23,7,60,50,110,FLDegN_T,"-37.8168479, 144.96559789"
85720240128,85,2024-01-28,7,5,9,14,488Mac_T,"-37.79432415, 144.92973378"
62020240201,62,2024-02-01,0,61,60,121,Lat224_T,"-37.80996494, 144.96216521"
24620241027,24,2024-10-27,6,63,95,158,Col620_T,"-37.81887963, 144.95449198"
10820240708,10,2024-07-08,8,87,173,260,BouHbr_T,"-37.81876474, 144.94710545"
22020240218,2,2024-02-18,20,107,165,272,Bou283_T,"-37.81380668, 144.96516718"
35420250702,35,2025-07-02,4,4,2,6,SouthB_T,"-37.82018685, 144.96508508"
35520231020,35,2023-10-20,5,79,54,133,SouthB_T,"-37.82018685, 144.96508508"
58620241116,58,2024-11-16,6,40,44,84,Bou688_T,"-37.81686075, 144.95358075"
531520231229,53,2023-12-29,15,868,660,1528,Col254_T,"-37.81564191, 144.965499"
531520250625,53,2025-06-25,15,446,321,767,Col254_T,"-37.81564191, 144.965499"
79420250829,79,2025-08-29,4,17,22,39,FliSS_T,"-37.81794046, 144.96616678"
531620250831,53,2025-08-31,16,379,263,642,Col254_T,"-37.81564191, 144.965499"
191520231224,19,2023-12-24,15,591,628,1219,LtB210_T,"-37.81237202, 144.96550671"
19320240815,19,2024-08-15,3,10,11,21,LtB210_T,"-37.81237202, 144.96550671"
251520250221,25,2025-02-21,15,773,524,1297,MCEC_T,"-37.82401776, 144.95604426"
52620240817,52,2024-08-17,6,9,11,20,Eli263_T,"-37.81252157, 144.9619401"
1412120240709,141,2024-07-09,21,42,23,65,474Fl_T,"-37.81997273, 144.95834911"
1391920250920,139,2025-09-20,19,20,31,51,Signal1647_T,"-37.81959923, 144.9632832"
136920240602,136,2024-06-02,9,109,102,211,BirFed1120_T,"-37.8184141, 144.97357915"
164620241026,164,2024-10-26,6,9,5,14,Lat526_T,"-37.813005, 144.95160411"
1381620240126,138,2024-01-26,16,6,13,19,EntPark1671_T,"-37.81996544, 144.95981454"
1802320250602,180,2025-06-02,23,5,9,14,Mac330_T,"-37.79497059, 144.93530329"
661120250410,66,2025-04-10,11,785,1068,1853,QVN_T,"-37.81057846, 144.96444294"
691020240110,69,2024-01-10,10,187,140,327,FLDegC_T,"-37.81687226, 144.96559144"
69920250221,69,2025-02-21,9,232,125,357,FLDegC_T,"-37.81687226, 144.96559144"
84720240604,84,2024-06-04,7,660,237,897,ElFi_T,"-37.81798049, 144.96503383"
70720240607,70,2024-06-07,7,21,24,45,Errol20_T,"-37.80456984, 144.94946228"
521720250507,52,2025-05-07,17,406,331,737,Eli263_T,"-37.81252157, 144.9619401"
461920241004,46,2024-10-04,19,6,1,7,Pel147_T,"-37.80240719, 144.9615673"
51920250308,51,2025-03-08,9,81,92,173,Fra118_T,"-37.80841815, 144.95906316"
481320250106,48,2025-01-06,13,91,98,189,QVMQ_T,"-37.80631581, 144.95866697"
20920250831,20,2025-08-31,9,43,56,99,LtB170_T,"-37.81172914, 144.9682466"
137220231114,137,2023-11-14,2,1,1,2,BouHbr2353_T,"-37.81894815, 144.94612292"
1361220231103,136,2023-11-03,12,49,50,99,BirFed1120_T,"-37.8184141, 144.97357915"
1301020241114,130,2024-11-14,10,69,21,90,Bou892T,"-37.8204637, 144.94126826"
1301420250903,130,2025-09-03,14,67,49,116,Bou892T,"-37.8204637, 144.94126826"
1232320240906,123,2024-09-06,23,8,1,9,BirBridge_T,"-37.81753741, 144.97329734"
1171620240610,117,2024-06-10,16,92,114,206,Fli114F_T,"-37.81629332, 144.97090877"
117320240818,117,2024-08-18,3,12,9,21,Fli114F_T,"-37.81629332, 144.97090877"
109620241014,109,2024-10-14,6,26,97,123,LatWill_T,"-37.81193681, 144.95621105"
69320250320,69,2025-03-20,3,2,6,8,FLDegC_T,"-37.81687226, 144.96559144"
662320240614,66,2024-06-14,23,322,344,666,QVN_T,"-37.81057846, 144.96444294"
39120250306,39,2025-03-06,1,2,2,4,AlfPl_T,"-37.81379749, 144.96995745"
109720240502,109,2024-05-02,7,41,312,353,LatWill_T,"-37.81193681, 144.95621105"
11420240831,1,2024-08-31,14,1581,1441,3022,Bou292_T,"-37.81349441, 144.96515323"
1320241011,1,2024-10-11,3,6,17,23,Bou292_T,"-37.81349441, 144.96515323"
67220240423,67,2024-04-23,2,7,6,13,FLDegS_T,"-37.81688755, 144.96562569"
63220250917,63,2025-09-17,2,5,21,26,Bou231_T,"-37.81333081, 144.96675571"
122120231127,12,2023-11-27,21,165,145,310,NewQ_T,"-37.81457988, 144.94292398"
681120250820,68,2025-08-20,11,291,240,531,FLDegN_T,"-37.8168479, 144.96559789"
861920250817,86,2025-08-17,19,25,20,45,574Qub_T,"-37.80309992, 144.94908064"
72620240224,72,2024-02-24,6,19,42,61,ACMI_T,"-37.81726338, 144.96872809"
352220231231,35,2023-12-31,22,2466,2762,5228,SouthB_T,"-37.82018685, 144.96508508"
791120241123,79,2024-11-23,11,402,305,707,FliSS_T,"-37.81794046, 144.96616678"
92220241015,9,2024-10-15,22,55,22,77,Col700_T,"-37.81982992, 144.95102555"
92120241215,9,2024-12-15,21,35,38,73,Col700_T,"-37.81982992, 144.95102555"
91320250129,9,2025-01-29,13,400,501,901,Col700_T,"-37.81982992, 144.95102555"
53720240519,53,2024-05-19,7,29,19,48,Col254_T,"-37.81564191, 144.965499"
532020240118,53,2024-01-18,20,204,254,458,Col254_T,"-37.81564191, 144.965499"
231120241130,23,2024-11-30,11,157,161,318,Col623_T,"-37.81909256, 144.95452748"
232020240823,23,2024-08-23,20,90,184,274,Col623_T,"-37.81909256, 144.95452748"
30120250106,30,2025-01-06,1,98,52,150,Lon189_T,"-37.8112185, 144.96656806"
52220241219,52,2024-12-19,2,4,17,21,Eli263_T,"-37.81252157, 144.9619401"
521420250111,52,2025-01-11,14,314,286,600,Eli263_T,"-37.81252157, 144.9619401"
51720250130,51,2025-01-30,7,31,33,64,Fra118_T,"-37.80841815, 144.95906316"
49720251013,49,2025-10-13,7,56,80,136,Eli501_T,"-37.80730068, 144.95956055"
19820250105,19,2025-01-05,8,23,19,42,LtB210_T,"-37.81237202, 144.96550671"
462020250331,46,2025-03-31,20,1,0,1,Pel147_T,"-37.80240719, 144.9615673"
201420250910,20,2025-09-10,14,163,220,383,LtB170_T,"-37.81172914, 144.9682466"
1361920240726,136,2024-07-26,19,2,1,3,BirFed1120_T,"-37.8184141, 144.97357915"
1302120241007,130,2024-10-07,21,1,4,5,Bou892T,"-37.8204637, 144.94126826"
130620241129,130,2024-11-29,6,6,4,10,Bou892T,"-37.8204637, 144.94126826"
161620250907,161,2025-09-07,6,10,10,20,BirArt1109_T,"-37.81851276, 144.97131336"
1641720250228,164,2025-02-28,17,132,114,246,Lat526_T,"-37.813005, 144.95160411"
161720250112,161,2025-01-12,7,129,84,213,BirArt1109_T,"-37.81851276, 144.97131336"
411320231106,41,2023-11-06,13,1875,1537,3412,Swa31,"-37.81668634, 144.96689733"
3720240730,3,2024-07-30,7,75,161,236,Swa295_T,"-37.81101524, 144.96429485"
82220240502,8,2024-05-02,22,13,12,25,WebBN_T,"-37.82293543, 144.9471751"
8720250309,8,2025-03-09,7,28,89,117,WebBN_T,"-37.82293543, 144.9471751"
751320241122,75,2024-11-22,13,77,48,125,SprFli_T,"-37.81515276, 144.97467661"
78920250305,78,2025-03-05,9,38,29,67,HarEsB_T,"-37.81471642, 144.9446508"
41820240623,41,2024-06-23,8,28,21,49,Swa31,"-37.81668634, 144.96689733"
411320250111,41,2025-01-11,13,1761,1397,3158,Swa31,"-37.81668634, 144.96689733"
421120240823,42,2024-08-23,11,342,343,685,UM1_T,"-37.80008566, 144.96386412"
77220240227,77,2024-02-27,2,2,0,2,HarEsP_T,"-37.81441438, 144.94433026"
59820231102,59,2023-11-02,8,295,187,482,RMIT_T,"-37.80825648, 144.96304859"
591120240424,59,2024-04-24,11,1125,1077,2202,RMIT_T,"-37.80825648, 144.96304859"
281520240203,28,2024-02-03,15,951,958,1909,VAC_T,"-37.82129925, 144.96879309"
14520241218,14,2024-12-18,5,54,26,80,SanBri_T,"-37.82011242, 144.96291897"
54220240728,54,2024-07-28,2,29,9,38,Swa607_T,"-37.804024, 144.96308399"
54520251005,54,2025-10-05,5,7,5,12,Swa607_T,"-37.804024, 144.96308399"
36120241025,36,2024-10-25,1,8,11,19,Que85_T,"-37.81652527, 144.96121062"
431120240417,43,2024-04-17,11,266,216,482,UM2_T,"-37.79844526, 144.96411782"
1072220250708,107,2025-07-08,22,44,24,68,280Will_T,"-37.81246271, 144.95690188"
1341120231126,134,2023-11-26,11,329,340,669,Spen201_T,"-37.81694221, 144.95303935"
1321920250817,132,2025-08-17,19,97,131,228,King335_T,"-37.81267639, 144.95386444"
1071120240428,107,2024-04-28,11,80,83,163,280Will_T,"-37.81246271, 144.95690188"
108020250623,108,2025-06-23,0,22,18,40,261Will_T,"-37.81295822, 144.95678789"
1181320250305,118,2025-03-05,13,18,18,36,Fli114C_T,"-37.81632783, 144.97090512"
1821420250908,182,2025-09-08,14,161,175,336,King163_T,"-37.81627451, 144.95550503"
1851420250717,185,2025-07-17,14,793,854,1647,Eli197_T,"-37.81374643, 144.96276183"
165520250817,165,2025-08-17,5,2,0,2,Spen475_T,"-37.80953359, 144.94939004"
165020240923,165,2024-09-23,0,3,2,5,Spen475_T,"-37.80953359, 144.94939004"
1661720241201,166,2024-12-01,17,68,75,143,Spen484_T,"-37.80896733, 144.94931703"
1311220250417,131,2025-04-17,12,155,178,333,King2_T,"-37.82009057, 144.95758725"
652220231206,65,2023-12-06,22,393,337,730,SwaCs_T,"-37.81569416, 144.9668064"
71620241106,71,2024-11-06,6,17,14,31,WestWP_T,"-37.81235775, 144.97136962"
141920240407,14,2024-04-07,19,290,113,403,SanBri_T,"-37.82011242, 144.96291897"
14420250405,14,2025-04-05,4,33,5,38,SanBri_T,"-37.82011242, 144.96291897"
141920250709,14,2025-07-09,19,29,17,46,SanBri_T,"-37.82011242, 144.96291897"
31120250216,31,2025-02-16,1,20,39,59,Lyg161_T,"-37.80169681, 144.96658911"
541520241015,54,2024-10-15,15,158,227,385,Swa607_T,"-37.804024, 144.96308399"
281520250101,28,2025-01-01,15,1003,1065,2068,VAC_T,"-37.82129925, 144.96879309"
471920250314,47,2025-03-14,19,936,768,1704,Eli250_T,"-37.81258467, 144.9625775"
311520231214,31,2023-12-14,15,106,84,190,Lyg161_T,"-37.80169681, 144.96658911"
431520250503,43,2025-05-03,15,96,95,191,UM2_T,"-37.79844526, 144.96411782"
45320240802,45,2024-08-02,3,28,30,58,Swa148_T,"-37.81414075, 144.96609379"
442220250203,44,2025-02-03,22,1,11,12,UM3_T,"-37.79698741, 144.96441306"
451620240121,45,2024-01-21,16,685,952,1637,Swa148_T,"-37.81414075, 144.96609379"
1071420250930,107,2025-09-30,14,166,131,297,280Will_T,"-37.81246271, 144.95690188"
1072120241231,107,2024-12-31,21,464,865,1329,280Will_T,"-37.81246271, 144.95690188"
87520250822,87,2025-08-22,5,3,4,7,Errol23_T,"-37.80454949, 144.94921863"
108120231101,108,2023-11-01,1,7,16,23,261Will_T,"-37.81295822, 144.95678789"
872020240110,87,2024-01-10,20,82,78,160,Errol23_T,"-37.80454949, 144.94921863"
162320250508,162,2025-05-08,3,8,4,12,Eli489_T,"-37.80740397, 144.95987909"
1311520241013,131,2024-10-13,15,227,110,337,King2_T,"-37.82009057, 144.95758725"
141320241007,141,2024-10-07,3,8,10,18,474Fl_T,"-37.81997273, 144.95834911"
141720241207,141,2024-12-07,7,45,13,58,474Fl_T,"-37.81997273, 144.95834911"
1412120250525,141,2025-05-25,21,29,105,134,474Fl_T,"-37.81997273, 144.95834911"
139020250902,139,2025-09-02,0,1,3,4,Signal1647_T,"-37.81959923, 144.9632832"
142020250906,142,2025-09-06,0,1,0,1,Hammer1584_T,"-37.81970749, 144.96795734"
123620250830,123,2025-08-30,6,7,6,13,BirBridge_T,"-37.81753741, 144.97329734"
1231020250910,123,2025-09-10,10,16,15,31,BirBridge_T,"-37.81753741, 144.97329734"
49220250531,49,2025-05-31,2,49,43,92,Eli501_T,"-37.80730068, 144.95956055"
109820250214,109,2025-02-14,8,89,408,497,LatWill_T,"-37.81193681, 144.95621105"
109320250614,109,2025-06-14,3,6,2,8,LatWill_T,"-37.81193681, 144.95621105"
1091620250115,109,2025-01-15,16,305,125,430,LatWill_T,"-37.81193681, 144.95621105"
67620240131,67,2024-01-31,6,96,34,130,FLDegS_T,"-37.81688755, 144.96562569"
682220250117,68,2025-01-17,22,106,110,216,FLDegN_T,"-37.8168479, 144.96559789"
85920240108,85,2024-01-08,9,57,51,108,488Mac_T,"-37.79432415, 144.92973378"
851820250318,85,2025-03-18,18,58,126,184,488Mac_T,"-37.79432415, 144.92973378"
851520250429,85,2025-04-29,15,49,89,138,488Mac_T,"-37.79432415, 144.92973378"
11220241127,1,2024-11-27,12,1485,1265,2750,Bou292_T,"-37.81349441, 144.96515323"
632020240629,63,2024-06-29,20,189,237,426,Bou231_T,"-37.81333081, 144.96675571"
18920240316,18,2024-03-16,9,32,64,96,Col12_T,"-37.81344862, 144.97305353"
682120240114,68,2024-01-14,21,58,14,72,FLDegN_T,"-37.8168479, 144.96559789"
62620240731,62,2024-07-31,6,112,21,133,Lat224_T,"-37.80996494, 144.96216521"
241720240710,24,2024-07-10,17,686,2773,3459,Col620_T,"-37.81887963, 144.95449198"
581920250222,58,2025-02-22,19,381,227,608,Bou688_T,"-37.81686075, 144.95358075"
76720240922,76,2024-09-22,7,16,9,25,KenMac_T,"-37.79453803, 144.93036194"
761720250503,76,2025-05-03,17,76,56,132,KenMac_T,"-37.79453803, 144.93036194"
35520240917,35,2024-09-17,5,68,52,120,SouthB_T,"-37.82018685, 144.96508508"
35820240129,35,2024-01-29,8,537,1703,2240,SouthB_T,"-37.82018685, 144.96508508"
761920240326,76,2024-03-26,19,27,68,95,KenMac_T,"-37.79453803, 144.93036194"
21220240722,2,2024-07-22,12,651,701,1352,Bou283_T,"-37.81380668, 144.96516718"
53120240209,53,2024-02-09,1,13,10,23,Col254_T,"-37.81564191, 144.965499"
531720240427,53,2024-04-27,17,492,411,903,Col254_T,"-37.81564191, 144.965499"
23820250524,23,2025-05-24,8,99,86,185,Col623_T,"-37.81909256, 144.95452748"
192220240828,19,2024-08-28,22,141,269,410,LtB210_T,"-37.81237202, 144.96550671"
30920250925,30,2025-09-25,9,76,121,197,Lon189_T,"-37.8112185, 144.96656806"
251020250409,25,2025-04-09,10,154,461,615,MCEC_T,"-37.82401776, 144.95604426"
52320250306,52,2025-03-06,3,5,9,14,Eli263_T,"-37.81252157, 144.9619401"
52820231123,52,2023-11-23,8,168,364,532,Eli263_T,"-37.81252157, 144.9619401"
52720240328,52,2024-03-28,7,70,98,168,Eli263_T,"-37.81252157, 144.9619401"
66620250824,66,2025-08-24,6,21,25,46,QVN_T,"-37.81057846, 144.96444294"
61520241119,6,2024-11-19,15,1133,768,1901,FliS_T,"-37.81911705, 144.96558255"
70720250729,70,2025-07-29,7,28,21,49,Errol20_T,"-37.80456984, 144.94946228"
75420231103,75,2023-11-03,4,3,4,7,SprFli_T,"-37.81515276, 144.97467661"
75420250203,75,2025-02-03,4,1,0,1,SprFli_T,"-37.81515276, 144.97467661"
661420240715,66,2024-07-15,14,779,798,1577,QVN_T,"-37.81057846, 144.96444294"
69020250801,69,2025-08-01,0,1,2,3,FLDegC_T,"-37.81687226, 144.96559144"
841820240825,84,2024-08-25,18,481,719,1200,ElFi_T,"-37.81798049, 144.96503383"
661120240108,66,2024-01-08,11,123,113,236,QVN_T,"-37.81057846, 144.96444294"
4520240708,4,2024-07-08,5,21,14,35,Swa123_T,"-37.81487988, 144.9660878"
701420240329,70,2024-03-29,14,149,160,309,Errol20_T,"-37.80456984, 144.94946228"
391520250819,39,2025-08-19,15,90,61,151,AlfPl_T,"-37.81379749, 144.96995745"
75920240417,75,2024-04-17,9,46,31,77,SprFli_T,"-37.81515276, 144.97467661"
75520250202,75,2025-02-02,5,1,2,3,SprFli_T,"-37.81515276, 144.97467661"
781820240925,78,2024-09-25,18,6,24,30,HarEsB_T,"-37.81471642, 144.9446508"
77220250530,77,2025-05-30,2,5,2,7,HarEsP_T,"-37.81441438, 144.94433026"
77020250708,77,2025-07-08,0,20,9,29,HarEsP_T,"-37.81441438, 144.94433026"
77220240615,77,2024-06-15,2,3,1,4,HarEsP_T,"-37.81441438, 144.94433026"
591720250819,59,2025-08-19,17,1274,1602,2876,RMIT_T,"-37.80825648, 144.96304859"
28420241007,28,2024-10-07,4,3,23,26,VAC_T,"-37.82129925, 144.96879309"
311420240628,31,2024-06-28,14,133,139,272,Lyg161_T,"-37.80169681, 144.96658911"
541620240511,54,2024-05-11,16,165,161,326,Swa607_T,"-37.804024, 144.96308399"
54920231029,54,2023-10-29,9,50,57,107,Swa607_T,"-37.804024, 144.96308399"
47320241129,47,2024-11-29,3,34,8,42,Eli250_T,"-37.81258467, 144.9625775"
311720250712,31,2025-07-12,17,349,215,564,Lyg161_T,"-37.80169681, 144.96658911"
211020250128,21,2025-01-28,10,156,106,262,Bourke155_T,"-37.81267313, 144.96788288"
45820250414,45,2025-04-14,8,241,347,588,Swa148_T,"-37.81414075, 144.96609379"
45720250818,45,2025-08-18,7,113,128,241,Swa148_T,"-37.81414075, 144.96609379"
107120250331,107,2025-03-31,1,7,17,24,280Will_T,"-37.81246271, 144.95690188"
107620250810,107,2025-08-10,6,9,21,30,280Will_T,"-37.81246271, 144.95690188"
1341720231029,134,2023-10-29,17,459,310,769,Spen201_T,"-37.81694221, 144.95303935"
1072020240813,107,2024-08-13,20,110,54,164,280Will_T,"-37.81246271, 144.95690188"
108620250404,108,2025-04-04,6,44,201,245,261Will_T,"-37.81295822, 144.95678789"
87220250513,87,2025-05-13,2,1,0,1,Errol23_T,"-37.80454949, 144.94921863"
61120241005,61,2024-10-05,1,90,24,114,RMIT14_T,"-37.80767455, 144.96309114"
165620250713,165,2025-07-13,6,2,3,5,Spen475_T,"-37.80953359, 144.94939004"
1651920250825,165,2025-08-25,19,25,5,30,Spen475_T,"-37.80953359, 144.94939004"
166420250116,166,2025-01-16,4,1,1,2,Spen484_T,"-37.80896733, 144.94931703"
162820250704,162,2025-07-04,8,176,143,319,Eli489_T,"-37.80740397, 144.95987909"
1401220250305,140,2025-03-05,12,109,58,167,Boyd2837_T,"-37.82590962, 144.96185972"
1401420250801,140,2025-08-01,14,103,82,185,Boyd2837_T,"-37.82590962, 144.96185972"
132120240605,132,2024-06-05,1,13,15,28,King335_T,"-37.81267639, 144.95386444"
85220231109,85,2023-11-09,2,0,1,1,488Mac_T,"-37.79432415, 144.92973378"
851920250404,85,2025-04-04,19,91,84,175,488Mac_T,"-37.79432415, 144.92973378"
17920241124,17,2024-11-24,9,30,25,55,Col15_T,"-37.81362543, 144.97323591"
1020241014,1,2024-10-14,0,28,23,51,Bou292_T,"-37.81349441, 144.96515323"
631420250803,63,2025-08-03,14,502,573,1075,Bou231_T,"-37.81333081, 144.96675571"
861120241214,86,2024-12-14,11,73,72,145,574Qub_T,"-37.80309992, 144.94908064"
112120231213,11,2023-12-13,21,79,93,172,WatCit_T,"-37.81564989, 144.93970694"
62720240311,62,2024-03-11,7,22,19,41,Lat224_T,"-37.80996494, 144.96216521"
1920251001,1,2025-10-01,9,346,443,789,Bou292_T,"-37.81349441, 144.96515323"
241720240503,24,2024-05-03,17,931,1557,2488,Col620_T,"-37.81887963, 144.95449198"
10320250726,10,2025-07-26,3,1,2,3,BouHbr_T,"-37.81876474, 144.94710545"
21020240203,2,2024-02-03,10,329,408,737,Bou283_T,"-37.81380668, 144.96516718"
1311220250709,131,2025-07-09,12,189,214,403,King2_T,"-37.82009057, 144.95758725"
143920250313,143,2025-03-13,9,133,292,425,Spencer_T,"-37.821728, 144.95557015"
1321720241126,132,2024-11-26,17,223,167,390,King335_T,"-37.81267639, 144.95386444"
1081320250113,108,2025-01-13,13,487,413,900,261Will_T,"-37.81295822, 144.95678789"
1341220240620,134,2024-06-20,12,412,407,819,Spen201_T,"-37.81694221, 144.95303935"
134320231019,134,2023-10-19,3,14,14,28,Spen201_T,"-37.81694221, 144.95303935"
871120250402,87,2025-04-02,11,107,77,184,Errol23_T,"-37.80454949, 144.94921863"
1651520250514,165,2025-05-14,15,41,38,79,Spen475_T,"-37.80953359, 144.94939004"
166820241002,166,2024-10-02,8,24,44,68,Spen484_T,"-37.80896733, 144.94931703"
1672220250227,167,2025-02-27,22,13,27,40,Lat526_T,"-37.81304149, 144.95155955"
1812220250728,181,2025-07-28,22,341,277,618,Eli368_T,"-37.81009465, 144.96143149"
672120231108,67,2023-11-08,21,82,217,299,FLDegS_T,"-37.81688755, 144.96562569"
671820231202,67,2023-12-02,18,358,422,780,FLDegS_T,"-37.81688755, 144.96562569"
17920240401,17,2024-04-01,9,134,104,238,Col15_T,"-37.81362543, 144.97323591"
172220250304,17,2025-03-04,22,60,65,125,Col15_T,"-37.81362543, 144.97323591"
671920250822,67,2025-08-22,19,389,418,807,FLDegS_T,"-37.81688755, 144.96562569"
631420250318,63,2025-03-18,14,361,465,826,Bou231_T,"-37.81333081, 144.96675571"
63520250617,63,2025-06-17,5,0,5,5,Bou231_T,"-37.81333081, 144.96675571"
671320240829,67,2024-08-29,13,519,767,1286,FLDegS_T,"-37.81688755, 144.96562569"
672320250605,67,2025-06-05,23,39,59,98,FLDegS_T,"-37.81688755, 144.96562569"
18920231125,18,2023-11-25,9,53,73,126,Col12_T,"-37.81344862, 144.97305353"
622220240113,62,2024-01-13,22,146,153,299,Lat224_T,"-37.80996494, 144.96216521"
241720241001,24,2024-10-01,17,593,2530,3123,Col620_T,"-37.81887963, 144.95449198"
241020231212,24,2023-12-12,10,563,356,919,Col620_T,"-37.81887963, 144.95449198"
582220240125,58,2024-01-25,22,264,199,463,Bou688_T,"-37.81686075, 144.95358075"
58220240827,58,2024-08-27,2,18,15,33,Bou688_T,"-37.81686075, 144.95358075"
58320231018,58,2023-10-18,3,1,6,7,Bou688_T,"-37.81686075, 144.95358075"
351320241025,35,2024-10-25,13,1118,1166,2284,SouthB_T,"-37.82018685, 144.96508508"
351920250128,35,2025-01-28,19,889,1046,1935,SouthB_T,"-37.82018685, 144.96508508"
352220240126,35,2024-01-26,22,912,1788,2700,SouthB_T,"-37.82018685, 144.96508508"
791520240227,79,2024-02-27,15,445,383,828,FliSS_T,"-37.81794046, 144.96616678"
51620241111,51,2024-11-11,6,14,14,28,Fra118_T,"-37.80841815, 144.95906316"
51720241123,51,2024-11-23,7,27,19,46,Fra118_T,"-37.80841815, 144.95906316"
252320250402,25,2025-04-02,23,58,59,117,MCEC_T,"-37.82401776, 144.95604426"
52620240706,52,2024-07-06,6,34,3,37,Eli263_T,"-37.81252157, 144.9619401"
521620240211,52,2024-02-11,16,281,334,615,Eli263_T,"-37.81252157, 144.9619401"
141720250827,141,2025-08-27,7,34,57,91,474Fl_T,"-37.81997273, 144.95834911"
1411520241120,141,2024-11-20,15,98,84,182,474Fl_T,"-37.81997273, 144.95834911"
142820240423,142,2024-04-23,8,202,223,425,Hammer1584_T,"-37.81970749, 144.96795734"
1611520240627,161,2024-06-27,15,124,139,263,BirArt1109_T,"-37.81851276, 144.97131336"
1611720241120,161,2024-11-20,17,265,230,495,BirArt1109_T,"-37.81851276, 144.97131336"
161620250113,161,2025-01-13,6,66,74,140,BirArt1109_T,"-37.81851276, 144.97131336"
49720250806,49,2025-08-06,7,44,79,123,Eli501_T,"-37.80730068, 144.95956055"
191020241223,19,2024-12-23,10,194,171,365,LtB210_T,"-37.81237202, 144.96550671"
691920241209,69,2024-12-09,19,72,46,118,FLDegC_T,"-37.81687226, 144.96559144"
61420240803,6,2024-08-03,14,873,909,1782,FliS_T,"-37.81911705, 144.96558255"
701920240803,70,2024-08-03,19,139,160,299,Errol20_T,"-37.80456984, 144.94946228"
701220250731,70,2025-07-31,12,158,162,320,Errol20_T,"-37.80456984, 144.94946228"
412220240914,41,2024-09-14,22,97,83,180,Swa31,"-37.81668634, 144.96689733"
41220240115,41,2024-01-15,2,66,50,116,Swa31,"-37.81668634, 144.96689733"
781120250625,78,2025-06-25,11,13,23,36,HarEsB_T,"-37.81471642, 144.9446508"
291620250626,29,2025-06-26,16,185,195,380,AG_T,"-37.8199817, 144.96872865"
291620240325,29,2024-03-25,16,299,315,614,AG_T,"-37.8199817, 144.96872865"
542020250219,54,2025-02-19,20,115,119,234,Swa607_T,"-37.804024, 144.96308399"
31720240129,31,2024-01-29,7,22,21,43,Lyg161_T,"-37.80169681, 144.96658911"
54820250413,54,2025-04-13,8,21,36,57,Swa607_T,"-37.804024, 144.96308399"
54820240111,54,2024-01-11,8,101,29,130,Swa607_T,"-37.804024, 144.96308399"
281120240617,28,2024-06-17,11,559,384,943,VAC_T,"-37.82129925, 144.96879309"
402020231218,40,2023-12-18,20,68,31,99,Spr201_T,"-37.80999341, 144.97227587"
361820240320,36,2024-03-20,18,243,218,461,Que85_T,"-37.81652527, 144.96121062"
36720240419,36,2024-04-19,7,84,65,149,Que85_T,"-37.81652527, 144.96121062"
37920250308,37,2025-03-08,9,42,41,83,Lyg260_T,"-37.80107122, 144.96704554"
371320240212,37,2024-02-12,13,112,126,238,Lyg260_T,"-37.80107122, 144.96704554"
501420240528,50,2024-05-28,14,151,117,268,Lyg309_T,"-37.79808192, 144.96721013"
44820241226,44,2024-12-26,8,8,2,10,UM3_T,"-37.79698741, 144.96441306"
44020250808,44,2025-08-08,0,8,0,8,UM3_T,"-37.79698741, 144.96441306"
5320250715,5,2025-07-15,3,17,12,29,PriNW_T,"-37.81874249, 144.96787656"
21020250920,21,2025-09-20,0,170,124,294,Bourke155_T,"-37.81267313, 144.96788288"
131420241118,131,2024-11-18,4,6,13,19,King2_T,"-37.82009057, 144.95758725"
861020240510,86,2024-05-10,10,34,28,62,574Qub_T,"-37.80309992, 144.94908064"
111420250514,11,2025-05-14,14,72,51,123,WatCit_T,"-37.81564989, 144.93970694"
351220240930,35,2024-09-30,12,1309,1174,2483,SouthB_T,"-37.82018685, 144.96508508"
35320240129,35,2024-01-29,3,18,18,36,SouthB_T,"-37.82018685, 144.96508508"
76720231208,76,2023-12-08,7,31,24,55,KenMac_T,"-37.79453803, 144.93036194"
272120241130,27,2024-11-30,21,144,54,198,Vic_T,"-37.80606888, 144.95644692"
30320240418,30,2024-04-18,3,20,53,73,Lon189_T,"-37.8112185, 144.96656806"
301720240514,30,2024-05-14,17,300,371,671,Lon189_T,"-37.8112185, 144.96656806"
20520250505,20,2025-05-05,5,6,2,8,LtB170_T,"-37.81172914, 144.9682466"
521020240207,52,2024-02-07,10,173,157,330,Eli263_T,"-37.81252157, 144.9619401"
511120231025,51,2023-10-25,11,97,50,147,Fra118_T,"-37.80841815, 144.95906316"
23220250613,23,2025-06-13,2,5,8,13,Col623_T,"-37.81909256, 144.95452748"
231320250126,23,2025-01-26,13,103,187,290,Col623_T,"-37.81909256, 144.95452748"
1171220241014,117,2024-10-14,12,161,188,349,Fli114F_T,"-37.81629332, 144.97090877"
1171520241111,117,2024-11-11,15,117,185,302,Fli114F_T,"-37.81629332, 144.97090877"
49620240527,49,2024-05-27,6,29,53,82,Eli501_T,"-37.80730068, 144.95956055"
1392020250614,139,2025-06-14,20,20,22,42,Signal1647_T,"-37.81959923, 144.9632832"
1641820241118,164,2024-11-18,18,116,139,255,Lat526_T,"-37.813005, 144.95160411"
62320241004,6,2024-10-04,23,557,402,959,FliS_T,"-37.81911705, 144.96558255"
84720240105,84,2024-01-05,7,286,193,479,ElFi_T,"-37.81798049, 144.96503383"
70820250420,70,2025-04-20,8,34,34,68,Errol20_T,"-37.80456984, 144.94946228"
41720240818,4,2024-08-18,17,1150,907,2057,Swa123_T,"-37.81487988, 144.9660878"
701620241119,70,2024-11-19,16,148,128,276,Errol20_T,"-37.80456984, 144.94946228"
391720240101,39,2024-01-01,17,34,16,50,AlfPl_T,"-37.81379749, 144.96995745"
3220251008,3,2025-10-08,2,50,34,84,Swa295_T,"-37.81101524, 144.96429485"
391520241016,39,2024-10-16,15,82,77,159,AlfPl_T,"-37.81379749, 144.96995745"
8820231107,8,2023-11-07,8,71,102,173,WebBN_T,"-37.82293543, 144.9471751"
81720240219,8,2024-02-19,17,254,353,607,WebBN_T,"-37.82293543, 144.9471751"
412320250121,41,2025-01-21,23,554,290,844,Swa31,"-37.81668634, 144.96689733"
77920250207,77,2025-02-07,9,91,97,188,HarEsP_T,"-37.81441438, 144.94433026"
14720231204,14,2023-12-04,7,198,177,375,SanBri_T,"-37.82011242, 144.96291897"
59320250904,59,2025-09-04,3,13,18,31,RMIT_T,"-37.80825648, 144.96304859"
591220240412,59,2024-04-12,12,1599,1894,3493,RMIT_T,"-37.80825648, 144.96304859"
141520241121,14,2024-11-21,15,413,153,566,SanBri_T,"-37.82011242, 144.96291897"
542320250613,54,2025-06-13,23,52,91,143,Swa607_T,"-37.804024, 144.96308399"
281820250715,28,2025-07-15,18,536,257,793,VAC_T,"-37.82129925, 144.96879309"
28520250429,28,2025-04-29,5,29,32,61,VAC_T,"-37.82129925, 144.96879309"
401320250908,40,2025-09-08,13,297,249,546,Spr201_T,"-37.80999341, 144.97227587"
311720240107,31,2024-01-07,17,147,111,258,Lyg161_T,"-37.80169681, 144.96658911"
51320240401,5,2024-04-01,13,1389,1339,2728,PriNW_T,"-37.81874249, 144.96787656"
5920241126,5,2024-11-26,9,235,537,772,PriNW_T,"-37.81874249, 144.96787656"
361720250119,36,2025-01-19,17,102,81,183,Que85_T,"-37.81652527, 144.96121062"
431920250729,43,2025-07-29,19,62,273,335,UM2_T,"-37.79844526, 144.96411782"
531820240411,53,2024-04-11,18,800,474,1274,Col254_T,"-37.81564191, 144.965499"
79820250904,79,2025-09-04,8,436,289,725,FliSS_T,"-37.81794046, 144.96616678"
20920240408,20,2024-04-08,9,39,58,97,LtB170_T,"-37.81172914, 144.9682466"
1412320240615,141,2024-06-15,23,103,100,203,474Fl_T,"-37.81997273, 144.95834911"
1361020240325,136,2024-03-25,10,87,58,145,BirFed1120_T,"-37.8184141, 144.97357915"
1302320250908,130,2025-09-08,23,2,0,2,Bou892T,"-37.8204637, 144.94126826"
1381720250724,138,2025-07-24,17,5,3,8,EntPark1671_T,"-37.81996544, 144.95981454"
123520241219,123,2024-12-19,5,1,0,1,BirBridge_T,"-37.81753741, 144.97329734"
123020250109,123,2025-01-09,0,1,0,1,BirBridge_T,"-37.81753741, 144.97329734"
1171420250423,117,2025-04-23,14,138,164,302,Fli114F_T,"-37.81629332, 144.97090877"
1091120231126,109,2023-11-26,11,93,69,162,LatWill_T,"-37.81193681, 144.95621105"
61020250812,6,2025-08-12,10,483,407,890,FliS_T,"-37.81911705, 144.96558255"
4720250408,4,2025-04-08,7,330,242,572,Swa123_T,"-37.81487988, 144.9660878"
3920240404,3,2024-04-04,9,236,387,623,Swa295_T,"-37.81101524, 144.96429485"
751020231122,75,2023-11-22,10,41,56,97,SprFli_T,"-37.81515276, 144.97467661"
851420240223,85,2024-02-23,14,58,57,115,488Mac_T,"-37.79432415, 144.92973378"
85420240801,85,2024-08-01,4,1,0,1,488Mac_T,"-37.79432415, 144.92973378"
18820240908,18,2024-09-08,8,19,27,46,Col12_T,"-37.81344862, 144.97305353"
631820250825,63,2025-08-25,18,46,162,208,Bou231_T,"-37.81333081, 144.96675571"
621920240912,62,2024-09-12,19,197,163,360,Lat224_T,"-37.80996494, 144.96216521"
56520240305,56,2024-03-05,5,12,10,22,Lon364_T,"-37.81234775, 144.96153311"
561720240821,56,2024-08-21,17,358,406,764,Lon364_T,"-37.81234775, 144.96153311"
10020250205,10,2025-02-05,0,0,3,3,BouHbr_T,"-37.81876474, 144.94710545"
27220250317,27,2025-03-17,2,4,0,4,Vic_T,"-37.80606888, 144.95644692"
30720240206,30,2024-02-06,7,49,62,111,Lon189_T,"-37.8112185, 144.96656806"
79920231019,79,2023-10-19,9,486,355,841,FliSS_T,"-37.81794046, 144.96616678"
481720240620,48,2024-06-20,17,131,161,292,QVMQ_T,"-37.80631581, 144.95866697"
48920231103,48,2023-11-03,9,149,129,278,QVMQ_T,"-37.80631581, 144.95866697"
46120240214,46,2024-02-14,1,2,0,2,Pel147_T,"-37.80240719, 144.9615673"
461720240613,46,2024-06-13,17,92,51,143,Pel147_T,"-37.80240719, 144.9615673"
251020240307,25,2024-03-07,10,193,399,592,MCEC_T,"-37.82401776, 144.95604426"
522020240716,52,2024-07-16,20,249,124,373,Eli263_T,"-37.81252157, 144.9619401"
461720250303,46,2025-03-03,17,105,203,308,Pel147_T,"-37.80240719, 144.9615673"
1372020231125,137,2023-11-25,20,6,6,12,BouHbr2353_T,"-37.81894815, 144.94612292"
1362020240505,136,2024-05-05,20,5,27,32,BirFed1120_T,"-37.8184141, 144.97357915"
1301620231221,130,2023-12-21,16,14,26,40,Bou892T,"-37.8204637, 144.94126826"
1301820231224,130,2023-12-24,18,11,14,25,Bou892T,"-37.8204637, 144.94126826"
130520250325,130,2025-03-25,5,1,0,1,Bou892T,"-37.8204637, 144.94126826"
1611020241115,161,2024-11-15,10,94,92,186,BirArt1109_T,"-37.81851276, 144.97131336"
1231520240529,123,2024-05-29,15,18,7,25,BirBridge_T,"-37.81753741, 144.97329734"
1091720250823,109,2025-08-23,17,88,146,234,LatWill_T,"-37.81193681, 144.95621105"
411820240118,41,2024-01-18,18,1730,1763,3493,Swa31,"-37.81668634, 144.96689733"
771520240608,77,2024-06-08,15,193,118,311,HarEsP_T,"-37.81441438, 144.94433026"
781420231101,78,2023-11-01,14,23,74,97,HarEsB_T,"-37.81471642, 144.9446508"
1671920250530,167,2025-05-30,19,12,52,64,Lat526_T,"-37.81304149, 144.95155955"
165820250924,165,2025-09-24,8,29,61,90,Spen475_T,"-37.80953359, 144.94939004"
1311220240702,131,2024-07-02,12,169,208,377,King2_T,"-37.82009057, 144.95758725"
132420240203,132,2024-02-03,4,9,3,12,King335_T,"-37.81267639, 144.95386444"
108220250505,108,2025-05-05,2,9,10,19,261Will_T,"-37.81295822, 144.95678789"
1331220231020,133,2023-10-20,12,526,553,1079,Spen229_T,"-37.81531435, 144.95227769"
1181920250301,118,2025-03-01,19,14,19,33,Fli114C_T,"-37.81632783, 144.97090512"
852120241120,85,2024-11-20,21,15,13,28,488Mac_T,"-37.79432415, 144.92973378"
11720250120,1,2025-01-20,17,1133,844,1977,Bou292_T,"-37.81349441, 144.96515323"
68020250920,68,2025-09-20,0,10,9,19,FLDegN_T,"-37.8168479, 144.96559789"
621420240621,62,2024-06-21,14,245,146,391,Lat224_T,"-37.80996494, 144.96216521"
56820250302,56,2025-03-02,8,87,65,152,Lon364_T,"-37.81234775, 144.96153311"
121320240801,12,2024-08-01,13,197,156,353,NewQ_T,"-37.81457988, 144.94292398"
10820240803,10,2024-08-03,8,23,21,44,BouHbr_T,"-37.81876474, 144.94710545"
10820240630,10,2024-06-30,8,13,7,20,BouHbr_T,"-37.81876474, 144.94710545"
721320231109,72,2023-11-09,13,237,299,536,ACMI_T,"-37.81726338, 144.96872809"
581020241014,58,2024-10-14,10,694,209,903,Bou688_T,"-37.81686075, 144.95358075"
58320240905,58,2024-09-05,3,10,11,21,Bou688_T,"-37.81686075, 144.95358075"
761220250821,76,2025-08-21,12,72,55,127,KenMac_T,"-37.79453803, 144.93036194"
271920231113,27,2023-11-13,19,78,40,118,Vic_T,"-37.80606888, 144.95644692"
532120240516,53,2024-05-16,21,123,171,294,Col254_T,"-37.81564191, 144.965499"
271420250103,27,2025-01-03,14,173,122,295,Vic_T,"-37.80606888, 144.95644692"
271220250523,27,2025-05-23,12,186,135,321,Vic_T,"-37.80606888, 144.95644692"
9520250625,9,2025-06-25,5,20,33,53,Col700_T,"-37.81982992, 144.95102555"
251820231020,25,2023-10-20,18,803,717,1520,MCEC_T,"-37.82401776, 144.95604426"
251620240628,25,2024-06-28,16,914,782,1696,MCEC_T,"-37.82401776, 144.95604426"
20420241023,20,2024-10-23,4,3,0,3,LtB170_T,"-37.81172914, 144.9682466"
51920241212,51,2024-12-12,9,61,46,107,Fra118_T,"-37.80841815, 144.95906316"
123820240802,123,2024-08-02,8,8,2,10,BirBridge_T,"-37.81753741, 144.97329734"
1231320250827,123,2025-08-27,13,92,33,125,BirBridge_T,"-37.81753741, 144.97329734"
117420240206,117,2024-02-06,4,4,2,6,Fli114F_T,"-37.81629332, 144.97090877"
1171120240809,117,2024-08-09,11,96,128,224,Fli114F_T,"-37.81629332, 144.97090877"
117120240910,117,2024-09-10,1,13,8,21,Fli114F_T,"-37.81629332, 144.97090877"
117620241026,117,2024-10-26,6,18,31,49,Fli114F_T,"-37.81629332, 144.97090877"
1171920241120,117,2024-11-20,19,145,219,364,Fli114F_T,"-37.81629332, 144.97090877"
117020250114,117,2025-01-14,0,59,69,128,Fli114F_T,"-37.81629332, 144.97090877"
1091120240704,109,2024-07-04,11,36,97,133,LatWill_T,"-37.81193681, 144.95621105"
491520240128,49,2024-01-28,15,291,459,750,Eli501_T,"-37.80730068, 144.95956055"
481520231122,48,2023-11-22,15,185,166,351,QVMQ_T,"-37.80631581, 144.95866697"
139120241204,139,2024-12-04,1,4,1,5,Signal1647_T,"-37.81959923, 144.9632832"
139120250107,139,2025-01-07,1,0,2,2,Signal1647_T,"-37.81959923, 144.9632832"
142120250322,142,2025-03-22,1,4,2,6,Hammer1584_T,"-37.81970749, 144.96795734"
41320240704,4,2024-07-04,13,1676,1543,3219,Swa123_T,"-37.81487988, 144.9660878"
701320240722,70,2024-07-22,13,159,142,301,Errol20_T,"-37.80456984, 144.94946228"
391220231222,39,2023-12-22,12,191,118,309,AlfPl_T,"-37.81379749, 144.96995745"
391320240806,39,2024-08-06,13,206,185,391,AlfPl_T,"-37.81379749, 144.96995745"
752220250302,75,2025-03-02,22,1,1,2,SprFli_T,"-37.81515276, 144.97467661"
751520250402,75,2025-04-02,15,53,52,105,SprFli_T,"-37.81515276, 144.97467661"
781520240201,78,2024-02-01,15,40,73,113,HarEsB_T,"-37.81471642, 144.9446508"
781420250201,78,2025-02-01,14,45,78,123,HarEsB_T,"-37.81471642, 144.9446508"
422020240913,42,2024-09-13,20,46,132,178,UM1_T,"-37.80008566, 144.96386412"
42920250322,42,2025-03-22,9,31,35,66,UM1_T,"-37.80008566, 144.96386412"
291420240526,29,2024-05-26,14,409,745,1154,AG_T,"-37.8199817, 144.96872865"
711020250306,71,2025-03-06,10,23,19,42,WestWP_T,"-37.81235775, 144.97136962"
59520240320,59,2024-03-20,5,28,18,46,RMIT_T,"-37.80825648, 144.96304859"
59120240928,59,2024-09-28,1,82,58,140,RMIT_T,"-37.80825648, 144.96304859"
541420241101,54,2024-11-01,14,117,116,233,Swa607_T,"-37.804024, 144.96308399"
54620250617,54,2025-06-17,6,13,12,25,Swa607_T,"-37.804024, 144.96308399"
472020240315,47,2024-03-15,20,732,630,1362,Eli250_T,"-37.81258467, 144.9625775"
401020250329,40,2025-03-29,10,255,85,340,Spr201_T,"-37.80999341, 144.97227587"
211820250926,21,2025-09-26,18,429,399,828,Bourke155_T,"-37.81267313, 144.96788288"
21620231127,21,2023-11-27,6,18,55,73,Bourke155_T,"-37.81267313, 144.96788288"
5820240307,5,2024-03-07,8,484,1123,1607,PriNW_T,"-37.81874249, 144.96787656"
871920231118,87,2023-11-18,19,87,78,165,Errol23_T,"-37.80454949, 144.94921863"
43220240830,43,2024-08-30,2,2,5,7,UM2_T,"-37.79844526, 144.96411782"
441220240519,44,2024-05-19,12,45,68,113,UM3_T,"-37.79698741, 144.96441306"
52020251010,5,2025-10-10,20,789,1063,1852,PriNW_T,"-37.81874249, 144.96787656"
451320231216,45,2023-12-16,13,225,234,459,Swa148_T,"-37.81414075, 144.96609379"
451220240112,45,2024-01-12,12,459,691,1150,Swa148_T,"-37.81414075, 144.96609379"
1341020240118,134,2024-01-18,10,372,463,835,Spen201_T,"-37.81694221, 144.95303935"
107620250101,107,2025-01-01,6,22,6,28,280Will_T,"-37.81246271, 144.95690188"
1332120231110,133,2023-11-10,21,476,324,800,Spen229_T,"-37.81531435, 144.95227769"
133520240306,133,2024-03-06,5,159,107,266,Spen229_T,"-37.81531435, 144.95227769"
1331020240525,133,2024-05-25,10,440,463,903,Spen229_T,"-37.81531435, 144.95227769"
1082320250207,108,2025-02-07,23,185,135,320,261Will_T,"-37.81295822, 144.95678789"
1791320250629,179,2025-06-29,13,56,48,104,Pow61_T,"-37.82392385, 144.96299677"
112320240819,11,2024-08-19,23,8,16,24,WatCit_T,"-37.81564989, 144.93970694"
12920250914,12,2025-09-14,9,137,114,251,NewQ_T,"-37.81457988, 144.94292398"
721620240203,72,2024-02-03,16,224,346,570,ACMI_T,"-37.81726338, 144.96872809"
761320240104,76,2024-01-04,13,65,68,133,KenMac_T,"-37.79453803, 144.93036194"
27820241204,27,2024-12-04,8,70,101,171,Vic_T,"-37.80606888, 144.95644692"
511720240420,51,2024-04-20,17,115,137,252,Fra118_T,"-37.80841815, 144.95906316"
30720240922,30,2024-09-22,7,33,55,88,Lon189_T,"-37.8112185, 144.96656806"
191720231222,19,2023-12-22,17,809,471,1280,LtB210_T,"-37.81237202, 144.96550671"
48820250919,48,2025-09-19,8,119,99,218,QVMQ_T,"-37.80631581, 144.95866697"
252220250521,25,2025-05-21,22,173,85,258,MCEC_T,"-37.82401776, 144.95604426"
20220240123,20,2024-01-23,2,5,3,8,LtB170_T,"-37.81172914, 144.9682466"
46920240914,46,2024-09-14,9,13,15,28,Pel147_T,"-37.80240719, 144.9615673"
46920250604,46,2025-06-04,9,123,34,157,Pel147_T,"-37.80240719, 144.9615673"
1421720250531,142,2025-05-31,17,454,368,822,Hammer1584_T,"-37.81970749, 144.96795734"
1381720240119,138,2024-01-19,17,9,4,13,EntPark1671_T,"-37.81996544, 144.95981454"
1611320250608,161,2025-06-08,13,273,97,370,BirArt1109_T,"-37.81851276, 144.97131336"
49620241001,49,2024-10-01,6,40,37,77,Eli501_T,"-37.80730068, 144.95956055"
109920241029,109,2024-10-29,9,74,406,480,LatWill_T,"-37.81193681, 144.95621105"
1091720241125,109,2024-11-25,17,442,137,579,LatWill_T,"-37.81193681, 144.95621105"
681620241009,68,2024-10-09,16,220,140,360,FLDegN_T,"-37.8168479, 144.96559789"
841720240825,84,2024-08-25,17,734,932,1666,ElFi_T,"-37.81798049, 144.96503383"
392320250209,39,2025-02-09,23,4,0,4,AlfPl_T,"-37.81379749, 144.96995745"
771120241228,77,2024-12-28,11,127,86,213,HarEsP_T,"-37.81441438, 144.94433026"
77520250823,77,2025-08-23,5,1,4,5,HarEsP_T,"-37.81441438, 144.94433026"
591920250111,59,2025-01-11,19,360,357,717,RMIT_T,"-37.80825648, 144.96304859"
312220240715,31,2024-07-15,22,12,45,57,Lyg161_T,"-37.80169681, 144.96658911"
292220250630,29,2025-06-30,22,25,48,73,AG_T,"-37.8199817, 144.96872865"
401620250410,40,2025-04-10,16,175,220,395,Spr201_T,"-37.80999341, 144.97227587"
471920240407,47,2024-04-07,19,554,586,1140,Eli250_T,"-37.81258467, 144.9625775"
211820250323,21,2025-03-23,18,418,474,892,Bourke155_T,"-37.81267313, 144.96788288"
51420240113,5,2024-01-13,14,1508,1926,3434,PriNW_T,"-37.81874249, 144.96787656"
372020240209,37,2024-02-09,20,252,244,496,Lyg260_T,"-37.80107122, 144.96704554"
872120250203,87,2025-02-03,21,14,27,41,Errol23_T,"-37.80454949, 144.94921863"
50620240526,50,2024-05-26,6,15,6,21,Lyg309_T,"-37.79808192, 144.96721013"
431920250901,43,2025-09-01,19,67,182,249,UM2_T,"-37.79844526, 144.96411782"
431620240322,43,2024-03-22,16,235,331,566,UM2_T,"-37.79844526, 144.96411782"
45920241018,45,2024-10-18,9,239,199,438,Swa148_T,"-37.81414075, 144.96609379"
45020241102,45,2024-11-02,0,93,195,288,Swa148_T,"-37.81414075, 144.96609379"
1401220231213,140,2023-12-13,12,121,73,194,Boyd2837_T,"-37.82590962, 144.96185972"
1401320240218,140,2024-02-18,13,130,98,228,Boyd2837_T,"-37.82590962, 144.96185972"
162020240814,162,2024-08-14,0,46,40,86,Eli489_T,"-37.80740397, 144.95987909"
143120241106,143,2024-11-06,1,57,25,82,Spencer_T,"-37.821728, 144.95557015"
133520240201,133,2024-02-01,5,72,100,172,Spen229_T,"-37.81531435, 144.95227769"
1081320241218,108,2024-12-18,13,442,504,946,261Will_T,"-37.81295822, 144.95678789"
1811920250829,181,2025-08-29,19,908,978,1886,Eli368_T,"-37.81009465, 144.96143149"
1791220250922,179,2025-09-22,12,40,53,93,Pow61_T,"-37.82392385, 144.96299677"
1672220250731,167,2025-07-31,22,19,10,29,Lat526_T,"-37.81304149, 144.95155955"
672220251015,67,2025-10-15,22,69,159,228,FLDegS_T,"-37.81688755, 144.96562569"
851920240731,85,2024-07-31,19,29,43,72,488Mac_T,"-37.79432415, 144.92973378"
17120240210,17,2024-02-10,1,28,29,57,Col15_T,"-37.81362543, 144.97323591"
171720250420,17,2025-04-20,17,158,128,286,Col15_T,"-37.81362543, 144.97323591"
68220250621,68,2025-06-21,2,2,2,4,FLDegN_T,"-37.8168479, 144.96559789"
181720241213,18,2024-12-13,17,483,147,630,Col12_T,"-37.81344862, 144.97305353"
63720240129,63,2024-01-29,7,61,64,125,Bou231_T,"-37.81333081, 144.96675571"
861420231121,86,2023-11-21,14,30,31,61,574Qub_T,"-37.80309992, 144.94908064"
671620240519,67,2024-05-19,16,209,363,572,FLDegS_T,"-37.81688755, 144.96562569"
242320240421,24,2024-04-21,23,84,148,232,Col620_T,"-37.81887963, 144.95449198"
102120240316,10,2024-03-16,21,63,31,94,BouHbr_T,"-37.81876474, 144.94710545"
352220240108,35,2024-01-08,22,338,440,778,SouthB_T,"-37.82018685, 144.96508508"
762220231129,76,2023-11-29,22,8,15,23,KenMac_T,"-37.79453803, 144.93036194"
2620250511,2,2025-05-11,6,9,8,17,Bou283_T,"-37.81380668, 144.96516718"
78320240407,78,2024-04-07,3,0,1,1,HarEsB_T,"-37.81471642, 144.9446508"
71020240901,71,2024-09-01,0,9,1,10,WestWP_T,"-37.81235775, 144.97136962"
711820250311,71,2025-03-11,18,10,20,30,WestWP_T,"-37.81235775, 144.97136962"
591620240318,59,2024-03-18,16,1451,2068,3519,RMIT_T,"-37.80825648, 144.96304859"
591020240505,59,2024-05-05,10,217,283,500,RMIT_T,"-37.80825648, 144.96304859"
291320231220,29,2023-12-20,13,269,416,685,AG_T,"-37.8199817, 144.96872865"
29620241128,29,2024-11-28,6,61,102,163,AG_T,"-37.8199817, 144.96872865"
29320240108,29,2024-01-08,3,2,0,2,AG_T,"-37.8199817, 144.96872865"
541320251001,54,2025-10-01,13,135,123,258,Swa607_T,"-37.804024, 144.96308399"
471520241010,47,2024-10-10,15,994,878,1872,Eli250_T,"-37.81258467, 144.9625775"
402120240128,40,2024-01-28,21,245,20,265,Spr201_T,"-37.80999341, 144.97227587"
51620240515,5,2024-05-15,16,1421,956,2377,PriNW_T,"-37.81874249, 144.96787656"
362120250623,36,2025-06-23,21,53,52,105,Que85_T,"-37.81652527, 144.96121062"
36920240430,36,2024-04-30,9,239,137,376,Que85_T,"-37.81652527, 144.96121062"
1081120241109,108,2024-11-09,11,107,127,234,261Will_T,"-37.81295822, 144.95678789"
871320250415,87,2025-04-15,13,140,141,281,Errol23_T,"-37.80454949, 144.94921863"
871420250920,87,2025-09-20,14,130,142,272,Errol23_T,"-37.80454949, 144.94921863"
871220231107,87,2023-11-07,12,137,115,252,Errol23_T,"-37.80454949, 144.94921863"
87820240313,87,2024-03-13,8,99,73,172,Errol23_T,"-37.80454949, 144.94921863"
61420240223,61,2024-02-23,4,14,10,24,RMIT14_T,"-37.80767455, 144.96309114"
451520250623,45,2025-06-23,15,387,579,966,Swa148_T,"-37.81414075, 144.96609379"
1661120241203,166,2024-12-03,11,6,6,12,Spen484_T,"-37.80896733, 144.94931703"
1661120250513,166,2025-05-13,11,46,42,88,Spen484_T,"-37.80896733, 144.94931703"
1671520241004,167,2024-10-04,15,46,51,97,Lat526_T,"-37.81304149, 144.95155955"
1652220240930,165,2024-09-30,22,8,2,10,Spen475_T,"-37.80953359, 144.94939004"
140720240804,140,2024-08-04,7,23,13,36,Boyd2837_T,"-37.82590962, 144.96185972"
108620250309,108,2025-03-09,6,13,11,24,261Will_T,"-37.81295822, 144.95678789"
1072220231218,107,2023-12-18,22,49,46,95,280Will_T,"-37.81246271, 144.95690188"
621420240414,62,2024-04-14,14,257,170,427,Lat224_T,"-37.80996494, 144.96216521"
241620240319,24,2024-03-19,16,506,2114,2620,Col620_T,"-37.81887963, 144.95449198"
12720240816,12,2024-08-16,7,74,73,147,NewQ_T,"-37.81457988, 144.94292398"
121520241011,12,2024-10-11,15,140,156,296,NewQ_T,"-37.81457988, 144.94292398"
122320240421,12,2024-04-21,23,28,21,49,NewQ_T,"-37.81457988, 144.94292398"
24220250716,24,2025-07-16,2,20,20,40,Col620_T,"-37.81887963, 144.95449198"
242320250117,24,2025-01-17,23,171,293,464,Col620_T,"-37.81887963, 144.95449198"
242320250220,24,2025-02-20,23,143,326,469,Col620_T,"-37.81887963, 144.95449198"
10820250214,10,2025-02-14,8,51,130,181,BouHbr_T,"-37.81876474, 144.94710545"
101220240113,10,2024-01-13,12,62,53,115,BouHbr_T,"-37.81876474, 144.94710545"
761820241117,76,2024-11-17,18,44,45,89,KenMac_T,"-37.79453803, 144.93036194"
2120250929,2,2025-09-29,1,3,12,15,Bou283_T,"-37.81380668, 144.96516718"
532120231103,53,2023-11-03,21,141,182,323,Col254_T,"-37.81564191, 144.965499"
30320250209,30,2025-02-09,3,119,190,309,Lon189_T,"-37.8112185, 144.96656806"
531920250626,53,2025-06-26,19,244,163,407,Col254_T,"-37.81564191, 144.965499"
252120240131,25,2024-01-31,21,186,179,365,MCEC_T,"-37.82401776, 144.95604426"
252020240814,25,2024-08-14,20,260,221,481,MCEC_T,"-37.82401776, 144.95604426"
522120241128,52,2024-11-28,21,277,240,517,Eli263_T,"-37.81252157, 144.9619401"
511620250901,51,2025-09-01,16,72,63,135,Fra118_T,"-37.80841815, 144.95906316"
22020250728,2,2025-07-28,20,95,155,250,Bou283_T,"-37.81380668, 144.96516718"
531720240324,53,2024-03-24,17,419,286,705,Col254_T,"-37.81564191, 144.965499"
23720250419,23,2025-04-19,7,55,73,128,Col623_T,"-37.81909256, 144.95452748"
30820240916,30,2024-09-16,8,100,95,195,Lon189_T,"-37.8112185, 144.96656806"
46920231027,46,2023-10-27,9,62,109,171,Pel147_T,"-37.80240719, 144.9615673"
201920240910,20,2024-09-10,19,259,314,573,LtB170_T,"-37.81172914, 144.9682466"
511620251005,51,2025-10-05,16,138,123,261,Fra118_T,"-37.80841815, 144.95906316"
1411820250309,141,2025-03-09,18,126,175,301,474Fl_T,"-37.81997273, 144.95834911"
142320240307,142,2024-03-07,3,3,1,4,Hammer1584_T,"-37.81970749, 144.96795734"
123820241001,123,2024-10-01,8,13,0,13,BirBridge_T,"-37.81753741, 144.97329734"
1232320250302,123,2025-03-02,23,9,5,14,BirBridge_T,"-37.81753741, 144.97329734"
117220241015,117,2024-10-15,2,7,0,7,Fli114F_T,"-37.81629332, 144.97090877"
191720240807,19,2024-08-07,17,660,441,1101,LtB210_T,"-37.81237202, 144.96550671"
692020240720,69,2024-07-20,20,46,18,64,FLDegC_T,"-37.81687226, 144.96559144"
691720250222,69,2025-02-22,17,145,177,322,FLDegC_T,"-37.81687226, 144.96559144"
841420240803,84,2024-08-03,14,1051,1364,2415,ElFi_T,"-37.81798049, 144.96503383"
4720231022,4,2023-10-22,7,86,57,143,Swa123_T,"-37.81487988, 144.9660878"
3720240227,3,2024-02-27,7,114,172,286,Swa295_T,"-37.81101524, 144.96429485"
41420250321,4,2025-03-21,14,1907,1577,3484,Swa123_T,"-37.81487988, 144.9660878"
391220250505,39,2025-05-05,12,253,154,407,AlfPl_T,"-37.81379749, 144.96995745"
751920241230,75,2024-12-30,19,40,14,54,SprFli_T,"-37.81515276, 144.97467661"
751020250527,75,2025-05-27,10,30,33,63,SprFli_T,"-37.81515276, 144.97467661"
412120241223,41,2024-12-23,21,1406,2656,4062,Swa31,"-37.81668634, 144.96689733"
142320240317,14,2024-03-17,23,181,42,223,SanBri_T,"-37.82011242, 144.96291897"
59920250921,59,2025-09-21,9,141,163,304,RMIT_T,"-37.80825648, 144.96304859"
311420241214,31,2024-12-14,14,196,210,406,Lyg161_T,"-37.80169681, 144.96658911"
312220250603,31,2025-06-03,22,24,47,71,Lyg161_T,"-37.80169681, 144.96658911"
311120240505,31,2024-05-05,11,125,57,182,Lyg161_T,"-37.80169681, 144.96658911"
28120250729,28,2025-07-29,1,12,1,13,VAC_T,"-37.82129925, 144.96879309"
28820250530,28,2025-05-30,8,335,217,552,VAC_T,"-37.82129925, 144.96879309"
40220240617,40,2024-06-17,2,3,2,5,Spr201_T,"-37.80999341, 144.97227587"
211320250905,21,2025-09-05,13,353,407,760,Bourke155_T,"-37.81267313, 144.96788288"
211720231125,21,2023-11-25,17,510,629,1139,Bourke155_T,"-37.81267313, 144.96788288"
361220250903,36,2025-09-03,12,328,299,627,Que85_T,"-37.81652527, 144.96121062"
37920231120,37,2023-11-20,9,30,33,63,Lyg260_T,"-37.80107122, 144.96704554"
131020250312,131,2025-03-12,0,21,20,41,King2_T,"-37.82009057, 144.95758725"
1431020241001,143,2024-10-01,10,108,176,284,Spencer_T,"-37.821728, 144.95557015"
135620250925,135,2025-09-25,6,72,85,157,Spen161_T,"-37.8172861, 144.95319102"
107920241125,107,2024-11-25,9,32,80,112,280Will_T,"-37.81246271, 144.95690188"
1332020250309,133,2025-03-09,20,442,371,813,Spen229_T,"-37.81531435, 144.95227769"
118820250711,118,2025-07-11,8,27,19,46,Fli114C_T,"-37.81632783, 144.97090512"
1082020240112,108,2024-01-12,20,136,117,253,261Will_T,"-37.81295822, 144.95678789"
179620250315,179,2025-03-15,6,6,2,8,Pow61_T,"-37.82392385, 144.96299677"
179820250328,179,2025-03-28,8,73,40,113,Pow61_T,"-37.82392385, 144.96299677"
1652320240915,165,2024-09-15,23,5,2,7,Spen475_T,"-37.80953359, 144.94939004"
852320240702,85,2024-07-02,23,2,0,2,488Mac_T,"-37.79432415, 144.92973378"
17320240808,17,2024-08-08,3,10,5,15,Col15_T,"-37.81362543, 144.97323591"
171720250902,17,2025-09-02,17,242,830,1072,Col15_T,"-37.81362543, 144.97323591"
11520240520,1,2024-05-20,15,954,784,1738,Bou292_T,"-37.81349441, 144.96515323"
11420250608,1,2025-06-08,14,1706,1656,3362,Bou292_T,"-37.81349441, 144.96515323"
631820240516,63,2024-05-16,18,262,353,615,Bou231_T,"-37.81333081, 144.96675571"
181420240827,18,2024-08-27,14,300,146,446,Col12_T,"-37.81344862, 144.97305353"
182320240226,18,2024-02-26,23,0,6,6,Col12_T,"-37.81344862, 144.97305353"
672320240802,67,2024-08-02,23,90,171,261,FLDegS_T,"-37.81688755, 144.96562569"
122120240522,12,2024-05-22,21,121,89,210,NewQ_T,"-37.81457988, 144.94292398"
72220250601,72,2025-06-01,2,1,10,11,ACMI_T,"-37.81726338, 144.96872809"
351620240120,35,2024-01-20,16,1643,2109,3752,SouthB_T,"-37.82018685, 144.96508508"
76520231101,76,2023-11-01,5,3,1,4,KenMac_T,"-37.79453803, 144.93036194"
76920240209,76,2024-02-09,9,97,84,181,KenMac_T,"-37.79453803, 144.93036194"
351820231021,35,2023-10-21,18,1867,2198,4065,SouthB_T,"-37.82018685, 144.96508508"
58520250312,58,2025-03-12,5,83,22,105,Bou688_T,"-37.81686075, 144.95358075"
92020240102,9,2024-01-02,20,37,25,62,Col700_T,"-37.81982992, 144.95102555"
791720250223,79,2025-02-23,17,374,449,823,FliSS_T,"-37.81794046, 144.96616678"
79620231125,79,2023-11-25,6,100,45,145,FliSS_T,"-37.81794046, 144.96616678"
53220240331,53,2024-03-31,2,22,31,53,Col254_T,"-37.81564191, 144.965499"
30120250702,30,2025-07-02,1,38,29,67,Lon189_T,"-37.8112185, 144.96656806"
48820250705,48,2025-07-05,8,98,107,205,QVMQ_T,"-37.80631581, 144.95866697"
202120250309,20,2025-03-09,21,212,411,623,LtB170_T,"-37.81172914, 144.9682466"
201020240214,20,2024-02-14,10,136,83,219,LtB170_T,"-37.81172914, 144.9682466"
521320250104,52,2025-01-04,13,288,255,543,Eli263_T,"-37.81252157, 144.9619401"
521720231214,52,2023-12-14,17,491,400,891,Eli263_T,"-37.81252157, 144.9619401"
491720250101,49,2025-01-01,17,171,128,299,Eli501_T,"-37.80730068, 144.95956055"
164520250211,164,2025-02-11,5,7,8,15,Lat526_T,"-37.813005, 144.95160411"
19620250507,19,2025-05-07,6,20,13,33,LtB210_T,"-37.81237202, 144.96550671"
1411020240726,141,2024-07-26,10,208,128,336,474Fl_T,"-37.81997273, 144.95834911"
1301520241024,130,2024-10-24,15,51,41,92,Bou892T,"-37.8204637, 144.94126826"
1231620250128,123,2025-01-28,16,26,35,61,BirBridge_T,"-37.81753741, 144.97329734"
1381020241124,138,2024-11-24,10,0,6,6,EntPark1671_T,"-37.81996544, 144.95981454"
1171920250715,117,2025-07-15,19,112,99,211,Fli114F_T,"-37.81629332, 144.97090877"
109620241024,109,2024-10-24,6,27,97,124,LatWill_T,"-37.81193681, 144.95621105"
66620240824,66,2024-08-24,6,17,20,37,QVN_T,"-37.81057846, 144.96444294"
692020231023,69,2023-10-23,20,46,21,67,FLDegC_T,"-37.81687226, 144.96559144"
691020250402,69,2025-04-02,10,195,175,370,FLDegC_T,"-37.81687226, 144.96559144"
6920240203,6,2024-02-03,9,458,331,789,FliS_T,"-37.81911705, 144.96558255"
62020250120,6,2025-01-20,20,660,611,1271,FliS_T,"-37.81911705, 144.96558255"
4920241016,4,2024-10-16,9,569,367,936,Swa123_T,"-37.81487988, 144.9660878"
701920250527,70,2025-05-27,19,89,163,252,Errol20_T,"-37.80456984, 144.94946228"
702120250924,70,2025-09-24,21,105,88,193,Errol20_T,"-37.80456984, 144.94946228"
31220250911,3,2025-09-11,12,1025,1202,2227,Swa295_T,"-37.81101524, 144.96429485"
75020250223,75,2025-02-23,0,3,4,7,SprFli_T,"-37.81515276, 144.97467661"
412120240508,41,2024-05-08,21,452,791,1243,Swa31,"-37.81668634, 144.96689733"
771820231023,77,2023-10-23,18,292,182,474,HarEsP_T,"-37.81441438, 144.94433026"
422320250424,42,2025-04-24,23,25,32,57,UM1_T,"-37.80008566, 144.96386412"
421920250824,42,2025-08-24,19,42,52,94,UM1_T,"-37.80008566, 144.96386412"
591320241015,59,2024-10-15,13,1009,1010,2019,RMIT_T,"-37.80825648, 144.96304859"
311520231126,31,2023-11-26,15,374,374,748,Lyg161_T,"-37.80169681, 144.96658911"
311420240429,31,2024-04-29,14,129,141,270,Lyg161_T,"-37.80169681, 144.96658911"
281220250324,28,2025-03-24,12,814,783,1597,VAC_T,"-37.82129925, 144.96879309"
281420250518,28,2025-05-18,14,909,1464,2373,VAC_T,"-37.82129925, 144.96879309"
291420250110,29,2025-01-10,14,248,358,606,AG_T,"-37.8199817, 144.96872865"
471920240122,47,2024-01-22,19,626,477,1103,Eli250_T,"-37.81258467, 144.9625775"
21420250307,21,2025-03-07,4,4,18,22,Bourke155_T,"-37.81267313, 144.96788288"
21920250710,21,2025-07-10,9,109,83,192,Bourke155_T,"-37.81267313, 144.96788288"
51220241229,5,2024-12-29,12,1315,2256,3571,PriNW_T,"-37.81874249, 144.96787656"
51220250402,5,2025-04-02,12,822,1060,1882,PriNW_T,"-37.81874249, 144.96787656"
371020250831,37,2025-08-31,10,64,71,135,Lyg260_T,"-37.80107122, 144.96704554"
1311920241109,131,2024-11-09,19,163,107,270,King2_T,"-37.82009057, 144.95758725"
167020241103,167,2024-11-03,0,6,17,23,Lat526_T,"-37.81304149, 144.95155955"
401620231220,40,2023-12-20,16,150,192,342,Spr201_T,"-37.80999341, 144.97227587"
40020240220,40,2024-02-20,0,3,2,5,Spr201_T,"-37.80999341, 144.97227587"
21220250723,21,2025-07-23,2,9,3,12,Bourke155_T,"-37.81267313, 144.96788288"
211920250108,21,2025-01-08,19,365,376,741,Bourke155_T,"-37.81267313, 144.96788288"
1081120241125,108,2024-11-25,11,98,135,233,261Will_T,"-37.81295822, 144.95678789"
871120240816,87,2024-08-16,11,88,86,174,Errol23_T,"-37.80454949, 144.94921863"
87720231219,87,2023-12-19,7,29,30,59,Errol23_T,"-37.80454949, 144.94921863"
44020240515,44,2024-05-15,0,2,1,3,UM3_T,"-37.79698741, 144.96441306"
1401520240921,140,2024-09-21,15,109,93,202,Boyd2837_T,"-37.82590962, 144.96185972"
1401120241027,140,2024-10-27,11,145,86,231,Boyd2837_T,"-37.82590962, 144.96185972"
1321420240601,132,2024-06-01,14,169,127,296,King335_T,"-37.81267639, 144.95386444"
132620240604,132,2024-06-04,6,18,11,29,King335_T,"-37.81267639, 144.95386444"
1321920250309,132,2025-03-09,19,139,146,285,King335_T,"-37.81267639, 144.95386444"
134520231122,134,2023-11-22,5,44,44,88,Spen201_T,"-37.81694221, 144.95303935"
134420250529,134,2025-05-29,4,13,7,20,Spen201_T,"-37.81694221, 144.95303935"
1331620250812,133,2025-08-12,16,406,458,864,Spen229_T,"-37.81531435, 144.95227769"
131320241016,131,2024-10-16,3,7,5,12,King2_T,"-37.82009057, 144.95758725"
1311620231022,131,2023-10-22,16,126,51,177,King2_T,"-37.82009057, 144.95758725"
1332220250313,133,2025-03-13,22,341,228,569,Spen229_T,"-37.81531435, 144.95227769"
133520240621,133,2024-06-21,5,42,53,95,Spen229_T,"-37.81531435, 144.95227769"
1331920240727,133,2024-07-27,19,399,314,713,Spen229_T,"-37.81531435, 144.95227769"
172320231109,17,2023-11-09,23,36,37,73,Col15_T,"-37.81362543, 144.97323591"
17120250921,17,2025-09-21,1,13,36,49,Col15_T,"-37.81362543, 144.97323591"
1620240814,1,2024-08-14,6,26,55,81,Bou292_T,"-37.81349441, 144.96515323"
621420240206,62,2024-02-06,14,228,187,415,Lat224_T,"-37.80996494, 144.96216521"
561020250206,56,2025-02-06,10,266,167,433,Lon364_T,"-37.81234775, 144.96153311"
86420241209,86,2024-12-09,4,1,3,4,574Qub_T,"-37.80309992, 144.94908064"
861920251006,86,2025-10-06,19,29,63,92,574Qub_T,"-37.80309992, 144.94908064"
121220240310,12,2024-03-10,12,69,44,113,NewQ_T,"-37.81457988, 144.94292398"
12720250816,12,2025-08-16,7,29,28,57,NewQ_T,"-37.81457988, 144.94292398"
56020250528,56,2025-05-28,0,9,14,23,Lon364_T,"-37.81234775, 144.96153311"
72420231216,72,2023-12-16,4,23,25,48,ACMI_T,"-37.81726338, 144.96872809"
581720240709,58,2024-07-09,17,568,1102,1670,Bou688_T,"-37.81686075, 144.95358075"
352020240110,35,2024-01-10,20,1017,1444,2461,SouthB_T,"-37.82018685, 144.96508508"
76720240414,76,2024-04-14,7,8,8,16,KenMac_T,"-37.79453803, 144.93036194"
582320250501,58,2025-05-01,23,228,231,459,Bou688_T,"-37.81686075, 144.95358075"
2420250129,2,2025-01-29,4,3,5,8,Bou283_T,"-37.81380668, 144.96516718"
792220250228,79,2025-02-28,22,387,447,834,FliSS_T,"-37.81794046, 144.96616678"
79120241108,79,2024-11-08,1,19,24,43,FliSS_T,"-37.81794046, 144.96616678"
791720240116,79,2024-01-16,17,1058,683,1741,FliSS_T,"-37.81794046, 144.96616678"
23020250824,23,2025-08-24,0,40,89,129,Col623_T,"-37.81909256, 144.95452748"
25420250824,25,2025-08-24,4,6,8,14,MCEC_T,"-37.82401776, 144.95604426"
201620240929,20,2024-09-29,16,342,281,623,LtB170_T,"-37.81172914, 144.9682466"
20920231029,20,2023-10-29,9,48,47,95,LtB170_T,"-37.81172914, 144.9682466"
141320231213,141,2023-12-13,3,6,12,18,474Fl_T,"-37.81997273, 144.95834911"
1362020240909,136,2024-09-09,20,1,0,1,BirFed1120_T,"-37.8184141, 144.97357915"
1421220240824,142,2024-08-24,12,506,574,1080,Hammer1584_T,"-37.81970749, 144.96795734"
1611020240818,161,2024-08-18,10,164,187,351,BirArt1109_T,"-37.81851276, 144.97131336"
1641820241015,164,2024-10-15,18,78,100,178,Lat526_T,"-37.813005, 144.95160411"
1381420240527,138,2024-05-27,14,6,7,13,EntPark1671_T,"-37.81996544, 144.95981454"
492220250323,49,2025-03-23,22,120,82,202,Eli501_T,"-37.80730068, 144.95956055"
49520231107,49,2023-11-07,5,20,28,48,Eli501_T,"-37.80730068, 144.95956055"
691520240503,69,2024-05-03,15,175,186,361,FLDegC_T,"-37.81687226, 144.96559144"
51120240616,51,2024-06-16,1,12,8,20,Fra118_T,"-37.80841815, 144.95906316"
232120241013,23,2024-10-13,21,68,175,243,Col623_T,"-37.81909256, 144.95452748"
130820250208,130,2025-02-08,8,69,17,86,Bou892T,"-37.8204637, 144.94126826"
117020240530,117,2024-05-30,0,20,6,26,Fli114F_T,"-37.81629332, 144.97090877"
1171320241220,117,2024-12-20,13,165,132,297,Fli114F_T,"-37.81629332, 144.97090877"
191220231116,19,2023-11-16,12,432,400,832,LtB210_T,"-37.81237202, 144.96550671"
19420240403,19,2024-04-03,4,9,5,14,LtB210_T,"-37.81237202, 144.96550671"
1371920240519,137,2024-05-19,19,1,1,2,BouHbr2353_T,"-37.81894815, 144.94612292"
161820250227,161,2025-02-27,8,126,186,312,BirArt1109_T,"-37.81851276, 144.97131336"
1642120241128,164,2024-11-28,21,67,105,172,Lat526_T,"-37.813005, 144.95160411"
1381920240112,138,2024-01-12,19,5,8,13,EntPark1671_T,"-37.81996544, 144.95981454"
1381120250405,138,2025-04-05,11,5,9,14,EntPark1671_T,"-37.81996544, 144.95981454"
111120240217,11,2024-02-17,11,114,134,248,WatCit_T,"-37.81564989, 144.93970694"
691420250711,69,2025-07-11,14,325,379,704,FLDegC_T,"-37.81687226, 144.96559144"
8920241004,8,2024-10-04,9,154,105,259,WebBN_T,"-37.82293543, 144.9471751"
781220240423,78,2024-04-23,12,37,39,76,HarEsB_T,"-37.81471642, 144.9446508"
781020240309,78,2024-03-09,10,20,78,98,HarEsB_T,"-37.81471642, 144.9446508"
291520240731,29,2024-07-31,15,199,351,550,AG_T,"-37.8199817, 144.96872865"
291920240809,29,2024-08-09,19,109,243,352,AG_T,"-37.8199817, 144.96872865"
141520250811,14,2025-08-11,15,392,134,526,SanBri_T,"-37.82011242, 144.96291897"
28320241230,28,2024-12-30,3,4,18,22,VAC_T,"-37.82129925, 144.96879309"
471220241119,47,2024-11-19,12,858,1010,1868,Eli250_T,"-37.81258467, 144.9625775"
311420250220,31,2025-02-20,14,142,149,291,Lyg161_T,"-37.80169681, 144.96658911"
52120250811,5,2025-08-11,21,1086,355,1441,PriNW_T,"-37.81874249, 144.96787656"
611120241102,61,2024-11-02,11,366,429,795,RMIT14_T,"-37.80767455, 144.96309114"
50920240618,50,2024-06-18,9,68,94,162,Lyg309_T,"-37.79808192, 144.96721013"
43420250531,43,2025-05-31,4,2,0,2,UM2_T,"-37.79844526, 144.96411782"
451220250802,45,2025-08-02,12,641,902,1543,Swa148_T,"-37.81414075, 144.96609379"
1081520250325,108,2025-03-25,15,698,249,947,261Will_T,"-37.81295822, 144.95678789"
1352220250124,135,2025-01-24,22,224,157,381,Spen161_T,"-37.8172861, 144.95319102"
135420240521,135,2024-05-21,4,7,5,12,Spen161_T,"-37.8172861, 144.95319102"
1071520250731,107,2025-07-31,15,128,109,237,280Will_T,"-37.81246271, 144.95690188"
107220231222,107,2023-12-22,2,5,3,8,280Will_T,"-37.81246271, 144.95690188"
133820240121,133,2024-01-21,8,251,311,562,Spen229_T,"-37.81531435, 144.95227769"
69620240508,69,2024-05-08,6,18,14,32,FLDegC_T,"-37.81687226, 144.96559144"
69420250103,69,2025-01-03,4,1,0,1,FLDegC_T,"-37.81687226, 144.96559144"
691220250421,69,2025-04-21,12,316,198,514,FLDegC_T,"-37.81687226, 144.96559144"
6220231125,6,2023-11-25,2,134,50,184,FliS_T,"-37.81911705, 144.96558255"
84420250822,84,2025-08-22,4,10,16,26,ElFi_T,"-37.81798049, 144.96503383"
4220240807,4,2024-08-07,2,7,4,11,Swa123_T,"-37.81487988, 144.9660878"
701920240129,70,2024-01-29,19,128,136,264,Errol20_T,"-37.80456984, 144.94946228"
39820250717,39,2025-07-17,8,78,109,187,AlfPl_T,"-37.81379749, 144.96995745"
392020240612,39,2024-06-12,20,22,33,55,AlfPl_T,"-37.81379749, 144.96995745"
391020241001,39,2024-10-01,10,84,86,170,AlfPl_T,"-37.81379749, 144.96995745"
81820240218,8,2024-02-18,18,211,132,343,WebBN_T,"-37.82293543, 144.9471751"
41420250622,41,2025-06-22,4,52,96,148,Swa31,"-37.81668634, 144.96689733"
412020250114,41,2025-01-14,20,958,798,1756,Swa31,"-37.81668634, 144.96689733"
71320251003,71,2025-10-03,3,2,2,4,WestWP_T,"-37.81235775, 144.97136962"
712120250106,71,2025-01-06,21,1,1,2,WestWP_T,"-37.81235775, 144.97136962"
591520240116,59,2024-01-16,15,429,520,949,RMIT_T,"-37.80825648, 144.96304859"
281820251001,28,2025-10-01,18,390,366,756,VAC_T,"-37.82129925, 144.96879309"
541120240612,54,2024-06-12,11,86,113,199,Swa607_T,"-37.804024, 144.96308399"
28520250427,28,2025-04-27,5,19,10,29,VAC_T,"-37.82129925, 144.96879309"
402120240514,40,2024-05-14,21,74,43,117,Spr201_T,"-37.80999341, 144.97227587"
40820250311,40,2025-03-11,8,267,333,600,Spr201_T,"-37.80999341, 144.97227587"
542020250116,54,2025-01-16,20,121,80,201,Swa607_T,"-37.804024, 144.96308399"
472020241004,47,2024-10-04,20,734,468,1202,Eli250_T,"-37.81258467, 144.9625775"
1661420250922,166,2025-09-22,14,39,47,86,Spen484_T,"-37.80896733, 144.94931703"
167820250516,167,2025-05-16,8,32,95,127,Lat526_T,"-37.81304149, 144.95155955"
1431420250619,143,2025-06-19,14,126,159,285,Spencer_T,"-37.821728, 144.95557015"
134920240810,134,2024-08-10,9,313,272,585,Spen201_T,"-37.81694221, 144.95303935"
134920250417,134,2025-04-17,9,347,435,782,Spen201_T,"-37.81694221, 144.95303935"
1181820250916,118,2025-09-16,18,13,38,51,Fli114C_T,"-37.81632783, 144.97090512"
44820241025,44,2024-10-25,8,44,48,92,UM3_T,"-37.79698741, 144.96441306"
1852020251004,185,2025-10-04,20,599,718,1317,Eli197_T,"-37.81374643, 144.96276183"
1662320250626,166,2025-06-26,23,1,4,5,Spen484_T,"-37.80896733, 144.94931703"
1071720231104,107,2023-11-04,17,95,139,234,280Will_T,"-37.81246271, 144.95690188"
1432320240423,143,2024-04-23,23,16,5,21,Spencer_T,"-37.821728, 144.95557015"
1432020240804,143,2024-08-04,20,142,110,252,Spencer_T,"-37.821728, 144.95557015"
135220250925,135,2025-09-25,2,6,9,15,Spen161_T,"-37.8172861, 144.95319102"
124720250317,124,2025-03-17,7,3,4,7,BirBridge_T,"-37.81757416, 144.97329934"
107620250317,107,2025-03-17,6,8,37,45,280Will_T,"-37.81246271, 144.95690188"
672120250523,67,2025-05-23,21,211,394,605,FLDegS_T,"-37.81688755, 144.96562569"
85920231022,85,2023-10-22,9,64,36,100,488Mac_T,"-37.79432415, 144.92973378"
112320231114,11,2023-11-14,23,22,117,139,WatCit_T,"-37.81564989, 144.93970694"
111620240513,11,2024-05-13,16,61,83,144,WatCit_T,"-37.81564989, 144.93970694"
10020231221,10,2023-12-21,0,0,4,4,BouHbr_T,"-37.81876474, 144.94710545"
721020240830,72,2024-08-30,10,202,194,396,ACMI_T,"-37.81726338, 144.96872809"
851920240516,85,2024-05-16,19,38,54,92,488Mac_T,"-37.79432415, 144.92973378"
172120240311,17,2024-03-11,21,45,56,101,Col15_T,"-37.81362543, 144.97323591"
17720240528,17,2024-05-28,7,495,104,599,Col15_T,"-37.81362543, 144.97323591"
11720250223,1,2025-02-23,17,1209,969,2178,Bou292_T,"-37.81349441, 144.96515323"
682020250918,68,2025-09-18,20,126,57,183,FLDegN_T,"-37.8168479, 144.96559789"
12520250330,12,2025-03-30,5,4,2,6,NewQ_T,"-37.81457988, 144.94292398"
35120250204,35,2025-02-04,1,22,27,49,SouthB_T,"-37.82018685, 144.96508508"
76820231029,76,2023-10-29,8,22,25,47,KenMac_T,"-37.79453803, 144.93036194"
9820240216,9,2024-02-16,8,84,1883,1967,Col700_T,"-37.81982992, 144.95102555"
30620240723,30,2024-07-23,6,18,31,49,Lon189_T,"-37.8112185, 144.96656806"
301220240331,30,2024-03-31,12,246,378,624,Lon189_T,"-37.8112185, 144.96656806"
9720250118,9,2025-01-18,7,27,27,54,Col700_T,"-37.81982992, 144.95102555"
252020231229,25,2023-12-29,20,1092,505,1597,MCEC_T,"-37.82401776, 144.95604426"
252120240305,25,2024-03-05,21,152,167,319,MCEC_T,"-37.82401776, 144.95604426"
201020240422,20,2024-04-22,10,88,122,210,LtB170_T,"-37.81172914, 144.9682466"
521020240923,52,2024-09-23,10,180,115,295,Eli263_T,"-37.81252157, 144.9619401"
23520250313,23,2025-03-13,5,30,34,64,Col623_T,"-37.81909256, 144.95452748"
232120241220,23,2024-12-20,21,152,184,336,Col623_T,"-37.81909256, 144.95452748"
1231720250907,123,2025-09-07,17,64,38,102,BirBridge_T,"-37.81753741, 144.97329734"
141720241217,141,2024-12-17,7,39,34,73,474Fl_T,"-37.81997273, 144.95834911"
482220240711,48,2024-07-11,22,32,48,80,QVMQ_T,"-37.80631581, 144.95866697"
30220251013,30,2025-10-13,2,29,22,51,Lon189_T,"-37.8112185, 144.96656806"
137720250823,137,2025-08-23,7,4,2,6,BouHbr2353_T,"-37.81894815, 144.94612292"
61420241216,6,2024-12-16,14,705,597,1302,FliS_T,"-37.81911705, 144.96558255"
84720240821,84,2024-08-21,7,731,206,937,ElFi_T,"-37.81798049, 144.96503383"
41420250829,4,2025-08-29,14,1186,1150,2336,Swa123_T,"-37.81487988, 144.9660878"
781220241208,78,2024-12-08,12,76,74,150,HarEsB_T,"-37.81471642, 144.9446508"
412220250612,41,2025-06-12,22,380,633,1013,Swa31,"-37.81668634, 144.96689733"
711720240430,71,2024-04-30,17,17,28,45,WestWP_T,"-37.81235775, 144.97136962"
591720250827,59,2025-08-27,17,1209,1414,2623,RMIT_T,"-37.80825648, 144.96304859"
28120241005,28,2024-10-05,1,25,13,38,VAC_T,"-37.82129925, 144.96879309"
29020240830,29,2024-08-30,0,13,50,63,AG_T,"-37.8199817, 144.96872865"
542020240929,54,2024-09-29,20,90,105,195,Swa607_T,"-37.804024, 144.96308399"
21720231026,21,2023-10-26,7,62,84,146,Bourke155_T,"-37.81267313, 144.96788288"
212320231209,21,2023-12-09,23,466,421,887,Bourke155_T,"-37.81267313, 144.96788288"
1661820250918,166,2025-09-18,18,69,82,151,Spen484_T,"-37.80896733, 144.94931703"
1792020251006,179,2025-10-06,20,59,67,126,Pow61_T,"-37.82392385, 144.96299677"
167720240912,167,2024-09-12,7,8,50,58,Lat526_T,"-37.81304149, 144.95155955"
135420240624,135,2024-06-24,4,5,8,13,Spen161_T,"-37.8172861, 144.95319102"
133820231218,133,2023-12-18,8,487,432,919,Spen229_T,"-37.81531435, 144.95227769"
1081820250825,108,2025-08-25,18,573,131,704,261Will_T,"-37.81295822, 144.95678789"
851220250409,85,2025-04-09,12,130,118,248,488Mac_T,"-37.79432415, 144.92973378"
241020250807,24,2025-08-07,10,788,294,1082,Col620_T,"-37.81887963, 144.95449198"
351720240808,35,2024-08-08,17,1908,1275,3183,SouthB_T,"-37.82018685, 144.96508508"
351820250923,35,2025-09-23,18,1005,971,1976,SouthB_T,"-37.82018685, 144.96508508"
2920240705,2,2024-07-05,9,135,232,367,Bou283_T,"-37.81380668, 144.96516718"
2720240823,2,2024-08-23,7,47,66,113,Bou283_T,"-37.81380668, 144.96516718"
91420231209,9,2023-12-09,14,95,95,190,Col700_T,"-37.81982992, 144.95102555"
79120231030,79,2023-10-30,1,20,24,44,FliSS_T,"-37.81794046, 144.96616678"
53920240811,53,2024-08-11,9,218,161,379,Col254_T,"-37.81564191, 144.965499"
512120240118,51,2024-01-18,21,61,45,106,Fra118_T,"-37.80841815, 144.95906316"
25520240120,25,2024-01-20,5,9,16,25,MCEC_T,"-37.82401776, 144.95604426"
1301520240605,130,2024-06-05,15,13,23,36,Bou892T,"-37.8204637, 144.94126826"
1301320240724,130,2024-07-24,13,21,43,64,Bou892T,"-37.8204637, 144.94126826"
1092120231027,109,2023-10-27,21,119,107,226,LatWill_T,"-37.81193681, 144.95621105"
164020250723,164,2025-07-23,0,9,6,15,Lat526_T,"-37.813005, 144.95160411"
692020231219,69,2023-12-19,20,37,44,81,FLDegC_T,"-37.81687226, 144.96559144"
841620240607,84,2024-06-07,16,984,1436,2420,ElFi_T,"-37.81798049, 144.96503383"
661920231105,66,2023-11-05,19,1049,876,1925,QVN_T,"-37.81057846, 144.96444294"
42120250329,4,2025-03-29,21,1157,1231,2388,Swa123_T,"-37.81487988, 144.9660878"
8720250425,8,2025-04-25,7,51,62,113,WebBN_T,"-37.82293543, 144.9471751"
42520240804,42,2024-08-04,5,0,1,1,UM1_T,"-37.80008566, 144.96386412"
781820231022,78,2023-10-22,18,22,49,71,HarEsB_T,"-37.81471642, 144.9446508"
141220241220,14,2024-12-20,12,290,118,408,SanBri_T,"-37.82011242, 144.96291897"
422320250912,42,2025-09-12,23,23,26,49,UM1_T,"-37.80008566, 144.96386412"
281920240815,28,2024-08-15,19,531,242,773,VAC_T,"-37.82129925, 144.96879309"
291820250428,29,2025-04-28,18,130,153,283,AG_T,"-37.8199817, 144.96872865"
292220240110,29,2024-01-10,22,73,140,213,AG_T,"-37.8199817, 144.96872865"
40620250202,40,2025-02-02,6,6,8,14,Spr201_T,"-37.80999341, 144.97227587"
45720250325,45,2025-03-25,7,100,215,315,Swa148_T,"-37.81414075, 144.96609379"
211420240402,21,2024-04-02,14,410,491,901,Bourke155_T,"-37.81267313, 144.96788288"
5320250915,5,2025-09-15,3,29,16,45,PriNW_T,"-37.81874249, 144.96787656"
108420231118,108,2023-11-18,4,10,7,17,261Will_T,"-37.81295822, 144.95678789"
61520241024,61,2024-10-24,5,15,24,39,RMIT14_T,"-37.80767455, 144.96309114"
871520231104,87,2023-11-04,15,67,64,131,Errol23_T,"-37.80454949, 144.94921863"
871820240113,87,2024-01-13,18,109,72,181,Errol23_T,"-37.80454949, 144.94921863"
49120241201,49,2024-12-01,1,49,64,113,Eli501_T,"-37.80730068, 144.95956055"
491820241231,49,2024-12-31,18,214,188,402,Eli501_T,"-37.80730068, 144.95956055"
117920241002,117,2024-10-02,9,182,98,280,Fli114F_T,"-37.81629332, 144.97090877"
109820240810,109,2024-08-10,8,21,50,71,LatWill_T,"-37.81193681, 144.95621105"
19020250323,19,2025-03-23,0,200,268,468,LtB210_T,"-37.81237202, 144.96550671"
191620250622,19,2025-06-22,16,709,484,1193,LtB210_T,"-37.81237202, 144.96550671"
1802220250821,180,2025-08-21,22,1,2,3,Mac330_T,"-37.79497059, 144.93530329"
61620250120,6,2025-01-20,16,1587,742,2329,FliS_T,"-37.81911705, 144.96558255"
4220250120,4,2025-01-20,2,27,16,43,Swa123_T,"-37.81487988, 144.9660878"
81620240509,8,2024-05-09,16,152,392,544,WebBN_T,"-37.82293543, 144.9471751"
77020250519,77,2025-05-19,0,19,5,24,HarEsP_T,"-37.81441438, 144.94433026"
14720250505,14,2025-05-05,7,172,216,388,SanBri_T,"-37.82011242, 144.96291897"
591920231029,59,2023-10-29,19,451,357,808,RMIT_T,"-37.80825648, 144.96304859"
59920231228,59,2023-12-28,9,94,166,260,RMIT_T,"-37.80825648, 144.96304859"
65120231128,65,2023-11-28,1,7,16,23,SwaCs_T,"-37.81569416, 144.9668064"
65920231210,65,2023-12-10,9,243,211,454,SwaCs_T,"-37.81569416, 144.9668064"
291620240915,29,2024-09-15,16,370,465,835,AG_T,"-37.8199817, 144.96872865"
40920250611,40,2025-06-11,9,161,206,367,Spr201_T,"-37.80999341, 144.97227587"
452120251007,45,2025-10-07,21,165,569,734,Swa148_T,"-37.81414075, 144.96609379"
51620250528,5,2025-05-28,16,103,184,287,PriNW_T,"-37.81874249, 144.96787656"
211720231120,21,2023-11-20,17,484,474,958,Bourke155_T,"-37.81267313, 144.96788288"
362120251008,36,2025-10-08,21,90,137,227,Que85_T,"-37.81652527, 144.96121062"
12320240508,1,2024-05-08,23,40,37,77,Bou292_T,"-37.81349441, 144.96515323"
11720241113,1,2024-11-13,17,1678,1114,2792,Bou292_T,"-37.81349441, 144.96515323"
182220240112,18,2024-01-12,22,15,11,26,Col12_T,"-37.81344862, 144.97305353"
181620250123,18,2025-01-23,16,498,138,636,Col12_T,"-37.81344862, 144.97305353"
631320250727,63,2025-07-27,13,384,407,791,Bou231_T,"-37.81333081, 144.96675571"
62420240603,62,2024-06-03,4,23,18,41,Lat224_T,"-37.80996494, 144.96216521"
56920240709,56,2024-07-09,9,182,122,304,Lon364_T,"-37.81234775, 144.96153311"
12520240924,12,2024-09-24,5,11,8,19,NewQ_T,"-37.81457988, 144.94292398"
12320240423,12,2024-04-23,3,1,7,8,NewQ_T,"-37.81457988, 144.94292398"
11720251015,11,2025-10-15,7,77,66,143,WatCit_T,"-37.81564989, 144.93970694"
121520250804,12,2025-08-04,15,90,121,211,NewQ_T,"-37.81457988, 144.94292398"
72520240603,72,2024-06-03,5,29,36,65,ACMI_T,"-37.81726338, 144.96872809"
24020251015,24,2025-10-15,0,49,57,106,Col620_T,"-37.81887963, 144.95449198"
761520250712,76,2025-07-12,15,42,44,86,KenMac_T,"-37.79453803, 144.93036194"
58920231027,58,2023-10-27,9,792,169,961,Bou688_T,"-37.81686075, 144.95358075"
351420241124,35,2024-11-24,14,924,1122,2046,SouthB_T,"-37.82018685, 144.96508508"
761520240410,76,2024-04-10,15,53,47,100,KenMac_T,"-37.79453803, 144.93036194"
35120250921,35,2025-09-21,1,99,130,229,SouthB_T,"-37.82018685, 144.96508508"
27020250720,27,2025-07-20,0,34,10,44,Vic_T,"-37.80606888, 144.95644692"
9820231210,9,2023-12-10,8,45,21,66,Col700_T,"-37.81982992, 144.95102555"
27020240926,27,2024-09-26,0,11,8,19,Vic_T,"-37.80606888, 144.95644692"
30820241123,30,2024-11-23,8,33,99,132,Lon189_T,"-37.8112185, 144.96656806"
301220240607,30,2024-06-07,12,316,429,745,Lon189_T,"-37.8112185, 144.96656806"
9720250904,9,2025-09-04,7,86,1108,1194,Col700_T,"-37.81982992, 144.95102555"
532320250915,53,2025-09-15,23,15,27,42,Col254_T,"-37.81564191, 144.965499"
9520251013,9,2025-10-13,5,19,26,45,Col700_T,"-37.81982992, 144.95102555"
20420240308,20,2024-03-08,4,32,25,57,LtB170_T,"-37.81172914, 144.9682466"
521620240530,52,2024-05-30,16,345,244,589,Eli263_T,"-37.81252157, 144.9619401"
511720240109,51,2024-01-09,17,104,75,179,Fra118_T,"-37.80841815, 144.95906316"
23120240405,23,2024-04-05,1,7,8,15,Col623_T,"-37.81909256, 144.95452748"
79120250930,79,2025-09-30,1,21,10,31,FliSS_T,"-37.81794046, 144.96616678"
1231320240214,123,2024-02-14,13,88,35,123,BirBridge_T,"-37.81753741, 144.97329734"
1172220250701,117,2025-07-01,22,48,43,91,Fli114F_T,"-37.81629332, 144.97090877"
1171120231224,117,2023-12-24,11,78,99,177,Fli114F_T,"-37.81629332, 144.97090877"
117720231228,117,2023-12-28,7,38,27,65,Fli114F_T,"-37.81629332, 144.97090877"
491120240603,49,2024-06-03,11,200,242,442,Eli501_T,"-37.80730068, 144.95956055"
251320250308,25,2025-03-08,13,664,756,1420,MCEC_T,"-37.82401776, 144.95604426"
25320250707,25,2025-07-07,3,6,9,15,MCEC_T,"-37.82401776, 144.95604426"
139320240920,139,2024-09-20,3,0,1,1,Signal1647_T,"-37.81959923, 144.9632832"
1641520250308,164,2025-03-08,15,102,81,183,Lat526_T,"-37.813005, 144.95160411"
138720250521,138,2025-05-21,7,3,2,5,EntPark1671_T,"-37.81996544, 144.95981454"
138420240121,138,2024-01-21,4,1,0,1,EntPark1671_T,"-37.81996544, 144.95981454"
1611220241126,161,2024-11-26,12,98,121,219,BirArt1109_T,"-37.81851276, 144.97131336"
691720240527,69,2024-05-27,17,53,69,122,FLDegC_T,"-37.81687226, 144.96559144"
61420231019,6,2023-10-19,14,999,705,1704,FliS_T,"-37.81911705, 144.96558255"
84120231230,84,2023-12-30,1,126,165,291,ElFi_T,"-37.81798049, 144.96503383"
842220240407,84,2024-04-07,22,252,335,587,ElFi_T,"-37.81798049, 144.96503383"
31420240727,3,2024-07-27,14,904,1034,1938,Swa295_T,"-37.81101524, 144.96429485"
78420240909,78,2024-09-09,4,2,1,3,HarEsB_T,"-37.81471642, 144.9446508"
65020231114,65,2023-11-14,0,11,21,32,SwaCs_T,"-37.81569416, 144.9668064"
651420231215,65,2023-12-15,14,442,499,941,SwaCs_T,"-37.81569416, 144.9668064"
772020240101,77,2024-01-01,20,218,164,382,HarEsP_T,"-37.81441438, 144.94433026"
71820250626,71,2025-06-26,8,22,18,40,WestWP_T,"-37.81235775, 144.97136962"
651120240909,65,2024-09-09,11,665,358,1023,SwaCs_T,"-37.81569416, 144.9668064"
291020231210,29,2023-12-10,10,195,259,454,AG_T,"-37.8199817, 144.96872865"
14720240926,14,2024-09-26,7,181,184,365,SanBri_T,"-37.82011242, 144.96291897"
14120250403,14,2025-04-03,1,13,9,22,SanBri_T,"-37.82011242, 144.96291897"
311720240926,31,2024-09-26,17,205,150,355,Lyg161_T,"-37.80169681, 144.96658911"
54920250503,54,2025-05-03,9,69,64,133,Swa607_T,"-37.804024, 144.96308399"
28820250806,28,2025-08-06,8,698,297,995,VAC_T,"-37.82129925, 144.96879309"
281220250901,28,2025-09-01,12,747,529,1276,VAC_T,"-37.82129925, 144.96879309"
401820250220,40,2025-02-20,18,134,304,438,Spr201_T,"-37.80999341, 144.97227587"
108920251011,108,2025-10-11,9,118,125,243,261Will_T,"-37.81295822, 144.95678789"
871520250721,87,2025-07-21,15,81,119,200,Errol23_T,"-37.80454949, 144.94921863"
611420251011,61,2025-10-11,14,327,637,964,RMIT14_T,"-37.80767455, 144.96309114"
441120240727,44,2024-07-27,11,47,95,142,UM3_T,"-37.79698741, 144.96441306"
185420250802,185,2025-08-02,4,47,28,75,Eli197_T,"-37.81374643, 144.96276183"
1671320251008,167,2025-10-08,13,86,100,186,Lat526_T,"-37.81304149, 144.95155955"
1082120250605,108,2025-06-05,21,176,95,271,261Will_T,"-37.81295822, 144.95678789"
1431120240602,143,2024-06-02,11,321,936,1257,Spencer_T,"-37.821728, 144.95557015"
132220250127,132,2025-01-27,2,20,12,32,King335_T,"-37.81267639, 144.95386444"
1321620250815,132,2025-08-15,16,123,135,258,King335_T,"-37.81267639, 144.95386444"
135120231024,135,2023-10-24,1,10,19,29,Spen161_T,"-37.8172861, 144.95319102"
1351220240527,135,2024-05-27,12,429,458,887,Spen161_T,"-37.8172861, 144.95319102"
1181020240618,118,2024-06-18,10,13,24,37,Fli114C_T,"-37.81632783, 144.97090512"
1072120250719,107,2025-07-19,21,66,66,132,280Will_T,"-37.81246271, 144.95690188"
681320240220,68,2024-02-20,13,319,220,539,FLDegN_T,"-37.8168479, 144.96559789"
851120250901,85,2025-09-01,11,87,57,144,488Mac_T,"-37.79432415, 144.92973378"
171020241208,17,2024-12-08,10,161,113,274,Col15_T,"-37.81362543, 144.97323591"
171720250928,17,2025-09-28,17,117,115,232,Col15_T,"-37.81362543, 144.97323591"
181420240426,18,2024-04-26,14,200,151,351,Col12_T,"-37.81344862, 144.97305353"
182220241006,18,2024-10-06,22,1,0,1,Col12_T,"-37.81344862, 144.97305353"
18820241231,18,2024-12-31,8,25,114,139,Col12_T,"-37.81344862, 144.97305353"
18520240128,18,2024-01-28,5,0,1,1,Col12_T,"-37.81344862, 144.97305353"
62920241228,62,2024-12-28,9,41,38,79,Lat224_T,"-37.80996494, 144.96216521"
861120250426,86,2025-04-26,11,79,96,175,574Qub_T,"-37.80309992, 144.94908064"
121920231231,12,2023-12-31,19,1582,1742,3324,NewQ_T,"-37.81457988, 144.94292398"
24020241201,24,2024-12-01,0,213,282,495,Col620_T,"-37.81887963, 144.95449198"
56720251013,56,2025-10-13,7,69,66,135,Lon364_T,"-37.81234775, 144.96153311"
581320241126,58,2024-11-26,13,766,557,1323,Bou688_T,"-37.81686075, 144.95358075"
58320240603,58,2024-06-03,3,4,9,13,Bou688_T,"-37.81686075, 144.95358075"
761020250813,76,2025-08-13,10,60,50,110,KenMac_T,"-37.79453803, 144.93036194"
35320240214,35,2024-02-14,3,15,18,33,SouthB_T,"-37.82018685, 144.96508508"
581620250308,58,2025-03-08,16,582,364,946,Bou688_T,"-37.81686075, 144.95358075"
301920241212,30,2024-12-12,19,294,457,751,Lon189_T,"-37.8112185, 144.96656806"
791020240725,79,2024-07-25,10,292,212,504,FliSS_T,"-37.81794046, 144.96616678"
53220251012,53,2025-10-12,2,25,31,56,Col254_T,"-37.81564191, 144.965499"
531920241112,53,2024-11-12,19,266,193,459,Col254_T,"-37.81564191, 144.965499"
51720241102,51,2024-11-02,7,15,13,28,Fra118_T,"-37.80841815, 144.95906316"
9220250815,9,2025-08-15,2,0,2,2,Col700_T,"-37.81982992, 144.95102555"
251420250106,25,2025-01-06,14,263,346,609,MCEC_T,"-37.82401776, 144.95604426"
521420250802,52,2025-08-02,14,491,394,885,Eli263_T,"-37.81252157, 144.9619401"
141820240627,141,2024-06-27,8,106,125,231,474Fl_T,"-37.81997273, 144.95834911"
1391520250906,139,2025-09-06,15,77,69,146,Signal1647_T,"-37.81959923, 144.9632832"
1641520250329,164,2025-03-29,15,131,164,295,Lat526_T,"-37.813005, 144.95160411"
671320240223,67,2024-02-23,13,374,369,743,FLDegS_T,"-37.81688755, 144.96562569"
172020240709,17,2024-07-09,20,74,55,129,Col15_T,"-37.81362543, 144.97323591"
671720240612,67,2024-06-12,17,339,567,906,FLDegS_T,"-37.81688755, 144.96562569"
672020250508,67,2025-05-08,20,154,329,483,FLDegS_T,"-37.81688755, 144.96562569"
108820240226,108,2024-02-26,8,181,2333,2514,261Will_T,"-37.81295822, 144.95678789"
871320240415,87,2024-04-15,13,128,134,262,Errol23_T,"-37.80454949, 144.94921863"
61220240317,61,2024-03-17,2,74,19,93,RMIT14_T,"-37.80767455, 144.96309114"
431020250921,43,2025-09-21,10,47,38,85,UM2_T,"-37.79844526, 144.96411782"
1661520250926,166,2025-09-26,15,52,49,101,Spen484_T,"-37.80896733, 144.94931703"
1671520241107,167,2024-11-07,15,38,64,102,Lat526_T,"-37.81304149, 144.95155955"
1651520250721,165,2025-07-21,15,33,31,64,Spen475_T,"-37.80953359, 144.94939004"
1652320250812,165,2025-08-12,23,6,1,7,Spen475_T,"-37.80953359, 144.94939004"
1401520250826,140,2025-08-26,15,71,86,157,Boyd2837_T,"-37.82590962, 144.96185972"
1841420250717,184,2025-07-17,14,1041,1318,2359,Eli124_T,"-37.81512416, 144.96371988"
1842120250820,184,2025-08-20,21,253,404,657,Eli124_T,"-37.81512416, 144.96371988"
1311920250325,131,2025-03-25,19,78,89,167,King2_T,"-37.82009057, 144.95758725"
1341920240306,134,2024-03-06,19,443,276,719,Spen201_T,"-37.81694221, 144.95303935"
1352320250525,135,2025-05-25,23,29,41,70,Spen161_T,"-37.8172861, 144.95319102"
1331320241104,133,2024-11-04,13,607,557,1164,Spen229_T,"-37.81531435, 144.95227769"
1072320240417,107,2024-04-17,23,29,22,51,280Will_T,"-37.81246271, 144.95690188"
1182020250423,118,2025-04-23,20,7,8,15,Fli114C_T,"-37.81632783, 144.97090512"
118020250425,118,2025-04-25,0,2,6,8,Fli114C_T,"-37.81632783, 144.97090512"
172220240726,17,2024-07-26,22,104,158,262,Col15_T,"-37.81362543, 144.97323591"
1620231022,1,2023-10-22,6,11,13,24,Bou292_T,"-37.81349441, 144.96515323"
11920240425,1,2024-04-25,19,656,452,1108,Bou292_T,"-37.81349441, 144.96515323"
67820240819,67,2024-08-19,8,302,290,592,FLDegS_T,"-37.81688755, 144.96562569"
24020240610,24,2024-06-10,0,95,125,220,Col620_T,"-37.81887963, 144.95449198"
11620250513,11,2025-05-13,6,32,28,60,WatCit_T,"-37.81564989, 144.93970694"
10520240530,10,2024-05-30,5,1,4,5,BouHbr_T,"-37.81876474, 144.94710545"
21320231215,2,2023-12-15,13,1072,1212,2284,Bou283_T,"-37.81380668, 144.96516718"
581020240910,58,2024-09-10,10,620,192,812,Bou688_T,"-37.81686075, 144.95358075"
582320240903,58,2024-09-03,23,94,71,165,Bou688_T,"-37.81686075, 144.95358075"
58520231106,58,2023-11-06,5,53,24,77,Bou688_T,"-37.81686075, 144.95358075"
22320250714,2,2025-07-14,23,18,13,31,Bou283_T,"-37.81380668, 144.96516718"
58020250601,58,2025-06-01,0,98,84,182,Bou688_T,"-37.81686075, 144.95358075"
21320240524,2,2024-05-24,13,764,709,1473,Bou283_T,"-37.81380668, 144.96516718"
271020241029,27,2024-10-29,10,92,94,186,Vic_T,"-37.80606888, 144.95644692"
30220241116,30,2024-11-16,2,161,156,317,Lon189_T,"-37.8112185, 144.96656806"
30620241231,30,2024-12-31,6,7,24,31,Lon189_T,"-37.8112185, 144.96656806"
91520250315,9,2025-03-15,15,92,70,162,Col700_T,"-37.81982992, 144.95102555"
201620240916,20,2024-09-16,16,158,194,352,LtB170_T,"-37.81172914, 144.9682466"
231020250601,23,2025-06-01,10,138,185,323,Col623_T,"-37.81909256, 144.95452748"
1231320241103,123,2024-11-03,13,16,2,18,BirBridge_T,"-37.81753741, 144.97329734"
1231920241107,123,2024-11-07,19,7,1,8,BirBridge_T,"-37.81753741, 144.97329734"
1231120250623,123,2025-06-23,11,38,14,52,BirBridge_T,"-37.81753741, 144.97329734"
481620250309,48,2025-03-09,16,254,98,352,QVMQ_T,"-37.80631581, 144.95866697"
492220240916,49,2024-09-16,22,87,88,175,Eli501_T,"-37.80730068, 144.95956055"
1091420240628,109,2024-06-28,14,158,159,317,LatWill_T,"-37.81193681, 144.95621105"
192220250319,19,2025-03-19,22,183,238,421,LtB210_T,"-37.81237202, 144.96550671"
25020250816,25,2025-08-16,0,46,46,92,MCEC_T,"-37.82401776, 144.95604426"
1361520250812,136,2025-08-12,15,61,39,100,BirFed1120_T,"-37.8184141, 144.97357915"
1361020251014,136,2025-10-14,10,78,90,168,BirFed1120_T,"-37.8184141, 144.97357915"
142620250817,142,2025-08-17,6,16,10,26,Hammer1584_T,"-37.81970749, 144.96795734"
164820240925,164,2024-09-25,8,45,27,72,Lat526_T,"-37.813005, 144.95160411"
69820240929,69,2024-09-29,8,95,41,136,FLDegC_T,"-37.81687226, 144.96559144"
692020250513,69,2025-05-13,20,13,14,27,FLDegC_T,"-37.81687226, 144.96559144"
841120250610,84,2025-06-10,11,761,618,1379,ElFi_T,"-37.81798049, 144.96503383"
1312120250611,131,2025-06-11,21,33,28,61,King2_T,"-37.82009057, 144.95758725"
1321320231106,132,2023-11-06,13,165,141,306,King335_T,"-37.81267639, 144.95386444"
1321920240704,132,2024-07-04,19,113,91,204,King335_T,"-37.81267639, 144.95386444"
1351020240428,135,2024-04-28,10,397,340,737,Spen161_T,"-37.8172861, 144.95319102"
1071920231216,107,2023-12-16,19,85,120,205,280Will_T,"-37.81246271, 144.95690188"
133520250123,133,2025-01-23,5,108,103,211,Spen229_T,"-37.81531435, 144.95227769"
1181320250122,118,2025-01-22,13,27,29,56,Fli114C_T,"-37.81632783, 144.97090512"
1081920241222,108,2024-12-22,19,91,86,177,261Will_T,"-37.81295822, 144.95678789"
108320250307,108,2025-03-07,3,9,5,14,261Will_T,"-37.81295822, 144.95678789"
1662020250301,166,2025-03-01,20,11,30,41,Spen484_T,"-37.80896733, 144.94931703"
85520240420,85,2024-04-20,5,2,0,2,488Mac_T,"-37.79432415, 144.92973378"
172320231229,17,2023-12-29,23,49,52,101,Col15_T,"-37.81362543, 144.97323591"
17520241214,17,2024-12-14,5,19,10,29,Col15_T,"-37.81362543, 144.97323591"
621420250819,62,2025-08-19,14,374,285,659,Lat224_T,"-37.80996494, 144.96216521"
622320250917,62,2025-09-17,23,67,61,128,Lat224_T,"-37.80996494, 144.96216521"
631620250711,63,2025-07-11,16,412,528,940,Bou231_T,"-37.81333081, 144.96675571"
561220231226,56,2023-12-26,12,350,233,583,Lon364_T,"-37.81234775, 144.96153311"
111620250223,11,2025-02-23,16,138,96,234,WatCit_T,"-37.81564989, 144.93970694"
241520250923,24,2025-09-23,15,491,1184,1675,Col620_T,"-37.81887963, 144.95449198"
72220241015,72,2024-10-15,2,5,1,6,ACMI_T,"-37.81726338, 144.96872809"
58220240922,58,2024-09-22,2,36,76,112,Bou688_T,"-37.81686075, 144.95358075"
271520240904,27,2024-09-04,15,83,96,179,Vic_T,"-37.80606888, 144.95644692"
22320250825,2,2025-08-25,23,13,53,66,Bou283_T,"-37.81380668, 144.96516718"
9320231022,9,2023-10-22,3,4,14,18,Col700_T,"-37.81982992, 144.95102555"
23420250322,23,2025-03-22,4,1,17,18,Col623_T,"-37.81909256, 144.95452748"
30920250814,30,2025-08-14,9,85,120,205,Lon189_T,"-37.8112185, 144.96656806"
482320231102,48,2023-11-02,23,25,48,73,QVMQ_T,"-37.80631581, 144.95866697"
251820250605,25,2025-06-05,18,548,239,787,MCEC_T,"-37.82401776, 144.95604426"
20020241208,20,2024-12-08,0,219,318,537,LtB170_T,"-37.81172914, 144.9682466"
252020250504,25,2025-05-04,20,246,236,482,MCEC_T,"-37.82401776, 144.95604426"
1641620250926,164,2025-09-26,16,103,80,183,Lat526_T,"-37.813005, 144.95160411"
139020231126,139,2023-11-26,0,17,25,42,Signal1647_T,"-37.81959923, 144.9632832"
139320240706,139,2024-07-06,3,0,1,1,Signal1647_T,"-37.81959923, 144.9632832"
137520240112,137,2024-01-12,5,0,1,1,BouHbr2353_T,"-37.81894815, 144.94612292"
1302020240922,130,2024-09-22,20,6,6,12,Bou892T,"-37.8204637, 144.94126826"
1381520240206,138,2024-02-06,15,7,12,19,EntPark1671_T,"-37.81996544, 144.95981454"
1232120250410,123,2025-04-10,21,1,0,1,BirBridge_T,"-37.81753741, 144.97329734"
109720241129,109,2024-11-29,7,47,184,231,LatWill_T,"-37.81193681, 144.95621105"
37020250824,37,2025-08-24,0,38,41,79,Lyg260_T,"-37.80107122, 144.96704554"
44920250329,44,2025-03-29,9,30,49,79,UM3_T,"-37.79698741, 144.96441306"
431320240828,43,2024-08-28,13,172,260,432,UM2_T,"-37.79844526, 144.96411782"
452120250201,45,2025-02-01,21,417,923,1340,Swa148_T,"-37.81414075, 144.96609379"
1311020250205,131,2025-02-05,10,63,97,160,King2_T,"-37.82009057, 144.95758725"
841020250907,84,2025-09-07,10,647,429,1076,ElFi_T,"-37.81798049, 144.96503383"
701120250414,70,2025-04-14,11,113,127,240,Errol20_T,"-37.80456984, 144.94946228"
31720250810,3,2025-08-10,17,1346,1774,3120,Swa295_T,"-37.81101524, 144.96429485"
391320250530,39,2025-05-30,13,162,176,338,AlfPl_T,"-37.81379749, 144.96995745"
411220250719,41,2025-07-19,12,2010,1271,3281,Swa31,"-37.81668634, 144.96689733"
421420250706,42,2025-07-06,14,74,53,127,UM1_T,"-37.80008566, 144.96386412"
29020240322,29,2024-03-22,0,15,52,67,AG_T,"-37.8199817, 144.96872865"
541620231228,54,2023-12-28,16,81,79,160,Swa607_T,"-37.804024, 144.96308399"
40820250917,40,2025-09-17,8,86,147,233,Spr201_T,"-37.80999341, 144.97227587"
401320250122,40,2025-01-22,13,315,248,563,Spr201_T,"-37.80999341, 144.97227587"
5820250712,5,2025-07-12,8,120,154,274,PriNW_T,"-37.81874249, 144.96787656"
361720241216,36,2024-12-16,17,205,178,383,Que85_T,"-37.81652527, 144.96121062"
361420241029,36,2024-10-29,14,203,237,440,Que85_T,"-37.81652527, 144.96121062"
871420250817,87,2025-08-17,14,112,109,221,Errol23_T,"-37.80454949, 144.94921863"
871020240819,87,2024-08-19,10,95,101,196,Errol23_T,"-37.80454949, 144.94921863"
502020241019,50,2024-10-19,20,338,381,719,Lyg309_T,"-37.79808192, 144.96721013"
501620250523,50,2025-05-23,16,156,133,289,Lyg309_T,"-37.79808192, 144.96721013"
50620250526,50,2025-05-26,6,13,9,22,Lyg309_T,"-37.79808192, 144.96721013"
44720250326,44,2025-03-26,7,21,32,53,UM3_T,"-37.79698741, 144.96441306"
452220250902,45,2025-09-02,22,94,180,274,Swa148_T,"-37.81414075, 144.96609379"
131820250520,131,2025-05-20,8,172,45,217,King2_T,"-37.82009057, 144.95758725"
1621720250920,162,2025-09-20,17,293,294,587,Eli489_T,"-37.80740397, 144.95987909"
143620250411,143,2025-04-11,6,37,80,117,Spencer_T,"-37.821728, 144.95557015"
1321120250209,132,2025-02-09,11,144,81,225,King335_T,"-37.81267639, 144.95386444"
108320250522,108,2025-05-22,3,6,5,11,261Will_T,"-37.81295822, 144.95678789"
134220231227,134,2023-12-27,2,16,10,26,Spen201_T,"-37.81694221, 144.95303935"
107320250927,107,2025-09-27,3,6,3,9,280Will_T,"-37.81246271, 144.95690188"
1241520231107,124,2023-11-07,15,2,2,4,BirBridge_T,"-37.81757416, 144.97329934"
682120240401,68,2024-04-01,21,5,1,6,FLDegN_T,"-37.8168479, 144.96559789"
85020241020,85,2024-10-20,0,1,4,5,488Mac_T,"-37.79432415, 144.92973378"
852020250328,85,2025-03-28,20,53,56,109,488Mac_T,"-37.79432415, 144.92973378"
17420240707,17,2024-07-07,4,13,10,23,Col15_T,"-37.81362543, 144.97323591"
1420240226,1,2024-02-26,4,3,15,18,Bou292_T,"-37.81349441, 144.96515323"
62020240209,62,2024-02-09,0,51,62,113,Lat224_T,"-37.80996494, 144.96216521"
122220241117,12,2024-11-17,22,81,101,182,NewQ_T,"-37.81457988, 144.94292398"
56020250628,56,2025-06-28,0,59,85,144,Lon364_T,"-37.81234775, 144.96153311"
10720250429,10,2025-04-29,7,37,137,174,BouHbr_T,"-37.81876474, 144.94710545"
761220240313,76,2024-03-13,12,93,78,171,KenMac_T,"-37.79453803, 144.93036194"
58520250415,58,2025-04-15,5,85,27,112,Bou688_T,"-37.81686075, 144.95358075"
21320240731,2,2024-07-31,13,674,794,1468,Bou283_T,"-37.81380668, 144.96516718"
531620240123,53,2024-01-23,16,771,544,1315,Col254_T,"-37.81564191, 144.965499"
301420250628,30,2025-06-28,14,296,495,791,Lon189_T,"-37.8112185, 144.96656806"
30020240701,30,2024-07-01,0,91,92,183,Lon189_T,"-37.8112185, 144.96656806"
302120231112,30,2023-11-12,21,202,368,570,Lon189_T,"-37.8112185, 144.96656806"
532120250619,53,2025-06-19,21,102,164,266,Col254_T,"-37.81564191, 144.965499"
1342220241007,134,2024-10-07,22,188,192,380,Spen201_T,"-37.81694221, 144.95303935"
135520240924,135,2024-09-24,5,21,28,49,Spen161_T,"-37.8172861, 144.95319102"
1071920240912,107,2024-09-12,19,98,90,188,280Will_T,"-37.81246271, 144.95690188"
1791920250822,179,2025-08-22,19,56,61,117,Pow61_T,"-37.82392385, 144.96299677"
1651020240922,165,2024-09-22,10,24,50,74,Spen475_T,"-37.80953359, 144.94939004"
662120251014,66,2025-10-14,21,654,490,1144,QVN_T,"-37.81057846, 144.96444294"
66920240821,66,2024-08-21,9,381,492,873,QVN_T,"-37.81057846, 144.96444294"
4220250610,4,2025-06-10,2,15,25,40,Swa123_T,"-37.81487988, 144.9660878"
701620240301,70,2024-03-01,16,140,132,272,Errol20_T,"-37.80456984, 144.94946228"
701220250826,70,2025-08-26,12,127,132,259,Errol20_T,"-37.80456984, 144.94946228"
751220231125,75,2023-11-25,12,50,25,75,SprFli_T,"-37.81515276, 144.97467661"
751120241125,75,2024-11-25,11,24,15,39,SprFli_T,"-37.81515276, 144.97467661"
82120250126,8,2025-01-26,21,56,44,100,WebBN_T,"-37.82293543, 144.9471751"
82120250301,8,2025-03-01,21,31,30,61,WebBN_T,"-37.82293543, 144.9471751"
771420250713,77,2025-07-13,14,188,389,577,HarEsP_T,"-37.81441438, 144.94433026"
71520240328,71,2024-03-28,5,4,3,7,WestWP_T,"-37.81235775, 144.97136962"
59620241217,59,2024-12-17,6,45,41,86,RMIT_T,"-37.80825648, 144.96304859"
592020241219,59,2024-12-19,20,388,261,649,RMIT_T,"-37.80825648, 144.96304859"
311720231230,31,2023-12-30,17,236,164,400,Lyg161_T,"-37.80169681, 144.96658911"
541720250504,54,2025-05-04,17,147,208,355,Swa607_T,"-37.804024, 144.96308399"
29920250608,29,2025-06-08,9,65,84,149,AG_T,"-37.8199817, 144.96872865"
471220240119,47,2024-01-19,12,931,1047,1978,Eli250_T,"-37.81258467, 144.9625775"
67620240418,67,2024-04-18,6,89,55,144,FLDegS_T,"-37.81688755, 144.96562569"
181420240716,18,2024-07-16,14,237,124,361,Col12_T,"-37.81344862, 144.97305353"
86220250209,86,2025-02-09,2,1,4,5,574Qub_T,"-37.80309992, 144.94908064"
621720240601,62,2024-06-01,17,212,144,356,Lat224_T,"-37.80996494, 144.96216521"
122320240110,12,2024-01-10,23,32,39,71,NewQ_T,"-37.81457988, 144.94292398"
72220240911,72,2024-09-11,2,5,3,8,ACMI_T,"-37.81726338, 144.96872809"
58220240206,58,2024-02-06,2,28,44,72,Bou688_T,"-37.81686075, 144.95358075"
58420250623,58,2025-06-23,4,20,12,32,Bou688_T,"-37.81686075, 144.95358075"
2620241227,2,2024-12-27,6,12,11,23,Bou283_T,"-37.81380668, 144.96516718"
9220250417,9,2025-04-17,2,3,5,8,Col700_T,"-37.81982992, 144.95102555"
9420240428,9,2024-04-28,4,6,13,19,Col700_T,"-37.81982992, 144.95102555"
53220251004,53,2025-10-04,2,6,17,23,Col254_T,"-37.81564191, 144.965499"
231020250705,23,2025-07-05,10,150,171,321,Col623_T,"-37.81909256, 144.95452748"
201720250806,20,2025-08-06,17,308,220,528,LtB170_T,"-37.81172914, 144.9682466"
201620250916,20,2025-09-16,16,173,165,338,LtB170_T,"-37.81172914, 144.9682466"
48920240102,48,2024-01-02,9,132,97,229,QVMQ_T,"-37.80631581, 144.95866697"
20520231230,20,2023-12-30,5,5,5,10,LtB170_T,"-37.81172914, 144.9682466"
251720231105,25,2023-11-05,17,1406,481,1887,MCEC_T,"-37.82401776, 144.95604426"
251020241022,25,2024-10-22,10,267,489,756,MCEC_T,"-37.82401776, 144.95604426"
511720250825,51,2025-08-25,17,105,84,189,Fra118_T,"-37.80841815, 144.95906316"
56320241012,56,2024-10-12,3,56,37,93,Lon364_T,"-37.81234775, 144.96153311"
24920241026,24,2024-10-26,9,492,371,863,Col620_T,"-37.81887963, 144.95449198"
101020231124,10,2023-11-24,10,131,93,224,BouHbr_T,"-37.81876474, 144.94710545"
101320231225,10,2023-12-25,13,12,7,19,BouHbr_T,"-37.81876474, 144.94710545"
581120240127,58,2024-01-27,11,682,225,907,Bou688_T,"-37.81686075, 144.95358075"
76320250418,76,2025-04-18,3,1,1,2,KenMac_T,"-37.79453803, 144.93036194"
581520231222,58,2023-12-22,15,651,449,1100,Bou688_T,"-37.81686075, 144.95358075"
35220250401,35,2025-04-01,2,17,46,63,SouthB_T,"-37.82018685, 144.96508508"
271020250326,27,2025-03-26,10,67,90,157,Vic_T,"-37.80606888, 144.95644692"
27920240223,27,2024-02-23,9,106,127,233,Vic_T,"-37.80606888, 144.95644692"
9620250508,9,2025-05-08,6,35,242,277,Col700_T,"-37.81982992, 144.95102555"
251520250717,25,2025-07-17,15,613,505,1118,MCEC_T,"-37.82401776, 144.95604426"
20020250417,20,2025-04-17,0,16,33,49,LtB170_T,"-37.81172914, 144.9682466"
25220240227,25,2024-02-27,2,19,18,37,MCEC_T,"-37.82401776, 144.95604426"
511220250224,51,2025-02-24,12,153,114,267,Fra118_T,"-37.80841815, 144.95906316"
137720241017,137,2024-10-17,7,41,7,48,BouHbr2353_T,"-37.81894815, 144.94612292"
1301120250610,130,2025-06-10,11,61,60,121,Bou892T,"-37.8204637, 144.94126826"
117120250917,117,2025-09-17,1,13,9,22,Fli114F_T,"-37.81629332, 144.97090877"
123220240119,123,2024-01-19,2,2,1,3,BirBridge_T,"-37.81753741, 144.97329734"
1171820231221,117,2023-12-21,18,233,251,484,Fli114F_T,"-37.81629332, 144.97090877"
49320240922,49,2024-09-22,3,37,46,83,Eli501_T,"-37.80730068, 144.95956055"
109920240610,109,2024-06-10,9,44,29,73,LatWill_T,"-37.81193681, 144.95621105"
1091420240714,109,2024-07-14,14,131,163,294,LatWill_T,"-37.81193681, 144.95621105"
19520240125,19,2024-01-25,5,8,4,12,LtB210_T,"-37.81237202, 144.96550671"
192020231027,19,2023-10-27,20,749,710,1459,LtB210_T,"-37.81237202, 144.96550671"
691220240411,69,2024-04-11,12,291,250,541,FLDegC_T,"-37.81687226, 144.96559144"
61320250520,6,2025-05-20,13,797,748,1545,FliS_T,"-37.81911705, 144.96558255"
84720250524,84,2025-05-24,7,169,110,279,ElFi_T,"-37.81798049, 144.96503383"
75220241226,75,2024-12-26,2,1,0,1,SprFli_T,"-37.81515276, 144.97467661"
81320251014,8,2025-10-14,13,273,347,620,WebBN_T,"-37.82293543, 144.9471751"
8820240121,8,2024-01-21,8,43,58,101,WebBN_T,"-37.82293543, 144.9471751"
41720241022,41,2024-10-22,7,62,89,151,Swa31,"-37.81668634, 144.96689733"
77120240128,77,2024-01-28,1,19,9,28,HarEsP_T,"-37.81441438, 144.94433026"
42620240522,42,2024-05-22,6,17,31,48,UM1_T,"-37.80008566, 144.96386412"
421420241101,42,2024-11-01,14,267,346,613,UM1_T,"-37.80008566, 144.96386412"
591420241007,59,2024-10-07,14,717,1087,1804,RMIT_T,"-37.80825648, 144.96304859"
281420241228,28,2024-12-28,14,1620,1261,2881,VAC_T,"-37.82129925, 144.96879309"
401820250408,40,2025-04-08,18,133,182,315,Spr201_T,"-37.80999341, 144.97227587"
40120231123,40,2023-11-23,1,1,0,1,Spr201_T,"-37.80999341, 144.97227587"
40520250502,40,2025-05-02,5,7,8,15,Spr201_T,"-37.80999341, 144.97227587"
311420231210,31,2023-12-10,14,323,196,519,Lyg161_T,"-37.80169681, 144.96658911"
371120250814,37,2025-08-14,11,73,74,147,Lyg260_T,"-37.80107122, 144.96704554"
451220240929,45,2024-09-29,12,535,767,1302,Swa148_T,"-37.81414075, 144.96609379"
871620240611,87,2024-06-11,16,84,96,180,Errol23_T,"-37.80454949, 144.94921863"
165820250117,165,2025-01-17,8,17,56,73,Spen475_T,"-37.80953359, 144.94939004"
167320241211,167,2024-12-11,3,1,3,4,Lat526_T,"-37.81304149, 144.95155955"
167920250316,167,2025-03-16,9,14,56,70,Lat526_T,"-37.81304149, 144.95155955"
1431920240612,143,2024-06-12,19,89,97,186,Spencer_T,"-37.821728, 144.95557015"
1321120240927,132,2024-09-27,11,193,114,307,King335_T,"-37.81267639, 144.95386444"
201020250930,20,2025-09-30,10,89,105,194,LtB170_T,"-37.81172914, 144.9682466"
251020231230,25,2023-12-30,10,186,595,781,MCEC_T,"-37.82401776, 144.95604426"
52320231230,52,2023-12-30,3,11,43,54,Eli263_T,"-37.81252157, 144.9619401"
512220240312,51,2024-03-12,22,35,25,60,Fra118_T,"-37.80841815, 144.95906316"
231220250509,23,2025-05-09,12,359,445,804,Col623_T,"-37.81909256, 144.95452748"
232120250806,23,2025-08-06,21,93,146,239,Col623_T,"-37.81909256, 144.95452748"
231020241015,23,2024-10-15,10,500,474,974,Col623_T,"-37.81909256, 144.95452748"
1172020250829,117,2025-08-29,20,111,180,291,Fli114F_T,"-37.81629332, 144.97090877"
109720231130,109,2023-11-30,7,39,315,354,LatWill_T,"-37.81193681, 144.95621105"
252120241123,25,2024-11-23,21,586,489,1075,MCEC_T,"-37.82401776, 144.95604426"
251920250312,25,2025-03-12,19,158,391,549,MCEC_T,"-37.82401776, 144.95604426"
139920240808,139,2024-08-08,9,24,162,186,Signal1647_T,"-37.81959923, 144.9632832"
137720250926,137,2025-09-26,7,2,7,9,BouHbr2353_T,"-37.81894815, 144.94612292"
1362320240326,136,2024-03-26,23,3,32,35,BirFed1120_T,"-37.8184141, 144.97357915"
136820250126,136,2025-01-26,8,72,140,212,BirFed1120_T,"-37.8184141, 144.97357915"
139820240108,139,2024-01-08,8,12,39,51,Signal1647_T,"-37.81959923, 144.9632832"
1301420250913,130,2025-09-13,14,85,59,144,Bou892T,"-37.8204637, 144.94126826"
1381320231127,138,2023-11-27,13,10,5,15,EntPark1671_T,"-37.81996544, 144.95981454"
138820240515,138,2024-05-15,8,7,7,14,EntPark1671_T,"-37.81996544, 144.95981454"
1611820240905,161,2024-09-05,18,4,5,9,BirArt1109_T,"-37.81851276, 144.97131336"
31020240224,31,2024-02-24,0,35,65,100,Lyg161_T,"-37.80169681, 144.96658911"
312320240321,31,2024-03-21,23,42,62,104,Lyg161_T,"-37.80169681, 144.96658911"
28020250925,28,2025-09-25,0,25,9,34,VAC_T,"-37.82129925, 144.96879309"
282120231105,28,2023-11-05,21,257,100,357,VAC_T,"-37.82129925, 144.96879309"
47820231120,47,2023-11-20,8,199,577,776,Eli250_T,"-37.81258467, 144.9625775"
401520250403,40,2025-04-03,15,197,163,360,Spr201_T,"-37.80999341, 144.97227587"
51920250310,5,2025-03-10,19,1222,1738,2960,PriNW_T,"-37.81874249, 144.96787656"
51220251014,5,2025-10-14,12,626,896,1522,PriNW_T,"-37.81874249, 144.96787656"
36820241110,36,2024-11-10,8,39,27,66,Que85_T,"-37.81652527, 144.96121062"
50220250308,50,2025-03-08,2,6,2,8,Lyg309_T,"-37.79808192, 144.96721013"
166820250622,166,2025-06-22,8,11,14,25,Spen484_T,"-37.80896733, 144.94931703"
131220240530,131,2024-05-30,2,12,11,23,King2_T,"-37.82009057, 144.95758725"
162620250319,162,2025-03-19,6,62,29,91,Eli489_T,"-37.80740397, 144.95987909"
1321520250625,132,2025-06-25,15,93,92,185,King335_T,"-37.81267639, 144.95386444"
1321920231222,132,2023-12-22,19,156,133,289,King335_T,"-37.81267639, 144.95386444"
1081620250409,108,2025-04-09,16,1110,259,1369,261Will_T,"-37.81295822, 144.95678789"
1072220250527,107,2025-05-27,22,36,19,55,280Will_T,"-37.81246271, 144.95690188"
1181120251015,118,2025-10-15,11,16,15,31,Fli114C_T,"-37.81632783, 144.97090512"
1241420250926,124,2025-09-26,14,6,5,11,BirBridge_T,"-37.81757416, 144.97329934"
6120240505,6,2024-05-05,1,223,115,338,FliS_T,"-37.81911705, 144.96558255"
84620240214,84,2024-02-14,6,265,130,395,ElFi_T,"-37.81798049, 144.96503383"
6920250617,6,2025-06-17,9,527,1186,1713,FliS_T,"-37.81911705, 144.96558255"
702220250521,70,2025-05-21,22,108,47,155,Errol20_T,"-37.80456984, 144.94946228"
661920231023,66,2023-10-23,19,943,825,1768,QVN_T,"-37.81057846, 144.96444294"
41420240701,4,2024-07-01,14,1449,1403,2852,Swa123_T,"-37.81487988, 144.9660878"
3120250524,3,2025-05-24,1,149,147,296,Swa295_T,"-37.81101524, 144.96429485"
39820231023,39,2023-10-23,8,184,148,332,AlfPl_T,"-37.81379749, 144.96995745"
39820240712,39,2024-07-12,8,89,117,206,AlfPl_T,"-37.81379749, 144.96995745"
751320240503,75,2024-05-03,13,54,70,124,SprFli_T,"-37.81515276, 144.97467661"
39620241207,39,2024-12-07,6,17,8,25,AlfPl_T,"-37.81379749, 144.96995745"
78120240621,78,2024-06-21,1,1,2,3,HarEsB_T,"-37.81471642, 144.9446508"
141520240129,14,2024-01-29,15,315,92,407,SanBri_T,"-37.82011242, 144.96291897"
591020231023,59,2023-10-23,10,448,382,830,RMIT_T,"-37.80825648, 144.96304859"
591420241020,59,2024-10-20,14,456,201,657,RMIT_T,"-37.80825648, 144.96304859"
282120240725,28,2024-07-25,21,95,113,208,VAC_T,"-37.82129925, 144.96879309"
292320240822,29,2024-08-22,23,4,30,34,AG_T,"-37.8199817, 144.96872865"
141120250222,14,2025-02-22,11,268,85,353,SanBri_T,"-37.82011242, 144.96291897"
852020250604,85,2025-06-04,20,24,16,40,488Mac_T,"-37.79432415, 144.92973378"
18120240115,18,2024-01-15,1,4,1,5,Col12_T,"-37.81344862, 144.97305353"
182120250517,18,2025-05-17,21,14,39,53,Col12_T,"-37.81344862, 144.97305353"
56220231020,56,2023-10-20,2,10,21,31,Lon364_T,"-37.81234775, 144.96153311"
561820250208,56,2025-02-08,18,362,451,813,Lon364_T,"-37.81234775, 144.96153311"
581220240715,58,2024-07-15,12,637,367,1004,Bou688_T,"-37.81686075, 144.95358075"
582020250530,58,2025-05-30,20,277,290,567,Bou688_T,"-37.81686075, 144.95358075"
531020240621,53,2024-06-21,10,461,376,837,Col254_T,"-37.81564191, 144.965499"
272020241201,27,2024-12-01,20,74,38,112,Vic_T,"-37.80606888, 144.95644692"
91120240210,9,2024-02-10,11,62,85,147,Col700_T,"-37.81982992, 144.95102555"
302320250924,30,2025-09-24,23,117,92,209,Lon189_T,"-37.8112185, 144.96656806"
522020240819,52,2024-08-19,20,233,154,387,Eli263_T,"-37.81252157, 144.9619401"
51220250721,51,2025-07-21,2,5,5,10,Fra118_T,"-37.80841815, 144.95906316"
1231020240619,123,2024-06-19,10,3,0,3,BirBridge_T,"-37.81753741, 144.97329734"
123120231209,123,2023-12-09,1,0,1,1,BirBridge_T,"-37.81753741, 144.97329734"
482020250702,48,2025-07-02,20,435,439,874,QVMQ_T,"-37.80631581, 144.95866697"
117920241230,117,2024-12-30,9,145,94,239,Fli114F_T,"-37.81629332, 144.97090877"
252120241227,25,2024-12-27,21,1080,491,1571,MCEC_T,"-37.82401776, 144.95604426"
1411920231120,141,2023-11-20,19,106,108,214,474Fl_T,"-37.81997273, 144.95834911"
142720231122,142,2023-11-22,7,252,234,486,Hammer1584_T,"-37.81970749, 144.96795734"
69720251005,69,2025-10-05,7,23,12,35,FLDegC_T,"-37.81687226, 144.96559144"
6920231205,6,2023-12-05,9,568,1144,1712,FliS_T,"-37.81911705, 144.96558255"
70420250502,70,2025-05-02,4,1,0,1,Errol20_T,"-37.80456984, 144.94946228"
282020240726,28,2024-07-26,20,221,477,698,VAC_T,"-37.82129925, 144.96879309"
291420240422,29,2024-04-22,14,307,396,703,AG_T,"-37.8199817, 144.96872865"
54720250221,54,2025-02-21,7,34,25,59,Swa607_T,"-37.804024, 144.96308399"
542020231207,54,2023-12-07,20,104,116,220,Swa607_T,"-37.804024, 144.96308399"
54220240702,54,2024-07-02,2,4,7,11,Swa607_T,"-37.804024, 144.96308399"
40420240628,40,2024-06-28,4,3,5,8,Spr201_T,"-37.80999341, 144.97227587"
21520250814,21,2025-08-14,5,5,18,23,Bourke155_T,"-37.81267313, 144.96788288"
179320250726,179,2025-07-26,3,3,8,11,Pow61_T,"-37.82392385, 144.96299677"
140720250528,140,2025-05-28,7,55,11,66,Boyd2837_T,"-37.82590962, 144.96185972"
1401920240327,140,2024-03-27,19,50,59,109,Boyd2837_T,"-37.82590962, 144.96185972"
1312320250511,131,2025-05-11,23,31,30,61,King2_T,"-37.82009057, 144.95758725"
1621820251008,162,2025-10-08,18,701,684,1385,Eli489_T,"-37.80740397, 144.95987909"
134720240817,134,2024-08-17,7,128,125,253,Spen201_T,"-37.81694221, 144.95303935"
1351920250408,135,2025-04-08,19,177,206,383,Spen161_T,"-37.8172861, 144.95319102"
135020231120,135,2023-11-20,0,28,38,66,Spen161_T,"-37.8172861, 144.95319102"
107420231129,107,2023-11-29,4,2,6,8,280Will_T,"-37.81246271, 144.95690188"
124720231127,124,2023-11-27,7,1,1,2,BirBridge_T,"-37.81757416, 144.97329934"
1851720250808,185,2025-08-08,17,1037,721,1758,Eli197_T,"-37.81374643, 144.96276183"
242120240917,24,2024-09-17,21,210,386,596,Col620_T,"-37.81887963, 144.95449198"
241320240920,24,2024-09-20,13,810,799,1609,Col620_T,"-37.81887963, 144.95449198"
72620250102,72,2025-01-02,6,22,10,32,ACMI_T,"-37.81726338, 144.96872809"
12720250609,12,2025-06-09,7,11,12,23,NewQ_T,"-37.81457988, 144.94292398"
582120241219,58,2024-12-19,21,275,369,644,Bou688_T,"-37.81686075, 144.95358075"
30420241127,30,2024-11-27,4,8,8,16,Lon189_T,"-37.8112185, 144.96656806"
9320250512,9,2025-05-12,3,1,3,4,Col700_T,"-37.81982992, 144.95102555"
20020250828,20,2025-08-28,0,13,17,30,LtB170_T,"-37.81172914, 144.9682466"
202120250524,20,2025-05-24,21,368,693,1061,LtB170_T,"-37.81172914, 144.9682466"
461720251010,46,2025-10-10,17,116,177,293,Pel147_T,"-37.80240719, 144.9615673"
117020250323,117,2025-03-23,0,106,54,160,Fli114F_T,"-37.81629332, 144.97090877"
251120250205,25,2025-02-05,11,258,414,672,MCEC_T,"-37.82401776, 144.95604426"
1422220250802,142,2025-08-02,22,3,4,7,Hammer1584_T,"-37.81970749, 144.96795734"
85220240721,85,2024-07-21,2,0,1,1,488Mac_T,"-37.79432415, 144.92973378"
111520231116,11,2023-11-16,15,49,50,99,WatCit_T,"-37.81564989, 144.93970694"
68820240620,68,2024-06-20,8,99,64,163,FLDegN_T,"-37.8168479, 144.96559789"
181820241024,18,2024-10-24,18,367,116,483,Col12_T,"-37.81344862, 144.97305353"
122020240211,12,2024-02-11,20,329,352,681,NewQ_T,"-37.81457988, 144.94292398"
69920240802,69,2024-08-02,9,226,82,308,FLDegC_T,"-37.81687226, 144.96559144"
841220250815,84,2025-08-15,12,983,1065,2048,ElFi_T,"-37.81798049, 144.96503383"
701920241113,70,2024-11-13,19,176,269,445,Errol20_T,"-37.80456984, 144.94946228"
391020241106,39,2024-11-06,10,152,131,283,AlfPl_T,"-37.81379749, 144.96995745"
39420240827,39,2024-08-27,4,0,2,2,AlfPl_T,"-37.81379749, 144.96995745"
771220231106,77,2023-11-06,12,178,115,293,HarEsP_T,"-37.81441438, 144.94433026"
41120240822,41,2024-08-22,1,21,24,45,Swa31,"-37.81668634, 144.96689733"
42420240601,42,2024-06-01,4,1,4,5,UM1_T,"-37.80008566, 144.96386412"
772220241231,77,2024-12-31,22,1284,1534,2818,HarEsP_T,"-37.81441438, 144.94433026"
711420240105,71,2024-01-05,14,19,19,38,WestWP_T,"-37.81235775, 144.97136962"
592320240705,59,2024-07-05,23,149,94,243,RMIT_T,"-37.80825648, 144.96304859"
59220241128,59,2024-11-28,2,16,11,27,RMIT_T,"-37.80825648, 144.96304859"
28420241017,28,2024-10-17,4,8,37,45,VAC_T,"-37.82129925, 144.96879309"
471520251010,47,2025-10-10,15,1161,934,2095,Eli250_T,"-37.81258467, 144.9625775"
471920240304,47,2024-03-04,19,756,564,1320,Eli250_T,"-37.81258467, 144.9625775"
212120251006,21,2025-10-06,21,190,235,425,Bourke155_T,"-37.81267313, 144.96788288"
36120250516,36,2025-05-16,1,23,10,33,Que85_T,"-37.81652527, 144.96121062"
36620240503,36,2024-05-03,6,30,20,50,Que85_T,"-37.81652527, 144.96121062"
872120250714,87,2025-07-14,21,13,24,37,Errol23_T,"-37.80454949, 144.94921863"
872320240304,87,2024-03-04,23,4,8,12,Errol23_T,"-37.80454949, 144.94921863"
872120240412,87,2024-04-12,21,44,50,94,Errol23_T,"-37.80454949, 144.94921863"
501020241020,50,2024-10-20,10,125,172,297,Lyg309_T,"-37.79808192, 144.96721013"
441420241230,44,2024-12-30,14,9,15,24,UM3_T,"-37.79698741, 144.96441306"
44620250505,44,2025-05-05,6,4,12,16,UM3_T,"-37.79698741, 144.96441306"
452220250626,45,2025-06-26,22,47,58,105,Swa148_T,"-37.81414075, 144.96609379"
1661820250201,166,2025-02-01,18,51,58,109,Spen484_T,"-37.80896733, 144.94931703"
1661620251011,166,2025-10-11,16,72,51,123,Spen484_T,"-37.80896733, 144.94931703"
134320251002,134,2025-10-02,3,10,14,24,Spen201_T,"-37.81694221, 144.95303935"
134720240101,134,2024-01-01,7,179,116,295,Spen201_T,"-37.81694221, 144.95303935"
1351920231030,135,2023-10-30,19,216,205,421,Spen161_T,"-37.8172861, 144.95319102"
135820240302,135,2024-03-02,8,185,134,319,Spen161_T,"-37.8172861, 144.95319102"
1331920240712,133,2024-07-12,19,352,328,680,Spen229_T,"-37.81531435, 144.95227769"
1181820240421,118,2024-04-21,18,18,5,23,Fli114C_T,"-37.81632783, 144.97090512"
124920250501,124,2025-05-01,9,4,6,10,BirBridge_T,"-37.81757416, 144.97329934"
672320240526,67,2024-05-26,23,8,29,37,FLDegS_T,"-37.81688755, 144.96562569"
68820240724,68,2024-07-24,8,119,66,185,FLDegN_T,"-37.8168479, 144.96559789"
171820240404,17,2024-04-04,18,193,322,515,Col15_T,"-37.81362543, 144.97323591"
1322220250719,132,2025-07-19,22,74,100,174,King335_T,"-37.81267639, 144.95386444"
133220250516,133,2025-05-16,2,13,5,18,Spen229_T,"-37.81531435, 144.95227769"
107720241109,107,2024-11-09,7,11,34,45,280Will_T,"-37.81246271, 144.95690188"
661120250125,66,2025-01-25,11,670,804,1474,QVN_T,"-37.81057846, 144.96444294"
661020231201,66,2023-12-01,10,613,578,1191,QVN_T,"-37.81057846, 144.96444294"
662220231030,66,2023-10-30,22,248,208,456,QVN_T,"-37.81057846, 144.96444294"
70120240609,70,2024-06-09,1,3,2,5,Errol20_T,"-37.80456984, 144.94946228"
32020240710,3,2024-07-10,20,987,960,1947,Swa295_T,"-37.81101524, 144.96429485"
8720240915,8,2024-09-15,7,27,52,79,WebBN_T,"-37.82293543, 144.9471751"
771520241228,77,2024-12-28,15,86,54,140,HarEsP_T,"-37.81441438, 144.94433026"
59520250304,59,2025-03-04,5,8,7,15,RMIT_T,"-37.80825648, 144.96304859"
54820231109,54,2023-11-09,8,131,56,187,Swa607_T,"-37.804024, 144.96308399"
541820231109,54,2023-11-09,18,194,219,413,Swa607_T,"-37.804024, 144.96308399"
28220231126,28,2023-11-26,2,23,12,35,VAC_T,"-37.82129925, 144.96879309"
371120240804,37,2024-08-04,11,94,77,171,Lyg260_T,"-37.80107122, 144.96704554"
451920250731,45,2025-07-31,19,298,732,1030,Swa148_T,"-37.81414075, 144.96609379"
45220240124,45,2024-01-24,2,52,28,80,Swa148_T,"-37.81414075, 144.96609379"
212020240208,21,2024-02-08,20,397,519,916,Bourke155_T,"-37.81267313, 144.96788288"
61120250423,61,2025-04-23,1,44,9,53,RMIT14_T,"-37.80767455, 144.96309114"
61920240731,61,2024-07-31,9,302,408,710,RMIT14_T,"-37.80767455, 144.96309114"
166520250625,166,2025-06-25,5,0,5,5,Spen484_T,"-37.80896733, 144.94931703"
131920250119,131,2025-01-19,9,62,153,215,King2_T,"-37.82009057, 144.95758725"
1622120250423,162,2025-04-23,21,226,306,532,Eli489_T,"-37.80740397, 144.95987909"
162720250519,162,2025-05-19,7,99,51,150,Eli489_T,"-37.80740397, 144.95987909"
1621320250830,162,2025-08-30,13,612,838,1450,Eli489_T,"-37.80740397, 144.95987909"
1621720250118,162,2025-01-18,17,261,317,578,Eli489_T,"-37.80740397, 144.95987909"
131020241022,131,2024-10-22,0,43,49,92,King2_T,"-37.82009057, 144.95758725"
1182020240507,118,2024-05-07,20,4,2,6,Fli114C_T,"-37.81632783, 144.97090512"
1241520250118,124,2025-01-18,15,9,12,21,BirBridge_T,"-37.81757416, 144.97329934"
67020240122,67,2024-01-22,0,13,34,47,FLDegS_T,"-37.81688755, 144.96562569"
171420240901,17,2024-09-01,14,119,98,217,Col15_T,"-37.81362543, 144.97323591"
631420240106,63,2024-01-06,14,298,308,606,Bou231_T,"-37.81333081, 144.96675571"
631020241219,63,2024-12-19,10,197,237,434,Bou231_T,"-37.81333081, 144.96675571"
631220250524,63,2025-05-24,12,449,329,778,Bou231_T,"-37.81333081, 144.96675571"
62020250510,62,2025-05-10,0,65,44,109,Lat224_T,"-37.80996494, 144.96216521"
56220240923,56,2024-09-23,2,19,10,29,Lon364_T,"-37.81234775, 144.96153311"
861320251009,86,2025-10-09,13,52,91,143,574Qub_T,"-37.80309992, 144.94908064"
111720240410,11,2024-04-10,17,120,135,255,WatCit_T,"-37.81564989, 144.93970694"
63320250611,63,2025-06-11,3,0,3,3,Bou231_T,"-37.81333081, 144.96675571"
56320250522,56,2025-05-22,3,2,1,3,Lon364_T,"-37.81234775, 144.96153311"
561320250809,56,2025-08-09,13,364,405,769,Lon364_T,"-37.81234775, 144.96153311"
621120240420,62,2024-04-20,11,149,149,298,Lat224_T,"-37.80996494, 144.96216521"
24220240311,24,2024-03-11,2,32,43,75,Col620_T,"-37.81887963, 144.95449198"
242120240711,24,2024-07-11,21,315,477,792,Col620_T,"-37.81887963, 144.95449198"
101020240205,10,2024-02-05,10,43,52,95,BouHbr_T,"-37.81876474, 144.94710545"
721120250109,72,2025-01-09,11,164,212,376,ACMI_T,"-37.81726338, 144.96872809"
562020250730,56,2025-07-30,20,232,343,575,Lon364_T,"-37.81234775, 144.96153311"
58020240229,58,2024-02-29,0,83,102,185,Bou688_T,"-37.81686075, 144.95358075"
581820240528,58,2024-05-28,18,435,609,1044,Bou688_T,"-37.81686075, 144.95358075"
72720250606,72,2025-06-06,7,106,45,151,ACMI_T,"-37.81726338, 144.96872809"
721520250628,72,2025-06-28,15,179,423,602,ACMI_T,"-37.81726338, 144.96872809"
721920250810,72,2025-08-10,19,95,137,232,ACMI_T,"-37.81726338, 144.96872809"
9820241105,9,2024-11-05,8,30,358,388,Col700_T,"-37.81982992, 144.95102555"
91420240309,9,2024-03-09,14,81,60,141,Col700_T,"-37.81982992, 144.95102555"
301320240122,30,2024-01-22,13,270,413,683,Lon189_T,"-37.8112185, 144.96656806"
792220240626,79,2024-06-26,22,218,1574,1792,FliSS_T,"-37.81794046, 144.96616678"
53520250807,53,2025-08-07,5,6,6,12,Col254_T,"-37.81564191, 144.965499"
252320240808,25,2024-08-08,23,26,44,70,MCEC_T,"-37.82401776, 144.95604426"
522020240206,52,2024-02-06,20,243,181,424,Eli263_T,"-37.81252157, 144.9619401"
1171020250830,117,2025-08-30,10,52,79,131,Fli114F_T,"-37.81629332, 144.97090877"
492220240305,49,2024-03-05,22,127,68,195,Eli501_T,"-37.80730068, 144.95956055"
492220231124,49,2023-11-24,22,101,78,179,Eli501_T,"-37.80730068, 144.95956055"
19620240817,19,2024-08-17,6,4,2,6,LtB210_T,"-37.81237202, 144.96550671"
691320241231,69,2024-12-31,13,283,301,584,FLDegC_T,"-37.81687226, 144.96559144"
62220241027,6,2024-10-27,22,395,263,658,FliS_T,"-37.81911705, 144.96558255"
841320250814,84,2025-08-14,13,1006,1195,2201,ElFi_T,"-37.81798049, 144.96503383"
392220241019,39,2024-10-19,22,5,6,11,AlfPl_T,"-37.81379749, 144.96995745"
391420251001,39,2025-10-01,14,103,148,251,AlfPl_T,"-37.81379749, 144.96995745"
8820250416,8,2025-04-16,8,344,234,578,WebBN_T,"-37.82293543, 144.9471751"
75320250530,75,2025-05-30,3,0,1,1,SprFli_T,"-37.81515276, 144.97467661"
771920231109,77,2023-11-09,19,231,184,415,HarEsP_T,"-37.81441438, 144.94433026"
42520241031,42,2024-10-31,5,3,3,6,UM1_T,"-37.80008566, 144.96386412"
59020231024,59,2023-10-24,0,92,52,144,RMIT_T,"-37.80825648, 144.96304859"
592020240711,59,2024-07-11,20,184,266,450,RMIT_T,"-37.80825648, 144.96304859"
591120250509,59,2025-05-09,11,689,855,1544,RMIT_T,"-37.80825648, 144.96304859"
54220250425,54,2025-04-25,2,26,10,36,Swa607_T,"-37.804024, 144.96308399"
47620250924,47,2025-09-24,6,53,151,204,Eli250_T,"-37.81258467, 144.9625775"
1391720240602,139,2024-06-02,17,47,46,93,Signal1647_T,"-37.81959923, 144.9632832"
139120240927,139,2024-09-27,1,1,4,5,Signal1647_T,"-37.81959923, 144.9632832"
1361020250807,136,2025-08-07,10,56,41,97,BirFed1120_T,"-37.8184141, 144.97357915"
1361020231222,136,2023-12-22,10,47,50,97,BirFed1120_T,"-37.8184141, 144.97357915"
1302020250811,130,2025-08-11,20,18,12,30,Bou892T,"-37.8204637, 144.94126826"
1611820240828,161,2024-08-28,18,19,12,31,BirArt1109_T,"-37.81851276, 144.97131336"
1231220240527,123,2024-05-27,12,44,20,64,BirBridge_T,"-37.81753741, 144.97329734"
1231920250114,123,2025-01-14,19,69,52,121,BirBridge_T,"-37.81753741, 144.97329734"
49920240212,49,2024-02-12,9,67,106,173,Eli501_T,"-37.80730068, 144.95956055"
66020250603,66,2025-06-03,0,64,44,108,QVN_T,"-37.81057846, 144.96444294"
69920240319,69,2024-03-19,9,171,80,251,FLDegC_T,"-37.81687226, 144.96559144"
69020240515,69,2024-05-15,0,1,0,1,FLDegC_T,"-37.81687226, 144.96559144"
6320240428,6,2024-04-28,3,68,58,126,FliS_T,"-37.81911705, 144.96558255"
84920240108,84,2024-01-08,9,410,285,695,ElFi_T,"-37.81798049, 144.96503383"
841920250723,84,2025-07-23,19,538,846,1384,ElFi_T,"-37.81798049, 144.96503383"
4120250428,4,2025-04-28,1,24,39,63,Swa123_T,"-37.81487988, 144.9660878"
41020250908,4,2025-09-08,10,962,607,1569,Swa123_T,"-37.81487988, 144.9660878"
70020240108,70,2024-01-08,0,1,4,5,Errol20_T,"-37.80456984, 144.94946228"
70220250525,70,2025-05-25,2,5,2,7,Errol20_T,"-37.80456984, 144.94946228"
411620241203,41,2024-12-03,16,1114,2158,3272,Swa31,"-37.81668634, 144.96689733"
411720250617,41,2025-06-17,17,1395,2012,3407,Swa31,"-37.81668634, 144.96689733"
78720240826,78,2024-08-26,7,32,27,59,HarEsB_T,"-37.81471642, 144.9446508"
292220231114,29,2023-11-14,22,117,85,202,AG_T,"-37.8199817, 144.96872865"
14120251015,14,2025-10-15,1,9,4,13,SanBri_T,"-37.82011242, 144.96291897"
71320240102,71,2024-01-02,3,0,1,1,WestWP_T,"-37.81235775, 144.97136962"
282320250208,28,2025-02-08,23,215,119,334,VAC_T,"-37.82129925, 144.96879309"
402020240708,40,2024-07-08,20,55,21,76,Spr201_T,"-37.80999341, 144.97227587"
5620240828,5,2024-08-28,6,121,223,344,PriNW_T,"-37.81874249, 144.96787656"
5120241221,5,2024-12-21,1,173,145,318,PriNW_T,"-37.81874249, 144.96787656"
371220250903,37,2025-09-03,12,61,61,122,Lyg260_T,"-37.80107122, 144.96704554"
87220250624,87,2025-06-24,2,2,0,2,Errol23_T,"-37.80454949, 144.94921863"
871020231130,87,2023-11-30,10,94,83,177,Errol23_T,"-37.80454949, 144.94921863"
44920250528,44,2025-05-28,9,46,99,145,UM3_T,"-37.79698741, 144.96441306"
501020231228,50,2023-12-28,10,139,200,339,Lyg309_T,"-37.79808192, 144.96721013"
501020250330,50,2025-03-30,10,138,158,296,Lyg309_T,"-37.79808192, 144.96721013"
45920250120,45,2025-01-20,9,242,289,531,Swa148_T,"-37.81414075, 144.96609379"
1311020250922,131,2025-09-22,10,78,133,211,King2_T,"-37.82009057, 144.95758725"
162920250919,162,2025-09-19,9,265,222,487,Eli489_T,"-37.80740397, 144.95987909"
1431720251013,143,2025-10-13,17,188,299,487,Spencer_T,"-37.821728, 144.95557015"
135520240208,135,2024-02-08,5,18,21,39,Spen161_T,"-37.8172861, 144.95319102"
1351020240627,135,2024-06-27,10,348,346,694,Spen161_T,"-37.8172861, 144.95319102"
1331020240111,133,2024-01-11,10,401,387,788,Spen229_T,"-37.81531435, 144.95227769"
1181320250408,118,2025-04-08,13,15,18,33,Fli114C_T,"-37.81632783, 144.97090512"
1081720250402,108,2025-04-02,17,1942,279,2221,261Will_T,"-37.81295822, 144.95678789"
111320241215,11,2024-12-15,13,82,98,180,WatCit_T,"-37.81564989, 144.93970694"
22020241115,2,2024-11-15,20,324,336,660,Bou283_T,"-37.81380668, 144.96516718"
2020250417,2,2025-04-17,0,5,36,41,Bou283_T,"-37.81380668, 144.96516718"
302320231027,30,2023-10-27,23,375,435,810,Lon189_T,"-37.8112185, 144.96656806"
511720231028,51,2023-10-28,17,97,165,262,Fra118_T,"-37.80841815, 144.95906316"
512320240819,51,2024-08-19,23,16,16,32,Fra118_T,"-37.80841815, 144.95906316"
48120231223,48,2023-12-23,1,21,28,49,QVMQ_T,"-37.80631581, 144.95866697"
462320250203,46,2025-02-03,23,2,0,2,Pel147_T,"-37.80240719, 144.9615673"
139320240825,139,2024-08-25,3,4,0,4,Signal1647_T,"-37.81959923, 144.9632832"
117720250728,117,2025-07-28,7,71,36,107,Fli114F_T,"-37.81629332, 144.97090877"
49820250810,49,2025-08-10,8,136,136,272,Eli501_T,"-37.80730068, 144.95956055"
491820250810,49,2025-08-10,18,235,280,515,Eli501_T,"-37.80730068, 144.95956055"
662320250810,66,2025-08-10,23,143,92,235,QVN_T,"-37.81057846, 144.96444294"
61720241231,6,2024-12-31,17,1183,1328,2511,FliS_T,"-37.81911705, 144.96558255"
42020250827,4,2025-08-27,20,536,697,1233,Swa123_T,"-37.81487988, 144.9660878"
702320240316,70,2024-03-16,23,113,39,152,Errol20_T,"-37.80456984, 144.94946228"
70620250123,70,2025-01-23,6,6,6,12,Errol20_T,"-37.80456984, 144.94946228"
81720240113,8,2024-01-13,17,224,122,346,WebBN_T,"-37.82293543, 144.9471751"
772320240405,77,2024-04-05,23,8,13,21,HarEsP_T,"-37.81441438, 144.94433026"
712220250727,71,2025-07-27,22,12,13,25,WestWP_T,"-37.81235775, 144.97136962"
591120231019,59,2023-10-19,11,531,626,1157,RMIT_T,"-37.80825648, 144.96304859"
28420250731,28,2025-07-31,4,4,17,21,VAC_T,"-37.82129925, 144.96879309"
28220250227,28,2025-02-27,2,11,5,16,VAC_T,"-37.82129925, 144.96879309"
401420250812,40,2025-08-12,14,241,216,457,Spr201_T,"-37.80999341, 144.97227587"
401820250921,40,2025-09-21,18,46,82,128,Spr201_T,"-37.80999341, 144.97227587"
361020241025,36,2024-10-25,10,127,136,263,Que85_T,"-37.81652527, 144.96121062"
37220240719,37,2024-07-19,2,1,6,7,Lyg260_T,"-37.80107122, 144.96704554"
37820241213,37,2024-12-13,8,42,47,89,Lyg260_T,"-37.80107122, 144.96704554"
37120240418,37,2024-04-18,1,3,3,6,Lyg260_T,"-37.80107122, 144.96704554"
471920250904,47,2025-09-04,19,708,591,1299,Eli250_T,"-37.81258467, 144.9625775"
47420240302,47,2024-03-02,4,26,44,70,Eli250_T,"-37.81258467, 144.9625775"
451020240926,45,2024-09-26,10,530,332,862,Swa148_T,"-37.81414075, 144.96609379"
185120250929,185,2025-09-29,1,34,18,52,Eli197_T,"-37.81374643, 144.96276183"
1662020241122,166,2024-11-22,20,21,23,44,Spen484_T,"-37.80896733, 144.94931703"
1662220250517,166,2025-05-17,22,74,0,74,Spen484_T,"-37.80896733, 144.94931703"
1621120250120,162,2025-01-20,11,222,351,573,Eli489_T,"-37.80740397, 144.95987909"
1431520250422,143,2025-04-22,15,168,224,392,Spencer_T,"-37.821728, 144.95557015"
135920250414,135,2025-04-14,9,250,353,603,Spen161_T,"-37.8172861, 144.95319102"
212120250730,21,2025-07-30,21,180,166,346,Bourke155_T,"-37.81267313, 144.96788288"
361120231209,36,2023-12-09,11,133,116,249,Que85_T,"-37.81652527, 144.96121062"
871920250419,87,2025-04-19,19,99,102,201,Errol23_T,"-37.80454949, 144.94921863"
87620250428,87,2025-04-28,6,11,12,23,Errol23_T,"-37.80454949, 144.94921863"
871220250623,87,2025-06-23,12,197,191,388,Errol23_T,"-37.80454949, 144.94921863"
501820250221,50,2025-02-21,18,204,275,479,Lyg309_T,"-37.79808192, 144.96721013"
43820250206,43,2025-02-06,8,154,47,201,UM2_T,"-37.79844526, 144.96411782"
45320250206,45,2025-02-06,3,7,17,24,Swa148_T,"-37.81414075, 144.96609379"
166020250518,166,2025-05-18,0,2,1,3,Spen484_T,"-37.80896733, 144.94931703"
1652220250724,165,2025-07-24,22,25,2,27,Spen475_T,"-37.80953359, 144.94939004"
1811320250817,181,2025-08-17,13,959,1577,2536,Eli368_T,"-37.81009465, 144.96143149"
1621720241127,162,2024-11-27,17,344,352,696,Eli489_T,"-37.80740397, 144.95987909"
1341620240923,134,2024-09-23,16,622,676,1298,Spen201_T,"-37.81694221, 144.95303935"
1352120240124,135,2024-01-24,21,141,188,329,Spen161_T,"-37.8172861, 144.95319102"
1332220250326,133,2025-03-26,22,277,222,499,Spen229_T,"-37.81531435, 144.95227769"
107720241019,107,2024-10-19,7,16,23,39,280Will_T,"-37.81246271, 144.95690188"
11520240416,1,2024-04-16,15,1058,929,1987,Bou292_T,"-37.81349441, 144.96515323"
111720240330,11,2024-03-30,17,208,174,382,WatCit_T,"-37.81564989, 144.93970694"
681320250301,68,2025-03-01,13,412,292,704,FLDegN_T,"-37.8168479, 144.96559789"
18820250314,18,2025-03-14,8,92,926,1018,Col12_T,"-37.81344862, 144.97305353"
631720250807,63,2025-08-07,17,456,562,1018,Bou231_T,"-37.81333081, 144.96675571"
68220241104,68,2024-11-04,2,1,0,1,FLDegN_T,"-37.8168479, 144.96559789"
56520250305,56,2025-03-05,5,7,9,16,Lon364_T,"-37.81234775, 144.96153311"
241120250329,24,2025-03-29,11,699,482,1181,Col620_T,"-37.81887963, 144.95449198"
242120250225,24,2025-02-25,21,281,475,756,Col620_T,"-37.81887963, 144.95449198"
112320240827,11,2024-08-27,23,6,4,10,WatCit_T,"-37.81564989, 144.93970694"
112220250325,11,2025-03-25,22,47,68,115,WatCit_T,"-37.81564989, 144.93970694"
10820240527,10,2024-05-27,8,52,178,230,BouHbr_T,"-37.81876474, 144.94710545"
53620240403,53,2024-04-03,6,34,21,55,Col254_T,"-37.81564191, 144.965499"
271920250422,27,2025-04-22,19,85,66,151,Vic_T,"-37.80606888, 144.95644692"
522220250518,52,2025-05-18,22,91,73,164,Eli263_T,"-37.81252157, 144.9619401"
201920250910,20,2025-09-10,19,277,293,570,LtB170_T,"-37.81172914, 144.9682466"
511820250602,51,2025-06-02,18,75,79,154,Fra118_T,"-37.80841815, 144.95906316"
117220251015,117,2025-10-15,2,13,7,20,Fli114F_T,"-37.81629332, 144.97090877"
1231220250828,123,2025-08-28,12,79,64,143,BirBridge_T,"-37.81753741, 144.97329734"
491520240405,49,2024-04-05,15,235,467,702,Eli501_T,"-37.80730068, 144.95956055"
49120240919,49,2024-09-19,1,37,39,76,Eli501_T,"-37.80730068, 144.95956055"
492220240131,49,2024-01-31,22,117,135,252,Eli501_T,"-37.80730068, 144.95956055"
462220240427,46,2024-04-27,22,24,50,74,Pel147_T,"-37.80240719, 144.9615673"
142620240412,142,2024-04-12,6,185,39,224,Hammer1584_T,"-37.81970749, 144.96795734"
841820240904,84,2024-09-04,18,895,1572,2467,ElFi_T,"-37.81798049, 144.96503383"
842220250709,84,2025-07-09,22,269,435,704,ElFi_T,"-37.81798049, 144.96503383"
84420250724,84,2025-07-24,4,2,12,14,ElFi_T,"-37.81798049, 144.96503383"
42320240316,4,2024-03-16,23,1087,620,1707,Swa123_T,"-37.81487988, 144.9660878"
41020241004,4,2024-10-04,10,930,671,1601,Swa123_T,"-37.81487988, 144.9660878"
4320250619,4,2025-06-19,3,13,17,30,Swa123_T,"-37.81487988, 144.9660878"
118620240703,118,2024-07-03,6,1,1,2,Fli114C_T,"-37.81632783, 144.97090512"
1072220241217,107,2024-12-17,22,66,41,107,280Will_T,"-37.81246271, 144.95690188"
672320250404,67,2025-04-04,23,74,178,252,FLDegS_T,"-37.81688755, 144.96562569"
171220240224,17,2024-02-24,12,260,137,397,Col15_T,"-37.81362543, 144.97323591"
17620241223,17,2024-12-23,6,49,30,79,Col15_T,"-37.81362543, 144.97323591"
1320240515,1,2024-05-15,3,7,8,15,Bou292_T,"-37.81349441, 144.96515323"
181320240515,18,2024-05-15,13,282,245,527,Col12_T,"-37.81344862, 144.97305353"
11620250304,1,2025-03-04,16,1128,963,2091,Bou292_T,"-37.81349441, 144.96515323"
621020240110,62,2024-01-10,10,346,329,675,Lat224_T,"-37.80996494, 144.96216521"
56320240205,56,2024-02-05,3,4,5,9,Lon364_T,"-37.81234775, 144.96153311"
561820250427,56,2025-04-27,18,299,296,595,Lon364_T,"-37.81234775, 144.96153311"
861320241222,86,2024-12-22,13,49,51,100,574Qub_T,"-37.80309992, 144.94908064"
861420251003,86,2025-10-03,14,44,59,103,574Qub_T,"-37.80309992, 144.94908064"
101820240616,10,2024-06-16,18,32,13,45,BouHbr_T,"-37.81876474, 144.94710545"
721320240612,72,2024-06-12,13,160,199,359,ACMI_T,"-37.81726338, 144.96872809"
242220251011,24,2025-10-11,22,262,482,744,Col620_T,"-37.81887963, 144.95449198"
76020240401,76,2024-04-01,0,2,0,2,KenMac_T,"-37.79453803, 144.93036194"
22120240728,2,2024-07-28,21,45,106,151,Bou283_T,"-37.81380668, 144.96516718"
21320240911,2,2024-09-11,13,596,701,1297,Bou283_T,"-37.81380668, 144.96516718"
301420231102,30,2023-11-02,14,210,366,576,Lon189_T,"-37.8112185, 144.96656806"
9620241123,9,2024-11-23,6,16,28,44,Col700_T,"-37.81982992, 144.95102555"
201420240905,20,2024-09-05,14,127,181,308,LtB170_T,"-37.81172914, 144.9682466"
46120240502,46,2024-05-02,1,2,7,9,Pel147_T,"-37.80240719, 144.9615673"
52120240414,52,2024-04-14,1,180,132,312,Eli263_T,"-37.81252157, 144.9619401"
137620250515,137,2025-05-15,6,6,4,10,BouHbr2353_T,"-37.81894815, 144.94612292"
1371220240423,137,2024-04-23,12,69,133,202,BouHbr2353_T,"-37.81894815, 144.94612292"
1372320240428,137,2024-04-28,23,0,1,1,BouHbr2353_T,"-37.81894815, 144.94612292"
1361220250129,136,2025-01-29,12,63,89,152,BirFed1120_T,"-37.8184141, 144.97357915"
1362120241230,136,2024-12-30,21,7,9,16,BirFed1120_T,"-37.8184141, 144.97357915"
142720240502,142,2024-05-02,7,217,132,349,Hammer1584_T,"-37.81970749, 144.96795734"
1421420250302,142,2025-03-02,14,616,503,1119,Hammer1584_T,"-37.81970749, 144.96795734"
1302220250809,130,2025-08-09,22,4,2,6,Bou892T,"-37.8204637, 144.94126826"
691020250418,69,2025-04-18,10,207,81,288,FLDegC_T,"-37.81687226, 144.96559144"
61420231218,6,2023-12-18,14,780,706,1486,FliS_T,"-37.81911705, 144.96558255"
84720240806,84,2024-08-06,7,702,230,932,ElFi_T,"-37.81798049, 144.96503383"
41820250714,4,2025-07-14,18,1113,1053,2166,Swa123_T,"-37.81487988, 144.9660878"
6520251009,6,2025-10-09,5,64,61,125,FliS_T,"-37.81911705, 144.96558255"
8020250427,8,2025-04-27,0,1,3,4,WebBN_T,"-37.82293543, 144.9471751"
421320241205,42,2024-12-05,13,186,349,535,UM1_T,"-37.80008566, 144.96386412"
78020250111,78,2025-01-11,0,1,4,5,HarEsB_T,"-37.81471642, 144.9446508"
78120250316,78,2025-03-16,1,3,9,12,HarEsB_T,"-37.81471642, 144.9446508"
141320240416,14,2024-04-16,13,331,145,476,SanBri_T,"-37.82011242, 144.96291897"
141820240213,14,2024-02-13,18,434,165,599,SanBri_T,"-37.82011242, 144.96291897"
71120250809,71,2025-08-09,1,3,3,6,WestWP_T,"-37.81235775, 144.97136962"
29520241220,29,2024-12-20,5,10,22,32,AG_T,"-37.8199817, 144.96872865"
36220240709,36,2024-07-09,2,3,2,5,Que85_T,"-37.81652527, 144.96121062"
45820231110,45,2023-11-10,8,212,258,470,Swa148_T,"-37.81414075, 144.96609379"
701120250102,70,2025-01-02,11,115,94,209,Errol20_T,"-37.80456984, 144.94946228"
752020231121,75,2023-11-21,20,15,39,54,SprFli_T,"-37.81515276, 144.97467661"
75820240131,75,2024-01-31,8,60,56,116,SprFli_T,"-37.81515276, 144.97467661"
75720240414,75,2024-04-14,7,12,23,35,SprFli_T,"-37.81515276, 144.97467661"
81820250713,8,2025-07-13,18,8,28,36,WebBN_T,"-37.82293543, 144.9471751"
77120250923,77,2025-09-23,1,10,3,13,HarEsP_T,"-37.81441438, 144.94433026"
711420241028,71,2024-10-28,14,14,9,23,WestWP_T,"-37.81235775, 144.97136962"
71420250303,71,2025-03-03,4,1,0,1,WestWP_T,"-37.81235775, 144.97136962"
311220240131,31,2024-01-31,12,173,112,285,Lyg161_T,"-37.80169681, 144.96658911"
54020250518,54,2025-05-18,0,46,62,108,Swa607_T,"-37.804024, 144.96308399"
401620240625,40,2024-06-25,16,171,199,370,Spr201_T,"-37.80999341, 144.97227587"
179320251002,179,2025-10-02,3,1,7,8,Pow61_T,"-37.82392385, 144.96299677"
165620250911,165,2025-09-11,6,3,4,7,Spen475_T,"-37.80953359, 144.94939004"
1401520240421,140,2024-04-21,15,100,109,209,Boyd2837_T,"-37.82590962, 144.96185972"
1321620250710,132,2025-07-10,16,157,129,286,King335_T,"-37.81267639, 144.95386444"
1341320240629,134,2024-06-29,13,138,170,308,Spen201_T,"-37.81694221, 144.95303935"
1342220250705,134,2025-07-05,22,1132,663,1795,Spen201_T,"-37.81694221, 144.95303935"
135820240913,135,2024-09-13,8,246,345,591,Spen161_T,"-37.8172861, 144.95319102"
135720250308,135,2025-03-08,7,91,104,195,Spen161_T,"-37.8172861, 144.95319102"
133220250330,133,2025-03-30,2,25,17,42,Spen229_T,"-37.81531435, 144.95227769"
107820240703,107,2024-07-03,8,56,226,282,280Will_T,"-37.81246271, 144.95690188"
1182120240501,118,2024-05-01,21,2,6,8,Fli114C_T,"-37.81632783, 144.97090512"
63620241223,63,2024-12-23,6,14,19,33,Bou231_T,"-37.81333081, 144.96675571"
67820240311,67,2024-03-11,8,74,106,180,FLDegS_T,"-37.81688755, 144.96562569"
68320250914,68,2025-09-14,3,2,2,4,FLDegN_T,"-37.8168479, 144.96559789"
56320240216,56,2024-02-16,3,6,11,17,Lon364_T,"-37.81234775, 144.96153311"
721920241120,72,2024-11-20,19,196,409,605,ACMI_T,"-37.81726338, 144.96872809"
721920231225,72,2023-12-25,19,216,296,512,ACMI_T,"-37.81726338, 144.96872809"
35520240424,35,2024-04-24,5,68,44,112,SouthB_T,"-37.82018685, 144.96508508"
2020250618,2,2025-06-18,0,12,22,34,Bou283_T,"-37.81380668, 144.96516718"
91220240804,9,2024-08-04,12,38,65,103,Col700_T,"-37.81982992, 144.95102555"
25220231104,25,2023-11-04,2,12,19,31,MCEC_T,"-37.82401776, 144.95604426"
521220250417,52,2025-04-17,12,445,366,811,Eli263_T,"-37.81252157, 144.9619401"
51520250627,51,2025-06-27,5,12,8,20,Fra118_T,"-37.80841815, 144.95906316"
462020250522,46,2025-05-22,20,4,1,5,Pel147_T,"-37.80240719, 144.9615673"
117620250819,117,2025-08-19,6,62,26,88,Fli114F_T,"-37.81629332, 144.97090877"
1172320250823,117,2025-08-23,23,197,315,512,Fli114F_T,"-37.81629332, 144.97090877"
1232220250116,123,2025-01-16,22,16,8,24,BirBridge_T,"-37.81753741, 144.97329734"
109720240716,109,2024-07-16,7,45,254,299,LatWill_T,"-37.81193681, 144.95621105"
191920231119,19,2023-11-19,19,665,535,1200,LtB210_T,"-37.81237202, 144.96550671"
137720250209,137,2025-02-09,7,0,7,7,BouHbr2353_T,"-37.81894815, 144.94612292"
51120250510,5,2025-05-10,11,1071,909,1980,PriNW_T,"-37.81874249, 144.96787656"
612120250430,61,2025-04-30,21,261,125,386,RMIT14_T,"-37.80767455, 144.96309114"
502120240106,50,2024-01-06,21,322,226,548,Lyg309_T,"-37.79808192, 144.96721013"
43420240215,43,2024-02-15,4,1,0,1,UM2_T,"-37.79844526, 144.96411782"
182420250714,182,2025-07-14,4,10,8,18,King163_T,"-37.81627451, 144.95550503"
185520250914,185,2025-09-14,5,17,26,43,Eli197_T,"-37.81374643, 144.96276183"
140620231210,140,2023-12-10,6,10,4,14,Boyd2837_T,"-37.82590962, 144.96185972"
131020250616,131,2025-06-16,0,8,10,18,King2_T,"-37.82009057, 144.95758725"
134520250808,134,2025-08-08,5,60,55,115,Spen201_T,"-37.81694221, 144.95303935"
1341920231117,134,2023-11-17,19,308,283,591,Spen201_T,"-37.81694221, 144.95303935"
134220240516,134,2024-05-16,2,17,17,34,Spen201_T,"-37.81694221, 144.95303935"
1241020231230,124,2023-12-30,10,0,1,1,BirBridge_T,"-37.81757416, 144.97329934"
107920251001,107,2025-10-01,9,72,187,259,280Will_T,"-37.81246271, 144.95690188"
181720240402,18,2024-04-02,17,375,18,393,Col12_T,"-37.81344862, 144.97305353"
18320250723,18,2025-07-23,3,0,3,3,Col12_T,"-37.81344862, 144.97305353"
862020231111,86,2023-11-11,20,10,28,38,574Qub_T,"-37.80309992, 144.94908064"
862220240211,86,2024-02-11,22,10,12,22,574Qub_T,"-37.80309992, 144.94908064"
111820250303,11,2025-03-03,18,134,119,253,WatCit_T,"-37.81564989, 144.93970694"
102220250929,10,2025-09-29,22,16,10,26,BouHbr_T,"-37.81876474, 144.94710545"
351320250723,35,2025-07-23,13,946,1089,2035,SouthB_T,"-37.82018685, 144.96508508"
35320240229,35,2024-02-29,3,10,17,27,SouthB_T,"-37.82018685, 144.96508508"
53520240715,53,2024-07-15,5,17,22,39,Col254_T,"-37.81564191, 144.965499"
91320231228,9,2023-12-28,13,80,115,195,Col700_T,"-37.81982992, 144.95102555"
27920241002,27,2024-10-02,9,53,90,143,Vic_T,"-37.80606888, 144.95644692"
9220241208,9,2024-12-08,2,2,10,12,Col700_T,"-37.81982992, 144.95102555"
23320250818,23,2025-08-18,3,8,8,16,Col623_T,"-37.81909256, 144.95452748"
25420241217,25,2024-12-17,4,10,6,16,MCEC_T,"-37.82401776, 144.95604426"
25520251006,25,2025-10-06,5,28,22,50,MCEC_T,"-37.82401776, 144.95604426"
1371420250122,137,2025-01-22,14,28,80,108,BouHbr2353_T,"-37.81894815, 144.94612292"
1411820250304,141,2025-03-04,18,123,139,262,474Fl_T,"-37.81997273, 144.95834911"
139120250308,139,2025-03-08,1,10,14,24,Signal1647_T,"-37.81959923, 144.9632832"
1422020250429,142,2025-04-29,20,8,6,14,Hammer1584_T,"-37.81970749, 144.96795734"
161820240926,161,2024-09-26,8,159,160,319,BirArt1109_T,"-37.81851276, 144.97131336"
1611520250825,161,2025-08-25,15,142,94,236,BirArt1109_T,"-37.81851276, 144.97131336"
1171320241209,117,2024-12-09,13,175,200,375,Fli114F_T,"-37.81629332, 144.97090877"
1171820241215,117,2024-12-15,18,108,165,273,Fli114F_T,"-37.81629332, 144.97090877"
1092320250607,109,2025-06-07,23,29,53,82,LatWill_T,"-37.81193681, 144.95621105"
109020240214,109,2024-02-14,0,6,34,40,LatWill_T,"-37.81193681, 144.95621105"
191320250827,19,2025-08-27,13,418,371,789,LtB210_T,"-37.81237202, 144.96550671"
842120231215,84,2023-12-15,21,1129,1777,2906,ElFi_T,"-37.81798049, 144.96503383"
41420241010,4,2024-10-10,14,1330,1248,2578,Swa123_T,"-37.81487988, 144.9660878"
70820240207,70,2024-02-07,8,80,72,152,Errol20_T,"-37.80456984, 144.94946228"
701120240910,70,2024-09-10,11,118,112,230,Errol20_T,"-37.80456984, 144.94946228"
751020241126,75,2024-11-26,10,15,30,45,SprFli_T,"-37.81515276, 144.97467661"
31720250514,3,2025-05-14,17,955,1185,2140,Swa295_T,"-37.81101524, 144.96429485"
411820240908,41,2024-09-08,18,98,69,167,Swa31,"-37.81668634, 144.96689733"
771120240930,77,2024-09-30,11,124,80,204,HarEsP_T,"-37.81441438, 144.94433026"
78020250516,78,2025-05-16,0,0,3,3,HarEsB_T,"-37.81471642, 144.9446508"
121920231124,12,2023-11-24,19,194,195,389,NewQ_T,"-37.81457988, 144.94292398"
101120250216,10,2025-02-16,11,30,20,50,BouHbr_T,"-37.81876474, 144.94710545"
101220250622,10,2025-06-22,12,99,45,144,BouHbr_T,"-37.81876474, 144.94710545"
101620240330,10,2024-03-30,16,84,39,123,BouHbr_T,"-37.81876474, 144.94710545"
72520240810,72,2024-08-10,5,13,8,21,ACMI_T,"-37.81726338, 144.96872809"
72220240126,72,2024-01-26,2,9,11,20,ACMI_T,"-37.81726338, 144.96872809"
76920240925,76,2024-09-25,9,22,10,32,KenMac_T,"-37.79453803, 144.93036194"
351920241003,35,2024-10-03,19,1227,1325,2552,SouthB_T,"-37.82018685, 144.96508508"
27020231031,27,2023-10-31,0,7,9,16,Vic_T,"-37.80606888, 144.95644692"
79920231122,79,2023-11-22,9,507,297,804,FliSS_T,"-37.81794046, 144.96616678"
231020241118,23,2024-11-18,10,191,200,391,Col623_T,"-37.81909256, 144.95452748"
461420250106,46,2025-01-06,14,19,28,47,Pel147_T,"-37.80240719, 144.9615673"
1301620240324,130,2024-03-24,16,5,16,21,Bou892T,"-37.8204637, 144.94126826"
1301120241230,130,2024-12-30,11,42,16,58,Bou892T,"-37.8204637, 144.94126826"
1381120231130,138,2023-11-30,11,4,3,7,EntPark1671_T,"-37.81996544, 144.95981454"
1381720241207,138,2024-12-07,17,4,1,5,EntPark1671_T,"-37.81996544, 144.95981454"
1231220250222,123,2025-02-22,12,16,17,33,BirBridge_T,"-37.81753741, 144.97329734"
1231420250721,123,2025-07-21,14,47,16,63,BirBridge_T,"-37.81753741, 144.97329734"
117820250505,117,2025-05-05,8,332,100,432,Fli114F_T,"-37.81629332, 144.97090877"
117820250807,117,2025-08-07,8,458,104,562,Fli114F_T,"-37.81629332, 144.97090877"
1171220240410,117,2024-04-10,12,72,179,251,Fli114F_T,"-37.81629332, 144.97090877"
1172120240708,117,2024-07-08,21,75,40,115,Fli114F_T,"-37.81629332, 144.97090877"
1091720250712,109,2025-07-12,17,64,105,169,LatWill_T,"-37.81193681, 144.95621105"
631920240221,63,2024-02-21,19,156,266,422,Bou231_T,"-37.81333081, 144.96675571"
67720250825,67,2025-08-25,7,144,120,264,FLDegS_T,"-37.81688755, 144.96562569"
86220240210,86,2024-02-10,2,1,2,3,574Qub_T,"-37.80309992, 144.94908064"
861020240303,86,2024-03-03,10,40,21,61,574Qub_T,"-37.80309992, 144.94908064"
701520250518,70,2025-05-18,15,164,127,291,Errol20_T,"-37.80456984, 144.94946228"
3620250407,3,2025-04-07,6,27,71,98,Swa295_T,"-37.81101524, 144.96429485"
752320241003,75,2024-10-03,23,5,9,14,SprFli_T,"-37.81515276, 144.97467661"
39520240715,39,2024-07-15,5,6,6,12,AlfPl_T,"-37.81379749, 144.96995745"
78520250521,78,2025-05-21,5,1,0,1,HarEsB_T,"-37.81471642, 144.9446508"
291120240428,29,2024-04-28,11,319,591,910,AG_T,"-37.8199817, 144.96872865"
14920250818,14,2025-08-18,9,190,179,369,SanBri_T,"-37.82011242, 144.96291897"
141420240805,14,2024-08-05,14,282,92,374,SanBri_T,"-37.82011242, 144.96291897"
592220250814,59,2025-08-14,22,280,187,467,RMIT_T,"-37.80825648, 144.96304859"
592220240513,59,2024-05-13,22,247,131,378,RMIT_T,"-37.80825648, 144.96304859"
472320240309,47,2024-03-09,23,464,306,770,Eli250_T,"-37.81258467, 144.9625775"
371520250422,37,2025-04-22,15,74,85,159,Lyg260_T,"-37.80107122, 144.96704554"
37020250901,37,2025-09-01,0,14,7,21,Lyg260_T,"-37.80107122, 144.96704554"
45020240318,45,2024-03-18,0,43,106,149,Swa148_T,"-37.81414075, 144.96609379"
1312120231103,131,2023-11-03,21,81,113,194,King2_T,"-37.82009057, 144.95758725"
78220250519,78,2025-05-19,2,0,1,1,HarEsB_T,"-37.81471642, 144.9446508"
782320240305,78,2024-03-05,23,4,6,10,HarEsB_T,"-37.81471642, 144.9446508"
592320250818,59,2025-08-18,23,120,102,222,RMIT_T,"-37.80825648, 144.96304859"
592020250824,59,2025-08-24,20,462,289,751,RMIT_T,"-37.80825648, 144.96304859"
592020250114,59,2025-01-14,20,347,297,644,RMIT_T,"-37.80825648, 144.96304859"
59420250525,59,2025-05-25,4,24,7,31,RMIT_T,"-37.80825648, 144.96304859"
281720250811,28,2025-08-11,17,587,937,1524,VAC_T,"-37.82129925, 144.96879309"
29520231211,29,2023-12-11,5,12,15,27,AG_T,"-37.8199817, 144.96872865"
311320240725,31,2024-07-25,13,132,135,267,Lyg161_T,"-37.80169681, 144.96658911"
361920250104,36,2025-01-04,19,101,104,205,Que85_T,"-37.81652527, 144.96121062"
37020240201,37,2024-02-01,0,7,21,28,Lyg260_T,"-37.80107122, 144.96704554"
471020240211,47,2024-02-11,10,474,698,1172,Eli250_T,"-37.81258467, 144.9625775"
612320241205,61,2024-12-05,23,168,80,248,RMIT14_T,"-37.80767455, 144.96309114"
611120250209,61,2025-02-09,11,402,482,884,RMIT14_T,"-37.80767455, 144.96309114"
612020240503,61,2024-05-03,20,284,267,551,RMIT14_T,"-37.80767455, 144.96309114"
61420240911,61,2024-09-11,4,3,9,12,RMIT14_T,"-37.80767455, 144.96309114"
501320250814,50,2025-08-14,13,239,211,450,Lyg309_T,"-37.79808192, 144.96721013"
43620240629,43,2024-06-29,6,22,9,31,UM2_T,"-37.79844526, 144.96411782"
441720240309,44,2024-03-09,17,0,5,5,UM3_T,"-37.79698741, 144.96441306"
165020250830,165,2025-08-30,0,4,2,6,Spen475_T,"-37.80953359, 144.94939004"
1671620250915,167,2025-09-15,16,76,85,161,Lat526_T,"-37.81304149, 144.95155955"
140620240926,140,2024-09-26,6,37,16,53,Boyd2837_T,"-37.82590962, 144.96185972"
1401220250924,140,2025-09-24,12,93,62,155,Boyd2837_T,"-37.82590962, 144.96185972"
143920250418,143,2025-04-18,9,81,195,276,Spencer_T,"-37.821728, 144.95557015"
1321620240805,132,2024-08-05,16,163,173,336,King335_T,"-37.81267639, 144.95386444"
1311020240425,131,2024-04-25,10,57,195,252,King2_T,"-37.82009057, 144.95758725"
1351720240527,135,2024-05-27,17,329,393,722,Spen161_T,"-37.8172861, 144.95319102"
1182320250216,118,2025-02-16,23,3,2,5,Fli114C_T,"-37.81632783, 144.97090512"
107320241118,107,2024-11-18,3,4,1,5,280Will_T,"-37.81246271, 144.95690188"
682120240802,68,2024-08-02,21,91,29,120,FLDegN_T,"-37.8168479, 144.96559789"
681420251003,68,2025-10-03,14,409,416,825,FLDegN_T,"-37.8168479, 144.96559789"
851820250602,85,2025-06-02,18,56,82,138,488Mac_T,"-37.79432415, 144.92973378"
171020240805,17,2024-08-05,10,307,197,504,Col15_T,"-37.81362543, 144.97323591"
171220240808,17,2024-08-08,12,733,637,1370,Col15_T,"-37.81362543, 144.97323591"
17820240913,17,2024-09-13,8,774,181,955,Col15_T,"-37.81362543, 144.97323591"
11820250307,1,2025-03-07,18,1225,937,2162,Bou292_T,"-37.81349441, 144.96515323"
1520250608,1,2025-06-08,5,6,12,18,Bou292_T,"-37.81349441, 144.96515323"
622020231227,62,2023-12-27,20,162,83,245,Lat224_T,"-37.80996494, 144.96216521"
111020240310,11,2024-03-10,10,41,41,82,WatCit_T,"-37.81564989, 144.93970694"
241120241205,24,2024-12-05,11,744,463,1207,Col620_T,"-37.81887963, 144.95449198"
10120231021,10,2023-10-21,1,6,4,10,BouHbr_T,"-37.81876474, 144.94710545"
101620240613,10,2024-06-13,16,200,33,233,BouHbr_T,"-37.81876474, 144.94710545"
721920250214,72,2025-02-14,19,177,318,495,ACMI_T,"-37.81726338, 144.96872809"
761120250205,76,2025-02-05,11,47,36,83,KenMac_T,"-37.79453803, 144.93036194"
58920231203,58,2023-12-03,9,435,134,569,Bou688_T,"-37.81686075, 144.95358075"
21420250623,2,2025-06-23,14,530,506,1036,Bou283_T,"-37.81380668, 144.96516718"
27520240823,27,2024-08-23,5,7,5,12,Vic_T,"-37.80606888, 144.95644692"
53920250124,53,2025-01-24,9,415,216,631,Col254_T,"-37.81564191, 144.965499"
231520250807,23,2025-08-07,15,253,352,605,Col623_T,"-37.81909256, 144.95452748"
1621620250308,162,2025-03-08,16,366,671,1037,Eli489_T,"-37.80740397, 144.95987909"
1431820240626,143,2024-06-26,18,169,187,356,Spencer_T,"-37.821728, 144.95557015"
1341520250702,134,2025-07-02,15,153,179,332,Spen201_T,"-37.81694221, 144.95303935"
135920250406,135,2025-04-06,9,377,517,894,Spen161_T,"-37.8172861, 144.95319102"
1351120241218,135,2024-12-18,11,523,430,953,Spen161_T,"-37.8172861, 144.95319102"
1071920240809,107,2024-08-09,19,93,138,231,280Will_T,"-37.81246271, 144.95690188"
133020250110,133,2025-01-10,0,54,36,90,Spen229_T,"-37.81531435, 144.95227769"
133320250207,133,2025-02-07,3,8,14,22,Spen229_T,"-37.81531435, 144.95227769"
1332320250406,133,2025-04-06,23,54,30,84,Spen229_T,"-37.81531435, 144.95227769"
184120250927,184,2025-09-27,1,35,81,116,Eli124_T,"-37.81512416, 144.96371988"
1661320250206,166,2025-02-06,13,58,43,101,Spen484_T,"-37.80896733, 144.94931703"
85820240417,85,2024-04-17,8,147,60,207,488Mac_T,"-37.79432415, 144.92973378"
171020231021,17,2023-10-21,10,151,93,244,Col15_T,"-37.81362543, 144.97323591"
181220251004,18,2025-10-04,12,82,93,175,Col12_T,"-37.81344862, 144.97305353"
861820250705,86,2025-07-05,18,64,35,99,574Qub_T,"-37.80309992, 144.94908064"
672020240816,67,2024-08-16,20,369,571,940,FLDegS_T,"-37.81688755, 144.96562569"
68020240309,68,2024-03-09,0,18,7,25,FLDegN_T,"-37.8168479, 144.96559789"
12820250430,12,2025-04-30,8,188,124,312,NewQ_T,"-37.81457988, 144.94292398"
121020240524,12,2024-05-24,10,147,91,238,NewQ_T,"-37.81457988, 144.94292398"
121020250825,12,2025-08-25,10,103,81,184,NewQ_T,"-37.81457988, 144.94292398"
111120250830,11,2025-08-30,11,36,35,71,WatCit_T,"-37.81564989, 144.93970694"
101620240225,10,2024-02-25,16,8,11,19,BouHbr_T,"-37.81876474, 144.94710545"
76920250623,76,2025-06-23,9,61,49,110,KenMac_T,"-37.79453803, 144.93036194"
35620241219,35,2024-12-19,6,231,302,533,SouthB_T,"-37.82018685, 144.96508508"
35220240215,35,2024-02-15,2,14,23,37,SouthB_T,"-37.82018685, 144.96508508"
352120240521,35,2024-05-21,21,297,655,952,SouthB_T,"-37.82018685, 144.96508508"
27720240710,27,2024-07-10,7,30,41,71,Vic_T,"-37.80606888, 144.95644692"
21820250312,2,2025-03-12,18,475,385,860,Bou283_T,"-37.81380668, 144.96516718"
272320250616,27,2025-06-16,23,13,4,17,Vic_T,"-37.80606888, 144.95644692"
791420240514,79,2024-05-14,14,455,346,801,FliSS_T,"-37.81794046, 144.96616678"
53420250816,53,2025-08-16,4,8,4,12,Col254_T,"-37.81564191, 144.965499"
46620240719,46,2024-07-19,6,7,4,11,Pel147_T,"-37.80240719, 144.9615673"
251320250228,25,2025-02-28,13,535,564,1099,MCEC_T,"-37.82401776, 144.95604426"
521120250721,52,2025-07-21,11,250,180,430,Eli263_T,"-37.81252157, 144.9619401"
46920250302,46,2025-03-02,9,20,21,41,Pel147_T,"-37.80240719, 144.9615673"
49920250817,49,2025-08-17,9,273,244,517,Eli501_T,"-37.80730068, 144.95956055"
1641320241201,164,2024-12-01,13,114,66,180,Lat526_T,"-37.813005, 144.95160411"
1372020240703,137,2024-07-03,20,1,3,4,BouHbr2353_T,"-37.81894815, 144.94612292"
1361220241025,136,2024-10-25,12,173,80,253,BirFed1120_T,"-37.8184141, 144.97357915"
1381720231208,138,2023-12-08,17,5,5,10,EntPark1671_T,"-37.81996544, 144.95981454"
1171520240404,117,2024-04-04,15,134,205,339,Fli114F_T,"-37.81629332, 144.97090877"
49520240819,49,2024-08-19,5,12,11,23,Eli501_T,"-37.80730068, 144.95956055"
109920240917,109,2024-09-17,9,90,368,458,LatWill_T,"-37.81193681, 144.95621105"
661620250622,66,2025-06-22,16,1412,1478,2890,QVN_T,"-37.81057846, 144.96444294"
661420241213,66,2024-12-13,14,1055,1108,2163,QVN_T,"-37.81057846, 144.96444294"
61920240102,6,2024-01-02,19,337,336,673,FliS_T,"-37.81911705, 144.96558255"
61620250418,6,2025-04-18,16,1129,879,2008,FliS_T,"-37.81911705, 144.96558255"
84520250627,84,2025-06-27,5,31,30,61,ElFi_T,"-37.81798049, 144.96503383"
32120240907,3,2024-09-07,21,932,1026,1958,Swa295_T,"-37.81101524, 144.96429485"
751120240307,75,2024-03-07,11,51,42,93,SprFli_T,"-37.81515276, 144.97467661"
142720240914,142,2024-09-14,7,76,68,144,Hammer1584_T,"-37.81970749, 144.96795734"
1422220241216,142,2024-12-16,22,17,11,28,Hammer1584_T,"-37.81970749, 144.96795734"
661620241105,66,2024-11-05,16,1327,1323,2650,QVN_T,"-37.81057846, 144.96444294"
62320240218,6,2024-02-18,23,449,464,913,FliS_T,"-37.81911705, 144.96558255"
61720240825,6,2024-08-25,17,672,575,1247,FliS_T,"-37.81911705, 144.96558255"
70520240630,70,2024-06-30,5,1,3,4,Errol20_T,"-37.80456984, 144.94946228"
70320250101,70,2025-01-01,3,4,3,7,Errol20_T,"-37.80456984, 144.94946228"
421920240730,42,2024-07-30,19,124,269,393,UM1_T,"-37.80008566, 144.96386412"
77320250606,77,2025-06-06,3,2,1,3,HarEsP_T,"-37.81441438, 144.94433026"
592320240325,59,2024-03-25,23,142,89,231,RMIT_T,"-37.80825648, 144.96304859"
292320250719,29,2025-07-19,23,35,88,123,AG_T,"-37.8199817, 144.96872865"
29320250721,29,2025-07-21,3,0,1,1,AG_T,"-37.8199817, 144.96872865"
472320240420,47,2024-04-20,23,343,377,720,Eli250_T,"-37.81258467, 144.9625775"
471920240130,47,2024-01-30,19,601,455,1056,Eli250_T,"-37.81258467, 144.9625775"
31320241107,31,2024-11-07,3,1,0,1,Lyg161_T,"-37.80169681, 144.96658911"
45120240905,45,2024-09-05,1,17,26,43,Swa148_T,"-37.81414075, 144.96609379"
5720250821,5,2025-08-21,7,221,442,663,PriNW_T,"-37.81874249, 144.96787656"
21120250223,21,2025-02-23,1,162,225,387,Bourke155_T,"-37.81267313, 144.96788288"
21120240329,21,2024-03-29,1,231,244,475,Bourke155_T,"-37.81267313, 144.96788288"
108420241127,108,2024-11-27,4,3,6,9,261Will_T,"-37.81295822, 144.95678789"
872020240921,87,2024-09-21,20,49,61,110,Errol23_T,"-37.80454949, 144.94921863"
50520241206,50,2024-12-06,5,0,6,6,Lyg309_T,"-37.79808192, 144.96721013"
43420241014,43,2024-10-14,4,1,0,1,UM2_T,"-37.79844526, 144.96411782"
431620241218,43,2024-12-18,16,79,67,146,UM2_T,"-37.79844526, 144.96411782"
43820231106,43,2023-11-06,8,98,39,137,UM2_T,"-37.79844526, 144.96411782"
167620250918,167,2025-09-18,6,7,36,43,Lat526_T,"-37.81304149, 144.95155955"
181520250415,181,2025-04-15,5,36,54,90,Eli368_T,"-37.81009465, 144.96143149"
140720241114,140,2024-11-14,7,110,21,131,Boyd2837_T,"-37.82590962, 144.96185972"
1321620241123,132,2024-11-23,16,130,139,269,King335_T,"-37.81267639, 144.95386444"
1321020250110,132,2025-01-10,10,155,82,237,King335_T,"-37.81267639, 144.95386444"
135120250810,135,2025-08-10,1,48,60,108,Spen161_T,"-37.8172861, 144.95319102"
1351620231105,135,2023-11-05,16,442,377,819,Spen161_T,"-37.8172861, 144.95319102"
1351020231223,135,2023-12-23,10,351,330,681,Spen161_T,"-37.8172861, 144.95319102"
107420240102,107,2024-01-02,4,3,2,5,280Will_T,"-37.81246271, 144.95690188"
1181220250226,118,2025-02-26,12,13,21,34,Fli114C_T,"-37.81632783, 144.97090512"
172220250312,17,2025-03-12,22,52,60,112,Col15_T,"-37.81362543, 144.97323591"
631120240730,63,2024-07-30,11,205,262,467,Bou231_T,"-37.81333081, 144.96675571"
67220250312,67,2025-03-12,2,4,3,7,FLDegS_T,"-37.81688755, 144.96562569"
181420231027,18,2023-10-27,14,246,138,384,Col12_T,"-37.81344862, 144.97305353"
582020231221,58,2023-12-21,20,339,243,582,Bou688_T,"-37.81686075, 144.95358075"
531320240321,53,2024-03-21,13,1042,908,1950,Col254_T,"-37.81564191, 144.965499"
53120240727,53,2024-07-27,1,11,25,36,Col254_T,"-37.81564191, 144.965499"
9820240321,9,2024-03-21,8,151,3349,3500,Col700_T,"-37.81982992, 144.95102555"
301320240503,30,2024-05-03,13,326,390,716,Lon189_T,"-37.8112185, 144.96656806"
202220240222,20,2024-02-22,22,114,343,457,LtB170_T,"-37.81172914, 144.9682466"
511620241108,51,2024-11-08,16,89,103,192,Fra118_T,"-37.80841815, 144.95906316"
117920240515,117,2024-05-15,9,213,91,304,Fli114F_T,"-37.81629332, 144.97090877"
751120250712,75,2025-07-12,11,69,34,103,SprFli_T,"-37.81515276, 144.97467661"
81620250728,8,2025-07-28,16,134,262,396,WebBN_T,"-37.82293543, 144.9471751"
411920231206,41,2023-12-06,19,1159,1280,2439,Swa31,"-37.81668634, 144.96689733"
8220250521,8,2025-05-21,2,2,0,2,WebBN_T,"-37.82293543, 144.9471751"
78920241010,78,2024-10-10,9,32,19,51,HarEsB_T,"-37.81471642, 144.9446508"
281920250809,28,2025-08-09,19,638,591,1229,VAC_T,"-37.82129925, 144.96879309"
281820240413,28,2024-04-13,18,640,428,1068,VAC_T,"-37.82129925, 144.96879309"
471120231218,47,2023-12-18,11,668,775,1443,Eli250_T,"-37.81258467, 144.9625775"
40020250322,40,2025-03-22,0,34,13,47,Spr201_T,"-37.80999341, 144.97227587"
51820240222,5,2024-02-22,18,872,1255,2127,PriNW_T,"-37.81874249, 144.96787656"
37220241016,37,2024-10-16,2,6,3,9,Lyg260_T,"-37.80107122, 144.96704554"
61720240114,61,2024-01-14,7,15,51,66,RMIT14_T,"-37.80767455, 144.96309114"
611920240319,61,2024-03-19,19,380,482,862,RMIT14_T,"-37.80767455, 144.96309114"
441720250216,44,2025-02-16,17,36,38,74,UM3_T,"-37.79698741, 144.96441306"
50920250411,50,2025-04-11,9,54,111,165,Lyg309_T,"-37.79808192, 144.96721013"
43620241006,43,2024-10-06,6,1,3,4,UM2_T,"-37.79844526, 144.96411782"
44120240423,44,2024-04-23,1,0,1,1,UM3_T,"-37.79698741, 144.96441306"
452020240411,45,2024-04-11,20,642,1025,1667,Swa148_T,"-37.81414075, 144.96609379"
1401420250414,140,2025-04-14,14,2,2,4,Boyd2837_T,"-37.82590962, 144.96185972"
1312120240921,131,2024-09-21,21,228,116,344,King2_T,"-37.82009057, 144.95758725"
1321920250324,132,2025-03-24,19,165,183,348,King335_T,"-37.81267639, 144.95386444"
134320250821,134,2025-08-21,3,15,12,27,Spen201_T,"-37.81694221, 144.95303935"
1181820231216,118,2023-12-16,18,26,50,76,Fli114C_T,"-37.81632783, 144.97090512"
118720250511,118,2025-05-11,7,3,16,19,Fli114C_T,"-37.81632783, 144.97090512"
1181920250611,118,2025-06-11,19,4,8,12,Fli114C_T,"-37.81632783, 144.97090512"
182620250701,182,2025-07-01,6,20,36,56,King163_T,"-37.81627451, 144.95550503"
451820231125,45,2023-11-25,18,644,946,1590,Swa148_T,"-37.81414075, 144.96609379"
140920241109,140,2024-11-09,9,94,41,135,Boyd2837_T,"-37.82590962, 144.96185972"
143820250907,143,2025-09-07,8,85,123,208,Spencer_T,"-37.821728, 144.95557015"
132420240808,132,2024-08-08,4,4,5,9,King335_T,"-37.81267639, 144.95386444"
132020250206,132,2025-02-06,0,20,25,45,King335_T,"-37.81267639, 144.95386444"
1341120250425,134,2025-04-25,11,479,541,1020,Spen201_T,"-37.81694221, 144.95303935"
135920250102,135,2025-01-02,9,244,282,526,Spen161_T,"-37.8172861, 144.95319102"
107020241029,107,2024-10-29,0,11,13,24,280Will_T,"-37.81246271, 144.95690188"
1331320240328,133,2024-03-28,13,541,497,1038,Spen229_T,"-37.81531435, 144.95227769"
1181620240729,118,2024-07-29,16,12,28,40,Fli114C_T,"-37.81632783, 144.97090512"
1081420250628,108,2025-06-28,14,145,167,312,261Will_T,"-37.81295822, 144.95678789"
179220250812,179,2025-08-12,2,2,1,3,Pow61_T,"-37.82392385, 144.96299677"
1661420240928,166,2024-09-28,14,52,54,106,Spen484_T,"-37.80896733, 144.94931703"
166820250726,166,2025-07-26,8,16,29,45,Spen484_T,"-37.80896733, 144.94931703"
67720240524,67,2024-05-24,7,123,98,221,FLDegS_T,"-37.81688755, 144.96562569"
672120250427,67,2025-04-27,21,70,112,182,FLDegS_T,"-37.81688755, 144.96562569"
181120231102,18,2023-11-02,11,196,229,425,Col12_T,"-37.81344862, 144.97305353"
86720250725,86,2025-07-25,7,20,10,30,574Qub_T,"-37.80309992, 144.94908064"
62420240611,62,2024-06-11,4,9,6,15,Lat224_T,"-37.80996494, 144.96216521"
562220240911,56,2024-09-11,22,85,132,217,Lon364_T,"-37.81234775, 144.96153311"
56820250119,56,2025-01-19,8,65,51,116,Lon364_T,"-37.81234775, 144.96153311"
482120250121,48,2025-01-21,21,46,84,130,QVMQ_T,"-37.80631581, 144.95866697"
251920241002,25,2024-10-02,19,315,281,596,MCEC_T,"-37.82401776, 144.95604426"
1391820250913,139,2025-09-13,18,40,40,80,Signal1647_T,"-37.81959923, 144.9632832"
1422320250104,142,2025-01-04,23,16,10,26,Hammer1584_T,"-37.81970749, 144.96795734"
66320240217,66,2024-02-17,3,28,17,45,QVN_T,"-37.81057846, 144.96444294"
66920241028,66,2024-10-28,9,237,442,679,QVN_T,"-37.81057846, 144.96444294"
841220240514,84,2024-05-14,12,880,1018,1898,ElFi_T,"-37.81798049, 144.96503383"
84120240712,84,2024-07-12,1,49,60,109,ElFi_T,"-37.81798049, 144.96503383"
70220240222,70,2024-02-22,2,4,2,6,Errol20_T,"-37.80456984, 144.94946228"
32220240323,3,2024-03-23,22,920,909,1829,Swa295_T,"-37.81101524, 144.96429485"
82020250707,8,2025-07-07,20,4,4,8,WebBN_T,"-37.82293543, 144.9471751"
751420250628,75,2025-06-28,14,68,55,123,SprFli_T,"-37.81515276, 144.97467661"
78620241220,78,2024-12-20,6,15,13,28,HarEsB_T,"-37.81471642, 144.9446508"
421520240721,42,2024-07-21,15,117,109,226,UM1_T,"-37.80008566, 144.96386412"
772220240723,77,2024-07-23,22,10,4,14,HarEsP_T,"-37.81441438, 144.94433026"
281320241211,28,2024-12-11,13,655,539,1194,VAC_T,"-37.82129925, 144.96879309"
541820250307,54,2025-03-07,18,147,304,451,Swa607_T,"-37.804024, 144.96308399"
281320250114,28,2025-01-14,13,974,1016,1990,VAC_T,"-37.82129925, 144.96879309"
47720231230,47,2023-12-30,7,55,85,140,Eli250_T,"-37.81258467, 144.9625775"
452320240517,45,2024-05-17,23,141,256,397,Swa148_T,"-37.81414075, 144.96609379"
1081920240714,108,2024-07-14,19,21,67,88,261Will_T,"-37.81295822, 144.95678789"
87520240427,87,2024-04-27,5,5,3,8,Errol23_T,"-37.80454949, 144.94921863"
501420240224,50,2024-02-24,14,295,320,615,Lyg309_T,"-37.79808192, 144.96721013"
1651120241229,165,2024-12-29,11,28,63,91,Spen475_T,"-37.80953359, 144.94939004"
1431920240816,143,2024-08-16,19,194,205,399,Spencer_T,"-37.821728, 144.95557015"
134120250501,134,2025-05-01,1,28,37,65,Spen201_T,"-37.81694221, 144.95303935"
1341220250811,134,2025-08-11,12,483,440,923,Spen201_T,"-37.81694221, 144.95303935"
133820241113,133,2024-11-13,8,515,533,1048,Spen229_T,"-37.81531435, 144.95227769"
107720240812,107,2024-08-12,7,27,70,97,280Will_T,"-37.81246271, 144.95690188"
1071920241016,107,2024-10-16,19,100,122,222,280Will_T,"-37.81246271, 144.95690188"
133520250917,133,2025-09-17,5,73,45,118,Spen229_T,"-37.81531435, 144.95227769"
1182020240121,118,2024-01-21,20,50,21,71,Fli114C_T,"-37.81632783, 144.97090512"
108120250908,108,2025-09-08,1,12,15,27,261Will_T,"-37.81295822, 144.95678789"
1082220231019,108,2023-10-19,22,65,64,129,261Will_T,"-37.81295822, 144.95678789"
72320240420,72,2024-04-20,3,13,7,20,ACMI_T,"-37.81726338, 144.96872809"
72720231021,72,2023-10-21,7,36,33,69,ACMI_T,"-37.81726338, 144.96872809"
532120240110,53,2024-01-10,21,113,260,373,Col254_T,"-37.81564191, 144.965499"
302020240526,30,2024-05-26,20,196,377,573,Lon189_T,"-37.8112185, 144.96656806"
201020250213,20,2025-02-13,10,88,103,191,LtB170_T,"-37.81172914, 144.9682466"
51620250221,51,2025-02-21,6,37,28,65,Fra118_T,"-37.80841815, 144.95906316"
791420250712,79,2025-07-12,14,726,532,1258,FliSS_T,"-37.81794046, 144.96616678"
19320250616,19,2025-06-16,3,9,6,15,LtB210_T,"-37.81237202, 144.96550671"
49620251001,49,2025-10-01,6,32,45,77,Eli501_T,"-37.80730068, 144.95956055"
109720240206,109,2024-02-06,7,39,272,311,LatWill_T,"-37.81193681, 144.95621105"
481420240322,48,2024-03-22,14,370,202,572,QVMQ_T,"-37.80631581, 144.95866697"
139720250322,139,2025-03-22,7,9,11,20,Signal1647_T,"-37.81959923, 144.9632832"
1421120240626,142,2024-06-26,11,294,343,637,Hammer1584_T,"-37.81970749, 144.96795734"
1362120251012,136,2025-10-12,21,0,3,3,BirFed1120_T,"-37.8184141, 144.97357915"
1381820231122,138,2023-11-22,18,9,2,11,EntPark1671_T,"-37.81996544, 144.95981454"
161820240713,161,2024-07-13,8,117,111,228,BirArt1109_T,"-37.81851276, 144.97131336"
851320250305,85,2025-03-05,13,70,71,141,488Mac_T,"-37.79432415, 144.92973378"
851020250502,85,2025-05-02,10,87,75,162,488Mac_T,"-37.79432415, 144.92973378"
851220250513,85,2025-05-13,12,76,95,171,488Mac_T,"-37.79432415, 144.92973378"
171820231026,17,2023-10-26,18,365,395,760,Col15_T,"-37.81362543, 144.97323591"
17920231110,17,2023-11-10,9,516,231,747,Col15_T,"-37.81362543, 144.97323591"
631720241221,63,2024-12-21,17,658,477,1135,Bou231_T,"-37.81333081, 144.96675571"
18620251016,18,2025-10-16,6,14,78,92,Col12_T,"-37.81344862, 144.97305353"
621120250317,62,2025-03-17,11,252,192,444,Lat224_T,"-37.80996494, 144.96216521"
621720250428,62,2025-04-28,17,305,224,529,Lat224_T,"-37.80996494, 144.96216521"
562120240324,56,2024-03-24,21,210,276,486,Lon364_T,"-37.81234775, 144.96153311"
56220240812,56,2024-08-12,2,1,12,13,Lon364_T,"-37.81234775, 144.96153311"
122320241025,12,2024-10-25,23,74,66,140,NewQ_T,"-37.81457988, 144.94292398"
121120250215,12,2025-02-15,11,170,164,334,NewQ_T,"-37.81457988, 144.94292398"
101520241107,10,2024-11-07,15,120,47,167,BouHbr_T,"-37.81876474, 144.94710545"
111120250623,11,2025-06-23,11,32,22,54,WatCit_T,"-37.81564989, 144.93970694"
122220250807,12,2025-08-07,22,11,29,40,NewQ_T,"-37.81457988, 144.94292398"
69920240526,69,2024-05-26,9,133,64,197,FLDegC_T,"-37.81687226, 144.96559144"
4020241005,4,2024-10-05,0,112,156,268,Swa123_T,"-37.81487988, 144.9660878"
70220250801,70,2025-08-01,2,0,1,1,Errol20_T,"-37.80456984, 144.94946228"
751920231102,75,2023-11-02,19,40,31,71,SprFli_T,"-37.81515276, 144.97467661"
39920241023,39,2024-10-23,9,103,85,188,AlfPl_T,"-37.81379749, 144.96995745"
75720250922,75,2025-09-22,7,31,21,52,SprFli_T,"-37.81515276, 144.97467661"
78420241116,78,2024-11-16,4,0,1,1,HarEsB_T,"-37.81471642, 144.9446508"
78620250806,78,2025-08-06,6,2,2,4,HarEsB_T,"-37.81471642, 144.9446508"
711220250428,71,2025-04-28,12,30,38,68,WestWP_T,"-37.81235775, 144.97136962"
59720240315,59,2024-03-15,7,185,97,282,RMIT_T,"-37.80825648, 144.96304859"
142320240212,14,2024-02-12,23,128,30,158,SanBri_T,"-37.82011242, 144.96291897"
311520240704,31,2024-07-04,15,114,121,235,Lyg161_T,"-37.80169681, 144.96658911"
541920240704,54,2024-07-04,19,101,111,212,Swa607_T,"-37.804024, 144.96308399"
54620240713,54,2024-07-13,6,8,3,11,Swa607_T,"-37.804024, 144.96308399"
28620250405,28,2025-04-05,6,51,49,100,VAC_T,"-37.82129925, 144.96879309"
31120250907,31,2025-09-07,1,21,21,42,Lyg161_T,"-37.80169681, 144.96658911"
212120241109,21,2024-11-09,21,324,434,758,Bourke155_T,"-37.81267313, 144.96788288"
36220250930,36,2025-09-30,2,5,5,10,Que85_T,"-37.81652527, 144.96121062"
37220250525,37,2025-05-25,2,5,3,8,Lyg260_T,"-37.80107122, 144.96704554"
36120231207,36,2023-12-07,1,5,6,11,Que85_T,"-37.81652527, 144.96121062"
611720250903,61,2025-09-03,17,497,561,1058,RMIT14_T,"-37.80767455, 144.96309114"
431420240610,43,2024-06-10,14,66,90,156,UM2_T,"-37.79844526, 144.96411782"
432320250914,43,2025-09-14,23,69,13,82,UM2_T,"-37.79844526, 144.96411782"
166520250123,166,2025-01-23,5,1,4,5,Spen484_T,"-37.80896733, 144.94931703"
140920240117,140,2024-01-17,9,21,6,27,Boyd2837_T,"-37.82590962, 144.96185972"
1401520240318,140,2024-03-18,15,79,98,177,Boyd2837_T,"-37.82590962, 144.96185972"
122220250626,12,2025-06-26,22,6,7,13,NewQ_T,"-37.81457988, 144.94292398"
102120240618,10,2024-06-18,21,17,9,26,BouHbr_T,"-37.81876474, 144.94710545"
721920240128,72,2024-01-28,19,228,294,522,ACMI_T,"-37.81726338, 144.96872809"
761420251015,76,2025-10-15,14,43,58,101,KenMac_T,"-37.79453803, 144.93036194"
582220250513,58,2025-05-13,22,132,182,314,Bou688_T,"-37.81686075, 144.95358075"
164520250928,164,2025-09-28,5,1,0,1,Lat526_T,"-37.813005, 144.95160411"
1372020231117,137,2023-11-17,20,13,17,30,BouHbr2353_T,"-37.81894815, 144.94612292"
1361520241019,136,2024-10-19,15,160,111,271,BirFed1120_T,"-37.8184141, 144.97357915"
1361020241221,136,2024-12-21,10,52,62,114,BirFed1120_T,"-37.8184141, 144.97357915"
142920250711,142,2025-07-11,9,230,188,418,Hammer1584_T,"-37.81970749, 144.96795734"
130920240219,130,2024-02-19,9,11,14,25,Bou892T,"-37.8204637, 144.94126826"
1381720240904,138,2024-09-04,17,5,3,8,EntPark1671_T,"-37.81996544, 144.95981454"
1231120250512,123,2025-05-12,11,28,22,50,BirBridge_T,"-37.81753741, 144.97329734"
1231320250716,123,2025-07-16,13,78,42,120,BirBridge_T,"-37.81753741, 144.97329734"
1232120240108,123,2024-01-08,21,0,2,2,BirBridge_T,"-37.81753741, 144.97329734"
481720250921,48,2025-09-21,17,121,127,248,QVMQ_T,"-37.80631581, 144.95866697"
1171120240912,117,2024-09-12,11,111,97,208,Fli114F_T,"-37.81629332, 144.97090877"
691920250215,69,2025-02-15,19,86,51,137,FLDegC_T,"-37.81687226, 144.96559144"
61120240429,6,2024-04-29,11,482,352,834,FliS_T,"-37.81911705, 144.96558255"
841020241114,84,2024-11-14,10,828,615,1443,ElFi_T,"-37.81798049, 144.96503383"
4620250820,4,2025-08-20,6,124,91,215,Swa123_T,"-37.81487988, 144.9660878"
701620240912,70,2024-09-12,16,161,156,317,Errol20_T,"-37.80456984, 144.94946228"
412020241017,41,2024-10-17,20,205,141,346,Swa31,"-37.81668634, 144.96689733"
411520250705,41,2025-07-05,15,1881,1745,3626,Swa31,"-37.81668634, 144.96689733"
411020240121,41,2024-01-21,10,1183,876,2059,Swa31,"-37.81668634, 144.96689733"
42020250709,42,2025-07-09,0,7,4,11,UM1_T,"-37.80008566, 144.96386412"
421420241127,42,2024-11-27,14,118,137,255,UM1_T,"-37.80008566, 144.96386412"
421820241213,42,2024-12-13,18,98,73,171,UM1_T,"-37.80008566, 144.96386412"
292220240914,29,2024-09-14,22,52,137,189,AG_T,"-37.8199817, 144.96872865"
592220250925,59,2025-09-25,22,371,247,618,RMIT_T,"-37.80825648, 144.96304859"
141120231226,14,2023-12-26,11,493,172,665,SanBri_T,"-37.82011242, 144.96291897"
59820240101,59,2024-01-01,8,48,46,94,RMIT_T,"-37.80825648, 144.96304859"
591020240427,59,2024-04-27,10,264,312,576,RMIT_T,"-37.80825648, 144.96304859"
542220250525,54,2025-05-25,22,76,81,157,Swa607_T,"-37.804024, 144.96308399"
401120250713,40,2025-07-13,11,143,205,348,Spr201_T,"-37.80999341, 144.97227587"
47120240602,47,2024-06-02,1,86,107,193,Eli250_T,"-37.81258467, 144.9625775"
37220240119,37,2024-01-19,2,0,6,6,Lyg260_T,"-37.80107122, 144.96704554"
61620250328,61,2025-03-28,6,37,61,98,RMIT14_T,"-37.80767455, 144.96309114"
871020231027,87,2023-10-27,10,110,99,209,Errol23_T,"-37.80454949, 144.94921863"
87620250609,87,2025-06-09,6,2,1,3,Errol23_T,"-37.80454949, 144.94921863"
612020240407,61,2024-04-07,20,168,149,317,RMIT14_T,"-37.80767455, 144.96309114"
431820240807,43,2024-08-07,18,164,304,468,UM2_T,"-37.79844526, 144.96411782"
431520241022,43,2024-10-22,15,120,113,233,UM2_T,"-37.79844526, 144.96411782"
431420240722,43,2024-07-22,14,245,362,607,UM2_T,"-37.79844526, 144.96411782"
441420240316,44,2024-03-16,14,11,24,35,UM3_T,"-37.79698741, 144.96441306"
451420231109,45,2023-11-09,14,474,707,1181,Swa148_T,"-37.81414075, 144.96609379"
691520240407,69,2024-04-07,15,195,195,390,FLDegC_T,"-37.81687226, 144.96559144"
69320240914,69,2024-09-14,3,7,3,10,FLDegC_T,"-37.81687226, 144.96559144"
1081620250131,108,2025-01-31,16,691,189,880,261Will_T,"-37.81295822, 144.95678789"
1081820250317,108,2025-03-17,18,614,194,808,261Will_T,"-37.81295822, 144.95678789"
1312020250302,131,2025-03-02,20,101,65,166,King2_T,"-37.82009057, 144.95758725"
671020231120,67,2023-11-20,10,320,359,679,FLDegS_T,"-37.81688755, 144.96562569"
181320250727,18,2025-07-27,13,94,51,145,Col12_T,"-37.81344862, 144.97305353"
11720251010,1,2025-10-10,17,1511,1191,2702,Bou292_T,"-37.81349441, 144.96515323"
72720231228,72,2023-12-28,7,47,26,73,ACMI_T,"-37.81726338, 144.96872809"
721920240810,72,2024-08-10,19,270,283,553,ACMI_T,"-37.81726338, 144.96872809"
351720240803,35,2024-08-03,17,2235,1870,4105,SouthB_T,"-37.82018685, 144.96508508"
762220240310,76,2024-03-10,22,3,5,8,KenMac_T,"-37.79453803, 144.93036194"
272320241022,27,2024-10-22,23,29,17,46,Vic_T,"-37.80606888, 144.95644692"
79620240917,79,2024-09-17,6,150,68,218,FliSS_T,"-37.81794046, 144.96616678"
521520240928,52,2024-09-28,15,279,267,546,Eli263_T,"-37.81252157, 144.9619401"
522320241020,52,2024-10-20,23,36,44,80,Eli263_T,"-37.81252157, 144.9619401"
51620240222,51,2024-02-22,6,18,24,42,Fra118_T,"-37.80841815, 144.95906316"
231220240716,23,2024-07-16,12,404,516,920,Col623_T,"-37.81909256, 144.95452748"
79720241213,79,2024-12-13,7,212,121,333,FliSS_T,"-37.81794046, 144.96616678"
491720240921,49,2024-09-21,17,199,220,419,Eli501_T,"-37.80730068, 144.95956055"
252320250705,25,2025-07-05,23,265,167,432,MCEC_T,"-37.82401776, 144.95604426"
1391720240421,139,2024-04-21,17,55,39,94,Signal1647_T,"-37.81959923, 144.9632832"
661720240822,66,2024-08-22,17,1486,1677,3163,QVN_T,"-37.81057846, 144.96444294"
69320240501,69,2024-05-01,3,2,3,5,FLDegC_T,"-37.81687226, 144.96559144"
69920250110,69,2025-01-10,9,182,93,275,FLDegC_T,"-37.81687226, 144.96559144"
69620250503,69,2025-05-03,6,4,7,11,FLDegC_T,"-37.81687226, 144.96559144"
841720240317,84,2024-03-17,17,900,1263,2163,ElFi_T,"-37.81798049, 144.96503383"
751920240618,75,2024-06-18,19,5,12,17,SprFli_T,"-37.81515276, 144.97467661"
39720250407,39,2025-04-07,7,46,36,82,AlfPl_T,"-37.81379749, 144.96995745"
81720240729,8,2024-07-29,17,252,385,637,WebBN_T,"-37.82293543, 144.9471751"
411920250722,41,2025-07-22,19,538,805,1343,Swa31,"-37.81668634, 144.96689733"
77720250826,77,2025-08-26,7,54,83,137,HarEsP_T,"-37.81441438, 144.94433026"
71920250220,71,2025-02-20,9,18,17,35,WestWP_T,"-37.81235775, 144.97136962"
141320240126,14,2024-01-26,13,478,162,640,SanBri_T,"-37.82011242, 144.96291897"
59920240421,59,2024-04-21,9,131,171,302,RMIT_T,"-37.80825648, 144.96304859"
312320231210,31,2023-12-10,23,36,55,91,Lyg161_T,"-37.80169681, 144.96658911"
372320250609,37,2025-06-09,23,22,28,50,Lyg260_T,"-37.80107122, 144.96704554"
1081020240622,108,2024-06-22,10,50,86,136,261Will_T,"-37.81295822, 144.95678789"
501220250514,50,2025-05-14,12,204,220,424,Lyg309_T,"-37.79808192, 144.96721013"
61520240101,6,2024-01-01,15,909,817,1726,FliS_T,"-37.81911705, 144.96558255"
84920240411,84,2024-04-11,9,918,414,1332,ElFi_T,"-37.81798049, 144.96503383"
701720231217,70,2023-12-17,17,113,140,253,Errol20_T,"-37.80456984, 144.94946228"
32220240426,3,2024-04-26,22,1077,885,1962,Swa295_T,"-37.81101524, 144.96429485"
81820250428,8,2025-04-28,18,39,50,89,WebBN_T,"-37.82293543, 144.9471751"
772220240412,77,2024-04-12,22,445,52,497,HarEsP_T,"-37.81441438, 144.94433026"
142320250722,14,2025-07-22,23,9,1,10,SanBri_T,"-37.82011242, 144.96291897"
14020240125,14,2024-01-25,0,30,17,47,SanBri_T,"-37.82011242, 144.96291897"
712220250105,71,2025-01-05,22,2,2,4,WestWP_T,"-37.81235775, 144.97136962"
591120240612,59,2024-06-12,11,368,448,816,RMIT_T,"-37.80825648, 144.96304859"
28720250907,28,2025-09-07,7,23,39,62,VAC_T,"-37.82129925, 144.96879309"
40520241024,40,2024-10-24,5,8,16,24,Spr201_T,"-37.80999341, 144.97227587"
51620240523,5,2024-05-23,16,1157,838,1995,PriNW_T,"-37.81874249, 144.96787656"
5120240918,5,2024-09-18,1,6,12,18,PriNW_T,"-37.81874249, 144.96787656"
371020240418,37,2024-04-18,10,81,56,137,Lyg260_T,"-37.80107122, 144.96704554"
431820231222,43,2023-12-22,18,59,42,101,UM2_T,"-37.79844526, 144.96411782"
43020240414,43,2024-04-14,0,19,16,35,UM2_T,"-37.79844526, 144.96411782"
452120240729,45,2024-07-29,21,139,283,422,Swa148_T,"-37.81414075, 144.96609379"
140720250804,140,2025-08-04,7,95,17,112,Boyd2837_T,"-37.82590962, 144.96185972"
1312120250723,131,2025-07-23,21,70,49,119,King2_T,"-37.82009057, 144.95758725"
1311920250730,131,2025-07-30,19,58,68,126,King2_T,"-37.82009057, 144.95758725"
131520251006,131,2025-10-06,5,5,2,7,King2_T,"-37.82009057, 144.95758725"
162120250531,162,2025-05-31,1,61,53,114,Eli489_T,"-37.80740397, 144.95987909"
162020240703,162,2024-07-03,0,30,35,65,Eli489_T,"-37.80740397, 144.95987909"
1622020250120,162,2025-01-20,20,202,146,348,Eli489_T,"-37.80740397, 144.95987909"
1321320250320,132,2025-03-20,13,209,135,344,King335_T,"-37.81267639, 144.95386444"
134320240105,134,2024-01-05,3,25,29,54,Spen201_T,"-37.81694221, 144.95303935"
1352020231110,135,2023-11-10,20,183,189,372,Spen161_T,"-37.8172861, 144.95319102"
107720250528,107,2025-05-28,7,39,96,135,280Will_T,"-37.81246271, 144.95690188"
1332320250303,133,2025-03-03,23,114,89,203,Spen229_T,"-37.81531435, 144.95227769"
1241420250918,124,2025-09-18,14,3,3,6,BirBridge_T,"-37.81757416, 144.97329934"
108720250120,108,2025-01-20,7,68,645,713,261Will_T,"-37.81295822, 144.95678789"
108620240611,108,2024-06-11,6,6,161,167,261Will_T,"-37.81295822, 144.95678789"
1791220250819,179,2025-08-19,12,50,47,97,Pow61_T,"-37.82392385, 144.96299677"
1791920241228,179,2024-12-28,19,66,64,130,Pow61_T,"-37.82392385, 144.96299677"
1651320250718,165,2025-07-18,13,24,47,71,Spen475_T,"-37.80953359, 144.94939004"
1671720250710,167,2025-07-10,17,38,81,119,Lat526_T,"-37.81304149, 144.95155955"
1920240501,1,2024-05-01,9,329,377,706,Bou292_T,"-37.81349441, 144.96515323"
11920240529,1,2024-05-29,19,479,310,789,Bou292_T,"-37.81349441, 144.96515323"
182120240517,18,2024-05-17,21,1,0,1,Col12_T,"-37.81344862, 144.97305353"
181120240618,18,2024-06-18,11,171,231,402,Col12_T,"-37.81344862, 144.97305353"
56220241019,56,2024-10-19,2,53,80,133,Lon364_T,"-37.81234775, 144.96153311"
112120250617,11,2025-06-17,21,41,46,87,WatCit_T,"-37.81564989, 144.93970694"
122320240413,12,2024-04-13,23,83,85,168,NewQ_T,"-37.81457988, 144.94292398"
721820250509,72,2025-05-09,18,219,299,518,ACMI_T,"-37.81726338, 144.96872809"
581720240613,58,2024-06-13,17,736,1297,2033,Bou688_T,"-37.81686075, 144.95358075"
35720250427,35,2025-04-27,7,224,169,393,SouthB_T,"-37.82018685, 144.96508508"
58420250321,58,2025-03-21,4,12,6,18,Bou688_T,"-37.81686075, 144.95358075"
1792320250930,179,2025-09-30,23,15,19,34,Pow61_T,"-37.82392385, 144.96299677"
1432020250421,143,2025-04-21,20,71,47,118,Spencer_T,"-37.821728, 144.95557015"
108720250303,108,2025-03-03,7,92,720,812,261Will_T,"-37.81295822, 144.95678789"
134220250605,134,2025-06-05,2,12,12,24,Spen201_T,"-37.81694221, 144.95303935"
107720250709,107,2025-07-09,7,27,83,110,280Will_T,"-37.81246271, 144.95690188"
1181520250429,118,2025-04-29,15,12,16,28,Fli114C_T,"-37.81632783, 144.97090512"
1081620250917,108,2025-09-17,16,1141,228,1369,261Will_T,"-37.81295822, 144.95678789"
68420250702,68,2025-07-02,4,2,2,4,FLDegN_T,"-37.8168479, 144.96559789"
68020250706,68,2025-07-06,0,13,17,30,FLDegN_T,"-37.8168479, 144.96559789"
852020240811,85,2024-08-11,20,16,22,38,488Mac_T,"-37.79432415, 144.92973378"
852120241017,85,2024-10-17,21,23,17,40,488Mac_T,"-37.79432415, 144.92973378"
85420250109,85,2025-01-09,4,1,1,2,488Mac_T,"-37.79432415, 144.92973378"
852120250810,85,2025-08-10,21,7,8,15,488Mac_T,"-37.79432415, 144.92973378"
171420250811,17,2025-08-11,14,418,382,800,Col15_T,"-37.81362543, 144.97323591"
12320240404,1,2024-04-04,23,68,54,122,Bou292_T,"-37.81349441, 144.96515323"
67020240430,67,2024-04-30,0,11,6,17,FLDegS_T,"-37.81688755, 144.96562569"
11820241216,11,2024-12-16,8,33,30,63,WatCit_T,"-37.81564989, 144.93970694"
21520231106,2,2023-11-06,15,1040,939,1979,Bou283_T,"-37.81380668, 144.96516718"
2220231217,2,2023-12-17,2,40,84,124,Bou283_T,"-37.81380668, 144.96516718"
58520250103,58,2025-01-03,5,39,14,53,Bou688_T,"-37.81686075, 144.95358075"
351720231218,35,2023-12-18,17,1823,1425,3248,SouthB_T,"-37.82018685, 144.96508508"
582120250805,58,2025-08-05,21,190,202,392,Bou688_T,"-37.81686075, 144.95358075"
21520240726,2,2024-07-26,15,635,677,1312,Bou283_T,"-37.81380668, 144.96516718"
532120240619,53,2024-06-19,21,105,216,321,Col254_T,"-37.81564191, 144.965499"
302320250313,30,2025-03-13,23,147,267,414,Lon189_T,"-37.8112185, 144.96656806"
792220240730,79,2024-07-30,22,101,115,216,FliSS_T,"-37.81794046, 144.96616678"
9820250829,9,2025-08-29,8,72,1800,1872,Col700_T,"-37.81982992, 144.95102555"
52720251001,52,2025-10-01,7,77,78,155,Eli263_T,"-37.81252157, 144.9619401"
202020250929,20,2025-09-29,20,160,324,484,LtB170_T,"-37.81172914, 144.9682466"
232020240910,23,2024-09-10,20,131,195,326,Col623_T,"-37.81909256, 144.95452748"
130720240906,130,2024-09-06,7,17,26,43,Bou892T,"-37.8204637, 144.94126826"
1411120240109,141,2024-01-09,11,154,118,272,474Fl_T,"-37.81997273, 144.95834911"
1171220240228,117,2024-02-28,12,182,221,403,Fli114F_T,"-37.81629332, 144.97090877"
1171820241103,117,2024-11-03,18,154,156,310,Fli114F_T,"-37.81629332, 144.97090877"
191120241031,19,2024-10-31,11,348,191,539,LtB210_T,"-37.81237202, 144.96550671"
180620250314,180,2025-03-14,6,7,24,31,Mac330_T,"-37.79497059, 144.93530329"
1361920240208,136,2024-02-08,19,69,35,104,BirFed1120_T,"-37.8184141, 144.97357915"
1361920241201,136,2024-12-01,19,18,18,36,BirFed1120_T,"-37.8184141, 144.97357915"
1422320240520,142,2024-05-20,23,8,9,17,Hammer1584_T,"-37.81970749, 144.96795734"
161820251014,161,2025-10-14,8,164,315,479,BirArt1109_T,"-37.81851276, 144.97131336"
84420250517,84,2025-05-17,4,24,17,41,ElFi_T,"-37.81798049, 144.96503383"
4320231207,4,2023-12-07,3,28,15,43,Swa123_T,"-37.81487988, 144.9660878"
70720250426,70,2025-04-26,7,18,14,32,Errol20_T,"-37.80456984, 144.94946228"
78120231105,78,2023-11-05,1,8,18,26,HarEsB_T,"-37.81471642, 144.9446508"
77720240318,77,2024-03-18,7,79,104,183,HarEsP_T,"-37.81441438, 144.94433026"
772320240914,77,2024-09-14,23,33,11,44,HarEsP_T,"-37.81441438, 144.94433026"
77120250613,77,2025-06-13,1,8,2,10,HarEsP_T,"-37.81441438, 144.94433026"
591420250606,59,2025-06-06,14,780,706,1486,RMIT_T,"-37.80825648, 144.96304859"
291720250506,29,2025-05-06,17,322,438,760,AG_T,"-37.8199817, 144.96872865"
471720241129,47,2024-11-29,17,1533,1143,2676,Eli250_T,"-37.81258467, 144.9625775"
45020240205,45,2024-02-05,0,54,78,132,Swa148_T,"-37.81414075, 144.96609379"
36920250221,36,2025-02-21,9,156,149,305,Que85_T,"-37.81652527, 144.96121062"
20520231225,20,2023-12-25,5,4,3,7,LtB170_T,"-37.81172914, 144.9682466"
52320240608,52,2024-06-08,3,61,29,90,Eli263_T,"-37.81252157, 144.9619401"
461220240524,46,2024-05-24,12,128,127,255,Pel147_T,"-37.80240719, 144.9615673"
512320250911,51,2025-09-11,23,46,36,82,Fra118_T,"-37.80841815, 144.95906316"
137620251015,137,2025-10-15,6,44,2,46,BouHbr2353_T,"-37.81894815, 144.94612292"
1411520250428,141,2025-04-28,15,89,88,177,474Fl_T,"-37.81997273, 144.95834911"
1371520240111,137,2024-01-11,15,19,125,144,BouHbr2353_T,"-37.81894815, 144.94612292"
136320251011,136,2025-10-11,3,2,0,2,BirFed1120_T,"-37.8184141, 144.97357915"
130920240809,130,2024-08-09,9,8,9,17,Bou892T,"-37.8204637, 144.94126826"
1301620250418,130,2025-04-18,16,31,22,53,Bou892T,"-37.8204637, 144.94126826"
1611920250302,161,2025-03-02,19,511,93,604,BirArt1109_T,"-37.81851276, 144.97131336"
1611720250428,161,2025-04-28,17,189,78,267,BirArt1109_T,"-37.81851276, 144.97131336"
138620250901,138,2025-09-01,6,3,1,4,EntPark1671_T,"-37.81996544, 144.95981454"
138720250926,138,2025-09-26,7,1,1,2,EntPark1671_T,"-37.81996544, 144.95981454"
481020250217,48,2025-02-17,10,150,109,259,QVMQ_T,"-37.80631581, 144.95866697"
1091520231023,109,2023-10-23,15,248,147,395,LatWill_T,"-37.81193681, 144.95621105"
109620250224,109,2025-02-24,6,13,85,98,LatWill_T,"-37.81193681, 144.95621105"
191720250812,19,2025-08-12,17,526,341,867,LtB210_T,"-37.81237202, 144.96550671"
772220240212,77,2024-02-12,22,94,59,153,HarEsP_T,"-37.81441438, 144.94433026"
781120250520,78,2025-05-20,11,44,37,81,HarEsB_T,"-37.81471642, 144.9446508"
78420250909,78,2025-09-09,4,0,3,3,HarEsB_T,"-37.81471642, 144.9446508"
14320240822,14,2024-08-22,3,5,1,6,SanBri_T,"-37.82011242, 144.96291897"
651020240407,65,2024-04-07,10,254,237,491,SwaCs_T,"-37.81569416, 144.9668064"
311720240417,31,2024-04-17,17,185,95,280,Lyg161_T,"-37.80169681, 144.96658911"
361720231101,36,2023-11-01,17,286,322,608,Que85_T,"-37.81652527, 144.96121062"
5420240917,5,2024-09-17,4,34,23,57,PriNW_T,"-37.81874249, 144.96787656"
1171520250613,117,2025-06-13,15,172,180,352,Fli114F_T,"-37.81629332, 144.97090877"
117220231101,117,2023-11-01,2,8,2,10,Fli114F_T,"-37.81629332, 144.97090877"
109620250727,109,2025-07-27,6,6,15,21,LatWill_T,"-37.81193681, 144.95621105"
109120250831,109,2025-08-31,1,12,37,49,LatWill_T,"-37.81193681, 144.95621105"
491920250816,49,2025-08-16,19,258,260,518,Eli501_T,"-37.80730068, 144.95956055"
85020240818,85,2024-08-18,0,5,8,13,488Mac_T,"-37.79432415, 144.92973378"
852320250404,85,2025-04-04,23,12,26,38,488Mac_T,"-37.79432415, 144.92973378"
11420240521,1,2024-05-21,14,1042,944,1986,Bou292_T,"-37.81349441, 144.96515323"
11220241205,1,2024-12-05,12,1606,1365,2971,Bou292_T,"-37.81349441, 144.96515323"
621020250426,62,2025-04-26,10,115,110,225,Lat224_T,"-37.80996494, 144.96216521"
861020240801,86,2024-08-01,10,57,36,93,574Qub_T,"-37.80309992, 144.94908064"
101720240816,10,2024-08-16,17,163,112,275,BouHbr_T,"-37.81876474, 144.94710545"
72820240605,72,2024-06-05,8,654,103,757,ACMI_T,"-37.81726338, 144.96872809"
72620250522,72,2025-05-22,6,76,29,105,ACMI_T,"-37.81726338, 144.96872809"
721320250705,72,2025-07-05,13,370,579,949,ACMI_T,"-37.81726338, 144.96872809"
721820241118,72,2024-11-18,18,204,415,619,ACMI_T,"-37.81726338, 144.96872809"
72320241213,72,2024-12-13,3,8,5,13,ACMI_T,"-37.81726338, 144.96872809"
101320250910,10,2025-09-10,13,105,107,212,BouHbr_T,"-37.81876474, 144.94710545"
76620231227,76,2023-12-27,6,2,2,4,KenMac_T,"-37.79453803, 144.93036194"
581720250706,58,2025-07-06,17,499,431,930,Bou688_T,"-37.81686075, 144.95358075"
271720250911,27,2025-09-11,17,188,71,259,Vic_T,"-37.80606888, 144.95644692"
532220231028,53,2023-10-28,22,152,336,488,Col254_T,"-37.81564191, 144.965499"
531920240322,53,2024-03-22,19,529,318,847,Col254_T,"-37.81564191, 144.965499"
79120240608,79,2024-06-08,1,50,101,151,FliSS_T,"-37.81794046, 144.96616678"
23220250827,23,2025-08-27,2,3,5,8,Col623_T,"-37.81909256, 144.95452748"
252120250625,25,2025-06-25,21,103,102,205,MCEC_T,"-37.82401776, 144.95604426"
20520250103,20,2025-01-03,5,4,2,6,LtB170_T,"-37.81172914, 144.9682466"
2420231124,2,2023-11-24,4,3,7,10,Bou283_T,"-37.81380668, 144.96516718"
91820241221,9,2024-12-21,18,53,62,115,Col700_T,"-37.81982992, 144.95102555"
92320250502,9,2025-05-02,23,39,30,69,Col700_T,"-37.81982992, 144.95102555"
791120240216,79,2024-02-16,11,658,412,1070,FliSS_T,"-37.81794046, 144.96616678"
231820240710,23,2024-07-10,18,281,488,769,Col623_T,"-37.81909256, 144.95452748"
30320250323,30,2025-03-23,3,95,173,268,Lon189_T,"-37.8112185, 144.96656806"
30420250920,30,2025-09-20,4,54,91,145,Lon189_T,"-37.8112185, 144.96656806"
20520250401,20,2025-04-01,5,5,3,8,LtB170_T,"-37.81172914, 144.9682466"
49020241212,49,2024-12-12,0,67,68,135,Eli501_T,"-37.80730068, 144.95956055"
164220241203,164,2024-12-03,2,4,1,5,Lat526_T,"-37.813005, 144.95160411"
19820251003,19,2025-10-03,8,80,52,132,LtB210_T,"-37.81237202, 144.96550671"
1391420250605,139,2025-06-05,14,42,48,90,Signal1647_T,"-37.81959923, 144.9632832"
1381720250421,138,2025-04-21,17,9,9,18,EntPark1671_T,"-37.81996544, 144.95981454"
1092320240113,109,2024-01-13,23,104,99,203,LatWill_T,"-37.81193681, 144.95621105"
661020250904,66,2025-09-04,10,427,424,851,QVN_T,"-37.81057846, 144.96444294"
691420241124,69,2024-11-24,14,254,233,487,FLDegC_T,"-37.81687226, 144.96559144"
4320250826,4,2025-08-26,3,16,10,26,Swa123_T,"-37.81487988, 144.9660878"
701520250621,70,2025-06-21,15,128,152,280,Errol20_T,"-37.80456984, 144.94946228"
70220250628,70,2025-06-28,2,0,7,7,Errol20_T,"-37.80456984, 144.94946228"
752020240905,75,2024-09-05,20,9,23,32,SprFli_T,"-37.81515276, 144.97467661"
411120231024,41,2023-10-24,11,1170,892,2062,Swa31,"-37.81668634, 144.96689733"
41120231125,41,2023-11-25,1,173,317,490,Swa31,"-37.81668634, 144.96689733"
411520231231,41,2023-12-31,15,1688,1531,3219,Swa31,"-37.81668634, 144.96689733"
41420250516,41,2025-05-16,4,16,12,28,Swa31,"-37.81668634, 144.96689733"
78620241013,78,2024-10-13,6,3,3,6,HarEsB_T,"-37.81471642, 144.9446508"
421020250501,42,2025-05-01,10,374,268,642,UM1_T,"-37.80008566, 144.96386412"
141120250328,14,2025-03-28,11,328,172,500,SanBri_T,"-37.82011242, 144.96291897"
71220250903,71,2025-09-03,2,1,0,1,WestWP_T,"-37.81235775, 144.97136962"
591420250425,59,2025-04-25,14,194,263,457,RMIT_T,"-37.80825648, 144.96304859"
471020240419,47,2024-04-19,10,401,505,906,Eli250_T,"-37.81258467, 144.9625775"
402020250222,40,2025-02-22,20,156,118,274,Spr201_T,"-37.80999341, 144.97227587"
871820231024,87,2023-10-24,18,167,118,285,Errol23_T,"-37.80454949, 144.94921863"
1401120240731,140,2024-07-31,11,88,50,138,Boyd2837_T,"-37.82590962, 144.96185972"
1311120241108,131,2024-11-08,11,67,91,158,King2_T,"-37.82009057, 144.95758725"
167320241028,167,2024-10-28,3,0,1,1,Lat526_T,"-37.81304149, 144.95155955"
1311320250313,131,2025-03-13,13,213,160,373,King2_T,"-37.82009057, 144.95758725"
1341220240121,134,2024-01-21,12,349,387,736,Spen201_T,"-37.81694221, 144.95303935"
1341020240421,134,2024-04-21,10,346,316,662,Spen201_T,"-37.81694221, 144.95303935"
1351020231111,135,2023-11-11,10,379,415,794,Spen161_T,"-37.8172861, 144.95319102"
1351020231215,135,2023-12-15,10,453,451,904,Spen161_T,"-37.8172861, 144.95319102"
135920250205,135,2025-02-05,9,283,343,626,Spen161_T,"-37.8172861, 144.95319102"
107920250815,107,2025-08-15,9,90,167,257,280Will_T,"-37.81246271, 144.95690188"
1331320250629,133,2025-06-29,13,405,385,790,Spen229_T,"-37.81531435, 144.95227769"
1181120250705,118,2025-07-05,11,8,25,33,Fli114C_T,"-37.81632783, 144.97090512"
108020240623,108,2024-06-23,0,10,27,37,261Will_T,"-37.81295822, 144.95678789"
1821520250414,182,2025-04-14,15,211,180,391,King163_T,"-37.81627451, 144.95550503"
1821420250916,182,2025-09-16,14,210,201,411,King163_T,"-37.81627451, 144.95550503"
165520250115,165,2025-01-15,5,2,1,3,Spen475_T,"-37.80953359, 144.94939004"
1672320250708,167,2025-07-08,23,1,4,5,Lat526_T,"-37.81304149, 144.95155955"
1081520240808,108,2024-08-08,15,204,203,407,261Will_T,"-37.81295822, 144.95678789"
872320231227,87,2023-12-27,23,3,19,22,Errol23_T,"-37.80454949, 144.94921863"
87220240115,87,2024-01-15,2,0,1,1,Errol23_T,"-37.80454949, 144.94921863"
87020241027,87,2024-10-27,0,6,11,17,Errol23_T,"-37.80454949, 144.94921863"
44720241214,44,2024-12-14,7,12,3,15,UM3_T,"-37.79698741, 144.96441306"
45720250601,45,2025-06-01,7,22,78,100,Swa148_T,"-37.81414075, 144.96609379"
1662120250825,166,2025-08-25,21,7,4,11,Spen484_T,"-37.80896733, 144.94931703"
1651520241204,165,2024-12-04,15,35,38,73,Spen475_T,"-37.80953359, 144.94939004"
1311720240219,131,2024-02-19,17,118,150,268,King2_T,"-37.82009057, 144.95758725"
167520240917,167,2024-09-17,5,0,7,7,Lat526_T,"-37.81304149, 144.95155955"
1322320241019,132,2024-10-19,23,142,154,296,King335_T,"-37.81267639, 144.95386444"
135420250105,135,2025-01-05,4,21,15,36,Spen161_T,"-37.8172861, 144.95319102"
1331620250129,133,2025-01-29,16,534,693,1227,Spen229_T,"-37.81531435, 144.95227769"
281720250125,28,2025-01-25,17,541,1331,1872,VAC_T,"-37.82129925, 144.96879309"
28620231027,28,2023-10-27,6,104,48,152,VAC_T,"-37.82129925, 144.96879309"
47620250718,47,2025-07-18,6,32,122,154,Eli250_T,"-37.81258467, 144.9625775"
51720240412,5,2024-04-12,17,1386,1735,3121,PriNW_T,"-37.81874249, 144.96787656"
5820241125,5,2024-11-25,8,120,395,515,PriNW_T,"-37.81874249, 144.96787656"
211920231023,21,2023-10-23,19,372,414,786,Bourke155_T,"-37.81267313, 144.96788288"
212120250116,21,2025-01-16,21,226,271,497,Bourke155_T,"-37.81267313, 144.96788288"
37120250108,37,2025-01-08,1,4,6,10,Lyg260_T,"-37.80107122, 144.96704554"
1081120240325,108,2024-03-25,11,310,340,650,261Will_T,"-37.81295822, 144.95678789"
1082220250119,108,2025-01-19,22,87,71,158,261Will_T,"-37.81295822, 144.95678789"
871620240805,87,2024-08-05,16,89,99,188,Errol23_T,"-37.80454949, 144.94921863"
87220240831,87,2024-08-31,2,9,6,15,Errol23_T,"-37.80454949, 144.94921863"
612220250718,61,2025-07-18,22,122,80,202,RMIT14_T,"-37.80767455, 144.96309114"
442220250420,44,2025-04-20,22,9,11,20,UM3_T,"-37.79698741, 144.96441306"
43120231210,43,2023-12-10,1,2,3,5,UM2_T,"-37.79844526, 144.96411782"
167620250712,167,2025-07-12,6,1,2,3,Lat526_T,"-37.81304149, 144.95155955"
140020240521,140,2024-05-21,0,3,7,10,Boyd2837_T,"-37.82590962, 144.96185972"
1401520240929,140,2024-09-29,15,118,122,240,Boyd2837_T,"-37.82590962, 144.96185972"
1311820240515,131,2024-05-15,18,49,146,195,King2_T,"-37.82009057, 144.95758725"
135520250104,135,2025-01-04,5,35,13,48,Spen161_T,"-37.8172861, 144.95319102"
133420240410,133,2024-04-10,4,7,28,35,Spen229_T,"-37.81531435, 144.95227769"
1182120250802,118,2025-08-02,21,13,8,21,Fli114C_T,"-37.81632783, 144.97090512"
1081220231125,108,2023-11-25,12,129,148,277,261Will_T,"-37.81295822, 144.95678789"
851220231204,85,2023-12-04,12,86,89,175,488Mac_T,"-37.79432415, 144.92973378"
852120240302,85,2024-03-02,21,10,18,28,488Mac_T,"-37.79432415, 144.92973378"
852320241115,85,2024-11-15,23,11,13,24,488Mac_T,"-37.79432415, 144.92973378"
631720241014,63,2024-10-14,17,320,371,691,Bou231_T,"-37.81333081, 144.96675571"
671120241123,67,2024-11-23,11,371,413,784,FLDegS_T,"-37.81688755, 144.96562569"
86520240902,86,2024-09-02,5,2,1,3,574Qub_T,"-37.80309992, 144.94908064"
621620231118,62,2023-11-18,16,259,146,405,Lat224_T,"-37.80996494, 144.96216521"
241520250709,24,2025-07-09,15,477,1362,1839,Col620_T,"-37.81887963, 144.95449198"
1411820250804,141,2025-08-04,18,79,73,152,474Fl_T,"-37.81997273, 144.95834911"
137320250508,137,2025-05-08,3,0,1,1,BouHbr2353_T,"-37.81894815, 144.94612292"
117520250108,117,2025-01-08,5,4,7,11,Fli114F_T,"-37.81629332, 144.97090877"
1081120231201,108,2023-12-01,11,282,377,659,261Will_T,"-37.81295822, 144.95678789"
1081420241217,108,2024-12-17,14,359,284,643,261Will_T,"-37.81295822, 144.95678789"
87320250801,87,2025-08-01,3,1,2,3,Errol23_T,"-37.80454949, 144.94921863"
611020250901,61,2025-09-01,10,181,344,525,RMIT14_T,"-37.80767455, 144.96309114"
612020240905,61,2024-09-05,20,458,503,961,RMIT14_T,"-37.80767455, 144.96309114"
501920250410,50,2025-04-10,19,237,228,465,Lyg309_T,"-37.79808192, 144.96721013"
431720231121,43,2023-11-21,17,301,210,511,UM2_T,"-37.79844526, 144.96411782"
431120241202,43,2024-12-02,11,61,59,120,UM2_T,"-37.79844526, 144.96411782"
140920250330,140,2025-03-30,9,114,37,151,Boyd2837_T,"-37.82590962, 144.96185972"
143020251009,143,2025-10-09,0,76,37,113,Spencer_T,"-37.821728, 144.95557015"
132820240628,132,2024-06-28,8,120,115,235,King335_T,"-37.81267639, 144.95386444"
134820240525,134,2024-05-25,8,222,232,454,Spen201_T,"-37.81694221, 144.95303935"
1341520240829,134,2024-08-29,15,419,463,882,Spen201_T,"-37.81694221, 144.95303935"
134720241013,134,2024-10-13,7,128,164,292,Spen201_T,"-37.81694221, 144.95303935"
135020250909,135,2025-09-09,0,17,50,67,Spen161_T,"-37.8172861, 144.95319102"
1241720240212,124,2024-02-12,17,0,1,1,BirBridge_T,"-37.81757416, 144.97329934"
85520241019,85,2024-10-19,5,2,0,2,488Mac_T,"-37.79432415, 144.92973378"
671920240207,67,2024-02-07,19,239,292,531,FLDegS_T,"-37.81688755, 144.96562569"
18720240719,18,2024-07-19,7,7,129,136,Col12_T,"-37.81344862, 144.97305353"
181820250920,18,2025-09-20,18,32,30,62,Col12_T,"-37.81344862, 144.97305353"
621320250319,62,2025-03-19,13,314,229,543,Lat224_T,"-37.80996494, 144.96216521"
862120240302,86,2024-03-02,21,23,58,81,574Qub_T,"-37.80309992, 144.94908064"
561120250616,56,2025-06-16,11,284,232,516,Lon364_T,"-37.81234775, 144.96153311"
10520240917,10,2024-09-17,5,1,3,4,BouHbr_T,"-37.81876474, 144.94710545"
582220241202,58,2024-12-02,22,153,157,310,Bou688_T,"-37.81686075, 144.95358075"
35020250329,35,2025-03-29,0,294,482,776,SouthB_T,"-37.82018685, 144.96508508"
351620240425,35,2024-04-25,16,1053,1341,2394,SouthB_T,"-37.82018685, 144.96508508"
762020240414,76,2024-04-14,20,3,6,9,KenMac_T,"-37.79453803, 144.93036194"
53020240514,53,2024-05-14,0,13,13,26,Col254_T,"-37.81564191, 144.965499"
30320250407,30,2025-04-07,3,12,59,71,Lon189_T,"-37.8112185, 144.96656806"
79320240830,79,2024-08-30,3,5,15,20,FliSS_T,"-37.81794046, 144.96616678"
23020241106,23,2024-11-06,0,11,17,28,Col623_T,"-37.81909256, 144.95452748"
1391820241105,139,2024-11-05,18,63,58,121,Signal1647_T,"-37.81959923, 144.9632832"
1361720240704,136,2024-07-04,17,79,236,315,BirFed1120_T,"-37.8184141, 144.97357915"
130720240927,130,2024-09-27,7,7,10,17,Bou892T,"-37.8204637, 144.94126826"
1611620250113,161,2025-01-13,16,1282,1480,2762,BirArt1109_T,"-37.81851276, 144.97131336"
1171420241203,117,2024-12-03,14,131,302,433,Fli114F_T,"-37.81629332, 144.97090877"
109220240316,109,2024-03-16,2,21,11,32,LatWill_T,"-37.81193681, 144.95621105"
1092320241028,109,2024-10-28,23,30,21,51,LatWill_T,"-37.81193681, 144.95621105"
191120240804,19,2024-08-04,11,425,241,666,LtB210_T,"-37.81237202, 144.96550671"
180820250905,180,2025-09-05,8,68,28,96,Mac330_T,"-37.79497059, 144.93530329"
662320241231,66,2024-12-31,23,551,1947,2498,QVN_T,"-37.81057846, 144.96444294"
841420231213,84,2023-12-13,14,822,1085,1907,ElFi_T,"-37.81798049, 144.96503383"
841320250904,84,2025-09-04,13,845,1028,1873,ElFi_T,"-37.81798049, 144.96503383"
631620250401,63,2025-04-01,16,323,478,801,Bou231_T,"-37.81333081, 144.96675571"
681620241112,68,2024-11-12,16,179,152,331,FLDegN_T,"-37.8168479, 144.96559789"
861820240229,86,2024-02-29,18,84,80,164,574Qub_T,"-37.80309992, 144.94908064"
11120241112,11,2024-11-12,1,5,3,8,WatCit_T,"-37.81564989, 144.93970694"
12520250503,12,2025-05-03,5,7,6,13,NewQ_T,"-37.81457988, 144.94292398"
101020250921,10,2025-09-21,10,38,39,77,BouHbr_T,"-37.81876474, 144.94710545"
581520240923,58,2024-09-23,15,524,548,1072,Bou688_T,"-37.81686075, 144.95358075"
35020240928,35,2024-09-28,0,271,299,570,SouthB_T,"-37.82018685, 144.96508508"
351520241002,35,2024-10-02,15,1064,1229,2293,SouthB_T,"-37.82018685, 144.96508508"
11420250131,11,2025-01-31,4,0,2,2,WatCit_T,"-37.81564989, 144.93970694"
271620231119,27,2023-11-19,16,210,95,305,Vic_T,"-37.80606888, 144.95644692"
91220240321,9,2024-03-21,12,834,741,1575,Col700_T,"-37.81982992, 144.95102555"
91320250828,9,2025-08-28,13,715,505,1220,Col700_T,"-37.81982992, 144.95102555"
201020250724,20,2025-07-24,10,97,93,190,LtB170_T,"-37.81172914, 144.9682466"
521820250228,52,2025-02-28,18,392,359,751,Eli263_T,"-37.81252157, 144.9619401"
137920240724,137,2024-07-24,9,75,32,107,BouHbr2353_T,"-37.81894815, 144.94612292"
1371720250414,137,2025-04-14,17,15,109,124,BouHbr2353_T,"-37.81894815, 144.94612292"
1302020240103,130,2024-01-03,20,6,12,18,Bou892T,"-37.8204637, 144.94126826"
691220250101,69,2025-01-01,12,404,183,587,FLDegC_T,"-37.81687226, 144.96559144"
62120250328,6,2025-03-28,21,967,795,1762,FliS_T,"-37.81911705, 144.96558255"
841820240327,84,2024-03-27,18,887,1527,2414,ElFi_T,"-37.81798049, 144.96503383"
32120241011,3,2024-10-11,21,896,812,1708,Swa295_T,"-37.81101524, 144.96429485"
75420240516,75,2024-05-16,4,2,1,3,SprFli_T,"-37.81515276, 144.97467661"
751220240711,75,2024-07-11,12,60,41,101,SprFli_T,"-37.81515276, 144.97467661"
39120240608,39,2024-06-08,1,9,6,15,AlfPl_T,"-37.81379749, 144.96995745"
39520250412,39,2025-04-12,5,4,1,5,AlfPl_T,"-37.81379749, 144.96995745"
8620240221,8,2024-02-21,6,60,49,109,WebBN_T,"-37.82293543, 144.9471751"
711820250914,71,2025-09-14,18,6,3,9,WestWP_T,"-37.81235775, 144.97136962"
361020250418,36,2025-04-18,10,100,97,197,Que85_T,"-37.81652527, 144.96121062"
612220250829,61,2025-08-29,22,216,141,357,RMIT14_T,"-37.80767455, 144.96309114"
50920240109,50,2024-01-09,9,101,124,225,Lyg309_T,"-37.79808192, 144.96721013"
501820250327,50,2025-03-27,18,187,202,389,Lyg309_T,"-37.79808192, 144.96721013"
2420231021,2,2023-10-21,4,5,18,23,Bou283_T,"-37.81380668, 144.96516718"
581220240921,58,2024-09-21,12,782,202,984,Bou688_T,"-37.81686075, 144.95358075"
582320241110,58,2024-11-10,23,100,83,183,Bou688_T,"-37.81686075, 144.95358075"
271220231214,27,2023-12-14,12,171,154,325,Vic_T,"-37.80606888, 144.95644692"
21120250320,2,2025-03-20,11,459,468,927,Bou283_T,"-37.81380668, 144.96516718"
27320250507,27,2025-05-07,3,10,3,13,Vic_T,"-37.80606888, 144.95644692"
301620250131,30,2025-01-31,16,220,319,539,Lon189_T,"-37.8112185, 144.96656806"
30120231116,30,2023-11-16,1,86,116,202,Lon189_T,"-37.8112185, 144.96656806"
79920240527,79,2024-05-27,9,307,196,503,FliSS_T,"-37.81794046, 144.96616678"
201220240330,20,2024-03-30,12,344,311,655,LtB170_T,"-37.81172914, 144.9682466"
251220240826,25,2024-08-26,12,405,477,882,MCEC_T,"-37.82401776, 144.95604426"
20220241115,20,2024-11-15,2,36,47,83,LtB170_T,"-37.81172914, 144.9682466"
201620241123,20,2024-11-23,16,274,336,610,LtB170_T,"-37.81172914, 144.9682466"
46920231019,46,2023-10-19,9,66,185,251,Pel147_T,"-37.80240719, 144.9615673"
51120231204,51,2023-12-04,1,18,17,35,Fra118_T,"-37.80841815, 144.95906316"
511320241202,51,2024-12-02,13,74,80,154,Fra118_T,"-37.80841815, 144.95906316"
23120240302,23,2024-03-02,1,13,19,32,Col623_T,"-37.81909256, 144.95452748"
1411320240702,141,2024-07-02,13,269,145,414,474Fl_T,"-37.81997273, 144.95834911"
1171820240827,117,2024-08-27,18,178,199,377,Fli114F_T,"-37.81629332, 144.97090877"
1092320240528,109,2024-05-28,23,19,28,47,LatWill_T,"-37.81193681, 144.95621105"
482120240330,48,2024-03-30,21,85,91,176,QVMQ_T,"-37.80631581, 144.95866697"
482220231125,48,2023-11-25,22,63,70,133,QVMQ_T,"-37.80631581, 144.95866697"
1392220250924,139,2025-09-24,22,1,9,10,Signal1647_T,"-37.81959923, 144.9632832"
1371120231226,137,2023-12-26,11,10,9,19,BouHbr2353_T,"-37.81894815, 144.94612292"
1361920250718,136,2025-07-18,19,3,1,4,BirFed1120_T,"-37.8184141, 144.97357915"
142120250529,142,2025-05-29,1,1,0,1,Hammer1584_T,"-37.81970749, 144.96795734"
3920250301,3,2025-03-01,9,198,203,401,Swa295_T,"-37.81101524, 144.96429485"
751220240822,75,2024-08-22,12,77,72,149,SprFli_T,"-37.81515276, 144.97467661"
81320250511,8,2025-05-11,13,161,263,424,WebBN_T,"-37.82293543, 144.9471751"
751920250919,75,2025-09-19,19,29,90,119,SprFli_T,"-37.81515276, 144.97467661"
781420240506,78,2024-05-06,14,23,66,89,HarEsB_T,"-37.81471642, 144.9446508"
59620240701,59,2024-07-01,6,42,38,80,RMIT_T,"-37.80825648, 144.96304859"
292320250512,29,2025-05-12,23,5,16,21,AG_T,"-37.8199817, 144.96872865"
281520240213,28,2024-02-13,15,517,1170,1687,VAC_T,"-37.82129925, 144.96879309"
54520250123,54,2025-01-23,5,5,3,8,Swa607_T,"-37.804024, 144.96308399"
281520250929,28,2025-09-29,15,551,780,1331,VAC_T,"-37.82129925, 144.96879309"
84820250401,84,2025-04-01,8,1702,449,2151,ElFi_T,"-37.81798049, 144.96503383"
70820231111,70,2023-11-11,8,62,73,135,Errol20_T,"-37.80456984, 144.94946228"
3920240715,3,2024-07-15,9,220,358,578,Swa295_T,"-37.81101524, 144.96429485"
391620250617,39,2025-06-17,16,58,55,113,AlfPl_T,"-37.81379749, 144.96995745"
75920250306,75,2025-03-06,9,78,58,136,SprFli_T,"-37.81515276, 144.97467661"
752020250319,75,2025-03-19,20,9,8,17,SprFli_T,"-37.81515276, 144.97467661"
782120250307,78,2025-03-07,21,30,17,47,HarEsB_T,"-37.81471642, 144.9446508"
411420250221,41,2025-02-21,14,1734,1843,3577,Swa31,"-37.81668634, 144.96689733"
412320250727,41,2025-07-27,23,149,183,332,Swa31,"-37.81668634, 144.96689733"
77920240623,77,2024-06-23,9,76,72,148,HarEsP_T,"-37.81441438, 144.94433026"
45220241002,45,2024-10-02,2,2,18,20,Swa148_T,"-37.81414075, 144.96609379"
442020240714,44,2024-07-14,20,10,4,14,UM3_T,"-37.79698741, 144.96441306"
452020240308,45,2024-03-08,20,413,1103,1516,Swa148_T,"-37.81414075, 144.96609379"
45220241105,45,2024-11-05,2,9,56,65,Swa148_T,"-37.81414075, 144.96609379"
1311320240424,131,2024-04-24,13,153,133,286,King2_T,"-37.82009057, 144.95758725"
1311020240923,131,2024-09-23,10,70,120,190,King2_T,"-37.82009057, 144.95758725"
1672320241018,167,2024-10-18,23,0,11,11,Lat526_T,"-37.81304149, 144.95155955"
107720231020,107,2023-10-20,7,46,78,124,280Will_T,"-37.81246271, 144.95690188"
107420231026,107,2023-10-26,4,1,6,7,280Will_T,"-37.81246271, 144.95690188"
672120240910,67,2024-09-10,21,139,266,405,FLDegS_T,"-37.81688755, 144.96562569"
851820231120,85,2023-11-20,18,83,110,193,488Mac_T,"-37.79432415, 144.92973378"
631620240513,63,2024-05-13,16,211,311,522,Bou231_T,"-37.81333081, 144.96675571"
62720250223,62,2025-02-23,7,29,26,55,Lat224_T,"-37.80996494, 144.96216521"
62720250424,62,2025-04-24,7,20,45,65,Lat224_T,"-37.80996494, 144.96216521"
62420250430,62,2025-04-30,4,10,15,25,Lat224_T,"-37.80996494, 144.96216521"
56920231028,56,2023-10-28,9,122,86,208,Lon364_T,"-37.81234775, 144.96153311"
121020240420,12,2024-04-20,10,151,150,301,NewQ_T,"-37.81457988, 144.94292398"
10520250530,10,2025-05-30,5,6,7,13,BouHbr_T,"-37.81876474, 144.94710545"
722120250415,72,2025-04-15,21,139,154,293,ACMI_T,"-37.81726338, 144.96872809"
721020240209,72,2024-02-09,10,126,127,253,ACMI_T,"-37.81726338, 144.96872809"
35020250817,35,2025-08-17,0,179,207,386,SouthB_T,"-37.82018685, 144.96508508"
761820231214,76,2023-12-14,18,68,74,142,KenMac_T,"-37.79453803, 144.93036194"
22220240901,2,2024-09-01,22,34,103,137,Bou283_T,"-37.81380668, 144.96516718"
91820240402,9,2024-04-02,18,589,92,681,Col700_T,"-37.81982992, 144.95102555"
9320240719,9,2024-07-19,3,4,2,6,Col700_T,"-37.81982992, 144.95102555"
792220250202,79,2025-02-02,22,86,199,285,FliSS_T,"-37.81794046, 144.96616678"
79720240420,79,2024-04-20,7,84,56,140,FliSS_T,"-37.81794046, 144.96616678"
511820241223,51,2024-12-23,18,90,64,154,Fra118_T,"-37.80841815, 144.95906316"
231820240529,23,2024-05-29,18,187,377,564,Col623_T,"-37.81909256, 144.95452748"
30520241031,30,2024-10-31,5,11,8,19,Lon189_T,"-37.8112185, 144.96656806"
20420250713,20,2025-07-13,4,45,87,132,LtB170_T,"-37.81172914, 144.9682466"
46620250130,46,2025-01-30,6,4,4,8,Pel147_T,"-37.80240719, 144.9615673"
1371720250827,137,2025-08-27,17,14,160,174,BouHbr2353_T,"-37.81894815, 144.94612292"
137520240312,137,2024-03-12,5,2,1,3,BouHbr2353_T,"-37.81894815, 144.94612292"
141020250313,141,2025-03-13,0,21,25,46,474Fl_T,"-37.81997273, 144.95834911"
1171220240125,117,2024-01-25,12,206,259,465,Fli114F_T,"-37.81629332, 144.97090877"
117720240208,117,2024-02-08,7,126,75,201,Fli114F_T,"-37.81629332, 144.97090877"
49620240112,49,2024-01-12,6,49,49,98,Eli501_T,"-37.80730068, 144.95956055"
66420250522,66,2025-05-22,4,6,22,28,QVN_T,"-37.81057846, 144.96444294"
661620250614,66,2025-06-14,16,1383,1552,2935,QVN_T,"-37.81057846, 144.96444294"
4420231028,4,2023-10-28,4,29,34,63,Swa123_T,"-37.81487988, 144.9660878"
42320241212,4,2024-12-12,23,307,309,616,Swa123_T,"-37.81487988, 144.9660878"
31420250512,3,2025-05-12,14,864,849,1713,Swa295_T,"-37.81101524, 144.96429485"
421020240716,42,2024-07-16,10,194,230,424,UM1_T,"-37.80008566, 144.96386412"
591120240129,59,2024-01-29,11,284,275,559,RMIT_T,"-37.80825648, 144.96304859"
59920240213,59,2024-02-13,9,925,289,1214,RMIT_T,"-37.80825648, 144.96304859"
311520241014,31,2024-10-14,15,138,97,235,Lyg161_T,"-37.80169681, 144.96658911"
21820250906,21,2025-09-06,8,32,51,83,Bourke155_T,"-37.81267313, 144.96788288"
871120240418,87,2024-04-18,11,125,98,223,Errol23_T,"-37.80454949, 144.94921863"
50120250807,50,2025-08-07,1,27,1,28,Lyg309_T,"-37.79808192, 144.96721013"
43620240402,43,2024-04-02,6,4,2,6,UM2_T,"-37.79844526, 144.96411782"
45420250504,45,2025-05-04,4,6,34,40,Swa148_T,"-37.81414075, 144.96609379"
451620231122,45,2023-11-22,16,598,708,1306,Swa148_T,"-37.81414075, 144.96609379"
1401320241004,140,2024-10-04,13,116,67,183,Boyd2837_T,"-37.82590962, 144.96185972"
1312120241025,131,2024-10-25,21,109,101,210,King2_T,"-37.82009057, 144.95758725"
162320250317,162,2025-03-17,3,24,11,35,Eli489_T,"-37.80740397, 144.95987909"
1341720241028,134,2024-10-28,17,648,617,1265,Spen201_T,"-37.81694221, 144.95303935"
1341520250521,134,2025-05-21,15,405,508,913,Spen201_T,"-37.81694221, 144.95303935"
1351920250122,135,2025-01-22,19,316,272,588,Spen161_T,"-37.8172861, 144.95319102"
107920241014,107,2024-10-14,9,56,178,234,280Will_T,"-37.81246271, 144.95690188"
133120240113,133,2024-01-13,1,59,32,91,Spen229_T,"-37.81531435, 144.95227769"
1331920240401,133,2024-04-01,19,330,268,598,Spen229_T,"-37.81531435, 144.95227769"
118620250628,118,2025-06-28,6,1,0,1,Fli114C_T,"-37.81632783, 144.97090512"
1081920240507,108,2024-05-07,19,65,103,168,261Will_T,"-37.81295822, 144.95678789"
17320231223,17,2023-12-23,3,8,6,14,Col15_T,"-37.81362543, 144.97323591"
632220240501,63,2024-05-01,22,65,105,170,Bou231_T,"-37.81333081, 144.96675571"
631420231130,63,2023-11-30,14,363,472,835,Bou231_T,"-37.81333081, 144.96675571"
861620240530,86,2024-05-30,16,39,50,89,574Qub_T,"-37.80309992, 144.94908064"
62620231129,62,2023-11-29,6,65,50,115,Lat224_T,"-37.80996494, 144.96216521"
12520231029,12,2023-10-29,5,51,29,80,NewQ_T,"-37.81457988, 144.94292398"
12520240131,12,2024-01-31,5,9,8,17,NewQ_T,"-37.81457988, 144.94292398"
24320241112,24,2024-11-12,3,8,11,19,Col620_T,"-37.81887963, 144.95449198"
101920241108,10,2024-11-08,19,66,45,111,BouHbr_T,"-37.81876474, 144.94710545"
721020241106,72,2024-11-06,10,163,115,278,ACMI_T,"-37.81726338, 144.96872809"
271320231101,27,2023-11-01,13,100,112,212,Vic_T,"-37.80606888, 144.95644692"
27220231215,27,2023-12-15,2,12,5,17,Vic_T,"-37.80606888, 144.95644692"
2420240821,2,2024-08-21,4,3,6,9,Bou283_T,"-37.81380668, 144.96516718"
531820241126,53,2024-11-26,18,361,389,750,Col254_T,"-37.81564191, 144.965499"
48320240827,48,2024-08-27,3,4,5,9,QVMQ_T,"-37.80631581, 144.95866697"
46620240615,46,2024-06-15,6,2,6,8,Pel147_T,"-37.80240719, 144.9615673"
521620231125,52,2023-11-25,16,391,419,810,Eli263_T,"-37.81252157, 144.9619401"
46820250912,46,2025-09-12,8,86,33,119,Pel147_T,"-37.80240719, 144.9615673"
511220250926,51,2025-09-26,12,123,108,231,Fra118_T,"-37.80841815, 144.95906316"
164820241003,164,2024-10-03,8,134,79,213,Lat526_T,"-37.813005, 144.95160411"
1411420240206,141,2024-02-06,14,162,135,297,474Fl_T,"-37.81997273, 144.95834911"
139920250317,139,2025-03-17,9,44,119,163,Signal1647_T,"-37.81959923, 144.9632832"
1391420241122,139,2024-11-22,14,48,28,76,Signal1647_T,"-37.81959923, 144.9632832"
1301520231206,130,2023-12-06,15,12,16,28,Bou892T,"-37.8204637, 144.94126826"
1381620250524,138,2025-05-24,16,16,5,21,EntPark1671_T,"-37.81996544, 144.95981454"
1611220240816,161,2024-08-16,12,138,126,264,BirArt1109_T,"-37.81851276, 144.97131336"
1611920250509,161,2025-05-09,19,29,0,29,BirArt1109_T,"-37.81851276, 144.97131336"
49420231209,49,2023-12-09,4,25,33,58,Eli501_T,"-37.80730068, 144.95956055"
192220240526,19,2024-05-26,22,133,223,356,LtB210_T,"-37.81237202, 144.96550671"
691920240216,69,2024-02-16,19,115,111,226,FLDegC_T,"-37.81687226, 144.96559144"
662220240301,66,2024-03-01,22,935,651,1586,QVN_T,"-37.81057846, 144.96444294"
311420241110,31,2024-11-10,14,224,231,455,Lyg161_T,"-37.80169681, 144.96658911"
451620240406,45,2024-04-06,16,798,1061,1859,Swa148_T,"-37.81414075, 144.96609379"
371220240903,37,2024-09-03,12,128,92,220,Lyg260_T,"-37.80107122, 144.96704554"
1081520250116,108,2025-01-16,15,401,206,607,261Will_T,"-37.81295822, 144.95678789"
871520250307,87,2025-03-07,15,85,129,214,Errol23_T,"-37.80454949, 144.94921863"
871520250410,87,2025-04-10,15,91,90,181,Errol23_T,"-37.80454949, 144.94921863"
871020241129,87,2024-11-29,10,76,71,147,Errol23_T,"-37.80454949, 144.94921863"
611220240316,61,2024-03-16,12,237,466,703,RMIT14_T,"-37.80767455, 144.96309114"
44920250215,44,2025-02-15,9,15,10,25,UM3_T,"-37.79698741, 144.96441306"
431120240513,43,2024-05-13,11,202,181,383,UM2_T,"-37.79844526, 144.96411782"
162820250608,162,2025-06-08,8,100,75,175,Eli489_T,"-37.80740397, 144.95987909"
1821020250505,182,2025-05-05,10,156,145,301,King163_T,"-37.81627451, 144.95550503"
1431620250408,143,2025-04-08,16,154,236,390,Spencer_T,"-37.821728, 144.95557015"
132120240701,132,2024-07-01,1,12,12,24,King335_T,"-37.81267639, 144.95386444"
1351220231027,135,2023-10-27,12,499,557,1056,Spen161_T,"-37.8172861, 144.95319102"
1331120241107,133,2024-11-07,11,340,425,765,Spen229_T,"-37.81531435, 144.95227769"
1331220240709,133,2024-07-09,12,358,319,677,Spen229_T,"-37.81531435, 144.95227769"
1331320240320,133,2024-03-20,13,613,594,1207,Spen229_T,"-37.81531435, 144.95227769"
133820240329,133,2024-03-29,8,473,481,954,Spen229_T,"-37.81531435, 144.95227769"
1181020250424,118,2025-04-24,10,13,22,35,Fli114C_T,"-37.81632783, 144.97090512"
1181220240815,118,2024-08-15,12,15,36,51,Fli114C_T,"-37.81632783, 144.97090512"
681220250724,68,2025-07-24,12,687,480,1167,FLDegN_T,"-37.8168479, 144.96559789"
11720240329,1,2024-03-29,17,804,611,1415,Bou292_T,"-37.81349441, 144.96515323"
1120240827,1,2024-08-27,1,11,14,25,Bou292_T,"-37.81349441, 144.96515323"
861320250924,86,2025-09-24,13,48,74,122,574Qub_T,"-37.80309992, 144.94908064"
861620241107,86,2024-11-07,16,44,67,111,574Qub_T,"-37.80309992, 144.94908064"
621220231109,62,2023-11-09,12,227,146,373,Lat224_T,"-37.80996494, 144.96216521"
622120240311,62,2024-03-11,21,143,76,219,Lat224_T,"-37.80996494, 144.96216521"
621020240313,62,2024-03-13,10,176,139,315,Lat224_T,"-37.80996494, 144.96216521"
621020240821,62,2024-08-21,10,150,141,291,Lat224_T,"-37.80996494, 144.96216521"
561320231018,56,2023-10-18,13,320,196,516,Lon364_T,"-37.81234775, 144.96153311"
121120250321,12,2025-03-21,11,35,17,52,NewQ_T,"-37.81457988, 144.94292398"
241320241127,24,2024-11-27,13,703,859,1562,Col620_T,"-37.81887963, 144.95449198"
561020250627,56,2025-06-27,10,243,216,459,Lon364_T,"-37.81234775, 144.96153311"
101620241122,10,2024-11-22,16,138,44,182,BouHbr_T,"-37.81876474, 144.94710545"
10820250423,10,2025-04-23,8,53,131,184,BouHbr_T,"-37.81876474, 144.94710545"
12920250811,12,2025-08-11,9,113,83,196,NewQ_T,"-37.81457988, 144.94292398"
581220250404,58,2025-04-04,12,759,388,1147,Bou688_T,"-37.81686075, 144.95358075"
271220240730,27,2024-07-30,12,240,195,435,Vic_T,"-37.80606888, 144.95644692"
271320231109,27,2023-11-09,13,177,126,303,Vic_T,"-37.80606888, 144.95644692"
21220240801,2,2024-08-01,12,669,803,1472,Bou283_T,"-37.81380668, 144.96516718"
301620250917,30,2025-09-17,16,192,372,564,Lon189_T,"-37.8112185, 144.96656806"
79620231229,79,2023-12-29,6,67,62,129,FliSS_T,"-37.81794046, 144.96616678"
53020250103,53,2025-01-03,0,16,19,35,Col254_T,"-37.81564191, 144.965499"
25020240203,25,2024-02-03,0,70,72,142,MCEC_T,"-37.82401776, 144.95604426"
521420240128,52,2024-01-28,14,277,278,555,Eli263_T,"-37.81252157, 144.9619401"
701220241007,70,2024-10-07,12,185,175,360,Errol20_T,"-37.80456984, 144.94946228"
701320241101,70,2024-11-01,13,139,141,280,Errol20_T,"-37.80456984, 144.94946228"
75520241031,75,2024-10-31,5,13,1,14,SprFli_T,"-37.81515276, 144.97467661"
78320241122,78,2024-11-22,3,0,1,1,HarEsB_T,"-37.81471642, 144.9446508"
651920240609,65,2024-06-09,19,148,306,454,SwaCs_T,"-37.81569416, 144.9668064"
77320250330,77,2025-03-30,3,6,1,7,HarEsP_T,"-37.81441438, 144.94433026"
141520241018,14,2024-10-18,15,311,105,416,SanBri_T,"-37.82011242, 144.96291897"
291520240808,29,2024-08-08,15,153,258,411,AG_T,"-37.8199817, 144.96872865"
541020250612,54,2025-06-12,10,110,80,190,Swa607_T,"-37.804024, 144.96308399"
282120231217,28,2023-12-17,21,635,255,890,VAC_T,"-37.82129925, 144.96879309"
47320250819,47,2025-08-19,3,13,16,29,Eli250_T,"-37.81258467, 144.9625775"
47520231028,47,2023-10-28,5,23,51,74,Eli250_T,"-37.81258467, 144.9625775"
402020240906,40,2024-09-06,20,97,76,173,Spr201_T,"-37.80999341, 144.97227587"
21620240824,21,2024-08-24,6,13,21,34,Bourke155_T,"-37.81267313, 144.96788288"
372220231212,37,2023-12-12,22,79,167,246,Lyg260_T,"-37.80107122, 144.96704554"
872020241128,87,2024-11-28,20,91,90,181,Errol23_T,"-37.80454949, 144.94921863"
612320250505,61,2025-05-05,23,80,31,111,RMIT14_T,"-37.80767455, 144.96309114"
61920240420,61,2024-04-20,9,117,228,345,RMIT14_T,"-37.80767455, 144.96309114"
44120250725,44,2025-07-25,1,1,1,2,UM3_T,"-37.79698741, 144.96441306"
50320240731,50,2024-07-31,3,6,2,8,Lyg309_T,"-37.79808192, 144.96721013"
431020240205,43,2024-02-05,10,82,95,177,UM2_T,"-37.79844526, 144.96411782"
45520240908,45,2024-09-08,5,38,54,92,Swa148_T,"-37.81414075, 144.96609379"
140820231117,140,2023-11-17,8,198,26,224,Boyd2837_T,"-37.82590962, 144.96185972"
131120240314,131,2024-03-14,1,7,11,18,King2_T,"-37.82009057, 144.95758725"
1431520250427,143,2025-04-27,15,292,171,463,Spencer_T,"-37.821728, 144.95557015"
1321320231218,132,2023-12-18,13,130,88,218,King335_T,"-37.81267639, 144.95386444"
1341720240131,134,2024-01-31,17,416,294,710,Spen201_T,"-37.81694221, 144.95303935"
1341720250503,134,2025-05-03,17,512,475,987,Spen201_T,"-37.81694221, 144.95303935"
1351920240607,135,2024-06-07,19,308,292,600,Spen161_T,"-37.8172861, 144.95319102"
1331920241116,133,2024-11-16,19,589,749,1338,Spen229_T,"-37.81531435, 144.95227769"
1081220240504,108,2024-05-04,12,39,125,164,261Will_T,"-37.81295822, 144.95678789"
181720250927,181,2025-09-27,7,84,147,231,Eli368_T,"-37.81009465, 144.96143149"
181720250522,181,2025-05-22,7,237,296,533,Eli368_T,"-37.81009465, 144.96143149"
671920250131,67,2025-01-31,19,297,378,675,FLDegS_T,"-37.81688755, 144.96562569"
851720240109,85,2024-01-09,17,64,132,196,488Mac_T,"-37.79432415, 144.92973378"
851120250816,85,2025-08-16,11,129,114,243,488Mac_T,"-37.79432415, 144.92973378"
682120250123,68,2025-01-23,21,132,87,219,FLDegN_T,"-37.8168479, 144.96559789"
681320250715,68,2025-07-15,13,468,460,928,FLDegN_T,"-37.8168479, 144.96559789"
111520240322,11,2024-03-22,15,65,83,148,WatCit_T,"-37.81564989, 144.93970694"
111820250822,11,2025-08-22,18,40,52,92,WatCit_T,"-37.81564989, 144.93970694"
121520250701,12,2025-07-01,15,78,119,197,NewQ_T,"-37.81457988, 144.94292398"
241020250227,24,2025-02-27,10,754,392,1146,Col620_T,"-37.81887963, 144.95449198"
10320250718,10,2025-07-18,3,0,1,1,BouHbr_T,"-37.81876474, 144.94710545"
102020240516,10,2024-05-16,20,26,18,44,BouHbr_T,"-37.81876474, 144.94710545"
72820231118,72,2023-11-18,8,86,93,179,ACMI_T,"-37.81726338, 144.96872809"
271020240209,27,2024-02-09,10,122,124,246,Vic_T,"-37.80606888, 144.95644692"
91020231104,9,2023-11-04,10,98,97,195,Col700_T,"-37.81982992, 144.95102555"
79920251009,79,2025-10-09,9,356,292,648,FliSS_T,"-37.81794046, 144.96616678"
23820240205,23,2024-02-05,8,618,267,885,Col623_T,"-37.81909256, 144.95452748"
481520240527,48,2024-05-27,15,155,82,237,QVMQ_T,"-37.80631581, 144.95866697"
48920240921,48,2024-09-21,9,212,199,411,QVMQ_T,"-37.80631581, 144.95866697"
482020250425,48,2025-04-25,20,75,80,155,QVMQ_T,"-37.80631581, 144.95866697"
48120240229,48,2024-02-29,1,3,10,13,QVMQ_T,"-37.80631581, 144.95866697"
251920250527,25,2025-05-27,19,152,155,307,MCEC_T,"-37.82401776, 144.95604426"
46520240503,46,2024-05-03,5,5,8,13,Pel147_T,"-37.80240719, 144.9615673"
201420231103,20,2023-11-03,14,222,253,475,LtB170_T,"-37.81172914, 144.9682466"
20120231211,20,2023-12-11,1,12,13,25,LtB170_T,"-37.81172914, 144.9682466"
521420250707,52,2025-07-07,14,439,404,843,Eli263_T,"-37.81252157, 144.9619401"
46120241111,46,2024-11-11,1,2,1,3,Pel147_T,"-37.80240719, 144.9615673"
231320250508,23,2025-05-08,13,348,686,1034,Col623_T,"-37.81909256, 144.95452748"
481420250623,48,2025-06-23,14,131,148,279,QVMQ_T,"-37.80631581, 144.95866697"
481820251001,48,2025-10-01,18,218,477,695,QVMQ_T,"-37.80631581, 144.95866697"
1172220240122,117,2024-01-22,22,168,126,294,Fli114F_T,"-37.81629332, 144.97090877"
1171920241017,117,2024-10-17,19,208,213,421,Fli114F_T,"-37.81629332, 144.97090877"
491520241120,49,2024-11-20,15,208,207,415,Eli501_T,"-37.80730068, 144.95956055"
491120231018,49,2023-10-18,11,160,175,335,Eli501_T,"-37.80730068, 144.95956055"
1372220250131,137,2025-01-31,22,1,2,3,BouHbr2353_T,"-37.81894815, 144.94612292"
136220241129,136,2024-11-29,2,2,0,2,BirFed1120_T,"-37.8184141, 144.97357915"
1421520241006,142,2024-10-06,15,760,556,1316,Hammer1584_T,"-37.81970749, 144.96795734"
1381020250131,138,2025-01-31,10,5,7,12,EntPark1671_T,"-37.81996544, 144.95981454"
691520240519,69,2024-05-19,15,156,140,296,FLDegC_T,"-37.81687226, 144.96559144"
691420240917,69,2024-09-17,14,176,219,395,FLDegC_T,"-37.81687226, 144.96559144"
691820241226,69,2024-12-26,18,71,56,127,FLDegC_T,"-37.81687226, 144.96559144"
752220240716,75,2024-07-16,22,12,12,24,SprFli_T,"-37.81515276, 144.97467661"
391620250824,39,2025-08-24,16,26,29,55,AlfPl_T,"-37.81379749, 144.96995745"
41820231203,41,2023-12-03,8,419,253,672,Swa31,"-37.81668634, 144.96689733"
712020250416,71,2025-04-16,20,4,9,13,WestWP_T,"-37.81235775, 144.97136962"
29520240403,29,2024-04-03,5,7,28,35,AG_T,"-37.8199817, 144.96872865"
291320231116,29,2023-11-16,13,269,264,533,AG_T,"-37.8199817, 144.96872865"
40820240409,40,2024-04-09,8,241,502,743,Spr201_T,"-37.80999341, 144.97227587"
5220250125,5,2025-01-25,2,33,46,79,PriNW_T,"-37.81874249, 144.96787656"
871920250210,87,2025-02-10,19,63,73,136,Errol23_T,"-37.80454949, 144.94921863"
872320250605,87,2025-06-05,23,7,10,17,Errol23_T,"-37.80454949, 144.94921863"
611720250220,61,2025-02-20,17,851,1174,2025,RMIT14_T,"-37.80767455, 144.96309114"
871920240523,87,2024-05-23,19,92,59,151,Errol23_T,"-37.80454949, 144.94921863"
61620231019,61,2023-10-19,6,48,66,114,RMIT14_T,"-37.80767455, 144.96309114"
502120241018,50,2024-10-18,21,347,133,480,Lyg309_T,"-37.79808192, 144.96721013"
451520250830,45,2025-08-30,15,442,830,1272,Swa148_T,"-37.81414075, 144.96609379"
44920240701,44,2024-07-01,9,31,40,71,UM3_T,"-37.79698741, 144.96441306"
1812220250815,181,2025-08-15,22,749,719,1468,Eli368_T,"-37.81009465, 144.96143149"
1311820250816,131,2025-08-16,18,130,107,237,King2_T,"-37.82009057, 144.95758725"
162120250712,162,2025-07-12,1,46,42,88,Eli489_T,"-37.80740397, 144.95987909"
1431420251007,143,2025-10-07,14,124,180,304,Spencer_T,"-37.821728, 144.95557015"
143520241229,143,2024-12-29,5,19,10,29,Spencer_T,"-37.821728, 144.95557015"
1321820250410,132,2025-04-10,18,186,194,380,King335_T,"-37.81267639, 144.95386444"
1341420240523,134,2024-05-23,14,282,276,558,Spen201_T,"-37.81694221, 144.95303935"
1181620240721,118,2024-07-21,16,26,13,39,Fli114C_T,"-37.81632783, 144.97090512"
1181820250212,118,2025-02-12,18,11,38,49,Fli114C_T,"-37.81632783, 144.97090512"
861220241202,86,2024-12-02,12,68,67,135,574Qub_T,"-37.80309992, 144.94908064"
862320250121,86,2025-01-21,23,2,8,10,574Qub_T,"-37.80309992, 144.94908064"
56220231227,56,2023-12-27,2,13,8,21,Lon364_T,"-37.81234775, 144.96153311"
24320250802,24,2025-08-02,3,24,34,58,Col620_T,"-37.81887963, 144.95449198"
101320240725,10,2024-07-25,13,101,74,175,BouHbr_T,"-37.81876474, 144.94710545"
351120250312,35,2025-03-12,11,801,822,1623,SouthB_T,"-37.82018685, 144.96508508"
271920240629,27,2024-06-29,19,112,74,186,Vic_T,"-37.80606888, 144.95644692"
581620250413,58,2025-04-13,16,479,288,767,Bou688_T,"-37.81686075, 144.95358075"
3720231201,3,2023-12-01,7,82,127,209,Swa295_T,"-37.81101524, 144.96429485"
751820240205,75,2024-02-05,18,37,33,70,SprFli_T,"-37.81515276, 144.97467661"
421420241129,42,2024-11-29,14,116,122,238,UM1_T,"-37.80008566, 144.96386412"
141920241011,14,2024-10-11,19,495,136,631,SanBri_T,"-37.82011242, 144.96291897"
711220240112,71,2024-01-12,12,30,34,64,WestWP_T,"-37.81235775, 144.97136962"
651720240701,65,2024-07-01,17,704,957,1661,SwaCs_T,"-37.81569416, 144.9668064"
40520240325,40,2024-03-25,5,9,10,19,Spr201_T,"-37.80999341, 144.97227587"
401520241105,40,2024-11-05,15,83,67,150,Spr201_T,"-37.80999341, 144.97227587"
311620250919,31,2025-09-19,16,120,147,267,Lyg161_T,"-37.80169681, 144.96658911"
54520250819,54,2025-08-19,5,10,3,13,Swa607_T,"-37.804024, 144.96308399"
311220241125,31,2024-11-25,12,109,92,201,Lyg161_T,"-37.80169681, 144.96658911"
542320250123,54,2025-01-23,23,14,20,34,Swa607_T,"-37.804024, 144.96308399"
54620250522,54,2025-05-22,6,14,9,23,Swa607_T,"-37.804024, 144.96308399"
37720250223,37,2025-02-23,7,12,4,16,Lyg260_T,"-37.80107122, 144.96704554"
451820231221,45,2023-12-21,18,910,1009,1919,Swa148_T,"-37.81414075, 144.96609379"
211720250514,21,2025-05-14,17,407,342,749,Bourke155_T,"-37.81267313, 144.96788288"
21020241210,21,2024-12-10,0,15,47,62,Bourke155_T,"-37.81267313, 144.96788288"
1081220240610,108,2024-06-10,12,48,144,192,261Will_T,"-37.81295822, 144.95678789"
872220250622,87,2025-06-22,22,7,15,22,Errol23_T,"-37.80454949, 144.94921863"
611620250327,61,2025-03-27,16,896,1371,2267,RMIT14_T,"-37.80767455, 144.96309114"
442020250105,44,2025-01-05,20,6,10,16,UM3_T,"-37.79698741, 144.96441306"
441220250204,44,2025-02-04,12,51,34,85,UM3_T,"-37.79698741, 144.96441306"
44120250823,44,2025-08-23,1,10,4,14,UM3_T,"-37.79698741, 144.96441306"
431920250403,43,2025-04-03,19,115,168,283,UM2_T,"-37.79844526, 144.96411782"
70120231113,70,2023-11-13,1,0,1,1,Errol20_T,"-37.80456984, 144.94946228"
1652220240830,165,2024-08-30,22,27,5,32,Spen475_T,"-37.80953359, 144.94939004"
162720250408,162,2025-04-08,7,164,96,260,Eli489_T,"-37.80740397, 144.95987909"
1621420250601,162,2025-06-01,14,703,964,1667,Eli489_T,"-37.80740397, 144.95987909"
1671520241102,167,2024-11-02,15,40,78,118,Lat526_T,"-37.81304149, 144.95155955"
143820250701,143,2025-07-01,8,105,118,223,Spencer_T,"-37.821728, 144.95557015"
1341120240601,134,2024-06-01,11,307,348,655,Spen201_T,"-37.81694221, 144.95303935"
1352320240809,135,2024-08-09,23,54,77,131,Spen161_T,"-37.8172861, 144.95319102"
1351520240923,135,2024-09-23,15,438,426,864,Spen161_T,"-37.8172861, 144.95319102"
1241420250802,124,2025-08-02,14,4,4,8,BirBridge_T,"-37.81757416, 144.97329934"
107220241127,107,2024-11-27,2,8,0,8,280Will_T,"-37.81246271, 144.95690188"
671320240627,67,2024-06-27,13,521,734,1255,FLDegS_T,"-37.81688755, 144.96562569"
68720240425,68,2024-04-25,7,84,79,163,FLDegN_T,"-37.8168479, 144.96559789"
85820250422,85,2025-04-22,8,107,46,153,488Mac_T,"-37.79432415, 144.92973378"
67720240831,67,2024-08-31,7,57,64,121,FLDegS_T,"-37.81688755, 144.96562569"
112220240207,11,2024-02-07,22,40,38,78,WatCit_T,"-37.81564989, 144.93970694"
111220240813,11,2024-08-13,12,133,136,269,WatCit_T,"-37.81564989, 144.93970694"
112320241123,11,2024-11-23,23,34,50,84,WatCit_T,"-37.81564989, 144.93970694"
112220250524,11,2025-05-24,22,61,142,203,WatCit_T,"-37.81564989, 144.93970694"
241420231107,24,2023-11-07,14,288,453,741,Col620_T,"-37.81887963, 144.95449198"
241120231211,24,2023-12-11,11,585,413,998,Col620_T,"-37.81887963, 144.95449198"
122320240718,12,2024-07-18,23,23,34,57,NewQ_T,"-37.81457988, 144.94292398"
12820240513,12,2024-05-13,8,129,114,243,NewQ_T,"-37.81457988, 144.94292398"
561520250621,56,2025-06-21,15,499,489,988,Lon364_T,"-37.81234775, 144.96153311"
72920240308,72,2024-03-08,9,232,152,384,ACMI_T,"-37.81726338, 144.96872809"
721920250327,72,2025-03-27,19,151,365,516,ACMI_T,"-37.81726338, 144.96872809"
351820241206,35,2024-12-06,18,1660,1717,3377,SouthB_T,"-37.82018685, 144.96508508"
272020231029,27,2023-10-29,20,104,55,159,Vic_T,"-37.80606888, 144.95644692"
2520240122,2,2024-01-22,5,5,11,16,Bou283_T,"-37.81380668, 144.96516718"
302320240925,30,2024-09-25,23,92,118,210,Lon189_T,"-37.8112185, 144.96656806"
79220240908,79,2024-09-08,2,96,129,225,FliSS_T,"-37.81794046, 144.96616678"
792120241128,79,2024-11-28,21,345,427,772,FliSS_T,"-37.81794046, 144.96616678"
301120240409,30,2024-04-09,11,162,240,402,Lon189_T,"-37.8112185, 144.96656806"
531320241031,53,2024-10-31,13,949,813,1762,Col254_T,"-37.81564191, 144.965499"
231120240417,23,2024-04-17,11,293,289,582,Col623_T,"-37.81909256, 144.95452748"
25820250330,25,2025-03-30,8,173,260,433,MCEC_T,"-37.82401776, 144.95604426"
201920250918,20,2025-09-18,19,410,599,1009,LtB170_T,"-37.81172914, 144.9682466"
180720250927,180,2025-09-27,7,24,8,32,Mac330_T,"-37.79497059, 144.93530329"
1362320250627,136,2025-06-27,23,3,2,5,BirFed1120_T,"-37.8184141, 144.97357915"
142720241121,142,2024-11-21,7,255,338,593,Hammer1584_T,"-37.81970749, 144.96795734"
123920241113,123,2024-11-13,9,2,0,2,BirBridge_T,"-37.81753741, 144.97329734"
19120240417,19,2024-04-17,1,44,53,97,LtB210_T,"-37.81237202, 144.96550671"
662120250902,66,2025-09-02,21,935,534,1469,QVN_T,"-37.81057846, 144.96444294"
6120250505,6,2025-05-05,1,23,22,45,FliS_T,"-37.81911705, 144.96558255"
84620240414,84,2024-04-14,6,88,74,162,ElFi_T,"-37.81798049, 144.96503383"
661420240325,66,2024-03-25,14,1166,1175,2341,QVN_T,"-37.81057846, 144.96444294"
32320231102,3,2023-11-02,23,294,265,559,Swa295_T,"-37.81101524, 144.96429485"
41720240715,4,2024-07-15,17,807,563,1370,Swa123_T,"-37.81487988, 144.9660878"
702020240314,70,2024-03-14,20,90,120,210,Errol20_T,"-37.80456984, 144.94946228"
75920250314,75,2025-03-14,9,48,27,75,SprFli_T,"-37.81515276, 144.97467661"
391520240809,39,2024-08-09,15,65,54,119,AlfPl_T,"-37.81379749, 144.96995745"
41220250513,41,2025-05-13,2,33,28,61,Swa31,"-37.81668634, 144.96689733"
771120240513,77,2024-05-13,11,160,96,256,HarEsP_T,"-37.81441438, 144.94433026"
77820240519,77,2024-05-19,8,56,63,119,HarEsP_T,"-37.81441438, 144.94433026"
711020250314,71,2025-03-14,10,21,24,45,WestWP_T,"-37.81235775, 144.97136962"
711020250417,71,2025-04-17,10,22,30,52,WestWP_T,"-37.81235775, 144.97136962"
282120241104,28,2024-11-04,21,153,114,267,VAC_T,"-37.82129925, 144.96879309"
28920241213,28,2024-12-13,9,354,201,555,VAC_T,"-37.82129925, 144.96879309"
471120240803,47,2024-08-03,11,689,838,1527,Eli250_T,"-37.81258467, 144.9625775"
40420240620,40,2024-06-20,4,2,1,3,Spr201_T,"-37.80999341, 144.97227587"
21920240606,21,2024-06-06,9,107,105,212,Bourke155_T,"-37.81267313, 144.96788288"
5520241206,5,2024-12-06,5,39,76,115,PriNW_T,"-37.81874249, 144.96787656"
362020250314,36,2025-03-14,20,194,203,397,Que85_T,"-37.81652527, 144.96121062"
61720241011,61,2024-10-11,7,149,140,289,RMIT14_T,"-37.80767455, 144.96309114"
611220250729,61,2025-07-29,12,681,775,1456,RMIT14_T,"-37.80767455, 144.96309114"
441020240205,44,2024-02-05,10,26,16,42,UM3_T,"-37.79698741, 144.96441306"
162020250331,162,2025-03-31,0,59,35,94,Eli489_T,"-37.80740397, 144.95987909"
162220241230,162,2024-12-30,2,16,12,28,Eli489_T,"-37.80740397, 144.95987909"
1321920250523,132,2025-05-23,19,120,101,221,King335_T,"-37.81267639, 144.95386444"
1351320250221,135,2025-02-21,13,554,589,1143,Spen161_T,"-37.8172861, 144.95319102"
1071320240728,107,2024-07-28,13,67,116,183,280Will_T,"-37.81246271, 144.95690188"
1331320251001,133,2025-10-01,13,613,481,1094,Spen229_T,"-37.81531435, 144.95227769"
133020241001,133,2024-10-01,0,41,25,66,Spen229_T,"-37.81531435, 144.95227769"
1331820240307,133,2024-03-07,18,541,529,1070,Spen229_T,"-37.81531435, 144.95227769"
133220240330,133,2024-03-30,2,48,18,66,Spen229_T,"-37.81531435, 144.95227769"
1081720231024,108,2023-10-24,17,1580,249,1829,261Will_T,"-37.81295822, 144.95678789"
1821220250619,182,2025-06-19,12,413,279,692,King163_T,"-37.81627451, 144.95550503"
1791920250814,179,2025-08-14,19,53,59,112,Pow61_T,"-37.82392385, 144.96299677"
179720250610,179,2025-06-10,7,28,16,44,Pow61_T,"-37.82392385, 144.96299677"
851120241230,85,2024-12-30,11,78,75,153,488Mac_T,"-37.79432415, 144.92973378"
852020250527,85,2025-05-27,20,21,23,44,488Mac_T,"-37.79432415, 144.92973378"
12220250210,1,2025-02-10,22,76,84,160,Bou292_T,"-37.81349441, 144.96515323"
63520250609,63,2025-06-09,5,0,4,4,Bou231_T,"-37.81333081, 144.96675571"
91520240729,9,2024-07-29,15,798,162,960,Col700_T,"-37.81982992, 144.95102555"
301320250804,30,2025-08-04,13,282,353,635,Lon189_T,"-37.8112185, 144.96656806"
791420240202,79,2024-02-02,14,526,328,854,FliSS_T,"-37.81794046, 144.96616678"
52220240625,52,2024-06-25,2,5,8,13,Eli263_T,"-37.81252157, 144.9619401"
512020250303,51,2025-03-03,20,101,72,173,Fra118_T,"-37.80841815, 144.95906316"
232020250427,23,2025-04-27,20,79,148,227,Col623_T,"-37.81909256, 144.95452748"
1411120240317,141,2024-03-17,11,462,157,619,474Fl_T,"-37.81997273, 144.95834911"
1412120241207,141,2024-12-07,21,178,183,361,474Fl_T,"-37.81997273, 144.95834911"
19320231204,19,2023-12-04,3,3,14,17,LtB210_T,"-37.81237202, 144.96550671"
48620231210,48,2023-12-10,6,22,29,51,QVMQ_T,"-37.80631581, 144.95866697"
137620250215,137,2025-02-15,6,1,0,1,BouHbr2353_T,"-37.81894815, 144.94612292"
671520250130,67,2025-01-30,15,387,598,985,FLDegS_T,"-37.81688755, 144.96562569"
672120231118,67,2023-11-18,21,234,322,556,FLDegS_T,"-37.81688755, 144.96562569"
121320231112,12,2023-11-12,13,249,246,495,NewQ_T,"-37.81457988, 144.94292398"
661420250108,66,2025-01-08,14,1066,932,1998,QVN_T,"-37.81057846, 144.96444294"
4620231105,4,2023-11-05,6,60,68,128,Swa123_T,"-37.81487988, 144.9660878"
391820240827,39,2024-08-27,18,103,42,145,AlfPl_T,"-37.81379749, 144.96995745"
71220251015,71,2025-10-15,2,1,1,2,WestWP_T,"-37.81235775, 144.97136962"
711820250303,71,2025-03-03,18,19,19,38,WestWP_T,"-37.81235775, 144.97136962"
29320241230,29,2024-12-30,3,7,7,14,AG_T,"-37.8199817, 144.96872865"
141120240405,14,2024-04-05,11,286,92,378,SanBri_T,"-37.82011242, 144.96291897"
28120250426,28,2025-04-26,1,20,0,20,VAC_T,"-37.82129925, 144.96879309"
401320241020,40,2024-10-20,13,159,157,316,Spr201_T,"-37.80999341, 144.97227587"
212220241008,21,2024-10-08,22,72,130,202,Bourke155_T,"-37.81267313, 144.96788288"
132620250721,132,2025-07-21,6,24,13,37,King335_T,"-37.81267639, 144.95386444"
1181020250605,118,2025-06-05,10,17,13,30,Fli114C_T,"-37.81632783, 144.97090512"
1181320231221,118,2023-12-21,13,16,22,38,Fli114C_T,"-37.81632783, 144.97090512"
611620241117,61,2024-11-17,16,460,513,973,RMIT14_T,"-37.80767455, 144.96309114"
61320241126,61,2024-11-26,3,1,1,2,RMIT14_T,"-37.80767455, 144.96309114"
611120240205,61,2024-02-05,11,184,409,593,RMIT14_T,"-37.80767455, 144.96309114"
1851620250926,185,2025-09-26,16,739,675,1414,Eli197_T,"-37.81374643, 144.96276183"
1651120241203,165,2024-12-03,11,26,46,72,Spen475_T,"-37.80953359, 144.94939004"
861320240208,86,2024-02-08,13,66,109,175,574Qub_T,"-37.80309992, 144.94908064"
86920240426,86,2024-04-26,9,51,34,85,574Qub_T,"-37.80309992, 144.94908064"
862120250508,86,2025-05-08,21,8,24,32,574Qub_T,"-37.80309992, 144.94908064"
68420250322,68,2025-03-22,4,2,1,3,FLDegN_T,"-37.8168479, 144.96559789"
62720241011,62,2024-10-11,7,51,57,108,Lat224_T,"-37.80996494, 144.96216521"
62120250418,62,2025-04-18,1,72,30,102,Lat224_T,"-37.80996494, 144.96216521"
62620250603,62,2025-06-03,6,69,18,87,Lat224_T,"-37.80996494, 144.96216521"
111020240110,11,2024-01-10,10,38,51,89,WatCit_T,"-37.81564989, 144.93970694"
241220250715,24,2025-07-15,12,887,756,1643,Col620_T,"-37.81887963, 144.95449198"
10020241103,10,2024-11-03,0,10,26,36,BouHbr_T,"-37.81876474, 144.94710545"
721520240904,72,2024-09-04,15,133,279,412,ACMI_T,"-37.81726338, 144.96872809"
351320240929,35,2024-09-29,13,642,719,1361,SouthB_T,"-37.82018685, 144.96508508"
79920250222,79,2025-02-22,9,381,281,662,FliSS_T,"-37.81794046, 144.96616678"
531320241002,53,2024-10-02,13,1082,766,1848,Col254_T,"-37.81564191, 144.965499"
201220250907,20,2025-09-07,12,249,235,484,LtB170_T,"-37.81172914, 144.9682466"
48920250508,48,2025-05-08,9,163,173,336,QVMQ_T,"-37.80631581, 144.95866697"
201320240906,20,2024-09-06,13,190,243,433,LtB170_T,"-37.81172914, 144.9682466"
251620240801,25,2024-08-01,16,672,479,1151,MCEC_T,"-37.82401776, 144.95604426"
137620250112,137,2025-01-12,6,0,3,3,BouHbr2353_T,"-37.81894815, 144.94612292"
142920240409,142,2024-04-09,9,111,62,173,Hammer1584_T,"-37.81970749, 144.96795734"
1381520250509,138,2025-05-09,15,8,5,13,EntPark1671_T,"-37.81996544, 144.95981454"
117720241028,117,2024-10-28,7,92,53,145,Fli114F_T,"-37.81629332, 144.97090877"
19620240920,19,2024-09-20,6,17,19,36,LtB210_T,"-37.81237202, 144.96550671"
692120231229,69,2023-12-29,21,52,44,96,FLDegC_T,"-37.81687226, 144.96559144"
84220240419,84,2024-04-19,2,30,29,59,ElFi_T,"-37.81798049, 144.96503383"
61620250721,6,2025-07-21,16,1428,691,2119,FliS_T,"-37.81911705, 144.96558255"
31420240925,3,2024-09-25,14,1103,1184,2287,Swa295_T,"-37.81101524, 144.96429485"
752020231018,75,2023-10-18,20,16,29,45,SprFli_T,"-37.81515276, 144.97467661"
751320240330,75,2024-03-30,13,43,28,71,SprFli_T,"-37.81515276, 144.97467661"
82020240205,8,2024-02-05,20,86,87,173,WebBN_T,"-37.82293543, 144.9471751"
81620241107,8,2024-11-07,16,159,330,489,WebBN_T,"-37.82293543, 144.9471751"
421520241229,42,2024-12-29,15,42,31,73,UM1_T,"-37.80008566, 144.96386412"
711520250930,71,2025-09-30,15,11,8,19,WestWP_T,"-37.81235775, 144.97136962"
541120250315,54,2025-03-15,11,69,67,136,Swa607_T,"-37.804024, 144.96308399"
541420250618,54,2025-06-18,14,160,147,307,Swa607_T,"-37.804024, 144.96308399"
541220240122,54,2024-01-22,12,84,101,185,Swa607_T,"-37.804024, 144.96308399"
40320250427,40,2025-04-27,3,12,1,13,Spr201_T,"-37.80999341, 144.97227587"
47520250502,47,2025-05-02,5,25,59,84,Eli250_T,"-37.81258467, 144.9625775"
401320250130,40,2025-01-30,13,433,288,721,Spr201_T,"-37.80999341, 144.97227587"
362120240114,36,2024-01-14,21,78,55,133,Que85_T,"-37.81652527, 144.96121062"
44320231021,44,2023-10-21,3,1,1,2,UM3_T,"-37.79698741, 144.96441306"
1321220240130,132,2024-01-30,12,195,121,316,King335_T,"-37.81267639, 144.95386444"
1341120240521,134,2024-05-21,11,241,335,576,Spen201_T,"-37.81694221, 144.95303935"
671020231216,67,2023-12-16,10,288,293,581,FLDegS_T,"-37.81688755, 144.96562569"
851620250514,85,2025-05-14,16,72,86,158,488Mac_T,"-37.79432415, 144.92973378"
1120241026,1,2024-10-26,1,32,36,68,Bou292_T,"-37.81349441, 144.96515323"
12220241230,1,2024-12-30,22,217,188,405,Bou292_T,"-37.81349441, 144.96515323"
67920250511,67,2025-05-11,9,201,235,436,FLDegS_T,"-37.81688755, 144.96562569"
181720231118,18,2023-11-18,17,91,77,168,Col12_T,"-37.81344862, 144.97305353"
861920240902,86,2024-09-02,19,19,29,48,574Qub_T,"-37.80309992, 144.94908064"
11920240701,11,2024-07-01,9,49,73,122,WatCit_T,"-37.81564989, 144.93970694"
622220250214,62,2025-02-14,22,147,114,261,Lat224_T,"-37.80996494, 144.96216521"
62520250318,62,2025-03-18,5,20,11,31,Lat224_T,"-37.80996494, 144.96216521"
561320240629,56,2024-06-29,13,308,264,572,Lon364_T,"-37.81234775, 144.96153311"
56120250127,56,2025-01-27,1,18,24,42,Lon364_T,"-37.81234775, 144.96153311"
122120240625,12,2024-06-25,21,117,97,214,NewQ_T,"-37.81457988, 144.94292398"
12420240727,12,2024-07-27,4,1,7,8,NewQ_T,"-37.81457988, 144.94292398"
10720250507,10,2025-05-07,7,36,137,173,BouHbr_T,"-37.81876474, 144.94710545"
101320250526,10,2025-05-26,13,111,89,200,BouHbr_T,"-37.81876474, 144.94710545"
101220251002,10,2025-10-02,12,184,104,288,BouHbr_T,"-37.81876474, 144.94710545"
35320240224,35,2024-02-24,3,29,70,99,SouthB_T,"-37.82018685, 144.96508508"
721320250617,72,2025-06-17,13,109,156,265,ACMI_T,"-37.81726338, 144.96872809"
531820231101,53,2023-11-01,18,474,322,796,Col254_T,"-37.81564191, 144.965499"
9820250207,9,2025-02-07,8,87,1863,1950,Col700_T,"-37.81982992, 144.95102555"
30120240813,30,2024-08-13,1,8,52,60,Lon189_T,"-37.8112185, 144.96656806"
231720240105,23,2024-01-05,17,178,236,414,Col623_T,"-37.81909256, 144.95452748"
511820240714,51,2024-07-14,18,67,62,129,Fra118_T,"-37.80841815, 144.95906316"
461920231116,46,2023-11-16,19,43,40,83,Pel147_T,"-37.80240719, 144.9615673"
462120240123,46,2024-01-23,21,23,37,60,Pel147_T,"-37.80240719, 144.9615673"
52120250727,52,2025-07-27,1,164,157,321,Eli263_T,"-37.81252157, 144.9619401"
201220240304,20,2024-03-04,12,262,240,502,LtB170_T,"-37.81172914, 144.9682466"
201320251002,20,2025-10-02,13,309,403,712,LtB170_T,"-37.81172914, 144.9682466"
251520240828,25,2024-08-28,15,460,407,867,MCEC_T,"-37.82401776, 144.95604426"
521320250512,52,2025-05-12,13,405,340,745,Eli263_T,"-37.81252157, 144.9619401"
512120250604,51,2025-06-04,21,64,75,139,Fra118_T,"-37.80841815, 144.95906316"
1301020240820,130,2024-08-20,10,18,12,30,Bou892T,"-37.8204637, 144.94126826"
138020250124,138,2025-01-24,0,1,0,1,EntPark1671_T,"-37.81996544, 144.95981454"
1171420250501,117,2025-05-01,14,136,181,317,Fli114F_T,"-37.81629332, 144.97090877"
1171920250802,117,2025-08-02,19,365,184,549,Fli114F_T,"-37.81629332, 144.97090877"
117620231028,117,2023-10-28,6,12,19,31,Fli114F_T,"-37.81629332, 144.97090877"
117420240319,117,2024-03-19,4,3,1,4,Fli114F_T,"-37.81629332, 144.97090877"
109620241213,109,2024-12-13,6,18,74,92,LatWill_T,"-37.81193681, 144.95621105"
191720240401,19,2024-04-01,17,654,387,1041,LtB210_T,"-37.81237202, 144.96550671"
48620241028,48,2024-10-28,6,22,9,31,QVMQ_T,"-37.80631581, 144.95866697"
1371620240827,137,2024-08-27,16,12,102,114,BouHbr2353_T,"-37.81894815, 144.94612292"
1371120240922,137,2024-09-22,11,6,16,22,BouHbr2353_T,"-37.81894815, 144.94612292"
137620250120,137,2025-01-20,6,8,5,13,BouHbr2353_T,"-37.81894815, 144.94612292"
701520250414,70,2025-04-14,15,120,122,242,Errol20_T,"-37.80456984, 144.94946228"
41820240814,41,2024-08-14,8,96,122,218,Swa31,"-37.81668634, 144.96689733"
8920250616,8,2025-06-16,9,179,101,280,WebBN_T,"-37.82293543, 144.9471751"
78220250821,78,2025-08-21,2,0,3,3,HarEsB_T,"-37.81471642, 144.9446508"
41120250504,41,2025-05-04,1,203,306,509,Swa31,"-37.81668634, 144.96689733"
411220250623,41,2025-06-23,12,1300,1094,2394,Swa31,"-37.81668634, 144.96689733"
42020250128,42,2025-01-28,0,10,1,11,UM1_T,"-37.80008566, 144.96386412"
771520250608,77,2025-06-08,15,152,70,222,HarEsP_T,"-37.81441438, 144.94433026"
591320240126,59,2024-01-26,13,671,400,1071,RMIT_T,"-37.80825648, 144.96304859"
592220240925,59,2024-09-25,22,189,120,309,RMIT_T,"-37.80825648, 144.96304859"
71820241014,71,2024-10-14,8,31,47,78,WestWP_T,"-37.81235775, 144.97136962"
711120241111,71,2024-11-11,11,49,22,71,WestWP_T,"-37.81235775, 144.97136962"
441520240417,44,2024-04-17,15,109,101,210,UM3_T,"-37.79698741, 144.96441306"
1351620240510,135,2024-05-10,16,458,430,888,Spen161_T,"-37.8172861, 144.95319102"
107620250707,107,2025-07-07,6,9,23,32,280Will_T,"-37.81246271, 144.95690188"
1331920240227,133,2024-02-27,19,547,420,967,Spen229_T,"-37.81531435, 144.95227769"
1181020241019,118,2024-10-19,10,11,22,33,Fli114C_T,"-37.81632783, 144.97090512"
1662320250329,166,2025-03-29,23,5,11,16,Spen484_T,"-37.80896733, 144.94931703"
171320231031,17,2023-10-31,13,700,677,1377,Col15_T,"-37.81362543, 144.97323591"
17920250427,17,2025-04-27,9,111,50,161,Col15_T,"-37.81362543, 144.97323591"
63820250425,63,2025-04-25,8,48,107,155,Bou231_T,"-37.81333081, 144.96675571"
681820240710,68,2024-07-10,18,105,19,124,FLDegN_T,"-37.8168479, 144.96559789"
621520240903,62,2024-09-03,15,220,151,371,Lat224_T,"-37.80996494, 144.96216521"
621720250705,62,2025-07-05,17,388,367,755,Lat224_T,"-37.80996494, 144.96216521"
561120240330,56,2024-03-30,11,366,216,582,Lon364_T,"-37.81234775, 144.96153311"
12020250109,12,2025-01-09,0,30,37,67,NewQ_T,"-37.81457988, 144.94292398"
121120250424,12,2025-04-24,11,116,107,223,NewQ_T,"-37.81457988, 144.94292398"
12920250612,12,2025-06-12,9,182,71,253,NewQ_T,"-37.81457988, 144.94292398"
351920250701,35,2025-07-01,19,420,453,873,SouthB_T,"-37.82018685, 144.96508508"
351820250710,35,2025-07-10,18,757,531,1288,SouthB_T,"-37.82018685, 144.96508508"
27220240911,27,2024-09-11,2,2,4,6,Vic_T,"-37.80606888, 144.95644692"
9520240116,9,2024-01-16,5,14,46,60,Col700_T,"-37.81982992, 144.95102555"
791120240416,79,2024-04-16,11,304,328,632,FliSS_T,"-37.81794046, 144.96616678"
531820250824,53,2025-08-24,18,369,248,617,Col254_T,"-37.81564191, 144.965499"
23920240613,23,2024-06-13,9,569,270,839,Col623_T,"-37.81909256, 144.95452748"
48920240619,48,2024-06-19,9,104,120,224,QVMQ_T,"-37.80631581, 144.95866697"
521120250824,52,2025-08-24,11,317,211,528,Eli263_T,"-37.81252157, 144.9619401"
52620231216,52,2023-12-16,6,23,18,41,Eli263_T,"-37.81252157, 144.9619401"
164420241206,164,2024-12-06,4,3,4,7,Lat526_T,"-37.813005, 144.95160411"
1371420240813,137,2024-08-13,14,15,43,58,BouHbr2353_T,"-37.81894815, 144.94612292"
1361320231128,136,2023-11-28,13,66,59,125,BirFed1120_T,"-37.8184141, 144.97357915"
1301320240719,130,2024-07-19,13,17,28,45,Bou892T,"-37.8204637, 144.94126826"
692320240706,69,2024-07-06,23,22,9,31,FLDegC_T,"-37.81687226, 144.96559144"
61420240423,6,2024-04-23,14,898,724,1622,FliS_T,"-37.81911705, 144.96558255"
4220240127,4,2024-01-27,2,77,77,154,Swa123_T,"-37.81487988, 144.9660878"
70020240515,70,2024-05-15,0,5,8,13,Errol20_T,"-37.80456984, 144.94946228"
701820250605,70,2025-06-05,18,135,155,290,Errol20_T,"-37.80456984, 144.94946228"
681620250526,68,2025-05-26,16,197,191,388,FLDegN_T,"-37.8168479, 144.96559789"
311420240507,31,2024-05-07,14,124,123,247,Lyg161_T,"-37.80169681, 144.96658911"
311320240804,31,2024-08-04,13,230,199,429,Lyg161_T,"-37.80169681, 144.96658911"
542020240903,54,2024-09-03,20,137,310,447,Swa607_T,"-37.804024, 144.96308399"
47320250311,47,2025-03-11,3,13,16,29,Eli250_T,"-37.81258467, 144.9625775"
45120231209,45,2023-12-09,1,123,258,381,Swa148_T,"-37.81414075, 144.96609379"
212320241027,21,2024-10-27,23,84,74,158,Bourke155_T,"-37.81267313, 144.96788288"
21220250304,21,2025-03-04,2,6,8,14,Bourke155_T,"-37.81267313, 144.96788288"
21120250321,21,2025-03-21,1,39,40,79,Bourke155_T,"-37.81267313, 144.96788288"
37920250610,37,2025-06-10,9,36,33,69,Lyg260_T,"-37.80107122, 144.96704554"
442120250522,44,2025-05-22,21,47,36,83,UM3_T,"-37.79698741, 144.96441306"
441420250721,44,2025-07-21,14,84,79,163,UM3_T,"-37.79698741, 144.96441306"
135920250819,135,2025-08-19,9,305,327,632,Spen161_T,"-37.8172861, 144.95319102"
135420240409,135,2024-04-09,4,12,4,16,Spen161_T,"-37.8172861, 144.95319102"
1321820250522,132,2025-05-22,18,126,172,298,King335_T,"-37.81267639, 144.95386444"
1331120241012,133,2024-10-12,11,436,496,932,Spen229_T,"-37.81531435, 144.95227769"
1181620240713,118,2024-07-13,16,18,15,33,Fli114C_T,"-37.81632783, 144.97090512"
1081520240713,108,2024-07-13,15,54,126,180,261Will_T,"-37.81295822, 144.95678789"
108620250211,108,2025-02-11,6,31,270,301,261Will_T,"-37.81295822, 144.95678789"
871720250522,87,2025-05-22,17,136,118,254,Errol23_T,"-37.80454949, 144.94921863"
1821420250718,182,2025-07-18,14,255,224,479,King163_T,"-37.81627451, 144.95550503"
1622220250224,162,2025-02-24,22,105,53,158,Eli489_T,"-37.80740397, 144.95987909"
165820250408,165,2025-04-08,8,31,69,100,Spen475_T,"-37.80953359, 144.94939004"
1651420250817,165,2025-08-17,14,38,47,85,Spen475_T,"-37.80953359, 144.94939004"
1621520250430,162,2025-04-30,15,320,408,728,Eli489_T,"-37.80740397, 144.95987909"
1432120250929,143,2025-09-29,21,109,109,218,Spencer_T,"-37.821728, 144.95557015"
143220240512,143,2024-05-12,2,72,48,120,Spencer_T,"-37.821728, 144.95557015"
1321820240729,132,2024-07-29,18,126,109,235,King335_T,"-37.81267639, 144.95386444"
1341820231220,134,2023-12-20,18,395,373,768,Spen201_T,"-37.81694221, 144.95303935"
1341420240704,134,2024-07-04,14,376,357,733,Spen201_T,"-37.81694221, 144.95303935"
67820250517,67,2025-05-17,8,65,84,149,FLDegS_T,"-37.81688755, 144.96562569"
68820250109,68,2025-01-09,8,181,142,323,FLDegN_T,"-37.8168479, 144.96559789"
681220250628,68,2025-06-28,12,398,373,771,FLDegN_T,"-37.8168479, 144.96559789"
681820240821,68,2024-08-21,18,101,13,114,FLDegN_T,"-37.8168479, 144.96559789"
17420231217,17,2023-12-17,4,11,6,17,Col15_T,"-37.81362543, 144.97323591"
171220240108,17,2024-01-08,12,301,279,580,Col15_T,"-37.81362543, 144.97323591"
181620251005,18,2025-10-05,16,51,36,87,Col12_T,"-37.81344862, 144.97305353"
63220250909,63,2025-09-09,2,8,11,19,Bou231_T,"-37.81333081, 144.96675571"
111120240804,11,2024-08-04,11,127,132,259,WatCit_T,"-37.81564989, 144.93970694"
11920250215,11,2025-02-15,9,22,24,46,WatCit_T,"-37.81564989, 144.93970694"
62320241031,62,2024-10-31,3,20,16,36,Lat224_T,"-37.80996494, 144.96216521"
56720250308,56,2025-03-08,7,49,22,71,Lon364_T,"-37.81234775, 144.96153311"
24920250311,24,2025-03-11,9,876,287,1163,Col620_T,"-37.81887963, 144.95449198"
10820250519,10,2025-05-19,8,55,174,229,BouHbr_T,"-37.81876474, 144.94710545"
241520241027,24,2024-10-27,15,304,670,974,Col620_T,"-37.81887963, 144.95449198"
24320241120,24,2024-11-20,3,21,20,41,Col620_T,"-37.81887963, 144.95449198"
58820240715,58,2024-07-15,8,1507,163,1670,Bou688_T,"-37.81686075, 144.95358075"
76120250415,76,2025-04-15,1,1,0,1,KenMac_T,"-37.79453803, 144.93036194"
581920231106,58,2023-11-06,19,395,301,696,Bou688_T,"-37.81686075, 144.95358075"
352020250616,35,2025-06-16,20,74,71,145,SouthB_T,"-37.82018685, 144.96508508"
232120240201,23,2024-02-01,21,74,138,212,Col623_T,"-37.81909256, 144.95452748"
231220250517,23,2025-05-17,12,134,163,297,Col623_T,"-37.81909256, 144.95452748"
231320250603,23,2025-06-03,13,307,504,811,Col623_T,"-37.81909256, 144.95452748"
79620250426,79,2025-04-26,6,52,42,94,FliSS_T,"-37.81794046, 144.96616678"
482120231227,48,2023-12-27,21,124,128,252,QVMQ_T,"-37.80631581, 144.95866697"
1361120250914,136,2025-09-14,11,112,66,178,BirFed1120_T,"-37.8184141, 144.97357915"
136420231203,136,2023-12-03,4,1,0,1,BirFed1120_T,"-37.8184141, 144.97357915"
1361620240206,136,2024-02-06,16,210,94,304,BirFed1120_T,"-37.8184141, 144.97357915"
142620251016,142,2025-10-16,6,154,103,257,Hammer1584_T,"-37.81970749, 144.96795734"
142920250123,142,2025-01-23,9,266,262,528,Hammer1584_T,"-37.81970749, 144.96795734"
1611220250808,161,2025-08-08,12,165,153,318,BirArt1109_T,"-37.81851276, 144.97131336"
141420250920,141,2025-09-20,4,18,22,40,474Fl_T,"-37.81997273, 144.95834911"
1381120250101,138,2025-01-01,11,13,3,16,EntPark1671_T,"-37.81996544, 144.95981454"
161920240912,161,2024-09-12,9,98,98,196,BirArt1109_T,"-37.81851276, 144.97131336"
492220250805,49,2025-08-05,22,109,83,192,Eli501_T,"-37.80730068, 144.95956055"
1231320241026,123,2024-10-26,13,16,2,18,BirBridge_T,"-37.81753741, 144.97329734"
1231320241129,123,2024-11-29,13,16,2,18,BirBridge_T,"-37.81753741, 144.97329734"
1231120250719,123,2025-07-19,11,53,21,74,BirBridge_T,"-37.81753741, 144.97329734"
851320240615,85,2024-06-15,13,112,99,211,488Mac_T,"-37.79432415, 144.92973378"
63320240617,63,2024-06-17,3,6,11,17,Bou231_T,"-37.81333081, 144.96675571"
68920231209,68,2023-12-09,9,106,74,180,FLDegN_T,"-37.8168479, 144.96559789"
181820250714,18,2025-07-14,18,40,30,70,Col12_T,"-37.81344862, 144.97305353"
63620251016,63,2025-10-16,6,37,43,80,Bou231_T,"-37.81333081, 144.96675571"
672320250319,67,2025-03-19,23,32,92,124,FLDegS_T,"-37.81688755, 144.96562569"
12720250506,12,2025-05-06,7,118,94,212,NewQ_T,"-37.81457988, 144.94292398"
121120240907,12,2024-09-07,11,186,161,347,NewQ_T,"-37.81457988, 144.94292398"
121520241003,12,2024-10-03,15,195,189,384,NewQ_T,"-37.81457988, 144.94292398"
10220241106,10,2024-11-06,2,0,1,1,BouHbr_T,"-37.81876474, 144.94710545"
102020240412,10,2024-04-12,20,34,23,57,BouHbr_T,"-37.81876474, 144.94710545"
10520240711,10,2024-07-11,5,2,4,6,BouHbr_T,"-37.81876474, 144.94710545"
722220250528,72,2025-05-28,22,8,34,42,ACMI_T,"-37.81726338, 144.96872809"
76520241031,76,2024-10-31,5,6,2,8,KenMac_T,"-37.79453803, 144.93036194"
76920241106,76,2024-11-06,9,50,55,105,KenMac_T,"-37.79453803, 144.93036194"
35620231220,35,2023-12-20,6,262,250,512,SouthB_T,"-37.82018685, 144.96508508"
35920240802,35,2024-08-02,9,503,662,1165,SouthB_T,"-37.82018685, 144.96508508"
271120240517,27,2024-05-17,11,203,138,341,Vic_T,"-37.80606888, 144.95644692"
272020240821,27,2024-08-21,20,143,121,264,Vic_T,"-37.80606888, 144.95644692"
2220241009,2,2024-10-09,2,3,22,25,Bou283_T,"-37.81380668, 144.96516718"
91120250926,9,2025-09-26,11,59,80,139,Col700_T,"-37.81982992, 144.95102555"
52920250426,52,2025-04-26,9,127,80,207,Eli263_T,"-37.81252157, 144.9619401"
1391720240429,139,2024-04-29,17,179,35,214,Signal1647_T,"-37.81959923, 144.9632832"
1361720250518,136,2025-05-18,17,193,156,349,BirFed1120_T,"-37.8184141, 144.97357915"
136620240106,136,2024-01-06,6,41,31,72,BirFed1120_T,"-37.8184141, 144.97357915"
136820240715,136,2024-07-15,8,67,100,167,BirFed1120_T,"-37.8184141, 144.97357915"
1301120250316,130,2025-03-16,11,29,21,50,Bou892T,"-37.8204637, 144.94126826"
1301020240312,130,2024-03-12,10,39,18,57,Bou892T,"-37.8204637, 144.94126826"
161620241027,161,2024-10-27,6,17,20,37,BirArt1109_T,"-37.81851276, 144.97131336"
109520231024,109,2023-10-24,5,10,18,28,LatWill_T,"-37.81193681, 144.95621105"
391620240824,39,2024-08-24,16,73,78,151,AlfPl_T,"-37.81379749, 144.96995745"
14920250921,14,2025-09-21,9,193,61,254,SanBri_T,"-37.82011242, 144.96291897"
592220250105,59,2025-01-05,22,126,81,207,RMIT_T,"-37.80825648, 144.96304859"
311720250401,31,2025-04-01,17,205,140,345,Lyg161_T,"-37.80169681, 144.96658911"
281120240723,28,2024-07-23,11,491,411,902,VAC_T,"-37.82129925, 144.96879309"
40420240213,40,2024-02-13,4,1,2,3,Spr201_T,"-37.80999341, 144.97227587"
51420240829,5,2024-08-29,14,822,657,1479,PriNW_T,"-37.81874249, 144.96787656"
37420250303,37,2025-03-03,4,2,0,2,Lyg260_T,"-37.80107122, 144.96704554"
611720240118,61,2024-01-18,17,356,418,774,RMIT14_T,"-37.80767455, 144.96309114"
441120240217,44,2024-02-17,11,16,22,38,UM3_T,"-37.79698741, 144.96441306"
1401720231223,140,2023-12-23,17,80,67,147,Boyd2837_T,"-37.82590962, 144.96185972"
1401420240725,140,2024-07-25,14,33,32,65,Boyd2837_T,"-37.82590962, 144.96185972"
1321820240713,132,2024-07-13,18,100,89,189,King335_T,"-37.81267639, 144.95386444"
511620250801,51,2025-08-01,16,93,100,193,Fra118_T,"-37.80841815, 144.95906316"
137920250908,137,2025-09-08,9,28,23,51,BouHbr2353_T,"-37.81894815, 144.94612292"
1412220240208,141,2024-02-08,22,63,80,143,474Fl_T,"-37.81997273, 144.95834911"
1411920250726,141,2025-07-26,19,93,110,203,474Fl_T,"-37.81997273, 144.95834911"
1361120250605,136,2025-06-05,11,54,54,108,BirFed1120_T,"-37.8184141, 144.97357915"
1421120250223,142,2025-02-23,11,423,542,965,Hammer1584_T,"-37.81970749, 144.96795734"
48220250206,48,2025-02-06,2,33,34,67,QVMQ_T,"-37.80631581, 144.95866697"
49020240122,49,2024-01-22,0,51,44,95,Eli501_T,"-37.80730068, 144.95956055"
1092220250415,109,2025-04-15,22,24,55,79,LatWill_T,"-37.81193681, 144.95621105"
191120250911,19,2025-09-11,11,219,203,422,LtB210_T,"-37.81237202, 144.96550671"
61820241031,6,2024-10-31,18,1387,901,2288,FliS_T,"-37.81911705, 144.96558255"
84220250514,84,2025-05-14,2,11,16,27,ElFi_T,"-37.81798049, 144.96503383"
662320231222,66,2023-12-22,23,473,316,789,QVN_T,"-37.81057846, 144.96444294"
70820250216,70,2025-02-16,8,34,25,59,Errol20_T,"-37.80456984, 144.94946228"
31720240504,3,2024-05-04,17,1411,1689,3100,Swa295_T,"-37.81101524, 144.96429485"
391320240227,39,2024-02-27,13,283,340,623,AlfPl_T,"-37.81379749, 144.96995745"
8420250918,8,2025-09-18,4,1,1,2,WebBN_T,"-37.82293543, 144.9471751"
41920250621,41,2025-06-21,9,930,419,1349,Swa31,"-37.81668634, 144.96689733"
411720250410,41,2025-04-10,17,1907,2911,4818,Swa31,"-37.81668634, 144.96689733"
771720250508,77,2025-05-08,17,323,135,458,HarEsP_T,"-37.81441438, 144.94433026"
78020240729,78,2024-07-29,0,3,2,5,HarEsB_T,"-37.81471642, 144.9446508"
782120240313,78,2024-03-13,21,3,18,21,HarEsB_T,"-37.81471642, 144.9446508"
14620240816,14,2024-08-16,6,78,111,189,SanBri_T,"-37.82011242, 144.96291897"
142320231105,14,2023-11-05,23,139,23,162,SanBri_T,"-37.82011242, 144.96291897"
71420240922,71,2024-09-22,4,1,1,2,WestWP_T,"-37.81235775, 144.97136962"
42420240622,42,2024-06-22,4,6,2,8,UM1_T,"-37.80008566, 144.96386412"
29620241020,29,2024-10-20,6,9,22,31,AG_T,"-37.8199817, 144.96872865"
292220250119,29,2025-01-19,22,266,347,613,AG_T,"-37.8199817, 144.96872865"
29020240616,29,2024-06-16,0,10,33,43,AG_T,"-37.8199817, 144.96872865"
401120240224,40,2024-02-24,11,126,163,289,Spr201_T,"-37.80999341, 144.97227587"
40820250811,40,2025-08-11,8,216,322,538,Spr201_T,"-37.80999341, 144.97227587"
311120240309,31,2024-03-09,11,131,83,214,Lyg161_T,"-37.80169681, 144.96658911"
36620250619,36,2025-06-19,6,36,15,51,Que85_T,"-37.81652527, 144.96121062"
36820240703,36,2024-07-03,8,226,146,372,Que85_T,"-37.81652527, 144.96121062"
36720241204,36,2024-12-04,7,113,71,184,Que85_T,"-37.81652527, 144.96121062"
361620241213,36,2024-12-13,16,304,256,560,Que85_T,"-37.81652527, 144.96121062"
371420240701,37,2024-07-01,14,119,123,242,Lyg260_T,"-37.80107122, 144.96704554"
211120241229,21,2024-12-29,11,266,183,449,Bourke155_T,"-37.81267313, 144.96788288"
611220250612,61,2025-06-12,12,294,487,781,RMIT14_T,"-37.80767455, 144.96309114"
431520250119,43,2025-01-19,15,60,23,83,UM2_T,"-37.79844526, 144.96411782"
43320240121,43,2024-01-21,3,2,1,3,UM2_T,"-37.79844526, 144.96411782"
179720250717,179,2025-07-17,7,32,12,44,Pow61_T,"-37.82392385, 144.96299677"
1672120250311,167,2025-03-11,21,16,28,44,Lat526_T,"-37.81304149, 144.95155955"
167420250510,167,2025-05-10,4,1,0,1,Lat526_T,"-37.81304149, 144.95155955"
1401320250704,140,2025-07-04,13,99,77,176,Boyd2837_T,"-37.82590962, 144.96185972"
1621020241205,162,2024-12-05,10,282,422,704,Eli489_T,"-37.80740397, 144.95987909"
1311020250505,131,2025-05-05,10,81,102,183,King2_T,"-37.82009057, 144.95758725"
1321620241208,132,2024-12-08,16,131,127,258,King335_T,"-37.81267639, 144.95386444"
1321120250715,132,2025-07-15,11,136,95,231,King335_T,"-37.81267639, 144.95386444"
1341020240416,134,2024-04-16,10,308,339,647,Spen201_T,"-37.81694221, 144.95303935"
1342320240507,134,2024-05-07,23,43,61,104,Spen201_T,"-37.81694221, 144.95303935"
1352320231231,135,2023-12-31,23,486,601,1087,Spen161_T,"-37.8172861, 144.95319102"
67120241103,67,2024-11-03,1,47,56,103,FLDegS_T,"-37.81688755, 144.96562569"
851620250222,85,2025-02-22,16,82,81,163,488Mac_T,"-37.79432415, 144.92973378"
17220240322,17,2024-03-22,2,9,9,18,Col15_T,"-37.81362543, 144.97323591"
11320240609,1,2024-06-09,13,1454,1220,2674,Bou292_T,"-37.81349441, 144.96515323"
107520240706,107,2024-07-06,5,1,2,3,280Will_T,"-37.81246271, 144.95690188"
107120250114,107,2025-01-14,1,25,12,37,280Will_T,"-37.81246271, 144.95690188"
107720250812,107,2025-08-12,7,32,93,125,280Will_T,"-37.81246271, 144.95690188"
1332320250518,133,2025-05-18,23,71,37,108,Spen229_T,"-37.81531435, 144.95227769"
1182120251009,118,2025-10-09,21,5,11,16,Fli114C_T,"-37.81632783, 144.97090512"
108520240229,108,2024-02-29,5,16,93,109,261Will_T,"-37.81295822, 144.95678789"
166020250510,166,2025-05-10,0,2,1,3,Spen484_T,"-37.80896733, 144.94931703"
86020241226,86,2024-12-26,0,0,3,3,574Qub_T,"-37.80309992, 144.94908064"
86820250313,86,2025-03-13,8,61,26,87,574Qub_T,"-37.80309992, 144.94908064"
561420241005,56,2024-10-05,14,369,319,688,Lon364_T,"-37.81234775, 144.96153311"
111520240624,11,2024-06-24,15,46,46,92,WatCit_T,"-37.81564989, 144.93970694"
121020240117,12,2024-01-17,10,24,28,52,NewQ_T,"-37.81457988, 144.94292398"
101120240702,10,2024-07-02,11,79,81,160,BouHbr_T,"-37.81876474, 144.94710545"
72220240229,72,2024-02-29,2,2,3,5,ACMI_T,"-37.81726338, 144.96872809"
581120250120,58,2025-01-20,11,638,247,885,Bou688_T,"-37.81686075, 144.95358075"
271920240913,27,2024-09-13,19,108,60,168,Vic_T,"-37.80606888, 144.95644692"
21920240122,2,2024-01-22,19,222,266,488,Bou283_T,"-37.81380668, 144.96516718"
9120241209,9,2024-12-09,1,6,4,10,Col700_T,"-37.81982992, 144.95102555"
91220250207,9,2025-02-07,12,539,460,999,Col700_T,"-37.81982992, 144.95102555"
301920240515,30,2024-05-15,19,254,387,641,Lon189_T,"-37.8112185, 144.96656806"
53420250705,53,2025-07-05,4,9,12,21,Col254_T,"-37.81564191, 144.965499"
53420250808,53,2025-08-08,4,7,2,9,Col254_T,"-37.81564191, 144.965499"
19320231126,19,2023-11-26,3,80,127,207,LtB210_T,"-37.81237202, 144.96550671"
46920240612,46,2024-06-12,9,40,138,178,Pel147_T,"-37.80240719, 144.9615673"
251220240723,25,2024-07-23,12,483,507,990,MCEC_T,"-37.82401776, 144.95604426"
1641920250309,164,2025-03-09,19,87,86,173,Lat526_T,"-37.813005, 144.95160411"
1391720250318,139,2025-03-18,17,421,64,485,Signal1647_T,"-37.81959923, 144.9632832"
1391920240526,139,2024-05-26,19,5,19,24,Signal1647_T,"-37.81959923, 144.9632832"
1421720240228,142,2024-02-28,17,391,232,623,Hammer1584_T,"-37.81970749, 144.96795734"
1231420240721,123,2024-07-21,14,7,2,9,BirBridge_T,"-37.81753741, 144.97329734"
1381920241001,138,2024-10-01,19,0,1,1,EntPark1671_T,"-37.81996544, 144.95981454"
49320241007,49,2024-10-07,3,22,11,33,Eli501_T,"-37.80730068, 144.95956055"
1091520231222,109,2023-12-22,15,171,98,269,LatWill_T,"-37.81193681, 144.95621105"
109920250719,109,2025-07-19,9,26,42,68,LatWill_T,"-37.81193681, 144.95621105"
68020250912,68,2025-09-12,0,4,4,8,FLDegN_T,"-37.8168479, 144.96559789"
17920250419,17,2025-04-19,9,133,118,251,Col15_T,"-37.81362543, 144.97323591"
11420231204,1,2023-12-04,14,1401,1237,2638,Bou292_T,"-37.81349441, 144.96515323"
632120240930,63,2024-09-30,21,16,81,97,Bou231_T,"-37.81333081, 144.96675571"
692120240209,69,2024-02-09,21,53,31,84,FLDegC_T,"-37.81687226, 144.96559144"
841120240101,84,2024-01-01,11,612,704,1316,ElFi_T,"-37.81798049, 144.96503383"
702120240512,70,2024-05-12,21,42,32,74,Errol20_T,"-37.80456984, 144.94946228"
70220241111,70,2024-11-11,2,1,1,2,Errol20_T,"-37.80456984, 144.94946228"
39320250902,39,2025-09-02,3,1,0,1,AlfPl_T,"-37.81379749, 144.96995745"
39220231223,39,2023-12-23,2,1,4,5,AlfPl_T,"-37.81379749, 144.96995745"
772320240604,77,2024-06-04,23,3,4,7,HarEsP_T,"-37.81441438, 144.94433026"
781420240919,78,2024-09-19,14,22,56,78,HarEsB_T,"-37.81471642, 144.9446508"
1092120250125,109,2025-01-25,21,58,88,146,LatWill_T,"-37.81193681, 144.95621105"
491320240117,49,2024-01-17,13,105,138,243,Eli501_T,"-37.80730068, 144.95956055"
48320241103,48,2024-11-03,3,3,17,20,QVMQ_T,"-37.80631581, 144.95866697"
69920241215,69,2024-12-15,9,133,84,217,FLDegC_T,"-37.81687226, 144.96559144"
84820241022,84,2024-10-22,8,1701,442,2143,ElFi_T,"-37.81798049, 144.96503383"
84420250930,84,2025-09-30,4,20,32,52,ElFi_T,"-37.81798049, 144.96503383"
4120251014,4,2025-10-14,1,17,34,51,Swa123_T,"-37.81487988, 144.9660878"
701120250930,70,2025-09-30,11,138,146,284,Errol20_T,"-37.80456984, 144.94946228"
42220240226,4,2024-02-26,22,336,178,514,Swa123_T,"-37.81487988, 144.9660878"
42320240411,4,2024-04-11,23,261,220,481,Swa123_T,"-37.81487988, 144.9660878"
701620241215,70,2024-12-15,16,92,146,238,Errol20_T,"-37.80456984, 144.94946228"
751120231230,75,2023-12-30,11,24,27,51,SprFli_T,"-37.81515276, 144.97467661"
81820241015,8,2024-10-15,18,144,259,403,WebBN_T,"-37.82293543, 144.9471751"
42420250928,42,2025-09-28,4,4,2,6,UM1_T,"-37.80008566, 144.96386412"
71420240605,71,2024-06-05,4,4,12,16,WestWP_T,"-37.81235775, 144.97136962"
14220250127,14,2025-01-27,2,22,16,38,SanBri_T,"-37.82011242, 144.96291897"
14120250308,14,2025-03-08,1,145,17,162,SanBri_T,"-37.82011242, 144.96291897"
312020250429,31,2025-04-29,20,104,116,220,Lyg161_T,"-37.80169681, 144.96658911"
28320231025,28,2023-10-25,3,2,14,16,VAC_T,"-37.82129925, 144.96879309"
47420241123,47,2024-11-23,4,35,42,77,Eli250_T,"-37.81258467, 144.9625775"
51220241125,5,2024-11-25,12,441,515,956,PriNW_T,"-37.81874249, 144.96787656"
5820251014,5,2025-10-14,8,422,891,1313,PriNW_T,"-37.81874249, 144.96787656"
118720250923,118,2025-09-23,7,8,10,18,Fli114C_T,"-37.81632783, 144.97090512"
1181220240228,118,2024-02-28,12,21,19,40,Fli114C_T,"-37.81632783, 144.97090512"
107220240117,107,2024-01-17,2,8,7,15,280Will_T,"-37.81246271, 144.95690188"
872320250701,87,2025-07-01,23,6,8,14,Errol23_T,"-37.80454949, 144.94921863"
61220250203,61,2025-02-03,2,13,4,17,RMIT14_T,"-37.80767455, 144.96309114"
166720250706,166,2025-07-06,7,3,6,9,Spen484_T,"-37.80896733, 144.94931703"
1651520241126,165,2024-11-26,15,36,32,68,Spen475_T,"-37.80953359, 144.94939004"
1652320250717,165,2025-07-17,23,7,3,10,Spen475_T,"-37.80953359, 144.94939004"
1671120250409,167,2025-04-09,11,48,84,132,Lat526_T,"-37.81304149, 144.95155955"
1401320240210,140,2024-02-10,13,112,65,177,Boyd2837_T,"-37.82590962, 144.96185972"
1401420240414,140,2024-04-14,14,105,68,173,Boyd2837_T,"-37.82590962, 144.96185972"
134720240127,134,2024-01-27,7,115,105,220,Spen201_T,"-37.81694221, 144.95303935"
491720241128,49,2024-11-28,17,271,205,476,Eli501_T,"-37.80730068, 144.95956055"
109720231208,109,2023-12-08,7,29,200,229,LatWill_T,"-37.81193681, 144.95621105"
681720231202,68,2023-12-02,17,184,118,302,FLDegN_T,"-37.8168479, 144.96559789"
85820240616,85,2024-06-16,8,38,18,56,488Mac_T,"-37.79432415, 144.92973378"
17420241119,17,2024-11-19,4,21,6,27,Col15_T,"-37.81362543, 144.97323591"
172320250806,17,2025-08-06,23,32,24,56,Col15_T,"-37.81362543, 144.97323591"
68820250212,68,2025-02-12,8,206,151,357,FLDegN_T,"-37.8168479, 144.96559789"
181820250722,18,2025-07-22,18,88,49,137,Col12_T,"-37.81344862, 144.97305353"
562120241204,56,2024-12-04,21,202,240,442,Lon364_T,"-37.81234775, 144.96153311"
12720250617,12,2025-06-17,7,30,17,47,NewQ_T,"-37.81457988, 144.94292398"
72720240123,72,2024-01-23,7,200,57,257,ACMI_T,"-37.81726338, 144.96872809"
58520240718,58,2024-07-18,5,85,23,108,Bou688_T,"-37.81686075, 144.95358075"
76720240103,76,2024-01-03,7,18,12,30,KenMac_T,"-37.79453803, 144.93036194"
532220240414,53,2024-04-14,22,37,54,91,Col254_T,"-37.81564191, 144.965499"
27520241119,27,2024-11-19,5,19,5,24,Vic_T,"-37.80606888, 144.95644692"
23520251002,23,2025-10-02,5,26,10,36,Col623_T,"-37.81909256, 144.95452748"
462320250508,46,2025-05-08,23,3,0,3,Pel147_T,"-37.80240719, 144.9615673"
461420240323,46,2024-03-23,14,86,74,160,Pel147_T,"-37.80240719, 144.9615673"
20420250125,20,2025-01-25,4,19,22,41,LtB170_T,"-37.81172914, 144.9682466"
521920240723,52,2024-07-23,19,290,215,505,Eli263_T,"-37.81252157, 144.9619401"
18320241213,18,2024-12-13,3,1,0,1,Col12_T,"-37.81344862, 144.97305353"
18120250208,18,2025-02-08,1,5,5,10,Col12_T,"-37.81344862, 144.97305353"
68720250518,68,2025-05-18,7,26,19,45,FLDegN_T,"-37.8168479, 144.96559789"
62720250523,62,2025-05-23,7,36,40,76,Lat224_T,"-37.80996494, 144.96216521"
121120240507,12,2024-05-07,11,89,104,193,NewQ_T,"-37.81457988, 144.94292398"
561720250725,56,2025-07-25,17,419,455,874,Lon364_T,"-37.81234775, 144.96153311"
101020240716,10,2024-07-16,10,69,58,127,BouHbr_T,"-37.81876474, 144.94710545"
101120240818,10,2024-08-18,11,78,35,113,BouHbr_T,"-37.81876474, 144.94710545"
72720231223,72,2023-12-23,7,19,33,52,ACMI_T,"-37.81726338, 144.96872809"
721120231229,72,2023-12-29,11,302,397,699,ACMI_T,"-37.81726338, 144.96872809"
21220231221,2,2023-12-21,12,1486,1421,2907,Bou283_T,"-37.81380668, 144.96516718"
351620250920,35,2025-09-20,16,1541,1581,3122,SouthB_T,"-37.82018685, 144.96508508"
271920250828,27,2025-08-28,19,120,75,195,Vic_T,"-37.80606888, 144.95644692"
271420241120,27,2024-11-20,14,144,122,266,Vic_T,"-37.80606888, 144.95644692"
2220241216,2,2024-12-16,2,0,12,12,Bou283_T,"-37.81380668, 144.96516718"
302320250713,30,2025-07-13,23,125,107,232,Lon189_T,"-37.8112185, 144.96656806"
79620240809,79,2024-08-09,6,69,48,117,FliSS_T,"-37.81794046, 144.96616678"
792020231119,79,2023-11-19,20,336,394,730,FliSS_T,"-37.81794046, 144.96616678"
791120240118,79,2024-01-18,11,933,464,1397,FliSS_T,"-37.81794046, 144.96616678"
531320250320,53,2025-03-20,13,819,679,1498,Col254_T,"-37.81564191, 144.965499"
532320250531,53,2025-05-31,23,50,93,143,Col254_T,"-37.81564191, 144.965499"
53820241011,53,2024-10-11,8,300,209,509,Col254_T,"-37.81564191, 144.965499"
231120231116,23,2023-11-16,11,242,279,521,Col623_T,"-37.81909256, 144.95452748"
232120240621,23,2024-06-21,21,104,195,299,Col623_T,"-37.81909256, 144.95452748"
48420240131,48,2024-01-31,4,2,7,9,QVMQ_T,"-37.80631581, 144.95866697"
46220240203,46,2024-02-03,2,2,3,5,Pel147_T,"-37.80240719, 144.9615673"
191920250921,19,2025-09-21,19,534,485,1019,LtB210_T,"-37.81237202, 144.96550671"
141620231220,141,2023-12-20,6,24,18,42,474Fl_T,"-37.81997273, 144.95834911"
137220231221,137,2023-12-21,2,0,1,1,BouHbr2353_T,"-37.81894815, 144.94612292"
1301220240611,130,2024-06-11,12,10,8,18,Bou892T,"-37.8204637, 144.94126826"
123720250207,123,2025-02-07,7,19,25,44,BirBridge_T,"-37.81753741, 144.97329734"
1231720250406,123,2025-04-06,17,30,14,44,BirBridge_T,"-37.81753741, 144.97329734"
1381220240518,138,2024-05-18,12,13,8,21,EntPark1671_T,"-37.81996544, 144.95981454"
481720250625,48,2025-06-25,17,136,812,948,QVMQ_T,"-37.80631581, 144.95866697"
1091720250312,109,2025-03-12,17,557,181,738,LatWill_T,"-37.81193681, 144.95621105"
19320240807,19,2024-08-07,3,12,17,29,LtB210_T,"-37.81237202, 144.96550671"
66420250627,66,2025-06-27,4,15,13,28,QVN_T,"-37.81057846, 144.96444294"
662320250907,66,2025-09-07,23,120,108,228,QVN_T,"-37.81057846, 144.96444294"
84420250112,84,2025-01-12,4,29,37,66,ElFi_T,"-37.81798049, 144.96503383"
32120250901,3,2025-09-01,21,539,489,1028,Swa295_T,"-37.81101524, 144.96429485"
751020240418,75,2024-04-18,10,57,57,114,SprFli_T,"-37.81515276, 144.97467661"
75920240812,75,2024-08-12,9,39,32,71,SprFli_T,"-37.81515276, 144.97467661"
81620250224,8,2025-02-24,16,195,317,512,WebBN_T,"-37.82293543, 144.9471751"
751120250613,75,2025-06-13,11,71,40,111,SprFli_T,"-37.81515276, 144.97467661"
781120240525,78,2024-05-25,11,56,87,143,HarEsB_T,"-37.81471642, 144.9446508"
59620250922,59,2025-09-22,6,38,33,71,RMIT_T,"-37.80825648, 144.96304859"
651820231020,65,2023-10-20,18,513,599,1112,SwaCs_T,"-37.81569416, 144.9668064"
591720241011,59,2024-10-11,17,490,1035,1525,RMIT_T,"-37.80825648, 144.96304859"
28120250512,28,2025-05-12,1,12,6,18,VAC_T,"-37.82129925, 144.96879309"
28920231018,28,2023-10-18,9,428,210,638,VAC_T,"-37.82129925, 144.96879309"
281120231212,28,2023-12-12,11,541,409,950,VAC_T,"-37.82129925, 144.96879309"
29120250104,29,2025-01-04,1,12,21,33,AG_T,"-37.8199817, 144.96872865"
402320241006,40,2024-10-06,23,30,6,36,Spr201_T,"-37.80999341, 144.97227587"
401020250605,40,2025-06-05,10,192,189,381,Spr201_T,"-37.80999341, 144.97227587"
311220240612,31,2024-06-12,12,170,174,344,Lyg161_T,"-37.80169681, 144.96658911"
361320250427,36,2025-04-27,13,90,78,168,Que85_T,"-37.81652527, 144.96121062"
371020240619,37,2024-06-19,10,50,41,91,Lyg260_T,"-37.80107122, 144.96704554"
47320241026,47,2024-10-26,3,27,40,67,Eli250_T,"-37.81258467, 144.9625775"
1361020250219,136,2025-02-19,10,62,40,102,BirFed1120_T,"-37.8184141, 144.97357915"
1361920241020,136,2024-10-20,19,40,28,68,BirFed1120_T,"-37.8184141, 144.97357915"
1642220250128,164,2025-01-28,22,28,71,99,Lat526_T,"-37.813005, 144.95160411"
691020231119,69,2023-11-19,10,180,108,288,FLDegC_T,"-37.81687226, 144.96559144"
691720240415,69,2024-04-15,17,82,146,228,FLDegC_T,"-37.81687226, 144.96559144"
6020240218,6,2024-02-18,0,570,381,951,FliS_T,"-37.81911705, 144.96558255"
61820241111,6,2024-11-11,18,1089,798,1887,FliS_T,"-37.81911705, 144.96558255"
6620250827,6,2025-08-27,6,174,333,507,FliS_T,"-37.81911705, 144.96558255"
6920250919,6,2025-09-19,9,580,630,1210,FliS_T,"-37.81911705, 144.96558255"
4520250310,4,2025-03-10,5,35,38,73,Swa123_T,"-37.81487988, 144.9660878"
70120231026,70,2023-10-26,1,2,1,3,Errol20_T,"-37.80456984, 144.94946228"
701820250812,70,2025-08-12,18,137,179,316,Errol20_T,"-37.80456984, 144.94946228"
31220241118,3,2024-11-18,12,931,962,1893,Swa295_T,"-37.81101524, 144.96429485"
59520240923,59,2024-09-23,5,15,16,31,RMIT_T,"-37.80825648, 144.96304859"
142220250719,14,2025-07-19,22,90,74,164,SanBri_T,"-37.82011242, 144.96291897"
141720240827,14,2024-08-27,17,1045,200,1245,SanBri_T,"-37.82011242, 144.96291897"
472220251005,47,2025-10-05,22,251,172,423,Eli250_T,"-37.81258467, 144.9625775"
52120240708,5,2024-07-08,21,183,227,410,PriNW_T,"-37.81874249, 144.96787656"
362020250208,36,2025-02-08,20,131,173,304,Que85_T,"-37.81652527, 144.96121062"
361320241109,36,2024-11-09,13,136,140,276,Que85_T,"-37.81652527, 144.96121062"
371320240704,37,2024-07-04,13,98,142,240,Lyg260_T,"-37.80107122, 144.96704554"
50020241116,50,2024-11-16,0,34,13,47,Lyg309_T,"-37.79808192, 144.96721013"
502120250120,50,2025-01-20,21,214,121,335,Lyg309_T,"-37.79808192, 144.96721013"
133420240713,133,2024-07-13,4,11,9,20,Spen229_T,"-37.81531435, 144.95227769"
1331520250908,133,2025-09-08,15,428,647,1075,Spen229_T,"-37.81531435, 144.95227769"
1071120250309,107,2025-03-09,11,98,89,187,280Will_T,"-37.81246271, 144.95690188"
872320250303,87,2025-03-03,23,1,5,6,Errol23_T,"-37.80454949, 144.94921863"
611220240411,61,2024-04-11,12,726,798,1524,RMIT14_T,"-37.80767455, 144.96309114"
179820250413,179,2025-04-13,8,46,22,68,Pow61_T,"-37.82392385, 144.96299677"
1431420250705,143,2025-07-05,14,235,288,523,Spencer_T,"-37.821728, 144.95557015"
1341420251005,134,2025-10-05,14,355,351,706,Spen201_T,"-37.81694221, 144.95303935"
85520250920,85,2025-09-20,5,2,0,2,488Mac_T,"-37.79432415, 144.92973378"
67120241113,67,2024-11-13,1,10,15,25,FLDegS_T,"-37.81688755, 144.96562569"
181420240708,18,2024-07-08,14,202,143,345,Col12_T,"-37.81344862, 144.97305353"
122120240901,12,2024-09-01,21,102,76,178,NewQ_T,"-37.81457988, 144.94292398"
24520241010,24,2024-10-10,5,116,58,174,Col620_T,"-37.81887963, 144.95449198"
10920240425,10,2024-04-25,9,20,29,49,BouHbr_T,"-37.81876474, 144.94710545"
102120240825,10,2024-08-25,21,13,16,29,BouHbr_T,"-37.81876474, 144.94710545"
581020240918,58,2024-09-18,10,740,240,980,Bou688_T,"-37.81686075, 144.95358075"
721120250903,72,2025-09-03,11,157,228,385,ACMI_T,"-37.81726338, 144.96872809"
721020250925,72,2025-09-25,10,218,148,366,ACMI_T,"-37.81726338, 144.96872809"
72320250817,72,2025-08-17,3,1,23,24,ACMI_T,"-37.81726338, 144.96872809"
58320250603,58,2025-06-03,3,8,2,10,Bou688_T,"-37.81686075, 144.95358075"
27320231102,27,2023-11-02,3,3,4,7,Vic_T,"-37.80606888, 144.95644692"
35820250517,35,2025-05-17,8,135,215,350,SouthB_T,"-37.82018685, 144.96508508"
21320250412,2,2025-04-12,13,769,722,1491,Bou283_T,"-37.81380668, 144.96516718"
22120250727,2,2025-07-27,21,59,133,192,Bou283_T,"-37.81380668, 144.96516718"
271220240704,27,2024-07-04,12,200,132,332,Vic_T,"-37.80606888, 144.95644692"
272020250710,27,2025-07-10,20,78,44,122,Vic_T,"-37.80606888, 144.95644692"
272320250704,27,2025-07-04,23,41,28,69,Vic_T,"-37.80606888, 144.95644692"
92120250920,9,2025-09-20,21,43,57,100,Col700_T,"-37.81982992, 144.95102555"
422220240517,42,2024-05-17,22,34,45,79,UM1_T,"-37.80008566, 144.96386412"
311420250731,31,2025-07-31,14,144,130,274,Lyg161_T,"-37.80169681, 144.96658911"
47920240205,47,2024-02-05,9,230,528,758,Eli250_T,"-37.81258467, 144.9625775"
871120241203,87,2024-12-03,11,88,79,167,Errol23_T,"-37.80454949, 144.94921863"
61020240505,61,2024-05-05,0,44,46,90,RMIT14_T,"-37.80767455, 144.96309114"
451320240801,45,2024-08-01,13,738,808,1546,Swa148_T,"-37.81414075, 144.96609379"
1622320250217,162,2025-02-17,23,58,32,90,Eli489_T,"-37.80740397, 144.95987909"
1321520250514,132,2025-05-14,15,130,159,289,King335_T,"-37.81267639, 144.95386444"
135020240602,135,2024-06-02,0,51,55,106,Spen161_T,"-37.8172861, 144.95319102"
1071420250319,107,2025-03-19,14,142,127,269,280Will_T,"-37.81246271, 144.95690188"
133520240505,133,2024-05-05,5,18,39,57,Spen229_T,"-37.81531435, 144.95227769"
118820240513,118,2024-05-13,8,25,9,34,Fli114C_T,"-37.81632783, 144.97090512"
108820251012,108,2025-10-12,8,45,72,117,261Will_T,"-37.81295822, 144.95678789"
1081420241111,108,2024-11-11,14,406,230,636,261Will_T,"-37.81295822, 144.95678789"
108020250321,108,2025-03-21,0,42,31,73,261Will_T,"-37.81295822, 144.95678789"
671420240202,67,2024-02-02,14,276,265,541,FLDegS_T,"-37.81688755, 144.96562569"
681220240930,68,2024-09-30,12,305,274,579,FLDegN_T,"-37.8168479, 144.96559789"
181620251013,18,2025-10-13,16,509,80,589,Col12_T,"-37.81344862, 144.97305353"
62720251010,62,2025-10-10,7,51,50,101,Lat224_T,"-37.80996494, 144.96216521"
67220240312,67,2024-03-12,2,4,1,5,FLDegS_T,"-37.81688755, 144.96562569"
24820250619,24,2025-06-19,8,1848,180,2028,Col620_T,"-37.81887963, 144.95449198"
762320240224,76,2024-02-24,23,1,2,3,KenMac_T,"-37.79453803, 144.93036194"
352020250608,35,2025-06-08,20,378,562,940,SouthB_T,"-37.82018685, 144.96508508"
35420240702,35,2024-07-02,4,14,14,28,SouthB_T,"-37.82018685, 144.96508508"
35220241001,35,2024-10-01,2,12,13,25,SouthB_T,"-37.82018685, 144.96508508"
791420241229,79,2024-12-29,14,574,420,994,FliSS_T,"-37.81794046, 144.96616678"
79320240613,79,2024-06-13,3,8,14,22,FliSS_T,"-37.81794046, 144.96616678"
531620250122,53,2025-01-22,16,669,542,1211,Col254_T,"-37.81564191, 144.965499"
1671620250311,167,2025-03-11,16,15,23,38,Lat526_T,"-37.81304149, 144.95155955"
851820240904,85,2024-09-04,18,53,99,152,488Mac_T,"-37.79432415, 144.92973378"
68620240726,68,2024-07-26,6,4,0,4,FLDegN_T,"-37.8168479, 144.96559789"
681220250612,68,2025-06-12,12,486,395,881,FLDegN_T,"-37.8168479, 144.96559789"
622320241124,62,2024-11-24,23,49,51,100,Lat224_T,"-37.80996494, 144.96216521"
10020240222,10,2024-02-22,0,3,7,10,BouHbr_T,"-37.81876474, 144.94710545"
721820231130,72,2023-11-30,18,527,566,1093,ACMI_T,"-37.81726338, 144.96872809"
761720241022,76,2024-10-22,17,56,87,143,KenMac_T,"-37.79453803, 144.93036194"
76920240608,76,2024-06-08,9,60,42,102,KenMac_T,"-37.79453803, 144.93036194"
27420240829,27,2024-08-29,4,2,1,3,Vic_T,"-37.80606888, 144.95644692"
91520240916,9,2024-09-16,15,900,150,1050,Col700_T,"-37.81982992, 144.95102555"
30220240608,30,2024-06-08,2,115,172,287,Lon189_T,"-37.8112185, 144.96656806"
23920240508,23,2024-05-08,9,526,318,844,Col623_T,"-37.81909256, 144.95452748"
461120240520,46,2024-05-20,11,77,100,177,Pel147_T,"-37.80240719, 144.9615673"
521120250816,52,2025-08-16,11,320,208,528,Eli263_T,"-37.81252157, 144.9619401"
521120240403,52,2024-04-03,11,286,205,491,Eli263_T,"-37.81252157, 144.9619401"
42820250813,42,2025-08-13,8,333,116,449,UM1_T,"-37.80008566, 144.96386412"
29720240804,29,2024-08-04,7,35,59,94,AG_T,"-37.8199817, 144.96872865"
40720250526,40,2025-05-26,7,79,81,160,Spr201_T,"-37.80999341, 144.97227587"
40620240129,40,2024-01-29,6,19,42,61,Spr201_T,"-37.80999341, 144.97227587"
31220240701,31,2024-07-01,2,1,1,2,Lyg161_T,"-37.80169681, 144.96658911"
311720231108,31,2023-11-08,17,98,67,165,Lyg161_T,"-37.80169681, 144.96658911"
541820240530,54,2024-05-30,18,115,180,295,Swa607_T,"-37.804024, 144.96308399"
47720250910,47,2025-09-10,7,114,206,320,Eli250_T,"-37.81258467, 144.9625775"
45820240725,45,2024-07-25,8,400,297,697,Swa148_T,"-37.81414075, 144.96609379"
52020240518,5,2024-05-18,20,479,726,1205,PriNW_T,"-37.81874249, 144.96787656"
51920241214,5,2024-12-14,19,1656,2592,4248,PriNW_T,"-37.81874249, 144.96787656"
211520241031,21,2024-10-31,15,281,341,622,Bourke155_T,"-37.81267313, 144.96788288"
1431420241128,143,2024-11-28,14,141,247,388,Spencer_T,"-37.821728, 144.95557015"
1311720240419,131,2024-04-19,17,113,121,234,King2_T,"-37.82009057, 144.95758725"
131220250122,131,2025-01-22,2,15,6,21,King2_T,"-37.82009057, 144.95758725"
1181820240620,118,2024-06-20,18,10,24,34,Fli114C_T,"-37.81632783, 144.97090512"
871920250411,87,2025-04-11,19,144,159,303,Errol23_T,"-37.80454949, 144.94921863"
165420241206,165,2024-12-06,4,2,1,3,Spen475_T,"-37.80953359, 144.94939004"
62420250621,62,2025-06-21,4,16,9,25,Lat224_T,"-37.80996494, 144.96216521"
561720250214,56,2025-02-14,17,440,441,881,Lon364_T,"-37.81234775, 144.96153311"
86720250707,86,2025-07-07,7,22,19,41,574Qub_T,"-37.80309992, 144.94908064"
24920240406,24,2024-04-06,9,489,300,789,Col620_T,"-37.81887963, 144.95449198"
121520250502,12,2025-05-02,15,150,184,334,NewQ_T,"-37.81457988, 144.94292398"
722220240820,72,2024-08-20,22,55,103,158,ACMI_T,"-37.81726338, 144.96872809"
72120241124,72,2024-11-24,1,40,52,92,ACMI_T,"-37.81726338, 144.96872809"
721620231101,72,2023-11-01,16,318,559,877,ACMI_T,"-37.81726338, 144.96872809"
581220240302,58,2024-03-02,12,793,254,1047,Bou688_T,"-37.81686075, 144.95358075"
351120241208,35,2024-12-08,11,1120,1151,2271,SouthB_T,"-37.82018685, 144.96508508"
351520240408,35,2024-04-08,15,876,929,1805,SouthB_T,"-37.82018685, 144.96508508"
58020250929,58,2025-09-29,0,57,60,117,Bou688_T,"-37.81686075, 144.95358075"
79520240417,79,2024-04-17,5,30,22,52,FliSS_T,"-37.81794046, 144.96616678"
531420250905,53,2025-09-05,14,727,588,1315,Col254_T,"-37.81564191, 144.965499"
511120240904,51,2024-09-04,11,71,70,141,Fra118_T,"-37.80841815, 144.95906316"
301920250117,30,2025-01-17,19,408,527,935,Lon189_T,"-37.8112185, 144.96656806"
231420250814,23,2025-08-14,14,245,410,655,Col623_T,"-37.81909256, 144.95452748"
192020250117,19,2025-01-17,20,675,666,1341,LtB210_T,"-37.81237202, 144.96550671"
481120250923,48,2025-09-23,11,288,251,539,QVMQ_T,"-37.80631581, 144.95866697"
191120240618,19,2024-06-18,11,273,170,443,LtB210_T,"-37.81237202, 144.96550671"
20020240302,20,2024-03-02,0,110,198,308,LtB170_T,"-37.81172914, 144.9682466"
1421720240107,142,2024-01-07,17,152,183,335,Hammer1584_T,"-37.81970749, 144.96795734"
9920250907,9,2025-09-07,9,52,75,127,Col700_T,"-37.81982992, 144.95102555"
232120240324,23,2024-03-24,21,111,192,303,Col623_T,"-37.81909256, 144.95452748"
481920240830,48,2024-08-30,19,120,143,263,QVMQ_T,"-37.80631581, 144.95866697"
25920241225,25,2024-12-25,9,125,89,214,MCEC_T,"-37.82401776, 144.95604426"
46720250412,46,2025-04-12,7,8,11,19,Pel147_T,"-37.80240719, 144.9615673"
201620241201,20,2024-12-01,16,258,323,581,LtB170_T,"-37.81172914, 144.9682466"
521020250812,52,2025-08-12,10,189,183,372,Eli263_T,"-37.81252157, 144.9619401"
1372020241204,137,2024-12-04,20,6,11,17,BouHbr2353_T,"-37.81894815, 144.94612292"
1392220240321,139,2024-03-21,22,28,36,64,Signal1647_T,"-37.81959923, 144.9632832"
1421320250131,142,2025-01-31,13,536,521,1057,Hammer1584_T,"-37.81970749, 144.96795734"
1231020240402,123,2024-04-02,10,4,4,8,BirBridge_T,"-37.81753741, 144.97329734"
130820240529,130,2024-05-29,8,4,1,5,Bou892T,"-37.8204637, 144.94126826"
1641020250827,164,2025-08-27,10,135,45,180,Lat526_T,"-37.813005, 144.95160411"
1091220240418,109,2024-04-18,12,252,231,483,LatWill_T,"-37.81193681, 144.95621105"
661320250509,66,2025-05-09,13,1123,1413,2536,QVN_T,"-37.81057846, 144.96444294"
691320240420,69,2024-04-20,13,252,240,492,FLDegC_T,"-37.81687226, 144.96559144"
69720250507,69,2025-05-07,7,154,50,204,FLDegC_T,"-37.81687226, 144.96559144"
3520250318,3,2025-03-18,5,13,25,38,Swa295_T,"-37.81101524, 144.96429485"
39620250102,39,2025-01-02,6,8,3,11,AlfPl_T,"-37.81379749, 144.96995745"
781620240827,78,2024-08-27,16,25,166,191,HarEsB_T,"-37.81471642, 144.9446508"
592020240530,59,2024-05-30,20,365,480,845,RMIT_T,"-37.80825648, 144.96304859"
29620240723,29,2024-07-23,6,37,64,101,AG_T,"-37.8199817, 144.96872865"
54620240824,54,2024-08-24,6,8,8,16,Swa607_T,"-37.804024, 144.96308399"
211520250207,21,2025-02-07,15,304,281,585,Bourke155_T,"-37.81267313, 144.96788288"
361420240917,36,2024-09-17,14,195,204,399,Que85_T,"-37.81652527, 144.96121062"
45220250112,45,2025-01-12,2,44,162,206,Swa148_T,"-37.81414075, 144.96609379"
5520250325,5,2025-03-25,5,38,76,114,PriNW_T,"-37.81874249, 144.96787656"
1072220250622,107,2025-06-22,22,30,18,48,280Will_T,"-37.81246271, 144.95690188"
1331320250802,133,2025-08-02,13,593,555,1148,Spen229_T,"-37.81531435, 144.95227769"
124620231030,124,2023-10-30,6,0,1,1,BirBridge_T,"-37.81757416, 144.97329934"
871420241205,87,2024-12-05,14,78,86,164,Errol23_T,"-37.80454949, 144.94921863"
70320250723,70,2025-07-23,3,1,0,1,Errol20_T,"-37.80456984, 144.94946228"
61120250418,61,2025-04-18,1,128,16,144,RMIT14_T,"-37.80767455, 144.96309114"
61920240627,61,2024-06-27,9,150,308,458,RMIT14_T,"-37.80767455, 144.96309114"
50920240523,50,2024-05-23,9,63,114,177,Lyg309_T,"-37.79808192, 144.96721013"
181320250407,181,2025-04-07,3,37,32,69,Eli368_T,"-37.81009465, 144.96143149"
179020250809,179,2025-08-09,0,5,12,17,Pow61_T,"-37.82392385, 144.96299677"
1651520250625,165,2025-06-25,15,27,20,47,Spen475_T,"-37.80953359, 144.94939004"
165020251003,165,2025-10-03,0,3,2,5,Spen475_T,"-37.80953359, 144.94939004"
1651820241102,165,2024-11-02,18,48,64,112,Spen475_T,"-37.80953359, 144.94939004"
1661820250106,166,2025-01-06,18,101,92,193,Spen484_T,"-37.80896733, 144.94931703"
1431520240920,143,2024-09-20,15,217,226,443,Spencer_T,"-37.821728, 144.95557015"
1351420240403,135,2024-04-03,14,359,414,773,Spen161_T,"-37.8172861, 144.95319102"
172120250112,17,2025-01-12,21,69,43,112,Col15_T,"-37.81362543, 144.97323591"
182020250930,18,2025-09-30,20,24,17,41,Col12_T,"-37.81344862, 144.97305353"
861820241110,86,2024-11-10,18,30,41,71,574Qub_T,"-37.80309992, 144.94908064"
111220240612,11,2024-06-12,12,72,70,142,WatCit_T,"-37.81564989, 144.93970694"
111520241022,11,2024-10-22,15,68,43,111,WatCit_T,"-37.81564989, 144.93970694"
56920240613,56,2024-06-13,9,178,177,355,Lon364_T,"-37.81234775, 144.96153311"
121220240205,12,2024-02-05,12,90,133,223,NewQ_T,"-37.81457988, 144.94292398"
561420250507,56,2025-05-07,14,308,297,605,Lon364_T,"-37.81234775, 144.96153311"
101720250415,10,2025-04-15,17,206,67,273,BouHbr_T,"-37.81876474, 144.94710545"
24320251017,24,2025-10-17,3,14,11,25,Col620_T,"-37.81887963, 144.95449198"
76720250403,76,2025-04-03,7,33,14,47,KenMac_T,"-37.79453803, 144.93036194"
9820241028,9,2024-10-28,8,91,2633,2724,Col700_T,"-37.81982992, 144.95102555"
791220250605,79,2025-06-05,12,381,387,768,FliSS_T,"-37.81794046, 144.96616678"
79320250709,79,2025-07-09,3,6,9,15,FliSS_T,"-37.81794046, 144.96616678"
91520250705,9,2025-07-05,15,207,142,349,Col700_T,"-37.81982992, 144.95102555"
301420250724,30,2025-07-24,14,207,359,566,Lon189_T,"-37.8112185, 144.96656806"
79320241003,79,2024-10-03,3,7,8,15,FliSS_T,"-37.81794046, 144.96616678"
511920250609,51,2025-06-09,19,67,49,116,Fra118_T,"-37.80841815, 144.95906316"
232020231230,23,2023-12-30,20,65,102,167,Col623_T,"-37.81909256, 144.95452748"
232120240727,23,2024-07-27,21,120,154,274,Col623_T,"-37.81909256, 144.95452748"
461920250915,46,2025-09-15,19,25,30,55,Pel147_T,"-37.80240719, 144.9615673"
25620240217,25,2024-02-17,6,38,30,68,MCEC_T,"-37.82401776, 144.95604426"
1422220231121,142,2023-11-21,22,106,98,204,Hammer1584_T,"-37.81970749, 144.96795734"
491120250211,49,2025-02-11,11,232,357,589,Eli501_T,"-37.80730068, 144.95956055"
1172020250803,117,2025-08-03,20,171,85,256,Fli114F_T,"-37.81629332, 144.97090877"
1091620231123,109,2023-11-23,16,403,164,567,LatWill_T,"-37.81193681, 144.95621105"
62120240110,6,2024-01-10,21,727,620,1347,FliS_T,"-37.81911705, 144.96558255"
4920241207,4,2024-12-07,9,732,408,1140,Swa123_T,"-37.81487988, 144.9660878"
3520250525,3,2025-05-25,5,43,46,89,Swa295_T,"-37.81101524, 144.96429485"
39820250515,39,2025-05-15,8,85,85,170,AlfPl_T,"-37.81379749, 144.96995745"
391420250905,39,2025-09-05,14,85,91,176,AlfPl_T,"-37.81379749, 144.96995745"
411220250321,41,2025-03-21,12,1695,1581,3276,Swa31,"-37.81668634, 144.96689733"
78420231107,78,2023-11-07,4,0,1,1,HarEsB_T,"-37.81471642, 144.9446508"
78820240301,78,2024-03-01,8,80,56,136,HarEsB_T,"-37.81471642, 144.9446508"
651320240111,65,2024-01-11,13,434,629,1063,SwaCs_T,"-37.81569416, 144.9668064"
42720250118,42,2025-01-18,7,19,17,36,UM1_T,"-37.80008566, 144.96386412"
652020240914,65,2024-09-14,20,324,364,688,SwaCs_T,"-37.81569416, 144.9668064"
651520240925,65,2024-09-25,15,776,714,1490,SwaCs_T,"-37.81569416, 144.9668064"
28120240719,28,2024-07-19,1,12,2,14,VAC_T,"-37.82129925, 144.96879309"
29620240320,29,2024-03-20,6,66,97,163,AG_T,"-37.8199817, 144.96872865"
472220250308,47,2025-03-08,22,763,471,1234,Eli250_T,"-37.81258467, 144.9625775"
361720251001,36,2025-10-01,17,264,227,491,Que85_T,"-37.81652527, 144.96121062"
361820241208,36,2024-12-08,18,58,84,142,Que85_T,"-37.81652527, 144.96121062"
37620240529,37,2024-05-29,6,7,4,11,Lyg260_T,"-37.80107122, 144.96704554"
47320240812,47,2024-08-12,3,17,14,31,Eli250_T,"-37.81258467, 144.9625775"
5520240911,5,2024-09-11,5,28,62,90,PriNW_T,"-37.81874249, 144.96787656"
21420250926,21,2025-09-26,4,11,22,33,Bourke155_T,"-37.81267313, 144.96788288"
1232320240213,123,2024-02-13,23,1,0,1,BirBridge_T,"-37.81753741, 144.97329734"
1091320250319,109,2025-03-19,13,177,208,385,LatWill_T,"-37.81193681, 144.95621105"
691820240330,69,2024-03-30,18,98,66,164,FLDegC_T,"-37.81687226, 144.96559144"
6520250516,6,2025-05-16,5,70,90,160,FliS_T,"-37.81911705, 144.96558255"
4820240210,4,2024-02-10,8,266,131,397,Swa123_T,"-37.81487988, 144.9660878"
4620251003,4,2025-10-03,6,118,62,180,Swa123_T,"-37.81487988, 144.9660878"
701520240603,70,2024-06-03,15,138,125,263,Errol20_T,"-37.80456984, 144.94946228"
391220241205,39,2024-12-05,12,331,171,502,AlfPl_T,"-37.81379749, 144.96995745"
3820250418,3,2025-04-18,8,107,124,231,Swa295_T,"-37.81101524, 144.96429485"
75120250415,75,2025-04-15,1,0,1,1,SprFli_T,"-37.81515276, 144.97467661"
75820250710,75,2025-07-10,8,51,54,105,SprFli_T,"-37.81515276, 144.97467661"
82320250621,8,2025-06-21,23,4,2,6,WebBN_T,"-37.82293543, 144.9471751"
8120231229,8,2023-12-29,1,9,9,18,WebBN_T,"-37.82293543, 144.9471751"
41220241213,41,2024-12-13,2,53,108,161,Swa31,"-37.81668634, 144.96689733"
41020250121,41,2025-01-21,0,145,127,272,Swa31,"-37.81668634, 144.96689733"
412320250907,41,2025-09-07,23,295,358,653,Swa31,"-37.81668634, 144.96689733"
421520241203,42,2024-12-03,15,174,284,458,UM1_T,"-37.80008566, 144.96386412"
771320250502,77,2025-05-02,13,166,75,241,HarEsP_T,"-37.81441438, 144.94433026"
782320250516,78,2025-05-16,23,7,4,11,HarEsB_T,"-37.81471642, 144.9446508"
59920241007,59,2024-10-07,9,677,277,954,RMIT_T,"-37.80825648, 144.96304859"
71020250323,71,2025-03-23,0,6,2,8,WestWP_T,"-37.81235775, 144.97136962"
54120240914,54,2024-09-14,1,29,37,66,Swa607_T,"-37.804024, 144.96308399"
541820250524,54,2025-05-24,18,155,150,305,Swa607_T,"-37.804024, 144.96308399"
281420251008,28,2025-10-08,14,392,457,849,VAC_T,"-37.82129925, 144.96879309"
28420240423,28,2024-04-23,4,2,29,31,VAC_T,"-37.82129925, 144.96879309"
361020231231,36,2023-12-31,10,64,69,133,Que85_T,"-37.81652527, 144.96121062"
501320241228,50,2024-12-28,13,237,274,511,Lyg309_T,"-37.79808192, 144.96721013"
43620240831,43,2024-08-31,6,12,1,13,UM2_T,"-37.79844526, 144.96411782"
442320240819,44,2024-08-19,23,4,0,4,UM3_T,"-37.79698741, 144.96441306"
5120250116,5,2025-01-16,1,13,48,61,PriNW_T,"-37.81874249, 144.96787656"
5820240805,5,2024-08-05,8,315,953,1268,PriNW_T,"-37.81874249, 144.96787656"
1821920250606,182,2025-06-06,19,298,269,567,King163_T,"-37.81627451, 144.95550503"
1432220240516,143,2024-05-16,22,142,110,252,Spencer_T,"-37.821728, 144.95557015"
1072220231104,107,2023-11-04,22,101,114,215,280Will_T,"-37.81246271, 144.95690188"
1321520250824,132,2025-08-24,15,156,148,304,King335_T,"-37.81267639, 144.95386444"
1342220250428,134,2025-04-28,22,109,99,208,Spen201_T,"-37.81694221, 144.95303935"
1351320240327,135,2024-03-27,13,763,826,1589,Spen161_T,"-37.8172861, 144.95319102"
107620231207,107,2023-12-07,6,16,37,53,280Will_T,"-37.81246271, 144.95690188"
1332020240731,133,2024-07-31,20,346,229,575,Spen229_T,"-37.81531435, 144.95227769"
133020250311,133,2025-03-11,0,44,27,71,Spen229_T,"-37.81531435, 144.95227769"
1081320250725,108,2025-07-25,13,456,381,837,261Will_T,"-37.81295822, 144.95678789"
1812120250927,181,2025-09-27,21,768,643,1411,Eli368_T,"-37.81009465, 144.96143149"
167520250225,167,2025-02-25,5,1,11,12,Lat526_T,"-37.81304149, 144.95155955"
1672020250427,167,2025-04-27,20,8,15,23,Lat526_T,"-37.81304149, 144.95155955"
771420250705,77,2025-07-05,14,230,166,396,HarEsP_T,"-37.81441438, 144.94433026"
772120240628,77,2024-06-28,21,7,4,11,HarEsP_T,"-37.81441438, 144.94433026"
138920250705,138,2025-07-05,9,4,0,4,EntPark1671_T,"-37.81996544, 144.95981454"
69420240521,69,2024-05-21,4,2,2,4,FLDegC_T,"-37.81687226, 144.96559144"
692120250703,69,2025-07-03,21,7,4,11,FLDegC_T,"-37.81687226, 144.96559144"
61820231208,6,2023-12-08,18,1337,1616,2953,FliS_T,"-37.81911705, 144.96558255"
6320240619,6,2024-06-19,3,4,6,10,FliS_T,"-37.81911705, 144.96558255"
841120240222,84,2024-02-22,11,754,722,1476,ElFi_T,"-37.81798049, 144.96503383"
702020250909,70,2025-09-09,20,102,95,197,Errol20_T,"-37.80456984, 144.94946228"
32220240617,3,2024-06-17,22,350,275,625,Swa295_T,"-37.81101524, 144.96429485"
75720250724,75,2025-07-24,7,32,45,77,SprFli_T,"-37.81515276, 144.97467661"
75520250911,75,2025-09-11,5,16,8,24,SprFli_T,"-37.81515276, 144.97467661"
781720240306,78,2024-03-06,17,39,297,336,HarEsB_T,"-37.81471642, 144.9446508"
78720240705,78,2024-07-05,7,3,4,7,HarEsB_T,"-37.81471642, 144.9446508"
77320240831,77,2024-08-31,3,1,0,1,HarEsP_T,"-37.81441438, 144.94433026"
771420250117,77,2025-01-17,14,140,61,201,HarEsP_T,"-37.81441438, 144.94433026"
771320250528,77,2025-05-28,13,75,57,132,HarEsP_T,"-37.81441438, 144.94433026"
77220231022,77,2023-10-22,2,10,5,15,HarEsP_T,"-37.81441438, 144.94433026"
591320250220,59,2025-02-20,13,565,313,878,RMIT_T,"-37.80825648, 144.96304859"
54220250823,54,2025-08-23,2,25,13,38,Swa607_T,"-37.804024, 144.96308399"
281420250327,28,2025-03-27,14,707,742,1449,VAC_T,"-37.82129925, 144.96879309"
29420231121,29,2023-11-21,4,2,0,2,AG_T,"-37.8199817, 144.96872865"
312220240905,31,2024-09-05,22,83,124,207,Lyg161_T,"-37.80169681, 144.96658911"
362120240701,36,2024-07-01,21,59,96,155,Que85_T,"-37.81652527, 144.96121062"
50920240912,50,2024-09-12,9,75,128,203,Lyg309_T,"-37.79808192, 144.96721013"
501320241202,50,2024-12-02,13,192,230,422,Lyg309_T,"-37.79808192, 144.96721013"
441320240717,44,2024-07-17,13,79,100,179,UM3_T,"-37.79698741, 144.96441306"
432220240601,43,2024-06-01,22,51,46,97,UM2_T,"-37.79844526, 144.96411782"
43020240605,43,2024-06-05,0,7,15,22,UM2_T,"-37.79844526, 144.96411782"
212020240506,21,2024-05-06,20,278,298,576,Bourke155_T,"-37.81267313, 144.96788288"
5820240720,5,2024-07-20,8,111,142,253,PriNW_T,"-37.81874249, 144.96787656"
21920250425,21,2025-04-25,9,78,64,142,Bourke155_T,"-37.81267313, 144.96788288"
140920241022,140,2024-10-22,9,120,47,167,Boyd2837_T,"-37.82590962, 144.96185972"
1312320240622,131,2024-06-22,23,187,126,313,King2_T,"-37.82009057, 144.95758725"
107520250525,107,2025-05-25,5,4,4,8,280Will_T,"-37.81246271, 144.95690188"
1331920240106,133,2024-01-06,19,487,416,903,Spen229_T,"-37.81531435, 144.95227769"
1081020250913,108,2025-09-13,10,133,114,247,261Will_T,"-37.81295822, 144.95678789"
87920231021,87,2023-10-21,9,102,119,221,Errol23_T,"-37.80454949, 144.94921863"
70420241003,70,2024-10-03,4,0,2,2,Errol20_T,"-37.80456984, 144.94946228"
166820250305,166,2025-03-05,8,42,58,100,Spen484_T,"-37.80896733, 144.94931703"
1651820250808,165,2025-08-08,18,41,36,77,Spen475_T,"-37.80953359, 144.94939004"
1621020250206,162,2025-02-06,10,358,395,753,Eli489_T,"-37.80740397, 144.95987909"
184020250918,184,2025-09-18,0,23,36,59,Eli124_T,"-37.81512416, 144.96371988"
672320250621,67,2025-06-21,23,74,139,213,FLDegS_T,"-37.81688755, 144.96562569"
172020250518,17,2025-05-18,20,51,37,88,Col15_T,"-37.81362543, 144.97323591"
11920231204,1,2023-12-04,19,1117,702,1819,Bou292_T,"-37.81349441, 144.96515323"
1820241121,1,2024-11-21,8,240,339,579,Bou292_T,"-37.81349441, 144.96515323"
68620250720,68,2025-07-20,6,2,1,3,FLDegN_T,"-37.8168479, 144.96559789"
18720240321,18,2024-03-21,7,16,367,383,Col12_T,"-37.81344862, 144.97305353"
182020250110,18,2025-01-10,20,47,40,87,Col12_T,"-37.81344862, 144.97305353"
12320240128,12,2024-01-28,3,2,10,12,NewQ_T,"-37.81457988, 144.94292398"
861120250114,86,2025-01-14,11,42,52,94,574Qub_T,"-37.80309992, 144.94908064"
241220240221,24,2024-02-21,12,842,790,1632,Col620_T,"-37.81887963, 144.95449198"
121520240812,12,2024-08-12,15,127,125,252,NewQ_T,"-37.81457988, 144.94292398"
721920240715,72,2024-07-15,19,68,92,160,ACMI_T,"-37.81726338, 144.96872809"
12320250430,12,2025-04-30,3,2,4,6,NewQ_T,"-37.81457988, 144.94292398"
10320241010,10,2024-10-10,3,1,0,1,BouHbr_T,"-37.81876474, 144.94710545"
134920250213,134,2025-02-13,9,275,319,594,Spen201_T,"-37.81694221, 144.95303935"
107120240711,107,2024-07-11,1,5,2,7,280Will_T,"-37.81246271, 144.95690188"
1181920240516,118,2024-05-16,19,4,5,9,Fli114C_T,"-37.81632783, 144.97090512"
1851320251014,185,2025-10-14,13,937,986,1923,Eli197_T,"-37.81374643, 144.96276183"
1651220250226,165,2025-02-26,12,39,36,75,Spen475_T,"-37.80953359, 144.94939004"
171820231121,17,2023-11-21,18,248,400,648,Col15_T,"-37.81362543, 144.97323591"
632120240628,63,2024-06-28,21,216,467,683,Bou231_T,"-37.81333081, 144.96675571"
181820240722,18,2024-07-22,18,0,1,1,Col12_T,"-37.81344862, 144.97305353"
56020231224,56,2023-12-24,0,59,147,206,Lon364_T,"-37.81234775, 144.96153311"
12720241118,12,2024-11-18,7,92,81,173,NewQ_T,"-37.81457988, 144.94292398"
722020240113,72,2024-01-13,20,146,200,346,ACMI_T,"-37.81726338, 144.96872809"
72420240424,72,2024-04-24,4,6,3,9,ACMI_T,"-37.81726338, 144.96872809"
581920241020,58,2024-10-20,19,305,273,578,Bou688_T,"-37.81686075, 144.95358075"
351820240614,35,2024-06-14,18,1144,1144,2288,SouthB_T,"-37.82018685, 144.96508508"
762320240512,76,2024-05-12,23,1,0,1,KenMac_T,"-37.79453803, 144.93036194"
22120250605,2,2025-06-05,21,75,173,248,Bou283_T,"-37.81380668, 144.96516718"
2520250930,2,2025-09-30,5,5,8,13,Bou283_T,"-37.81380668, 144.96516718"
9720241101,9,2024-11-01,7,46,564,610,Col700_T,"-37.81982992, 144.95102555"
91420250706,9,2025-07-06,14,88,101,189,Col700_T,"-37.81982992, 144.95102555"
30320250217,30,2025-02-17,3,16,56,72,Lon189_T,"-37.8112185, 144.96656806"
79320241019,79,2024-10-19,3,36,42,78,FliSS_T,"-37.81794046, 144.96616678"
791920250103,79,2025-01-03,19,366,354,720,FliSS_T,"-37.81794046, 144.96616678"
51320250309,51,2025-03-09,3,9,10,19,Fra118_T,"-37.80841815, 144.95906316"
1412020241011,141,2024-10-11,20,141,117,258,474Fl_T,"-37.81997273, 144.95834911"
1361520250907,136,2025-09-07,15,51,38,89,BirFed1120_T,"-37.8184141, 144.97357915"
1231720250621,123,2025-06-21,17,37,8,45,BirBridge_T,"-37.81753741, 144.97329734"
161620250224,161,2025-02-24,6,18,25,43,BirArt1109_T,"-37.81851276, 144.97131336"
117620240809,117,2024-08-09,6,26,16,42,Fli114F_T,"-37.81629332, 144.97090877"
62220241106,6,2024-11-06,22,443,286,729,FliS_T,"-37.81911705, 144.96558255"
84720240131,84,2024-01-31,7,613,231,844,ElFi_T,"-37.81798049, 144.96503383"
661720240623,66,2024-06-23,17,1092,1239,2331,QVN_T,"-37.81057846, 144.96444294"
841220250910,84,2025-09-10,12,912,967,1879,ElFi_T,"-37.81798049, 144.96503383"
41220250209,4,2025-02-09,12,2911,1383,4294,Swa123_T,"-37.81487988, 144.9660878"
70420250804,70,2025-08-04,4,0,2,2,Errol20_T,"-37.80456984, 144.94946228"
32320231216,3,2023-12-16,23,967,850,1817,Swa295_T,"-37.81101524, 144.96429485"
81720240316,8,2024-03-16,17,198,170,368,WebBN_T,"-37.82293543, 144.9471751"
751220241108,75,2024-11-08,12,46,32,78,SprFli_T,"-37.81515276, 144.97467661"
41720240820,41,2024-08-20,7,57,84,141,Swa31,"-37.81668634, 144.96689733"
412220241121,41,2024-11-21,22,421,448,869,Swa31,"-37.81668634, 144.96689733"
42220250915,42,2025-09-15,2,3,5,8,UM1_T,"-37.80008566, 144.96386412"
78120240717,78,2024-07-17,1,0,3,3,HarEsB_T,"-37.81471642, 144.9446508"
59620241113,59,2024-11-13,6,69,35,104,RMIT_T,"-37.80825648, 144.96304859"
311020240407,31,2024-04-07,10,105,82,187,Lyg161_T,"-37.80169681, 144.96658911"
54820240917,54,2024-09-17,8,226,44,270,Swa607_T,"-37.804024, 144.96308399"
28020250427,28,2025-04-27,0,48,11,59,VAC_T,"-37.82129925, 144.96879309"
28220240823,28,2024-08-23,2,4,18,22,VAC_T,"-37.82129925, 144.96879309"
401920240117,40,2024-01-17,19,117,125,242,Spr201_T,"-37.80999341, 144.97227587"
311820241127,31,2024-11-27,18,163,91,254,Lyg161_T,"-37.80169681, 144.96658911"
362220231101,36,2023-11-01,22,58,51,109,Que85_T,"-37.81652527, 144.96121062"
44820250206,44,2025-02-06,8,45,45,90,UM3_T,"-37.79698741, 144.96441306"
43120240519,43,2024-05-19,1,6,4,10,UM2_T,"-37.79844526, 144.96411782"
43020240912,43,2024-09-12,0,8,8,16,UM2_T,"-37.79844526, 144.96411782"
442020231025,44,2023-10-25,20,22,17,39,UM3_T,"-37.79698741, 144.96441306"
45720250929,45,2025-09-29,7,97,148,245,Swa148_T,"-37.81414075, 144.96609379"
45220231122,45,2023-11-22,2,2,16,18,Swa148_T,"-37.81414075, 144.96609379"
143820250319,143,2025-03-19,8,154,288,442,Spencer_T,"-37.821728, 144.95557015"
1321320240517,132,2024-05-17,13,228,177,405,King335_T,"-37.81267639, 144.95386444"
1792020250516,179,2025-05-16,20,75,48,123,Pow61_T,"-37.82392385, 144.96299677"
166020250221,166,2025-02-21,0,0,2,2,Spen484_T,"-37.80896733, 144.94931703"
171020240604,17,2024-06-04,10,417,280,697,Col15_T,"-37.81362543, 144.97323591"
1920250111,1,2025-01-11,9,182,328,510,Bou292_T,"-37.81349441, 144.96515323"
181020240128,18,2024-01-28,10,49,51,100,Col12_T,"-37.81344862, 144.97305353"
181820250316,18,2025-03-16,18,54,30,84,Col12_T,"-37.81344862, 144.97305353"
121920231029,12,2023-10-29,19,227,285,512,NewQ_T,"-37.81457988, 144.94292398"
622320240306,62,2024-03-06,23,111,76,187,Lat224_T,"-37.80996494, 144.96216521"
62520240930,62,2024-09-30,5,7,5,12,Lat224_T,"-37.80996494, 144.96216521"
102020231214,10,2023-12-14,20,54,20,74,BouHbr_T,"-37.81876474, 144.94710545"
101520250521,10,2025-05-21,15,148,33,181,BouHbr_T,"-37.81876474, 144.94710545"
531420240810,53,2024-08-10,14,824,605,1429,Col254_T,"-37.81564191, 144.965499"
79120241129,79,2024-11-29,1,39,41,80,FliSS_T,"-37.81794046, 144.96616678"
511420250423,51,2025-04-23,14,87,81,168,Fra118_T,"-37.80841815, 144.95906316"
511420240121,51,2024-01-21,14,173,169,342,Fra118_T,"-37.80841815, 144.95906316"
251620250819,25,2025-08-19,16,705,485,1190,MCEC_T,"-37.82401776, 144.95604426"
201120251012,20,2025-10-12,11,190,187,377,LtB170_T,"-37.81172914, 144.9682466"
52420241126,52,2024-11-26,4,2,4,6,Eli263_T,"-37.81252157, 144.9619401"
1231120250416,123,2025-04-16,11,31,23,54,BirBridge_T,"-37.81753741, 144.97329734"
1231820250520,123,2025-05-20,18,1,1,2,BirBridge_T,"-37.81753741, 144.97329734"
130220250323,130,2025-03-23,2,2,0,2,Bou892T,"-37.8204637, 144.94126826"
1231120231203,123,2023-12-03,11,56,24,80,BirBridge_T,"-37.81753741, 144.97329734"
491320241231,49,2024-12-31,13,466,709,1175,Eli501_T,"-37.80730068, 144.95956055"
49920250618,49,2025-06-18,9,182,208,390,Eli501_T,"-37.80730068, 144.95956055"
661020250809,66,2025-08-09,10,438,481,919,QVN_T,"-37.81057846, 144.96444294"
66120241225,66,2024-12-25,1,127,55,182,QVN_T,"-37.81057846, 144.96444294"
691020240721,69,2024-07-21,10,264,156,420,FLDegC_T,"-37.81687226, 144.96559144"
6620250525,6,2025-05-25,6,60,69,129,FliS_T,"-37.81911705, 144.96558255"
4320250731,4,2025-07-31,3,12,5,17,Swa123_T,"-37.81487988, 144.9660878"
6520250918,6,2025-09-18,5,70,85,155,FliS_T,"-37.81911705, 144.96558255"
41820240516,4,2024-05-16,18,1296,554,1850,Swa123_T,"-37.81487988, 144.9660878"
391020250518,39,2025-05-18,10,45,50,95,AlfPl_T,"-37.81379749, 144.96995745"
22320251016,2,2025-10-16,23,38,78,116,Bou283_T,"-37.81380668, 144.96516718"
2320240605,2,2024-06-05,3,2,11,13,Bou283_T,"-37.81380668, 144.96516718"
271720241230,27,2024-12-30,17,79,69,148,Vic_T,"-37.80606888, 144.95644692"
271220241231,27,2024-12-31,12,213,166,379,Vic_T,"-37.80606888, 144.95644692"
23220250205,23,2025-02-05,2,7,10,17,Col623_T,"-37.81909256, 144.95452748"
231220240628,23,2024-06-28,12,441,483,924,Col623_T,"-37.81909256, 144.95452748"
522020240827,52,2024-08-27,20,200,167,367,Eli263_T,"-37.81252157, 144.9619401"
461320240103,46,2024-01-03,13,48,51,99,Pel147_T,"-37.80240719, 144.9615673"
251020250910,25,2025-09-10,10,201,404,605,MCEC_T,"-37.82401776, 144.95604426"
481920250827,48,2025-08-27,19,189,556,745,QVMQ_T,"-37.80631581, 144.95866697"
46820240621,46,2024-06-21,8,47,83,130,Pel147_T,"-37.80240719, 144.9615673"
202020250731,20,2025-07-31,20,177,462,639,LtB170_T,"-37.81172914, 144.9682466"
1411820250116,141,2025-01-16,18,143,169,312,474Fl_T,"-37.81997273, 144.95834911"
130620250110,130,2025-01-10,6,3,2,5,Bou892T,"-37.8204637, 144.94126826"
142420240127,142,2024-01-27,4,2,2,4,Hammer1584_T,"-37.81970749, 144.96795734"
161820250720,161,2025-07-20,8,132,85,217,BirArt1109_T,"-37.81851276, 144.97131336"
1171120250919,117,2025-09-19,11,105,145,250,Fli114F_T,"-37.81629332, 144.97090877"
692120240623,69,2024-06-23,21,20,12,32,FLDegC_T,"-37.81687226, 144.96559144"
691320250221,69,2025-02-21,13,284,295,579,FLDegC_T,"-37.81687226, 144.96559144"
691520250905,69,2025-09-05,15,216,267,483,FLDegC_T,"-37.81687226, 144.96559144"
751520241030,75,2024-10-30,15,64,54,118,SprFli_T,"-37.81515276, 144.97467661"
75320250916,75,2025-09-16,3,2,0,2,SprFli_T,"-37.81515276, 144.97467661"
39320231023,39,2023-10-23,3,0,3,3,AlfPl_T,"-37.81379749, 144.96995745"
39220241110,39,2024-11-10,2,1,0,1,AlfPl_T,"-37.81379749, 144.96995745"
41520240817,41,2024-08-17,5,14,18,32,Swa31,"-37.81668634, 144.96689733"
42720241111,42,2024-11-11,7,35,45,80,UM1_T,"-37.80008566, 144.96386412"
781320250803,78,2025-08-03,13,143,75,218,HarEsB_T,"-37.81471642, 144.9446508"
782220251016,78,2025-10-16,22,2,11,13,HarEsB_T,"-37.81471642, 144.9446508"
71520241025,71,2024-10-25,5,5,8,13,WestWP_T,"-37.81235775, 144.97136962"
591920240223,59,2024-02-23,19,619,528,1147,RMIT_T,"-37.80825648, 144.96304859"
651420240609,65,2024-06-09,14,478,755,1233,SwaCs_T,"-37.81569416, 144.9668064"
281120240713,28,2024-07-13,11,999,679,1678,VAC_T,"-37.82129925, 144.96879309"
40720250725,40,2025-07-25,7,69,92,161,Spr201_T,"-37.80999341, 144.97227587"
40820250123,40,2025-01-23,8,225,270,495,Spr201_T,"-37.80999341, 144.97227587"
311520250108,31,2025-01-08,15,151,144,295,Lyg161_T,"-37.80169681, 144.96658911"
311020250206,31,2025-02-06,10,60,49,109,Lyg161_T,"-37.80169681, 144.96658911"
36320241110,36,2024-11-10,3,148,64,212,Que85_T,"-37.81652527, 144.96121062"
36620250322,36,2025-03-22,6,16,16,32,Que85_T,"-37.81652527, 144.96121062"
472120240511,47,2024-05-11,21,476,493,969,Eli250_T,"-37.81258467, 144.9625775"
61820250713,61,2025-07-13,8,25,92,117,RMIT14_T,"-37.80767455, 144.96309114"
612220231022,61,2023-10-22,22,118,68,186,RMIT14_T,"-37.80767455, 144.96309114"
502020240518,50,2024-05-18,20,379,293,672,Lyg309_T,"-37.79808192, 144.96721013"
44720240229,44,2024-02-29,7,6,5,11,UM3_T,"-37.79698741, 144.96441306"
212020250325,21,2025-03-25,20,223,295,518,Bourke155_T,"-37.81267313, 144.96788288"
1432220250621,143,2025-06-21,22,287,694,981,Spencer_T,"-37.821728, 144.95557015"
134520250924,134,2025-09-24,5,51,64,115,Spen201_T,"-37.81694221, 144.95303935"
134120240113,134,2024-01-13,1,74,58,132,Spen201_T,"-37.81694221, 144.95303935"
135220241129,135,2024-11-29,2,19,16,35,Spen161_T,"-37.8172861, 144.95319102"
871620250616,87,2025-06-16,16,90,77,167,Errol23_T,"-37.80454949, 144.94921863"
1671920250107,167,2025-01-07,19,33,50,83,Lat526_T,"-37.81304149, 144.95155955"
85920250225,85,2025-02-25,9,99,70,169,488Mac_T,"-37.79432415, 144.92973378"
75020240925,75,2024-09-25,0,2,4,6,SprFli_T,"-37.81515276, 144.97467661"
84020240703,84,2024-07-03,0,59,55,114,ElFi_T,"-37.81798049, 144.96503383"
662020240716,66,2024-07-16,20,826,566,1392,QVN_T,"-37.81057846, 144.96444294"
39520250317,39,2025-03-17,5,1,1,2,AlfPl_T,"-37.81379749, 144.96995745"
81020250517,8,2025-05-17,10,50,104,154,WebBN_T,"-37.82293543, 144.9471751"
8020241104,8,2024-11-04,0,9,13,22,WebBN_T,"-37.82293543, 144.9471751"
412020231215,41,2023-12-15,20,1493,2074,3567,Swa31,"-37.81668634, 144.96689733"
77120240913,77,2024-09-13,1,3,1,4,HarEsP_T,"-37.81441438, 144.94433026"
771320250321,77,2025-03-21,13,102,77,179,HarEsP_T,"-37.81441438, 144.94433026"
29320231205,29,2023-12-05,3,2,3,5,AG_T,"-37.8199817, 144.96872865"
29320251015,29,2025-10-15,3,1,3,4,AG_T,"-37.8199817, 144.96872865"
14120240427,14,2024-04-27,1,100,28,128,SanBri_T,"-37.82011242, 144.96291897"
28720250510,28,2025-05-10,7,62,49,111,VAC_T,"-37.82129925, 144.96879309"
401320250225,40,2025-02-25,13,414,301,715,Spr201_T,"-37.80999341, 144.97227587"
40620250808,40,2025-08-08,6,34,33,67,Spr201_T,"-37.80999341, 144.97227587"
402320240415,40,2024-04-15,23,7,13,20,Spr201_T,"-37.80999341, 144.97227587"
312120250125,31,2025-01-25,21,468,481,949,Lyg161_T,"-37.80169681, 144.96658911"
611220250228,61,2025-02-28,12,932,1245,2177,RMIT14_T,"-37.80767455, 144.96309114"
452120240713,45,2024-07-13,21,384,586,970,Swa148_T,"-37.81414075, 144.96609379"
51220250307,5,2025-03-07,12,1266,1069,2335,PriNW_T,"-37.81874249, 144.96787656"
1841020250806,184,2025-08-06,10,432,457,889,Eli124_T,"-37.81512416, 144.96371988"
1621320240730,162,2024-07-30,13,721,909,1630,Eli489_T,"-37.80740397, 144.95987909"
1432220250817,143,2025-08-17,22,109,90,199,Spencer_T,"-37.821728, 144.95557015"
1431820250429,143,2025-04-29,18,119,142,261,Spencer_T,"-37.821728, 144.95557015"
132020241027,132,2024-10-27,0,63,67,130,King335_T,"-37.81267639, 144.95386444"
134620240410,134,2024-04-10,6,105,112,217,Spen201_T,"-37.81694221, 144.95303935"
1341020250222,134,2025-02-22,10,250,369,619,Spen201_T,"-37.81694221, 144.95303935"
1352120240211,135,2024-02-11,21,158,177,335,Spen161_T,"-37.8172861, 144.95319102"
133520250901,133,2025-09-01,5,67,73,140,Spen229_T,"-37.81531435, 144.95227769"
872020250214,87,2025-02-14,20,109,121,230,Errol23_T,"-37.80454949, 144.94921863"
165120241225,165,2024-12-25,1,6,1,7,Spen475_T,"-37.80953359, 144.94939004"
1672320241217,167,2024-12-17,23,5,12,17,Lat526_T,"-37.81304149, 144.95155955"
17620240508,17,2024-05-08,6,170,40,210,Col15_T,"-37.81362543, 144.97323591"
12320240215,1,2024-02-15,23,65,88,153,Bou292_T,"-37.81349441, 144.96515323"
67020250221,67,2025-02-21,0,11,41,52,FLDegS_T,"-37.81688755, 144.96562569"
112220231026,11,2023-10-26,22,28,22,50,WatCit_T,"-37.81564989, 144.93970694"
632220240929,63,2024-09-29,22,19,84,103,Bou231_T,"-37.81333081, 144.96675571"
182320250423,18,2025-04-23,23,7,2,9,Col12_T,"-37.81344862, 144.97305353"
12420240306,12,2024-03-06,4,2,3,5,NewQ_T,"-37.81457988, 144.94292398"
12520240821,12,2024-08-21,5,12,11,23,NewQ_T,"-37.81457988, 144.94292398"
111620250724,11,2025-07-24,16,90,90,180,WatCit_T,"-37.81564989, 144.93970694"
62420241109,62,2024-11-09,4,28,25,53,Lat224_T,"-37.80996494, 144.96216521"
721720240825,72,2024-08-25,17,193,270,463,ACMI_T,"-37.81726338, 144.96872809"
10320250519,10,2025-05-19,3,1,2,3,BouHbr_T,"-37.81876474, 144.94710545"
351420240907,35,2024-09-07,14,1444,1734,3178,SouthB_T,"-37.82018685, 144.96508508"
582220250216,58,2025-02-16,22,179,137,316,Bou688_T,"-37.81686075, 144.95358075"
2620240527,2,2024-05-27,6,13,31,44,Bou283_T,"-37.81380668, 144.96516718"
281020250426,28,2025-04-26,10,323,224,547,VAC_T,"-37.82129925, 144.96879309"
281720250220,28,2025-02-20,17,661,1047,1708,VAC_T,"-37.82129925, 144.96879309"
40320240306,40,2024-03-06,3,1,0,1,Spr201_T,"-37.80999341, 144.97227587"
31920250729,31,2025-07-29,9,52,84,136,Lyg161_T,"-37.80169681, 144.96658911"
212220250318,21,2025-03-18,22,149,166,315,Bourke155_T,"-37.81267313, 144.96788288"
5420231123,5,2023-11-23,4,32,17,49,PriNW_T,"-37.81874249, 144.96787656"
1322220250517,132,2025-05-17,22,119,116,235,King335_T,"-37.81267639, 144.95386444"
1081820240220,108,2024-02-20,18,607,143,750,261Will_T,"-37.81295822, 144.95678789"
872020250828,87,2025-08-28,20,76,52,128,Errol23_T,"-37.80454949, 144.94921863"
612120250327,61,2025-03-27,21,436,374,810,RMIT14_T,"-37.80767455, 144.96309114"
871320231202,87,2023-12-02,13,104,92,196,Errol23_T,"-37.80454949, 144.94921863"
1401620240412,140,2024-04-12,16,106,101,207,Boyd2837_T,"-37.82590962, 144.96185972"
1341920250824,134,2025-08-24,19,356,274,630,Spen201_T,"-37.81694221, 144.95303935"
1311320240129,131,2024-01-29,13,171,144,315,King2_T,"-37.82009057, 144.95758725"
67520250329,67,2025-03-29,5,4,5,9,FLDegS_T,"-37.81688755, 144.96562569"
852020240922,85,2024-09-22,20,16,36,52,488Mac_T,"-37.79432415, 144.92973378"
62520240403,62,2024-04-03,5,12,13,25,Lat224_T,"-37.80996494, 144.96216521"
12520231228,12,2023-12-28,5,7,2,9,NewQ_T,"-37.81457988, 144.94292398"
35320240904,35,2024-09-04,3,12,7,19,SouthB_T,"-37.82018685, 144.96508508"
761320240425,76,2024-04-25,13,53,35,88,KenMac_T,"-37.79453803, 144.93036194"
302320240321,30,2024-03-21,23,183,238,421,Lon189_T,"-37.8112185, 144.96656806"
511120250901,51,2025-09-01,11,77,62,139,Fra118_T,"-37.80841815, 144.95906316"
511920240501,51,2024-05-01,19,89,113,202,Fra118_T,"-37.80841815, 144.95906316"
48920240220,48,2024-02-20,9,190,162,352,QVMQ_T,"-37.80631581, 144.95866697"
481620240627,48,2024-06-27,16,151,152,303,QVMQ_T,"-37.80631581, 144.95866697"
461520240623,46,2024-06-23,15,45,53,98,Pel147_T,"-37.80240719, 144.9615673"
201720250316,20,2025-03-16,17,221,255,476,LtB170_T,"-37.81172914, 144.9682466"
1361620240605,136,2024-06-05,16,119,73,192,BirFed1120_T,"-37.8184141, 144.97357915"
1171820240222,117,2024-02-22,18,155,252,407,Fli114F_T,"-37.81629332, 144.97090877"
1092320241201,109,2024-12-01,23,17,48,65,LatWill_T,"-37.81193681, 144.95621105"
6520240506,6,2024-05-06,5,71,73,144,FliS_T,"-37.81911705, 144.96558255"
842220240225,84,2024-02-25,22,384,431,815,ElFi_T,"-37.81798049, 144.96503383"
6520250807,6,2025-08-07,5,68,88,156,FliS_T,"-37.81911705, 144.96558255"
4520250117,4,2025-01-17,5,30,20,50,Swa123_T,"-37.81487988, 144.9660878"
4520251007,4,2025-10-07,5,38,36,74,Swa123_T,"-37.81487988, 144.9660878"
78320250224,78,2025-02-24,3,1,3,4,HarEsB_T,"-37.81471642, 144.9446508"
71820240823,71,2024-08-23,8,30,21,51,WestWP_T,"-37.81235775, 144.97136962"
711520241016,71,2024-10-16,15,6,6,12,WestWP_T,"-37.81235775, 144.97136962"
59520240802,59,2024-08-02,5,19,23,42,RMIT_T,"-37.80825648, 144.96304859"
59320240301,59,2024-03-01,3,29,7,36,RMIT_T,"-37.80825648, 144.96304859"
65920240906,65,2024-09-06,9,691,242,933,SwaCs_T,"-37.81569416, 144.9668064"
31620240730,31,2024-07-30,6,7,5,12,Lyg161_T,"-37.80169681, 144.96658911"
54420241107,54,2024-11-07,4,7,7,14,Swa607_T,"-37.804024, 144.96308399"
47720250616,47,2025-06-16,7,101,217,318,Eli250_T,"-37.81258467, 144.9625775"
212120250616,21,2025-06-16,21,61,105,166,Bourke155_T,"-37.81267313, 144.96788288"
211920250618,21,2025-06-18,19,189,243,432,Bourke155_T,"-37.81267313, 144.96788288"
451520240417,45,2024-04-17,15,556,823,1379,Swa148_T,"-37.81414075, 144.96609379"
452220250704,45,2025-07-04,22,480,587,1067,Swa148_T,"-37.81414075, 144.96609379"
107520250827,107,2025-08-27,5,13,9,22,280Will_T,"-37.81246271, 144.95690188"
1341420240825,134,2024-08-25,14,461,599,1060,Spen201_T,"-37.81694221, 144.95303935"
61020250226,61,2025-02-26,0,114,25,139,RMIT14_T,"-37.80767455, 144.96309114"
612020231124,61,2023-11-24,20,177,276,453,RMIT14_T,"-37.80767455, 144.96309114"
61420240320,61,2024-03-20,4,4,8,12,RMIT14_T,"-37.80767455, 144.96309114"
50020231203,50,2023-12-03,0,23,8,31,Lyg309_T,"-37.79808192, 144.96721013"
501020250511,50,2025-05-11,10,185,193,378,Lyg309_T,"-37.79808192, 144.96721013"
50520250713,50,2025-07-13,5,5,1,6,Lyg309_T,"-37.79808192, 144.96721013"
1661420250218,166,2025-02-18,14,53,46,99,Spen484_T,"-37.80896733, 144.94931703"
1671420241013,167,2024-10-13,14,21,44,65,Lat526_T,"-37.81304149, 144.95155955"
143720250903,143,2025-09-03,7,99,154,253,Spencer_T,"-37.821728, 144.95557015"
1311420241208,131,2024-12-08,14,106,81,187,King2_T,"-37.82009057, 144.95758725"
17020251002,17,2025-10-02,0,4,7,11,Col15_T,"-37.81362543, 144.97323591"
632320250630,63,2025-06-30,23,1,9,10,Bou231_T,"-37.81333081, 144.96675571"
67820240406,67,2024-04-06,8,100,121,221,FLDegS_T,"-37.81688755, 144.96562569"
682020250608,68,2025-06-08,20,146,103,249,FLDegN_T,"-37.8168479, 144.96559789"
17220250618,17,2025-06-18,2,1,0,1,Col15_T,"-37.81362543, 144.97323591"
721920250905,72,2025-09-05,19,73,216,289,ACMI_T,"-37.81726338, 144.96872809"
10320240924,10,2024-09-24,3,1,0,1,BouHbr_T,"-37.81876474, 144.94710545"
2220240112,2,2024-01-12,2,3,8,11,Bou283_T,"-37.81380668, 144.96516718"
351820250415,35,2025-04-15,18,1520,1464,2984,SouthB_T,"-37.82018685, 144.96508508"
35620250519,35,2025-05-19,6,132,98,230,SouthB_T,"-37.82018685, 144.96508508"
351020231205,35,2023-12-05,10,668,593,1261,SouthB_T,"-37.82018685, 144.96508508"
271220250515,27,2025-05-15,12,167,138,305,Vic_T,"-37.80606888, 144.95644692"
79720240524,79,2024-05-24,7,182,121,303,FliSS_T,"-37.81794046, 144.96616678"
9320250130,9,2025-01-30,3,1,1,2,Col700_T,"-37.81982992, 144.95102555"
512320250307,51,2025-03-07,23,40,37,77,Fra118_T,"-37.80841815, 144.95906316"
461620250101,46,2025-01-01,16,25,22,47,Pel147_T,"-37.80240719, 144.9615673"
461120231218,46,2023-12-18,11,43,49,92,Pel147_T,"-37.80240719, 144.9615673"
20020240913,20,2024-09-13,0,40,67,107,LtB170_T,"-37.81172914, 144.9682466"
1392120250322,139,2025-03-22,21,36,31,67,Signal1647_T,"-37.81959923, 144.9632832"
139720250417,139,2025-04-17,7,21,150,171,Signal1647_T,"-37.81959923, 144.9632832"
136820240428,136,2024-04-28,8,51,71,122,BirFed1120_T,"-37.8184141, 144.97357915"
1171520240109,117,2024-01-09,15,145,208,353,Fli114F_T,"-37.81629332, 144.97090877"
491620231018,49,2023-10-18,16,182,152,334,Eli501_T,"-37.80730068, 144.95956055"
68120250328,68,2025-03-28,1,2,0,2,FLDegN_T,"-37.8168479, 144.96559789"
182020250525,18,2025-05-25,20,10,15,25,Col12_T,"-37.81344862, 144.97305353"
63520240721,63,2024-07-21,5,11,28,39,Bou231_T,"-37.81333081, 144.96675571"
68720251013,68,2025-10-13,7,65,52,117,FLDegN_T,"-37.8168479, 144.96559789"
621820240223,62,2024-02-23,18,357,236,593,Lat224_T,"-37.80996494, 144.96216521"
62920250226,62,2025-02-26,9,134,144,278,Lat224_T,"-37.80996494, 144.96216521"
621620250513,62,2025-05-13,16,250,151,401,Lat224_T,"-37.80996494, 144.96216521"
24720240515,24,2024-05-15,7,981,227,1208,Col620_T,"-37.81887963, 144.95449198"
72720240519,72,2024-05-19,7,30,28,58,ACMI_T,"-37.81726338, 144.96872809"
351320250211,35,2025-02-11,13,1188,1171,2359,SouthB_T,"-37.82018685, 144.96508508"
351520250501,35,2025-05-01,15,1013,929,1942,SouthB_T,"-37.82018685, 144.96508508"
11420240626,11,2024-06-26,4,0,1,1,WatCit_T,"-37.81564989, 144.93970694"
581120241026,58,2024-10-26,11,802,258,1060,Bou688_T,"-37.81686075, 144.95358075"
21220240206,2,2024-02-06,12,802,876,1678,Bou283_T,"-37.81380668, 144.96516718"
91520250428,9,2025-04-28,15,928,187,1115,Col700_T,"-37.81982992, 144.95102555"
23920241218,23,2024-12-18,9,332,210,542,Col623_T,"-37.81909256, 144.95452748"
23820240318,23,2024-03-18,8,751,329,1080,Col623_T,"-37.81909256, 144.95452748"
23020240515,23,2024-05-15,0,14,16,30,Col623_T,"-37.81909256, 144.95452748"
231620240526,23,2024-05-26,16,150,236,386,Col623_T,"-37.81909256, 144.95452748"
52020240803,52,2024-08-03,0,149,95,244,Eli263_T,"-37.81252157, 144.9619401"
521620251012,52,2025-10-12,16,329,345,674,Eli263_T,"-37.81252157, 144.9619401"
49020250822,49,2025-08-22,0,69,62,131,Eli501_T,"-37.80730068, 144.95956055"
481620250902,48,2025-09-02,16,124,140,264,QVMQ_T,"-37.80631581, 144.95866697"
25820240325,25,2024-03-25,8,285,355,640,MCEC_T,"-37.82401776, 144.95604426"
141120231124,141,2023-11-24,1,17,40,57,474Fl_T,"-37.81997273, 144.95834911"
1411220240305,141,2024-03-05,12,262,221,483,474Fl_T,"-37.81997273, 144.95834911"
139720240130,139,2024-01-30,7,26,126,152,Signal1647_T,"-37.81959923, 144.9632832"
1171120231025,117,2023-10-25,11,114,88,202,Fli114F_T,"-37.81629332, 144.97090877"
701520240629,70,2024-06-29,15,92,90,182,Errol20_T,"-37.80456984, 144.94946228"
39020250614,39,2025-06-14,0,2,3,5,AlfPl_T,"-37.81379749, 144.96995745"
3620241012,3,2024-10-12,6,21,29,50,Swa295_T,"-37.81101524, 144.96429485"
8620250101,8,2025-01-01,6,17,12,29,WebBN_T,"-37.82293543, 144.9471751"
8320241003,8,2024-10-03,3,2,1,3,WebBN_T,"-37.82293543, 144.9471751"
75720240119,75,2024-01-19,7,32,25,57,SprFli_T,"-37.81515276, 144.97467661"
39420250318,39,2025-03-18,4,1,0,1,AlfPl_T,"-37.81379749, 144.96995745"
41620250609,41,2025-06-09,6,70,54,124,Swa31,"-37.81668634, 144.96689733"
411220241212,41,2024-12-12,12,1727,1436,3163,Swa31,"-37.81668634, 144.96689733"
77120250518,77,2025-05-18,1,5,0,5,HarEsP_T,"-37.81441438, 144.94433026"
591420240415,59,2024-04-15,14,1564,1556,3120,RMIT_T,"-37.80825648, 144.96304859"
591120240620,59,2024-06-20,11,432,420,852,RMIT_T,"-37.80825648, 144.96304859"
71120240309,71,2024-03-09,1,13,9,22,WestWP_T,"-37.81235775, 144.97136962"
71720240924,71,2024-09-24,7,19,14,33,WestWP_T,"-37.81235775, 144.97136962"
711920231029,71,2023-10-29,19,5,9,14,WestWP_T,"-37.81235775, 144.97136962"
611920240510,61,2024-05-10,19,322,381,703,RMIT14_T,"-37.80767455, 144.96309114"
45520240831,45,2024-08-31,5,22,37,59,Swa148_T,"-37.81414075, 144.96609379"
140920240202,140,2024-02-02,9,126,53,179,Boyd2837_T,"-37.82590962, 144.96185972"
391520240920,39,2024-09-20,15,58,53,111,AlfPl_T,"-37.81379749, 144.96995745"
392120250407,39,2025-04-07,21,26,17,43,AlfPl_T,"-37.81379749, 144.96995745"
78520240410,78,2024-04-10,5,1,2,3,HarEsB_T,"-37.81471642, 144.9446508"
78920250527,78,2025-05-27,9,38,25,63,HarEsB_T,"-37.81471642, 144.9446508"
41420250127,41,2025-01-27,4,34,37,71,Swa31,"-37.81668634, 144.96689733"
77720250413,77,2025-04-13,7,54,55,109,HarEsP_T,"-37.81441438, 144.94433026"
781620251002,78,2025-10-02,16,27,131,158,HarEsB_T,"-37.81471642, 144.9446508"
14520240330,14,2024-03-30,5,27,21,48,SanBri_T,"-37.82011242, 144.96291897"
592220240401,59,2024-04-01,22,32,14,46,RMIT_T,"-37.80825648, 144.96304859"
28320231221,28,2023-12-21,3,3,22,25,VAC_T,"-37.82129925, 144.96879309"
29720240510,29,2024-05-10,7,82,90,172,AG_T,"-37.8199817, 144.96872865"
21820241103,21,2024-11-03,8,32,28,60,Bourke155_T,"-37.81267313, 144.96788288"
361720240423,36,2024-04-23,17,319,276,595,Que85_T,"-37.81652527, 144.96121062"
371720250611,37,2025-06-11,17,108,125,233,Lyg260_T,"-37.80107122, 144.96704554"
432120231112,43,2023-11-12,21,21,3,24,UM2_T,"-37.79844526, 144.96411782"
452220240611,45,2024-06-11,22,140,122,262,Swa148_T,"-37.81414075, 144.96609379"
441820250804,44,2025-08-04,18,77,81,158,UM3_T,"-37.79698741, 144.96441306"
452320250214,45,2025-02-14,23,149,300,449,Swa148_T,"-37.81414075, 144.96609379"
51320240618,5,2024-06-18,13,855,732,1587,PriNW_T,"-37.81874249, 144.96787656"
1182020250622,118,2025-06-22,20,6,8,14,Fli114C_T,"-37.81632783, 144.97090512"
1071420240629,107,2024-06-29,14,56,45,101,280Will_T,"-37.81246271, 144.95690188"
108620250611,108,2025-06-11,6,39,217,256,261Will_T,"-37.81295822, 144.95678789"
1182020231226,118,2023-12-26,20,28,4,32,Fli114C_T,"-37.81632783, 144.97090512"
871620241022,87,2024-10-22,16,92,99,191,Errol23_T,"-37.80454949, 144.94921863"
671320240118,67,2024-01-18,13,521,494,1015,FLDegS_T,"-37.81688755, 144.96562569"
62420250828,62,2025-08-28,4,11,12,23,Lat224_T,"-37.80996494, 144.96216521"
861020250205,86,2025-02-05,10,53,49,102,574Qub_T,"-37.80309992, 144.94908064"
67220250407,67,2025-04-07,2,2,8,10,FLDegS_T,"-37.81688755, 144.96562569"
622120250602,62,2025-06-02,21,110,139,249,Lat224_T,"-37.80996494, 144.96216521"
56320240906,56,2024-09-06,3,3,4,7,Lon364_T,"-37.81234775, 144.96153311"
22320240422,2,2024-04-22,23,5,15,20,Bou283_T,"-37.81380668, 144.96516718"
351320250227,35,2025-02-27,13,1087,1362,2449,SouthB_T,"-37.82018685, 144.96508508"
351520240504,35,2024-05-04,15,1257,1700,2957,SouthB_T,"-37.82018685, 144.96508508"
511620231025,51,2023-10-25,16,86,107,193,Fra118_T,"-37.80841815, 144.95906316"
191620240703,19,2024-07-03,16,525,408,933,LtB210_T,"-37.81237202, 144.96550671"
19220240308,19,2024-03-08,2,22,30,52,LtB210_T,"-37.81237202, 144.96550671"
482320240127,48,2024-01-27,23,65,70,135,QVMQ_T,"-37.80631581, 144.95866697"
521020250727,52,2025-07-27,10,141,101,242,Eli263_T,"-37.81252157, 144.9619401"
1401520240302,140,2024-03-02,15,97,85,182,Boyd2837_T,"-37.82590962, 144.96185972"
1321920250131,132,2025-01-31,19,157,149,306,King335_T,"-37.81267639, 144.95386444"
1321120250307,132,2025-03-07,11,164,86,250,King335_T,"-37.81267639, 144.95386444"
1082220250423,108,2025-04-23,22,136,84,220,261Will_T,"-37.81295822, 144.95678789"
1311220250804,131,2025-08-04,12,155,173,328,King2_T,"-37.82009057, 144.95758725"
132020240330,132,2024-03-30,0,46,49,95,King335_T,"-37.81267639, 144.95386444"
134820240630,134,2024-06-30,8,57,84,141,Spen201_T,"-37.81694221, 144.95303935"
1342320240904,134,2024-09-04,23,97,105,202,Spen201_T,"-37.81694221, 144.95303935"
135920240214,135,2024-02-14,9,330,389,719,Spen161_T,"-37.8172861, 144.95319102"
1351320240828,135,2024-08-28,13,318,359,677,Spen161_T,"-37.8172861, 144.95319102"
1071520241015,107,2024-10-15,15,120,113,233,280Will_T,"-37.81246271, 144.95690188"
87120250225,87,2025-02-25,1,2,2,4,Errol23_T,"-37.80454949, 144.94921863"
165620240927,165,2024-09-27,6,4,12,16,Spen475_T,"-37.80953359, 144.94939004"
681420231118,68,2023-11-18,14,258,127,385,FLDegN_T,"-37.8168479, 144.96559789"
851120241108,85,2024-11-08,11,121,87,208,488Mac_T,"-37.79432415, 144.92973378"
68420250129,68,2025-01-29,4,6,2,8,FLDegN_T,"-37.8168479, 144.96559789"
631220241227,63,2024-12-27,12,386,404,790,Bou231_T,"-37.81333081, 144.96675571"
861320231218,86,2023-12-18,13,65,47,112,574Qub_T,"-37.80309992, 144.94908064"
111620240727,11,2024-07-27,16,100,44,144,WatCit_T,"-37.81564989, 144.93970694"
56820231210,56,2023-12-10,8,61,56,117,Lon364_T,"-37.81234775, 144.96153311"
241120250414,24,2025-04-14,11,737,469,1206,Col620_T,"-37.81887963, 144.95449198"
24320250519,24,2025-05-19,3,25,17,42,Col620_T,"-37.81887963, 144.95449198"
582220240220,58,2024-02-20,22,156,161,317,Bou688_T,"-37.81686075, 144.95358075"
35220240913,35,2024-09-13,2,7,19,26,SouthB_T,"-37.82018685, 144.96508508"
2620250702,2,2025-07-02,6,15,23,38,Bou283_T,"-37.81380668, 144.96516718"
581320250919,58,2025-09-19,13,777,469,1246,Bou688_T,"-37.81686075, 144.95358075"
272120250503,27,2025-05-03,21,64,41,105,Vic_T,"-37.80606888, 144.95644692"
91420250912,9,2025-09-12,14,444,207,651,Col700_T,"-37.81982992, 144.95102555"
23920231219,23,2023-12-19,9,398,198,596,Col623_T,"-37.81909256, 144.95452748"
511420250519,51,2025-05-19,14,74,77,151,Fra118_T,"-37.80841815, 144.95906316"
51820250224,51,2025-02-24,8,60,51,111,Fra118_T,"-37.80841815, 144.95906316"
491420231107,49,2023-11-07,14,147,159,306,Eli501_T,"-37.80730068, 144.95956055"
20620240108,20,2024-01-08,6,6,17,23,LtB170_T,"-37.81172914, 144.9682466"
1411120250203,141,2025-02-03,11,115,88,203,474Fl_T,"-37.81997273, 144.95834911"
1422220250725,142,2025-07-25,22,7,2,9,Hammer1584_T,"-37.81970749, 144.96795734"
164220250831,164,2025-08-31,2,2,1,3,Lat526_T,"-37.813005, 144.95160411"
161020250504,161,2025-05-04,0,0,1,1,BirArt1109_T,"-37.81851276, 144.97131336"
134620240728,134,2024-07-28,6,29,8,37,Spen201_T,"-37.81694221, 144.95303935"
131920231205,131,2023-12-05,9,88,76,164,King2_T,"-37.82009057, 144.95758725"
135020250612,135,2025-06-12,0,14,27,41,Spen161_T,"-37.8172861, 144.95319102"
1352320241026,135,2024-10-26,23,203,126,329,Spen161_T,"-37.8172861, 144.95319102"
1332120240704,133,2024-07-04,21,252,213,465,Spen229_T,"-37.81531435, 144.95227769"
1821220250428,182,2025-04-28,12,323,257,580,King163_T,"-37.81627451, 144.95550503"
1841720250724,184,2025-07-24,17,1095,1224,2319,Eli124_T,"-37.81512416, 144.96371988"
66420251012,66,2025-10-12,4,34,19,53,QVN_T,"-37.81057846, 144.96444294"
691420250115,69,2025-01-15,14,295,379,674,FLDegC_T,"-37.81687226, 144.96559144"
91020250109,9,2025-01-09,10,139,425,564,Col700_T,"-37.81982992, 144.95102555"
302320250803,30,2025-08-03,23,118,142,260,Lon189_T,"-37.8112185, 144.96656806"
20020231225,20,2023-12-25,0,24,36,60,LtB170_T,"-37.81172914, 144.9682466"
521120240515,52,2024-05-15,11,284,198,482,Eli263_T,"-37.81252157, 144.9619401"
136520240813,136,2024-08-13,5,1,0,1,BirFed1120_T,"-37.8184141, 144.97357915"
1171120250421,117,2025-04-21,11,159,247,406,Fli114F_T,"-37.81629332, 144.97090877"
481420250613,48,2025-06-13,14,344,187,531,QVMQ_T,"-37.80631581, 144.95866697"
241920250331,24,2025-03-31,19,331,459,790,Col620_T,"-37.81887963, 144.95449198"
761420240809,76,2024-08-09,14,55,52,107,KenMac_T,"-37.79453803, 144.93036194"
21020250228,2,2025-02-28,10,295,399,694,Bou283_T,"-37.81380668, 144.96516718"
22220250323,2,2025-03-23,22,36,115,151,Bou283_T,"-37.81380668, 144.96516718"
91320240813,9,2024-08-13,13,665,560,1225,Col700_T,"-37.81982992, 144.95102555"
91220240909,9,2024-09-09,12,535,554,1089,Col700_T,"-37.81982992, 144.95102555"
30820240908,30,2024-09-08,8,39,63,102,Lon189_T,"-37.8112185, 144.96656806"
231820241027,23,2024-10-27,18,88,154,242,Col623_T,"-37.81909256, 144.95452748"
48620240718,48,2024-07-18,6,27,31,58,QVMQ_T,"-37.80631581, 144.95866697"
301920250617,30,2025-06-17,19,223,340,563,Lon189_T,"-37.8112185, 144.96656806"
20320250502,20,2025-05-02,3,21,20,41,LtB170_T,"-37.81172914, 144.9682466"
521620250625,52,2025-06-25,16,266,185,451,Eli263_T,"-37.81252157, 144.9619401"
137720240816,137,2024-08-16,7,28,6,34,BouHbr2353_T,"-37.81894815, 144.94612292"
1392120240603,139,2024-06-03,21,19,5,24,Signal1647_T,"-37.81959923, 144.9632832"
1391420241226,139,2024-12-26,14,63,31,94,Signal1647_T,"-37.81959923, 144.9632832"
1611220240703,161,2024-07-03,12,169,179,348,BirArt1109_T,"-37.81851276, 144.97131336"
117020250514,117,2025-05-14,0,24,8,32,Fli114F_T,"-37.81629332, 144.97090877"
1232120231213,123,2023-12-13,21,4,0,4,BirBridge_T,"-37.81753741, 144.97329734"
481620250707,48,2025-07-07,16,123,151,274,QVMQ_T,"-37.80631581, 144.95866697"
1092320250323,109,2025-03-23,23,27,41,68,LatWill_T,"-37.81193681, 144.95621105"
491920240103,49,2024-01-03,19,334,443,777,Eli501_T,"-37.80730068, 144.95956055"
491120251006,49,2025-10-06,11,195,281,476,Eli501_T,"-37.80730068, 144.95956055"
69720250228,69,2025-02-28,7,109,48,157,FLDegC_T,"-37.81687226, 144.96559144"
6020250315,6,2025-03-15,0,469,228,697,FliS_T,"-37.81911705, 144.96558255"
61220250720,6,2025-07-20,12,694,716,1410,FliS_T,"-37.81911705, 144.96558255"
70420250303,70,2025-03-03,4,1,1,2,Errol20_T,"-37.80456984, 144.94946228"
391220240107,39,2024-01-07,12,49,20,69,AlfPl_T,"-37.81379749, 144.96995745"
411120250209,41,2025-02-09,11,1931,1185,3116,Swa31,"-37.81668634, 144.96689733"
78520241130,78,2024-11-30,5,2,2,4,HarEsB_T,"-37.81471642, 144.9446508"
78320250613,78,2025-06-13,3,0,2,2,HarEsB_T,"-37.81471642, 144.9446508"
291220240124,29,2024-01-24,12,282,292,574,AG_T,"-37.8199817, 144.96872865"
28820250522,28,2025-05-22,8,595,319,914,VAC_T,"-37.82129925, 144.96879309"
462320241009,46,2024-10-09,23,3,0,3,Pel147_T,"-37.80240719, 144.9615673"
1371720241207,137,2024-12-07,17,13,13,26,BouHbr2353_T,"-37.81894815, 144.94612292"
137620250313,137,2025-03-13,6,2,1,3,BouHbr2353_T,"-37.81894815, 144.94612292"
1391220241119,139,2024-11-19,12,87,91,178,Signal1647_T,"-37.81959923, 144.9632832"
142020231125,142,2023-11-25,0,104,37,141,Hammer1584_T,"-37.81970749, 144.96795734"
1301420240517,130,2024-05-17,14,7,8,15,Bou892T,"-37.8204637, 144.94126826"
1301220241203,130,2024-12-03,12,58,77,135,Bou892T,"-37.8204637, 144.94126826"
1172120231106,117,2023-11-06,21,142,99,241,Fli114F_T,"-37.81629332, 144.97090877"
191920250720,19,2025-07-20,19,552,506,1058,LtB210_T,"-37.81237202, 144.96550671"
109620250203,109,2025-02-03,6,22,69,91,LatWill_T,"-37.81193681, 144.95621105"
1091920250217,109,2025-02-17,19,111,87,198,LatWill_T,"-37.81193681, 144.95621105"
50020250512,50,2025-05-12,0,8,2,10,Lyg309_T,"-37.79808192, 144.96721013"
1672120241016,167,2024-10-16,21,12,40,52,Lat526_T,"-37.81304149, 144.95155955"
1311120250418,131,2025-04-18,11,142,218,360,King2_T,"-37.82009057, 144.95758725"
1621720241117,162,2024-11-17,17,266,317,583,Eli489_T,"-37.80740397, 144.95987909"
1351520240320,135,2024-03-20,15,586,454,1040,Spen161_T,"-37.8172861, 144.95319102"
1351220240604,135,2024-06-04,12,398,405,803,Spen161_T,"-37.8172861, 144.95319102"
171620240417,17,2024-04-17,16,237,507,744,Col15_T,"-37.81362543, 144.97323591"
62420241208,62,2024-12-08,4,23,24,47,Lat224_T,"-37.80996494, 144.96216521"
562020231031,56,2023-10-31,20,249,139,388,Lon364_T,"-37.81234775, 144.96153311"
86420240617,86,2024-06-17,4,1,0,1,574Qub_T,"-37.80309992, 144.94908064"
122120240203,12,2024-02-03,21,327,294,621,NewQ_T,"-37.81457988, 144.94292398"
561920250829,56,2025-08-29,19,427,492,919,Lon364_T,"-37.81234775, 144.96153311"
242220240524,24,2024-05-24,22,1045,546,1591,Col620_T,"-37.81887963, 144.95449198"
241620240812,24,2024-08-12,16,461,1693,2154,Col620_T,"-37.81887963, 144.95449198"
721220250309,72,2025-03-09,12,251,361,612,ACMI_T,"-37.81726338, 144.96872809"
581920241216,58,2024-12-16,19,257,232,489,Bou688_T,"-37.81686075, 144.95358075"
58920240329,58,2024-03-29,9,327,146,473,Bou688_T,"-37.81686075, 144.95358075"
76820240726,76,2024-07-26,8,101,58,159,KenMac_T,"-37.79453803, 144.93036194"
53320240626,53,2024-06-26,3,4,5,9,Col254_T,"-37.81564191, 144.965499"
53620250517,53,2025-05-17,6,4,11,15,Col254_T,"-37.81564191, 144.965499"
30020250223,30,2025-02-23,0,53,119,172,Lon189_T,"-37.8112185, 144.96656806"
30920250523,30,2025-05-23,9,110,143,253,Lon189_T,"-37.8112185, 144.96656806"
30820240519,30,2024-05-19,8,32,89,121,Lon189_T,"-37.8112185, 144.96656806"
23020240626,23,2024-06-26,0,24,14,38,Col623_T,"-37.81909256, 144.95452748"
23020250610,23,2025-06-10,0,5,18,23,Col623_T,"-37.81909256, 144.95452748"
48320240406,48,2024-04-06,3,4,19,23,QVMQ_T,"-37.80631581, 144.95866697"
522120240705,52,2024-07-05,21,384,242,626,Eli263_T,"-37.81252157, 144.9619401"
141220231214,141,2023-12-14,2,10,10,20,474Fl_T,"-37.81997273, 144.95834911"
141120250823,141,2025-08-23,1,89,73,162,474Fl_T,"-37.81997273, 144.95834911"
139220250810,139,2025-08-10,2,5,2,7,Signal1647_T,"-37.81959923, 144.9632832"
1421920250101,142,2025-01-01,19,581,475,1056,Hammer1584_T,"-37.81970749, 144.96795734"
1421820250419,142,2025-04-19,18,275,219,494,Hammer1584_T,"-37.81970749, 144.96795734"
1421620250528,142,2025-05-28,16,155,135,290,Hammer1584_T,"-37.81970749, 144.96795734"
1361420250315,136,2025-03-15,14,44,30,74,BirFed1120_T,"-37.8184141, 144.97357915"
142220240722,142,2024-07-22,2,2,1,3,Hammer1584_T,"-37.81970749, 144.96795734"
1231620240424,123,2024-04-24,16,20,8,28,BirBridge_T,"-37.81753741, 144.97329734"
138220250101,138,2025-01-01,2,5,1,6,EntPark1671_T,"-37.81996544, 144.95981454"
492120240422,49,2024-04-22,21,183,115,298,Eli501_T,"-37.80730068, 144.95956055"
311320241106,31,2024-11-06,13,156,121,277,Lyg161_T,"-37.80169681, 144.96658911"
36120240318,36,2024-03-18,1,15,11,26,Que85_T,"-37.81652527, 144.96121062"
611020250811,61,2025-08-11,10,343,487,830,RMIT14_T,"-37.80767455, 144.96309114"
611520240811,61,2024-08-11,15,983,854,1837,RMIT14_T,"-37.80767455, 144.96309114"
451620240512,45,2024-05-12,16,605,1029,1634,Swa148_T,"-37.81414075, 144.96609379"
452320241025,45,2024-10-25,23,243,356,599,Swa148_T,"-37.81414075, 144.96609379"
1621620241220,162,2024-12-20,16,232,285,517,Eli489_T,"-37.80740397, 144.95987909"
184620250821,184,2025-08-21,6,47,70,117,Eli124_T,"-37.81512416, 144.96371988"
131520250616,131,2025-06-16,5,4,7,11,King2_T,"-37.82009057, 144.95758725"
1312120240627,131,2024-06-27,21,43,53,96,King2_T,"-37.82009057, 144.95758725"
1401420240430,140,2024-04-30,14,79,81,160,Boyd2837_T,"-37.82590962, 144.96185972"
1072220241002,107,2024-10-02,22,48,57,105,280Will_T,"-37.81246271, 144.95690188"
133420250720,133,2025-07-20,4,17,25,42,Spen229_T,"-37.81531435, 144.95227769"
1331520240226,133,2024-02-26,15,570,729,1299,Spen229_T,"-37.81531435, 144.95227769"
1181220250513,118,2025-05-13,12,19,17,36,Fli114C_T,"-37.81632783, 144.97090512"
1082020231105,108,2023-11-05,20,103,105,208,261Will_T,"-37.81295822, 144.95678789"
166520241108,166,2024-11-08,5,1,1,2,Spen484_T,"-37.80896733, 144.94931703"
11320250501,1,2025-05-01,13,1303,1288,2591,Bou292_T,"-37.81349441, 144.96515323"
56820240731,56,2024-07-31,8,129,149,278,Lon364_T,"-37.81234775, 144.96153311"
561020250227,56,2025-02-27,10,270,180,450,Lon364_T,"-37.81234775, 144.96153311"
86920250823,86,2025-08-23,9,61,25,86,574Qub_T,"-37.80309992, 144.94908064"
662120250325,66,2025-03-25,21,718,558,1276,QVN_T,"-37.81057846, 144.96444294"
692320231025,69,2023-10-25,23,3,1,4,FLDegC_T,"-37.81687226, 144.96559144"
691420231030,69,2023-10-30,14,173,168,341,FLDegC_T,"-37.81687226, 144.96559144"
6120251003,6,2025-10-03,1,18,24,42,FliS_T,"-37.81911705, 144.96558255"
4420241122,4,2024-11-22,4,16,17,33,Swa123_T,"-37.81487988, 144.9660878"
411620241107,41,2024-11-07,16,1268,1551,2819,Swa31,"-37.81668634, 144.96689733"
412220250117,41,2025-01-17,22,1112,1196,2308,Swa31,"-37.81668634, 144.96689733"
41120240121,41,2024-01-21,1,313,457,770,Swa31,"-37.81668634, 144.96689733"
781420241206,78,2024-12-06,14,32,52,84,HarEsB_T,"-37.81471642, 144.9446508"
71820250902,71,2025-09-02,8,15,12,27,WestWP_T,"-37.81235775, 144.97136962"
541220240409,54,2024-04-09,12,260,302,562,Swa607_T,"-37.804024, 144.96308399"
28720240207,28,2024-02-07,7,498,348,846,VAC_T,"-37.82129925, 144.96879309"
282220250811,28,2025-08-11,22,108,68,176,VAC_T,"-37.82129925, 144.96879309"
401520250107,40,2025-01-07,15,149,138,287,Spr201_T,"-37.80999341, 144.97227587"
401420241226,40,2024-12-26,14,58,57,115,Spr201_T,"-37.80999341, 144.97227587"
311520250817,31,2025-08-17,15,287,267,554,Lyg161_T,"-37.80169681, 144.96658911"
372220240107,37,2024-01-07,22,112,131,243,Lyg260_T,"-37.80107122, 144.96704554"
37720240416,37,2024-04-16,7,19,32,51,Lyg260_T,"-37.80107122, 144.96704554"
50620240309,50,2024-03-09,6,3,7,10,Lyg309_T,"-37.79808192, 144.96721013"
21020241231,21,2024-12-31,0,52,68,120,Bourke155_T,"-37.81267313, 144.96788288"
1311320251002,131,2025-10-02,13,200,204,404,King2_T,"-37.82009057, 144.95758725"
41020241115,4,2024-11-15,10,1262,611,1873,Swa123_T,"-37.81487988, 144.9660878"
701920250604,70,2025-06-04,19,90,203,293,Errol20_T,"-37.80456984, 144.94946228"
3120231119,3,2023-11-19,1,260,332,592,Swa295_T,"-37.81101524, 144.96429485"
39920240806,39,2024-08-06,9,95,98,193,AlfPl_T,"-37.81379749, 144.96995745"
752120240621,75,2024-06-21,21,30,27,57,SprFli_T,"-37.81515276, 144.97467661"
751120241109,75,2024-11-09,11,42,31,73,SprFli_T,"-37.81515276, 144.97467661"
77720240221,77,2024-02-21,7,150,351,501,HarEsP_T,"-37.81441438, 144.94433026"
711720240717,71,2024-07-17,17,20,24,44,WestWP_T,"-37.81235775, 144.97136962"
591520250313,59,2025-03-13,15,788,1091,1879,RMIT_T,"-37.80825648, 144.96304859"
591320250808,59,2025-08-08,13,1321,1080,2401,RMIT_T,"-37.80825648, 144.96304859"
591020240531,59,2024-05-31,10,850,488,1338,RMIT_T,"-37.80825648, 144.96304859"
291320240918,29,2024-09-18,13,375,449,824,AG_T,"-37.8199817, 144.96872865"
141620250506,14,2025-05-06,16,755,150,905,SanBri_T,"-37.82011242, 144.96291897"
14220250111,14,2025-01-11,2,47,12,59,SanBri_T,"-37.82011242, 144.96291897"
311220250114,31,2025-01-14,12,129,116,245,Lyg161_T,"-37.80169681, 144.96658911"
54920241203,54,2024-12-03,9,53,38,91,Swa607_T,"-37.804024, 144.96308399"
54720240404,54,2024-04-04,7,32,26,58,Swa607_T,"-37.804024, 144.96308399"
542220231226,54,2023-12-26,22,39,40,79,Swa607_T,"-37.804024, 144.96308399"
471620250723,47,2025-07-23,16,1104,782,1886,Eli250_T,"-37.81258467, 144.9625775"
40720231217,40,2023-12-17,7,10,30,40,Spr201_T,"-37.80999341, 144.97227587"
36720250512,36,2025-05-12,7,86,36,122,Que85_T,"-37.81652527, 144.96121062"
361020231024,36,2023-10-24,10,176,171,347,Que85_T,"-37.81652527, 144.96121062"
442120240411,44,2024-04-11,21,35,51,86,UM3_T,"-37.79698741, 144.96441306"
44420240722,44,2024-07-22,4,0,1,1,UM3_T,"-37.79698741, 144.96441306"
51320250917,5,2025-09-17,13,1204,1131,2335,PriNW_T,"-37.81874249, 144.96787656"
51720250319,5,2025-03-19,17,1452,1282,2734,PriNW_T,"-37.81874249, 144.96787656"
5920240801,5,2024-08-01,9,303,711,1014,PriNW_T,"-37.81874249, 144.96787656"
1341420241212,134,2024-12-12,14,370,296,666,Spen201_T,"-37.81694221, 144.95303935"
1241720250424,124,2025-04-24,17,5,12,17,BirBridge_T,"-37.81757416, 144.97329934"
1181520241204,118,2024-12-04,15,13,23,36,Fli114C_T,"-37.81632783, 144.97090512"
108520250421,108,2025-04-21,5,17,10,27,261Will_T,"-37.81295822, 144.95678789"
50520250101,50,2025-01-01,5,7,2,9,Lyg309_T,"-37.79808192, 144.96721013"
1321420240802,132,2024-08-02,14,166,173,339,King335_T,"-37.81267639, 144.95386444"
1352120241212,135,2024-12-12,21,236,195,431,Spen161_T,"-37.8172861, 144.95319102"
1351020250611,135,2025-06-11,10,235,318,553,Spen161_T,"-37.8172861, 144.95319102"
17320241015,17,2024-10-15,3,2,3,5,Col15_T,"-37.81362543, 144.97323591"
1520240828,1,2024-08-28,5,2,7,9,Bou292_T,"-37.81349441, 144.96515323"
18720250916,18,2025-09-16,7,57,388,445,Col12_T,"-37.81344862, 144.97305353"
181820240807,18,2024-08-07,18,0,1,1,Col12_T,"-37.81344862, 144.97305353"
86520241119,86,2024-11-19,5,4,3,7,574Qub_T,"-37.80309992, 144.94908064"
62720231107,62,2023-11-07,7,36,22,58,Lat224_T,"-37.80996494, 144.96216521"
621720250420,62,2025-04-20,17,315,215,530,Lat224_T,"-37.80996494, 144.96216521"
861020250525,86,2025-05-25,10,54,41,95,574Qub_T,"-37.80309992, 144.94908064"
68520241121,68,2024-11-21,5,1,0,1,FLDegN_T,"-37.8168479, 144.96559789"
581220240826,58,2024-08-26,12,678,382,1060,Bou688_T,"-37.81686075, 144.95358075"
76520241222,76,2024-12-22,5,4,1,5,KenMac_T,"-37.79453803, 144.93036194"
761020250206,76,2025-02-06,10,48,32,80,KenMac_T,"-37.79453803, 144.93036194"
842020240520,84,2024-05-20,20,464,623,1087,ElFi_T,"-37.81798049, 144.96503383"
41020240410,4,2024-04-10,10,1325,697,2022,Swa123_T,"-37.81487988, 144.9660878"
3420240223,3,2024-02-23,4,46,30,76,Swa295_T,"-37.81101524, 144.96429485"
81620250815,8,2025-08-15,16,166,295,461,WebBN_T,"-37.82293543, 144.9471751"
81520240126,8,2024-01-26,15,157,212,369,WebBN_T,"-37.82293543, 144.9471751"
411520240221,41,2024-02-21,15,1490,1638,3128,Swa31,"-37.81668634, 144.96689733"
77920240510,77,2024-05-10,9,108,101,209,HarEsP_T,"-37.81441438, 144.94433026"
291120241014,29,2024-10-14,11,130,245,375,AG_T,"-37.8199817, 144.96872865"
14220240423,14,2024-04-23,2,10,3,13,SanBri_T,"-37.82011242, 144.96291897"
711020250224,71,2025-02-24,10,25,21,46,WestWP_T,"-37.81235775, 144.97136962"
282120250915,28,2025-09-15,21,949,118,1067,VAC_T,"-37.82129925, 144.96879309"
31120240304,31,2024-03-04,1,10,4,14,Lyg161_T,"-37.80169681, 144.96658911"
36420250518,36,2025-05-18,4,10,17,27,Que85_T,"-37.81652527, 144.96121062"
371420241209,37,2024-12-09,14,105,118,223,Lyg260_T,"-37.80107122, 144.96704554"
37420250110,37,2025-01-10,4,1,7,8,Lyg260_T,"-37.80107122, 144.96704554"
61120240308,61,2024-03-08,1,26,16,42,RMIT14_T,"-37.80767455, 144.96309114"
431520241213,43,2024-12-13,15,92,99,191,UM2_T,"-37.79844526, 144.96411782"
52220241208,5,2024-12-08,22,1734,821,2555,PriNW_T,"-37.81874249, 144.96787656"
21120240129,21,2024-01-29,1,60,80,140,Bourke155_T,"-37.81267313, 144.96788288"
1431720250531,143,2025-05-31,17,384,231,615,Spencer_T,"-37.821728, 144.95557015"
1431120250814,143,2025-08-14,11,107,216,323,Spencer_T,"-37.821728, 144.95557015"
1401120250611,140,2025-06-11,11,71,28,99,Boyd2837_T,"-37.82590962, 144.96185972"
85520250412,85,2025-04-12,5,2,0,2,488Mac_T,"-37.79432415, 144.92973378"
171520250317,17,2025-03-17,15,325,460,785,Col15_T,"-37.81362543, 144.97323591"
18020241113,18,2024-11-13,0,0,1,1,Col12_T,"-37.81344862, 144.97305353"
63320231223,63,2023-12-23,3,33,134,167,Bou231_T,"-37.81333081, 144.96675571"
63720240724,63,2024-07-24,7,86,93,179,Bou231_T,"-37.81333081, 144.96675571"
68020250722,68,2025-07-22,0,0,1,1,FLDegN_T,"-37.8168479, 144.96559789"
12120250330,1,2025-03-30,21,156,180,336,Bou292_T,"-37.81349441, 144.96515323"
11620250715,1,2025-07-15,16,1321,1209,2530,Bou292_T,"-37.81349441, 144.96515323"
86820231020,86,2023-10-20,8,42,31,73,574Qub_T,"-37.80309992, 144.94908064"
111820240330,11,2024-03-30,18,219,228,447,WatCit_T,"-37.81564989, 144.93970694"
622120231028,62,2023-10-28,21,10,3,13,Lat224_T,"-37.80996494, 144.96216521"
561320240309,56,2024-03-09,13,309,331,640,Lon364_T,"-37.81234775, 144.96153311"
101620240104,10,2024-01-04,16,120,51,171,BouHbr_T,"-37.81876474, 144.94710545"
722120250304,72,2025-03-04,21,65,104,169,ACMI_T,"-37.81726338, 144.96872809"
22120250409,2,2025-04-09,21,45,215,260,Bou283_T,"-37.81380668, 144.96516718"
21820231220,2,2023-12-20,18,1100,844,1944,Bou283_T,"-37.81380668, 144.96516718"
27420250423,27,2025-04-23,4,4,2,6,Vic_T,"-37.80606888, 144.95644692"
511620240814,51,2024-08-14,16,77,123,200,Fra118_T,"-37.80841815, 144.95906316"
52520240918,52,2024-09-18,5,7,7,14,Eli263_T,"-37.81252157, 144.9619401"
521620240408,52,2024-04-08,16,351,228,579,Eli263_T,"-37.81252157, 144.9619401"
512220250603,51,2025-06-03,22,30,17,47,Fra118_T,"-37.80841815, 144.95906316"
201920250608,20,2025-06-08,19,700,792,1492,LtB170_T,"-37.81172914, 144.9682466"
1801020250723,180,2025-07-23,10,47,21,68,Mac330_T,"-37.79497059, 144.93530329"
141820250813,141,2025-08-13,8,109,139,248,474Fl_T,"-37.81997273, 144.95834911"
139520240510,139,2024-05-10,5,0,1,1,Signal1647_T,"-37.81959923, 144.9632832"
2320250220,2,2025-02-20,3,2,10,12,Bou283_T,"-37.81380668, 144.96516718"
531120241219,53,2024-12-19,11,964,665,1629,Col254_T,"-37.81564191, 144.965499"
271920250820,27,2025-08-20,19,280,197,477,Vic_T,"-37.80606888, 144.95644692"
79620240719,79,2024-07-19,6,107,53,160,FliSS_T,"-37.81794046, 144.96616678"
512120250413,51,2025-04-13,21,46,78,124,Fra118_T,"-37.80841815, 144.95906316"
231920240224,23,2024-02-24,19,120,189,309,Col623_T,"-37.81909256, 144.95452748"
20420250514,20,2025-05-14,4,5,5,10,LtB170_T,"-37.81172914, 144.9682466"
20820240605,20,2024-06-05,8,62,48,110,LtB170_T,"-37.81172914, 144.9682466"
25520240310,25,2024-03-10,5,10,18,28,MCEC_T,"-37.82401776, 144.95604426"
25120240629,25,2024-06-29,1,37,18,55,MCEC_T,"-37.82401776, 144.95604426"
522220250930,52,2025-09-30,22,63,79,142,Eli263_T,"-37.81252157, 144.9619401"
46120241119,46,2024-11-19,1,1,0,1,Pel147_T,"-37.80240719, 144.9615673"
1412320240324,141,2024-03-24,23,48,60,108,474Fl_T,"-37.81997273, 144.95834911"
1411520240619,141,2024-06-19,15,146,100,246,474Fl_T,"-37.81997273, 144.95834911"
1411120250401,141,2025-04-01,11,120,91,211,474Fl_T,"-37.81997273, 144.95834911"
1391320250601,139,2025-06-01,13,36,48,84,Signal1647_T,"-37.81959923, 144.9632832"
139120250816,139,2025-08-16,1,6,2,8,Signal1647_T,"-37.81959923, 144.9632832"
1362120240530,136,2024-05-30,21,1,1,2,BirFed1120_T,"-37.8184141, 144.97357915"
109120250407,109,2025-04-07,1,13,13,26,LatWill_T,"-37.81193681, 144.95621105"
841720240412,84,2024-04-12,17,1319,1915,3234,ElFi_T,"-37.81798049, 144.96503383"
4420240330,4,2024-03-30,4,48,34,82,Swa123_T,"-37.81487988, 144.9660878"
4320250524,4,2025-05-24,3,33,70,103,Swa123_T,"-37.81487988, 144.9660878"
701320231214,70,2023-12-14,13,171,166,337,Errol20_T,"-37.80456984, 144.94946228"
39120250123,39,2025-01-23,1,0,1,1,AlfPl_T,"-37.81379749, 144.96995745"
71520240723,71,2024-07-23,5,23,16,39,WestWP_T,"-37.81235775, 144.97136962"
59520240330,59,2024-03-30,5,17,20,37,RMIT_T,"-37.80825648, 144.96304859"
311720240521,31,2024-05-21,17,167,122,289,Lyg161_T,"-37.80169681, 144.96658911"
28120250617,28,2025-06-17,1,14,4,18,VAC_T,"-37.82129925, 144.96879309"
312020231206,31,2023-12-06,20,178,149,327,Lyg161_T,"-37.80169681, 144.96658911"
372320240703,37,2024-07-03,23,17,18,35,Lyg260_T,"-37.80107122, 144.96704554"
442320241209,44,2024-12-09,23,21,1,22,UM3_T,"-37.79698741, 144.96441306"
45120250327,45,2025-03-27,1,9,40,49,Swa148_T,"-37.81414075, 144.96609379"
51520240928,5,2024-09-28,15,977,1003,1980,PriNW_T,"-37.81874249, 144.96787656"
134020240714,134,2024-07-14,0,47,56,103,Spen201_T,"-37.81694221, 144.95303935"
124720250601,124,2025-06-01,7,0,1,1,BirBridge_T,"-37.81757416, 144.97329934"
107920231212,107,2023-12-12,9,73,167,240,280Will_T,"-37.81246271, 144.95690188"
1182020240321,118,2024-03-21,20,11,20,31,Fli114C_T,"-37.81632783, 144.97090512"
61120240504,61,2024-05-04,1,39,21,60,RMIT14_T,"-37.80767455, 144.96309114"
61420240723,61,2024-07-23,4,4,14,18,RMIT14_T,"-37.80767455, 144.96309114"
1822120250423,182,2025-04-23,21,182,161,343,King163_T,"-37.81627451, 144.95550503"
1841820250803,184,2025-08-03,18,459,696,1155,Eli124_T,"-37.81512416, 144.96371988"
131420250919,131,2025-09-19,4,7,9,16,King2_T,"-37.82009057, 144.95758725"
162520250325,162,2025-03-25,5,25,2,27,Eli489_T,"-37.80740397, 144.95987909"
681320231207,68,2023-12-07,13,372,252,624,FLDegN_T,"-37.8168479, 144.96559789"
851620250410,85,2025-04-10,16,86,108,194,488Mac_T,"-37.79432415, 144.92973378"
112320241214,11,2024-12-14,23,35,37,72,WatCit_T,"-37.81564989, 144.93970694"
11720250326,11,2025-03-26,7,71,54,125,WatCit_T,"-37.81564989, 144.93970694"
671820250217,67,2025-02-17,18,244,421,665,FLDegS_T,"-37.81688755, 144.96562569"
561220231130,56,2023-11-30,12,364,259,623,Lon364_T,"-37.81234775, 144.96153311"
56120250111,56,2025-01-11,1,59,117,176,Lon364_T,"-37.81234775, 144.96153311"
561220250302,56,2025-03-02,12,364,273,637,Lon364_T,"-37.81234775, 144.96153311"
24220250706,24,2025-07-06,2,70,85,155,Col620_T,"-37.81887963, 144.95449198"
351420250419,35,2025-04-19,14,1311,1675,2986,SouthB_T,"-37.82018685, 144.96508508"
582220241210,58,2024-12-10,22,177,175,352,Bou688_T,"-37.81686075, 144.95358075"
2020240608,2,2024-06-08,0,50,53,103,Bou283_T,"-37.81380668, 144.96516718"
27020240115,27,2024-01-15,0,28,5,33,Vic_T,"-37.80606888, 144.95644692"
531020250406,53,2025-04-06,10,515,275,790,Col254_T,"-37.81564191, 144.965499"
791920250717,79,2025-07-17,19,228,281,509,FliSS_T,"-37.81794046, 144.96616678"
511320241212,51,2024-12-12,13,123,89,212,Fra118_T,"-37.80841815, 144.95906316"
51320240619,51,2024-06-19,3,2,3,5,Fra118_T,"-37.80841815, 144.95906316"
20620250426,20,2025-04-26,6,9,7,16,LtB170_T,"-37.81172914, 144.9682466"
302120250922,30,2025-09-22,21,119,192,311,Lon189_T,"-37.8112185, 144.96656806"
252320240713,25,2024-07-13,23,174,146,320,MCEC_T,"-37.82401776, 144.95604426"
137220250509,137,2025-05-09,2,0,1,1,BouHbr2353_T,"-37.81894815, 144.94612292"
139420240718,139,2024-07-18,4,1,1,2,Signal1647_T,"-37.81959923, 144.9632832"
123920241225,123,2024-12-25,9,32,23,55,BirBridge_T,"-37.81753741, 144.97329734"
117620240422,117,2024-04-22,6,37,15,52,Fli114F_T,"-37.81629332, 144.97090877"
492320231128,49,2023-11-28,23,59,43,102,Eli501_T,"-37.80730068, 144.95956055"
109620240516,109,2024-05-16,6,24,97,121,LatWill_T,"-37.81193681, 144.95621105"
109120240718,109,2024-07-18,1,6,11,17,LatWill_T,"-37.81193681, 144.95621105"
1091820250131,109,2025-01-31,18,177,79,256,LatWill_T,"-37.81193681, 144.95621105"
1802020250817,180,2025-08-17,20,0,2,2,Mac330_T,"-37.79497059, 144.93530329"
6420240406,6,2024-04-06,4,76,60,136,FliS_T,"-37.81911705, 144.96558255"
842320240208,84,2024-02-08,23,288,347,635,ElFi_T,"-37.81798049, 144.96503383"
841620250816,84,2025-08-16,16,1020,1380,2400,ElFi_T,"-37.81798049, 144.96503383"
4820250831,4,2025-08-31,8,179,132,311,Swa123_T,"-37.81487988, 144.9660878"
701820240130,70,2024-01-30,18,145,186,331,Errol20_T,"-37.80456984, 144.94946228"
391720250827,39,2025-08-27,17,158,62,220,AlfPl_T,"-37.81379749, 144.96995745"
412320250701,41,2025-07-01,23,118,193,311,Swa31,"-37.81668634, 144.96689733"
711520240518,71,2024-05-18,15,16,18,34,WestWP_T,"-37.81235775, 144.97136962"
291920240610,29,2024-06-10,19,61,193,254,AG_T,"-37.8199817, 144.96872865"
542020240223,54,2024-02-23,20,144,148,292,Swa607_T,"-37.804024, 144.96308399"
371420240806,37,2024-08-06,14,113,133,246,Lyg260_T,"-37.80107122, 144.96704554"
37820241221,37,2024-12-21,8,21,13,34,Lyg260_T,"-37.80107122, 144.96704554"
371720240223,37,2024-02-23,17,111,124,235,Lyg260_T,"-37.80107122, 144.96704554"
451120250128,45,2025-01-28,11,346,432,778,Swa148_T,"-37.81414075, 144.96609379"
45020231119,45,2023-11-19,0,142,297,439,Swa148_T,"-37.81414075, 144.96609379"
51020251011,5,2025-10-11,10,743,579,1322,PriNW_T,"-37.81874249, 144.96787656"
5920240507,5,2024-05-07,9,308,636,944,PriNW_T,"-37.81874249, 144.96787656"
1081920241005,108,2024-10-05,19,51,103,154,261Will_T,"-37.81295822, 144.95678789"
1351620240414,135,2024-04-14,16,427,377,804,Spen161_T,"-37.8172861, 144.95319102"
1352320240525,135,2024-05-25,23,89,106,195,Spen161_T,"-37.8172861, 144.95319102"
1331720240721,133,2024-07-21,17,447,428,875,Spen229_T,"-37.81531435, 144.95227769"
118820240608,118,2024-06-08,8,7,8,15,Fli114C_T,"-37.81632783, 144.97090512"
871820250506,87,2025-05-06,18,102,82,184,Errol23_T,"-37.80454949, 144.94921863"
70520250527,70,2025-05-27,5,3,0,3,Errol20_T,"-37.80456984, 144.94946228"
672020241102,67,2024-11-02,20,288,516,804,FLDegS_T,"-37.81688755, 144.96562569"
671420240712,67,2024-07-12,14,506,832,1338,FLDegS_T,"-37.81688755, 144.96562569"
631920250125,63,2025-01-25,19,397,546,943,Bou231_T,"-37.81333081, 144.96675571"
682320250602,68,2025-06-02,23,7,1,8,FLDegN_T,"-37.8168479, 144.96559789"
861820250911,86,2025-09-11,18,56,64,120,574Qub_T,"-37.80309992, 144.94908064"
671620250119,67,2025-01-19,16,291,426,717,FLDegS_T,"-37.81688755, 144.96562569"
62920231031,62,2023-10-31,9,111,127,238,Lat224_T,"-37.80996494, 144.96216521"
621720240315,62,2024-03-15,17,372,248,620,Lat224_T,"-37.80996494, 144.96216521"
10120240718,10,2024-07-18,1,0,1,1,BouHbr_T,"-37.81876474, 144.94710545"
101420250801,10,2025-08-01,14,66,63,129,BouHbr_T,"-37.81876474, 144.94710545"
102220250506,10,2025-05-06,22,10,7,17,BouHbr_T,"-37.81876474, 144.94710545"
76220240201,76,2024-02-01,2,0,1,1,KenMac_T,"-37.79453803, 144.93036194"
272020250122,27,2025-01-22,20,200,154,354,Vic_T,"-37.80606888, 144.95644692"
21520250127,2,2025-01-27,15,289,277,566,Bou283_T,"-37.81380668, 144.96516718"
301420240618,30,2024-06-18,14,228,347,575,Lon189_T,"-37.8112185, 144.96656806"
301120240902,30,2024-09-02,11,120,143,263,Lon189_T,"-37.8112185, 144.96656806"
30720241008,30,2024-10-08,7,39,66,105,Lon189_T,"-37.8112185, 144.96656806"
791020240912,79,2024-09-12,10,357,300,657,FliSS_T,"-37.81794046, 144.96616678"
232220241206,23,2024-12-06,22,88,174,262,Col623_T,"-37.81909256, 144.95452748"
251720240915,25,2024-09-15,17,993,329,1322,MCEC_T,"-37.82401776, 144.95604426"
46320240717,46,2024-07-17,3,1,6,7,Pel147_T,"-37.80240719, 144.9615673"
202020241206,20,2024-12-06,20,312,523,835,LtB170_T,"-37.81172914, 144.9682466"
141120240131,141,2024-01-31,1,9,15,24,474Fl_T,"-37.81997273, 144.95834911"
1362320240118,136,2024-01-18,23,20,57,77,BirFed1120_T,"-37.8184141, 144.97357915"
1171220250516,117,2025-05-16,12,190,238,428,Fli114F_T,"-37.81629332, 144.97090877"
1231520241106,123,2024-11-06,15,5,1,6,BirBridge_T,"-37.81753741, 144.97329734"
1091520231126,109,2023-11-26,15,116,152,268,LatWill_T,"-37.81193681, 144.95621105"
1091320240114,109,2024-01-14,13,83,55,138,LatWill_T,"-37.81193681, 144.95621105"
19320231222,19,2023-12-22,3,29,38,67,LtB210_T,"-37.81237202, 144.96550671"
662320240710,66,2024-07-10,23,185,127,312,QVN_T,"-37.81057846, 144.96444294"
662020250713,66,2025-07-13,20,605,563,1168,QVN_T,"-37.81057846, 144.96444294"
691520250810,69,2025-08-10,15,248,300,548,FLDegC_T,"-37.81687226, 144.96559144"
661720231030,66,2023-10-30,17,983,935,1918,QVN_T,"-37.81057846, 144.96444294"
61020250717,6,2025-07-17,10,529,428,957,FliS_T,"-37.81911705, 144.96558255"
42120250726,42,2025-07-26,1,3,3,6,UM1_T,"-37.80008566, 144.96386412"
422320240701,42,2024-07-01,23,8,8,16,UM1_T,"-37.80008566, 144.96386412"
422020240707,42,2024-07-07,20,22,26,48,UM1_T,"-37.80008566, 144.96386412"
29120241020,29,2024-10-20,1,19,54,73,AG_T,"-37.8199817, 144.96872865"
291820240328,29,2024-03-28,18,461,1752,2213,AG_T,"-37.8199817, 144.96872865"
142220240623,14,2024-06-23,22,170,48,218,SanBri_T,"-37.82011242, 144.96291897"
591620250617,59,2025-06-17,16,1257,610,1867,RMIT_T,"-37.80825648, 144.96304859"
141520240206,14,2024-02-06,15,432,127,559,SanBri_T,"-37.82011242, 144.96291897"
711520241127,71,2024-11-27,15,13,13,26,WestWP_T,"-37.81235775, 144.97136962"
541120251004,54,2025-10-04,11,85,80,165,Swa607_T,"-37.804024, 144.96308399"
282220250408,28,2025-04-08,22,123,415,538,VAC_T,"-37.82129925, 144.96879309"
282220231125,28,2023-11-25,22,188,2406,2594,VAC_T,"-37.82129925, 144.96879309"
282120250121,28,2025-01-21,21,641,118,759,VAC_T,"-37.82129925, 144.96879309"
402120240423,40,2024-04-23,21,86,23,109,Spr201_T,"-37.80999341, 144.97227587"
401320240607,40,2024-06-07,13,194,189,383,Spr201_T,"-37.80999341, 144.97227587"
130720250222,130,2025-02-22,7,13,2,15,Bou892T,"-37.8204637, 144.94126826"
1641420241104,164,2024-11-04,14,95,68,163,Lat526_T,"-37.813005, 144.95160411"
1301620240927,130,2024-09-27,16,38,30,68,Bou892T,"-37.8204637, 144.94126826"
117920240525,117,2024-05-25,9,45,114,159,Fli114F_T,"-37.81629332, 144.97090877"
61120231104,6,2023-11-04,11,894,721,1615,FliS_T,"-37.81911705, 144.96558255"
41920241105,4,2024-11-05,19,1014,524,1538,Swa123_T,"-37.81487988, 144.9660878"
39520250219,39,2025-02-19,5,8,4,12,AlfPl_T,"-37.81379749, 144.96995745"
3020240204,3,2024-02-04,0,423,430,853,Swa295_T,"-37.81101524, 144.96429485"
59320250518,59,2025-05-18,3,60,27,87,RMIT_T,"-37.80825648, 144.96304859"
541820250609,54,2025-06-09,18,113,152,265,Swa607_T,"-37.804024, 144.96308399"
541020240311,54,2024-03-11,10,215,96,311,Swa607_T,"-37.804024, 144.96308399"
292120250912,29,2025-09-12,21,156,114,270,AG_T,"-37.8199817, 144.96872865"
361920231203,36,2023-12-03,19,73,80,153,Que85_T,"-37.81652527, 144.96121062"
371620240730,37,2024-07-30,16,85,116,201,Lyg260_T,"-37.80107122, 144.96704554"
501020250206,50,2025-02-06,10,96,113,209,Lyg309_T,"-37.79808192, 144.96721013"
431420250115,43,2025-01-15,14,75,63,138,UM2_T,"-37.79844526, 144.96411782"
432320241129,43,2024-11-29,23,16,6,22,UM2_T,"-37.79844526, 144.96411782"
451520240122,45,2024-01-22,15,480,789,1269,Swa148_T,"-37.81414075, 144.96609379"
51820250102,5,2025-01-02,18,1346,2495,3841,PriNW_T,"-37.81874249, 144.96787656"
1341620231105,134,2023-11-05,16,500,368,868,Spen201_T,"-37.81694221, 144.95303935"
1182220250213,118,2025-02-13,22,9,6,15,Fli114C_T,"-37.81632783, 144.97090512"
118920250323,118,2025-03-23,9,10,23,33,Fli114C_T,"-37.81632783, 144.97090512"
181620250915,181,2025-09-15,6,79,125,204,Eli368_T,"-37.81009465, 144.96143149"
165620240816,165,2024-08-16,6,1,2,3,Spen475_T,"-37.80953359, 144.94939004"
162420250628,162,2025-06-28,4,30,23,53,Eli489_T,"-37.80740397, 144.95987909"
1621320251005,162,2025-10-05,13,752,1005,1757,Eli489_T,"-37.80740397, 144.95987909"
171320250907,17,2025-09-07,13,95,92,187,Col15_T,"-37.81362543, 144.97323591"
181720241231,18,2024-12-31,17,143,53,196,Col12_T,"-37.81344862, 144.97305353"
181220250529,18,2025-05-29,12,271,281,552,Col12_T,"-37.81344862, 144.97305353"
182320240426,18,2024-04-26,23,0,1,1,Col12_T,"-37.81344862, 144.97305353"
62520250927,62,2025-09-27,5,13,6,19,Lat224_T,"-37.80996494, 144.96216521"
63020240822,63,2024-08-22,0,20,33,53,Bou231_T,"-37.81333081, 144.96675571"
68620240307,68,2024-03-07,6,21,5,26,FLDegN_T,"-37.8168479, 144.96559789"
622120240812,62,2024-08-12,21,284,266,550,Lat224_T,"-37.80996494, 144.96216521"
112020251005,11,2025-10-05,20,32,11,43,WatCit_T,"-37.81564989, 144.93970694"
10420231204,10,2023-12-04,4,1,2,3,BouHbr_T,"-37.81876474, 144.94710545"
133620250908,133,2025-09-08,6,329,212,541,Spen229_T,"-37.81531435, 144.95227769"
1241720240122,124,2024-01-22,17,0,3,3,BirBridge_T,"-37.81757416, 144.97329934"
1081320250322,108,2025-03-22,13,150,196,346,261Will_T,"-37.81295822, 144.95678789"
87020250621,87,2025-06-21,0,3,6,9,Errol23_T,"-37.80454949, 144.94921863"
871620240728,87,2024-07-28,16,71,76,147,Errol23_T,"-37.80454949, 144.94921863"
871420240802,87,2024-08-02,14,104,113,217,Errol23_T,"-37.80454949, 144.94921863"
87320241116,87,2024-11-16,3,2,1,3,Errol23_T,"-37.80454949, 144.94921863"
1791520250415,179,2025-04-15,15,54,43,97,Pow61_T,"-37.82392385, 144.96299677"
179720250515,179,2025-05-15,7,34,27,61,Pow61_T,"-37.82392385, 144.96299677"
1652220240904,165,2024-09-04,22,15,4,19,Spen475_T,"-37.80953359, 144.94939004"
166620250307,166,2025-03-07,6,7,13,20,Spen484_T,"-37.80896733, 144.94931703"
1671920241212,167,2024-12-12,19,16,51,67,Lat526_T,"-37.81304149, 144.95155955"
167020250205,167,2025-02-05,0,6,6,12,Lat526_T,"-37.81304149, 144.95155955"
1311120250504,131,2025-05-04,11,103,133,236,King2_T,"-37.82009057, 144.95758725"
851520240515,85,2024-05-15,15,103,91,194,488Mac_T,"-37.79432415, 144.92973378"
171920241230,17,2024-12-30,19,109,88,197,Col15_T,"-37.81362543, 144.97323591"
112020240401,11,2024-04-01,20,20,5,25,WatCit_T,"-37.81564989, 144.93970694"
562320240224,56,2024-02-24,23,226,292,518,Lon364_T,"-37.81234775, 144.96153311"
861320250501,86,2025-05-01,13,76,90,166,574Qub_T,"-37.80309992, 144.94908064"
241620241215,24,2024-12-15,16,371,720,1091,Col620_T,"-37.81887963, 144.95449198"
101120240407,10,2024-04-07,11,30,29,59,BouHbr_T,"-37.81876474, 144.94710545"
351020250323,35,2025-03-23,10,1072,918,1990,SouthB_T,"-37.82018685, 144.96508508"
58020240310,58,2024-03-10,0,121,118,239,Bou688_T,"-37.81686075, 144.95358075"
91420240807,9,2024-08-07,14,669,262,931,Col700_T,"-37.81982992, 144.95102555"
91820250524,9,2025-05-24,18,63,184,247,Col700_T,"-37.81982992, 144.95102555"
231520250828,23,2025-08-28,15,173,274,447,Col623_T,"-37.81909256, 144.95452748"
191420240318,19,2024-03-18,14,395,539,934,LtB210_T,"-37.81237202, 144.96550671"
25320250611,25,2025-06-11,3,0,5,5,MCEC_T,"-37.82401776, 144.95604426"
251920240527,25,2024-05-27,19,239,196,435,MCEC_T,"-37.82401776, 144.95604426"
251520240603,25,2024-06-03,15,602,582,1184,MCEC_T,"-37.82401776, 144.95604426"
136920240129,136,2024-01-29,9,80,88,168,BirFed1120_T,"-37.8184141, 144.97357915"
142020240814,142,2024-08-14,0,5,0,5,Hammer1584_T,"-37.81970749, 144.96795734"
1231020231129,123,2023-11-29,10,4,1,5,BirBridge_T,"-37.81753741, 144.97329734"
1231320240222,123,2024-02-22,13,69,9,78,BirBridge_T,"-37.81753741, 144.97329734"
1301820241016,130,2024-10-16,18,57,53,110,Bou892T,"-37.8204637, 144.94126826"
161720241005,161,2024-10-05,7,100,123,223,BirArt1109_T,"-37.81851276, 144.97131336"
1382220250416,138,2025-04-16,22,1,0,1,EntPark1671_T,"-37.81996544, 144.95981454"
491820241017,49,2024-10-17,18,201,274,475,Eli501_T,"-37.80730068, 144.95956055"
117720231202,117,2023-12-02,7,17,23,40,Fli114F_T,"-37.81629332, 144.97090877"
661120241209,66,2024-12-09,11,528,788,1316,QVN_T,"-37.81057846, 144.96444294"
691820241009,69,2024-10-09,18,97,62,159,FLDegC_T,"-37.81687226, 144.96559144"
61120250901,6,2025-09-01,11,334,371,705,FliS_T,"-37.81911705, 144.96558255"
4320240221,4,2024-02-21,3,13,16,29,Swa123_T,"-37.81487988, 144.9660878"
81120240123,8,2024-01-23,11,141,238,379,WebBN_T,"-37.82293543, 144.9471751"
751820250611,75,2025-06-11,18,33,32,65,SprFli_T,"-37.81515276, 144.97467661"
781220240710,78,2024-07-10,12,22,42,64,HarEsB_T,"-37.81471642, 144.9446508"
781720240820,78,2024-08-20,17,11,156,167,HarEsB_T,"-37.81471642, 144.9446508"
78620241124,78,2024-11-24,6,1,4,5,HarEsB_T,"-37.81471642, 144.9446508"
41520241119,41,2024-11-19,5,133,84,217,Swa31,"-37.81668634, 144.96689733"
721120250808,72,2025-08-08,11,200,314,514,ACMI_T,"-37.81726338, 144.96872809"
9520241124,9,2024-11-24,5,2,3,5,Col700_T,"-37.81982992, 144.95102555"
9620250209,9,2025-02-09,6,7,15,22,Col700_T,"-37.81982992, 144.95102555"
511420240829,51,2024-08-29,14,116,96,212,Fra118_T,"-37.80841815, 144.95906316"
231620250605,23,2025-06-05,16,244,662,906,Col623_T,"-37.81909256, 144.95452748"
301620250427,30,2025-04-27,16,256,400,656,Lon189_T,"-37.8112185, 144.96656806"
49720240409,49,2024-04-09,7,98,96,194,Eli501_T,"-37.80730068, 144.95956055"
492220231202,49,2023-12-02,22,130,76,206,Eli501_T,"-37.80730068, 144.95956055"
19520240524,19,2024-05-24,5,12,6,18,LtB210_T,"-37.81237202, 144.96550671"
481820241017,48,2024-10-17,18,115,137,252,QVMQ_T,"-37.80631581, 144.95866697"
201920240720,20,2024-07-20,19,478,524,1002,LtB170_T,"-37.81172914, 144.9682466"
201320240819,20,2024-08-19,13,218,258,476,LtB170_T,"-37.81172914, 144.9682466"
19720250622,19,2025-06-22,7,9,11,20,LtB210_T,"-37.81237202, 144.96550671"
1391720250310,139,2025-03-10,17,40,25,65,Signal1647_T,"-37.81959923, 144.9632832"
1371320240628,137,2024-06-28,13,47,66,113,BouHbr2353_T,"-37.81894815, 144.94612292"
1381020240106,138,2024-01-06,10,7,1,8,EntPark1671_T,"-37.81996544, 144.95981454"
1091720240115,109,2024-01-15,17,401,129,530,LatWill_T,"-37.81193681, 144.95621105"
85920240911,85,2024-09-11,9,91,72,163,488Mac_T,"-37.79432415, 144.92973378"
851320250112,85,2025-01-12,13,33,26,59,488Mac_T,"-37.79432415, 144.92973378"
661420240731,66,2024-07-31,14,1221,1183,2404,QVN_T,"-37.81057846, 144.96444294"
691920241113,69,2024-11-13,19,74,63,137,FLDegC_T,"-37.81687226, 144.96559144"
661520240116,66,2024-01-16,15,911,768,1679,QVN_T,"-37.81057846, 144.96444294"
31920240804,3,2024-08-04,19,970,1158,2128,Swa295_T,"-37.81101524, 144.96429485"
771520241014,77,2024-10-14,15,152,142,294,HarEsP_T,"-37.81441438, 144.94433026"
291620241213,29,2024-12-13,16,327,466,793,AG_T,"-37.8199817, 144.96872865"
652320240604,65,2024-06-04,23,24,18,42,SwaCs_T,"-37.81569416, 144.9668064"
281620250420,28,2025-04-20,16,1107,1869,2976,VAC_T,"-37.82129925, 144.96879309"
29820250209,29,2025-02-09,8,67,128,195,AG_T,"-37.8199817, 144.96872865"
37520250519,37,2025-05-19,5,1,6,7,Lyg260_T,"-37.80107122, 144.96704554"
47820250517,47,2025-05-17,8,91,136,227,Eli250_T,"-37.81258467, 144.9625775"
471320241128,47,2024-11-28,13,1018,1069,2087,Eli250_T,"-37.81258467, 144.9625775"
612220250122,61,2025-01-22,22,176,84,260,RMIT14_T,"-37.80767455, 144.96309114"
501720250219,50,2025-02-19,17,219,182,401,Lyg309_T,"-37.79808192, 144.96721013"
45520250407,45,2025-04-07,5,11,34,45,Swa148_T,"-37.81414075, 144.96609379"
45120250912,45,2025-09-12,1,21,30,51,Swa148_T,"-37.81414075, 144.96609379"
211020240507,21,2024-05-07,10,153,179,332,Bourke155_T,"-37.81267313, 144.96788288"
107120231022,107,2023-10-22,1,14,18,32,280Will_T,"-37.81246271, 144.95690188"
871320240501,87,2024-05-01,13,144,157,301,Errol23_T,"-37.80454949, 144.94921863"
162420250223,162,2025-02-23,4,30,21,51,Eli489_T,"-37.80740397, 144.95987909"
14420240105,14,2024-01-05,4,23,2,25,SanBri_T,"-37.82011242, 144.96291897"
711820240127,71,2024-01-27,18,15,10,25,WestWP_T,"-37.81235775, 144.97136962"
711220240202,71,2024-02-02,12,18,24,42,WestWP_T,"-37.81235775, 144.97136962"
292120240414,29,2024-04-14,21,48,161,209,AG_T,"-37.8199817, 144.96872865"
14920240826,14,2024-08-26,9,185,210,395,SanBri_T,"-37.82011242, 144.96291897"
312020250308,31,2025-03-08,20,459,474,933,Lyg161_T,"-37.80169681, 144.96658911"
542120250626,54,2025-06-26,21,98,140,238,Swa607_T,"-37.804024, 144.96308399"
54720250722,54,2025-07-22,7,42,27,69,Swa607_T,"-37.804024, 144.96308399"
372320231221,37,2023-12-21,23,47,64,111,Lyg260_T,"-37.80107122, 144.96704554"
43120250529,43,2025-05-29,1,4,3,7,UM2_T,"-37.79844526, 144.96411782"
431820250531,43,2025-05-31,18,32,65,97,UM2_T,"-37.79844526, 144.96411782"
431120250925,43,2025-09-25,11,233,221,454,UM2_T,"-37.79844526, 144.96411782"
451020231118,45,2023-11-18,10,300,314,614,Swa148_T,"-37.81414075, 144.96609379"
51020250121,5,2025-01-21,10,604,959,1563,PriNW_T,"-37.81874249, 144.96787656"
1181020250830,118,2025-08-30,10,10,5,15,Fli114C_T,"-37.81632783, 144.97090512"
107320240515,107,2024-05-15,3,0,1,1,280Will_T,"-37.81246271, 144.95690188"
108520231112,108,2023-11-12,5,20,22,42,261Will_T,"-37.81295822, 144.95678789"
1081120250531,108,2025-05-31,11,158,137,295,261Will_T,"-37.81295822, 144.95678789"
871420240526,87,2024-05-26,14,91,92,183,Errol23_T,"-37.80454949, 144.94921863"
501220250418,50,2025-04-18,12,153,194,347,Lyg309_T,"-37.79808192, 144.96721013"
1792020250807,179,2025-08-07,20,66,68,134,Pow61_T,"-37.82392385, 144.96299677"
1321820240203,132,2024-02-03,18,156,76,232,King335_T,"-37.81267639, 144.95386444"
135520250130,135,2025-01-30,5,27,25,52,Spen161_T,"-37.8172861, 144.95319102"
491720250905,49,2025-09-05,17,283,293,576,Eli501_T,"-37.80730068, 144.95956055"
1381520241225,138,2024-12-25,15,9,2,11,EntPark1671_T,"-37.81996544, 144.95981454"
1171820250303,117,2025-03-03,18,129,170,299,Fli114F_T,"-37.81629332, 144.97090877"
19420240214,19,2024-02-14,4,0,4,4,LtB210_T,"-37.81237202, 144.96550671"
671420240918,67,2024-09-18,14,455,769,1224,FLDegS_T,"-37.81688755, 144.96562569"
852120240102,85,2024-01-02,21,7,5,12,488Mac_T,"-37.79432415, 144.92973378"
18220250530,18,2025-05-30,2,0,1,1,Col12_T,"-37.81344862, 144.97305353"
11020240303,11,2024-03-03,0,34,13,47,WatCit_T,"-37.81564989, 144.93970694"
112120240610,11,2024-06-10,21,16,26,42,WatCit_T,"-37.81564989, 144.93970694"
56920240322,56,2024-03-22,9,188,153,341,Lon364_T,"-37.81234775, 144.96153311"
56520241005,56,2024-10-05,5,24,17,41,Lon364_T,"-37.81234775, 144.96153311"
101320231217,10,2023-12-17,13,44,23,67,BouHbr_T,"-37.81876474, 144.94710545"
72620250724,72,2025-07-24,6,71,37,108,ACMI_T,"-37.81726338, 144.96872809"
351120241012,35,2024-10-12,11,1001,1065,2066,SouthB_T,"-37.82018685, 144.96508508"
21420240704,2,2024-07-04,14,714,795,1509,Bou283_T,"-37.81380668, 144.96516718"
22320250930,2,2025-09-30,23,11,48,59,Bou283_T,"-37.81380668, 144.96516718"
53920250410,53,2025-04-10,9,417,374,791,Col254_T,"-37.81564191, 144.965499"
9220240130,9,2024-01-30,2,2,4,6,Col700_T,"-37.81982992, 144.95102555"
30920240417,30,2024-04-17,9,132,117,249,Lon189_T,"-37.8112185, 144.96656806"
461920250513,46,2025-05-13,19,3,5,8,Pel147_T,"-37.80240719, 144.9615673"
202120240428,20,2024-04-28,21,144,334,478,LtB170_T,"-37.81172914, 144.9682466"
20220240916,20,2024-09-16,2,3,2,5,LtB170_T,"-37.81172914, 144.9682466"
522320250320,52,2025-03-20,23,96,89,185,Eli263_T,"-37.81252157, 144.9619401"
1411220240919,141,2024-09-19,12,184,174,358,474Fl_T,"-37.81997273, 144.95834911"
141020241013,141,2024-10-13,0,122,64,186,474Fl_T,"-37.81997273, 144.95834911"
1412120241026,141,2024-10-26,21,170,149,319,474Fl_T,"-37.81997273, 144.95834911"
139820250331,139,2025-03-31,8,18,477,495,Signal1647_T,"-37.81959923, 144.9632832"
1371520240605,137,2024-06-05,15,8,140,148,BouHbr2353_T,"-37.81894815, 144.94612292"
142620250825,142,2025-08-25,6,41,44,85,Hammer1584_T,"-37.81970749, 144.96795734"
1422020241024,142,2024-10-24,20,41,70,111,Hammer1584_T,"-37.81970749, 144.96795734"
161820241004,161,2024-10-04,8,81,131,212,BirArt1109_T,"-37.81851276, 144.97131336"
1611820240725,161,2024-07-25,18,8,1,9,BirArt1109_T,"-37.81851276, 144.97131336"
107220240619,107,2024-06-19,2,0,4,4,280Will_T,"-37.81246271, 144.95690188"
118020240916,118,2024-09-16,0,0,1,1,Fli114C_T,"-37.81632783, 144.97090512"
1181720250123,118,2025-01-23,17,54,89,143,Fli114C_T,"-37.81632783, 144.97090512"
1081720241229,108,2024-12-29,17,115,127,242,261Will_T,"-37.81295822, 144.95678789"
871720251012,87,2025-10-12,17,103,95,198,Errol23_T,"-37.80454949, 144.94921863"
1841120250921,184,2025-09-21,11,717,570,1287,Eli124_T,"-37.81512416, 144.96371988"
1621120250419,162,2025-04-19,11,673,1137,1810,Eli489_T,"-37.80740397, 144.95987909"
1401520240413,140,2024-04-13,15,101,88,189,Boyd2837_T,"-37.82590962, 144.96185972"
1431320240510,143,2024-05-10,13,252,229,481,Spencer_T,"-37.821728, 144.95557015"
1342020250404,134,2025-04-04,20,329,313,642,Spen201_T,"-37.81694221, 144.95303935"
1352020241127,135,2024-11-27,20,174,218,392,Spen161_T,"-37.8172861, 144.95319102"
135920250628,135,2025-06-28,9,253,211,464,Spen161_T,"-37.8172861, 144.95319102"
66720250905,66,2025-09-05,7,55,179,234,QVN_T,"-37.81057846, 144.96444294"
691320250928,69,2025-09-28,13,340,254,594,FLDegC_T,"-37.81687226, 144.96559144"
61320250512,6,2025-05-12,13,813,755,1568,FliS_T,"-37.81911705, 144.96558255"
70520240906,70,2024-09-06,5,3,2,5,Errol20_T,"-37.80456984, 144.94946228"
751920250421,75,2025-04-21,19,16,8,24,SprFli_T,"-37.81515276, 144.97467661"
781720250719,78,2025-07-19,17,16,30,46,HarEsB_T,"-37.81471642, 144.9446508"
77720231104,77,2023-11-04,7,32,49,81,HarEsP_T,"-37.81441438, 144.94433026"
29820240426,29,2024-04-26,8,100,107,207,AG_T,"-37.8199817, 144.96872865"
29920240823,29,2024-08-23,9,142,125,267,AG_T,"-37.8199817, 144.96872865"
281320250124,28,2025-01-24,13,1042,1126,2168,VAC_T,"-37.82129925, 144.96879309"
471820250225,47,2025-02-25,18,945,745,1690,Eli250_T,"-37.81258467, 144.9625775"
40720251001,40,2025-10-01,7,116,86,202,Spr201_T,"-37.80999341, 144.97227587"
312120231205,31,2023-12-05,21,114,145,259,Lyg161_T,"-37.80169681, 144.96658911"
31920231211,31,2023-12-11,9,46,59,105,Lyg161_T,"-37.80169681, 144.96658911"
21320241029,21,2024-10-29,3,2,4,6,Bourke155_T,"-37.81267313, 144.96788288"
37620240905,37,2024-09-05,6,7,10,17,Lyg260_T,"-37.80107122, 144.96704554"
432320231104,43,2023-11-04,23,25,11,36,UM2_T,"-37.79844526, 144.96411782"
431320240430,43,2024-04-30,13,238,288,526,UM2_T,"-37.79844526, 144.96411782"
451120240424,45,2024-04-24,11,373,438,811,Swa148_T,"-37.81414075, 144.96609379"
18020240129,18,2024-01-29,0,6,0,6,Col12_T,"-37.81344862, 144.97305353"
621720240816,62,2024-08-16,17,307,162,469,Lat224_T,"-37.80996494, 144.96216521"
56220250303,56,2025-03-03,2,10,7,17,Lon364_T,"-37.81234775, 144.96153311"
582320231101,58,2023-11-01,23,81,85,166,Bou688_T,"-37.81686075, 144.95358075"
351020240703,35,2024-07-03,10,635,526,1161,SouthB_T,"-37.82018685, 144.96508508"
27620250405,27,2025-04-05,6,4,10,14,Vic_T,"-37.80606888, 144.95644692"
271220231206,27,2023-12-06,12,134,122,256,Vic_T,"-37.80606888, 144.95644692"
53620250310,53,2025-03-10,6,7,8,15,Col254_T,"-37.81564191, 144.965499"
532120240731,53,2024-07-31,21,98,158,256,Col254_T,"-37.81564191, 144.965499"
30120241004,30,2024-10-04,1,66,78,144,Lon189_T,"-37.8112185, 144.96656806"
23520241121,23,2024-11-21,5,23,20,43,Col623_T,"-37.81909256, 144.95452748"
12120250216,1,2025-02-16,21,141,147,288,Bou292_T,"-37.81349441, 144.96515323"
67720241006,67,2024-10-06,7,32,47,79,FLDegS_T,"-37.81688755, 144.96562569"
1620250625,1,2025-06-25,6,20,46,66,Bou292_T,"-37.81349441, 144.96515323"
561020250101,56,2025-01-01,10,260,80,340,Lon364_T,"-37.81234775, 144.96153311"
56820250715,56,2025-07-15,8,105,142,247,Lon364_T,"-37.81234775, 144.96153311"
101520240606,10,2024-06-06,15,119,38,157,BouHbr_T,"-37.81876474, 144.94710545"
12620241011,12,2024-10-11,6,37,25,62,NewQ_T,"-37.81457988, 144.94292398"
72120250507,72,2025-05-07,1,5,3,8,ACMI_T,"-37.81726338, 144.96872809"
72120250226,72,2025-02-26,1,4,6,10,ACMI_T,"-37.81726338, 144.96872809"
22020250201,2,2025-02-01,20,200,231,431,Bou283_T,"-37.81380668, 144.96516718"
271720231208,27,2023-12-08,17,108,79,187,Vic_T,"-37.80606888, 144.95644692"
91220241217,9,2024-12-17,12,745,518,1263,Col700_T,"-37.81982992, 144.95102555"
791120251012,79,2025-10-12,11,471,527,998,FliSS_T,"-37.81794046, 144.96616678"
521520240324,52,2024-03-24,15,315,284,599,Eli263_T,"-37.81252157, 144.9619401"
491220250418,49,2025-04-18,12,235,341,576,Eli501_T,"-37.80730068, 144.95956055"
491320250521,49,2025-05-21,13,345,309,654,Eli501_T,"-37.80730068, 144.95956055"
481820250905,48,2025-09-05,18,124,158,282,QVMQ_T,"-37.80631581, 144.95866697"
1371320231216,137,2023-12-16,13,13,25,38,BouHbr2353_T,"-37.81894815, 144.94612292"
137120250722,137,2025-07-22,1,0,1,1,BouHbr2353_T,"-37.81894815, 144.94612292"
1362320250506,136,2025-05-06,23,2,2,4,BirFed1120_T,"-37.8184141, 144.97357915"
136220250525,136,2025-05-25,2,2,0,2,BirFed1120_T,"-37.8184141, 144.97357915"
1421420240326,142,2024-03-26,14,400,305,705,Hammer1584_T,"-37.81970749, 144.96795734"
142520240903,142,2024-09-03,5,11,0,11,Hammer1584_T,"-37.81970749, 144.96795734"
1381020250115,138,2025-01-15,10,7,3,10,EntPark1671_T,"-37.81996544, 144.95981454"
1231420240901,123,2024-09-01,14,17,5,22,BirBridge_T,"-37.81753741, 144.97329734"
6020250511,6,2025-05-11,0,367,212,579,FliS_T,"-37.81911705, 144.96558255"
841120240111,84,2024-01-11,11,792,774,1566,ElFi_T,"-37.81798049, 144.96503383"
841920250601,84,2025-06-01,19,488,771,1259,ElFi_T,"-37.81798049, 144.96503383"
4620240606,4,2024-06-06,6,152,38,190,Swa123_T,"-37.81487988, 144.9660878"
41620240807,4,2024-08-07,16,1385,1087,2472,Swa123_T,"-37.81487988, 144.9660878"
81220250424,8,2025-04-24,12,229,392,621,WebBN_T,"-37.82293543, 144.9471751"
77620250917,77,2025-09-17,6,37,73,110,HarEsP_T,"-37.81441438, 144.94433026"
421620240616,42,2024-06-16,16,104,83,187,UM1_T,"-37.80008566, 144.96386412"
141520241209,14,2024-12-09,15,410,115,525,SanBri_T,"-37.82011242, 144.96291897"
71520250214,71,2025-02-14,5,5,1,6,WestWP_T,"-37.81235775, 144.97136962"
59920241214,59,2024-12-14,9,61,115,176,RMIT_T,"-37.80825648, 144.96304859"
651920240428,65,2024-04-28,19,248,209,457,SwaCs_T,"-37.81569416, 144.9668064"
28420251001,28,2025-10-01,4,1,29,30,VAC_T,"-37.82129925, 144.96879309"
29820250614,29,2025-06-14,8,95,117,212,AG_T,"-37.8199817, 144.96872865"
311920240229,31,2024-02-29,19,218,218,436,Lyg161_T,"-37.80169681, 144.96658911"
311920240911,31,2024-09-11,19,175,130,305,Lyg161_T,"-37.80169681, 144.96658911"
361520231202,36,2023-12-02,15,129,163,292,Que85_T,"-37.81652527, 144.96121062"
36520240206,36,2024-02-06,5,8,5,13,Que85_T,"-37.81652527, 144.96121062"
362120240812,36,2024-08-12,21,54,92,146,Que85_T,"-37.81652527, 144.96121062"
37520250921,37,2025-09-21,5,3,7,10,Lyg260_T,"-37.80107122, 144.96704554"
372320240116,37,2024-01-16,23,51,67,118,Lyg260_T,"-37.80107122, 144.96704554"
44020240129,44,2024-01-29,0,2,0,2,UM3_T,"-37.79698741, 144.96441306"
211320241025,21,2024-10-25,13,387,450,837,Bourke155_T,"-37.81267313, 144.96788288"
211020250326,21,2025-03-26,10,161,107,268,Bourke155_T,"-37.81267313, 144.96788288"
21720240120,21,2024-01-20,7,23,41,64,Bourke155_T,"-37.81267313, 144.96788288"
143820241130,143,2024-11-30,8,37,46,83,Spencer_T,"-37.821728, 144.95557015"
1071920231025,107,2023-10-25,19,130,109,239,280Will_T,"-37.81246271, 144.95690188"
36120250619,36,2025-06-19,1,6,17,23,Que85_T,"-37.81652527, 144.96121062"
36620240115,36,2024-01-15,6,38,28,66,Que85_T,"-37.81652527, 144.96121062"
36120240205,36,2024-02-05,1,5,4,9,Que85_T,"-37.81652527, 144.96121062"
361520240805,36,2024-08-05,15,134,160,294,Que85_T,"-37.81652527, 144.96121062"
371320250626,37,2025-06-26,13,114,91,205,Lyg260_T,"-37.80107122, 144.96704554"
37220250819,37,2025-08-19,2,2,5,7,Lyg260_T,"-37.80107122, 144.96704554"
37520240313,37,2024-03-13,5,2,8,10,Lyg260_T,"-37.80107122, 144.96704554"
611920240928,61,2024-09-28,19,326,286,612,RMIT14_T,"-37.80767455, 144.96309114"
50720240917,50,2024-09-17,7,22,28,50,Lyg309_T,"-37.79808192, 144.96721013"
162120250521,162,2025-05-21,1,18,14,32,Eli489_T,"-37.80740397, 144.95987909"
131020240405,131,2024-04-05,0,21,9,30,King2_T,"-37.82009057, 144.95758725"
134320241209,134,2024-12-09,3,24,19,43,Spen201_T,"-37.81694221, 144.95303935"
135320240803,135,2024-08-03,3,33,10,43,Spen161_T,"-37.8172861, 144.95319102"
1071820250219,107,2025-02-19,18,164,139,303,280Will_T,"-37.81246271, 144.95690188"
133520250512,133,2025-05-12,5,57,74,131,Spen229_T,"-37.81531435, 144.95227769"
133620231127,133,2023-11-27,6,317,142,459,Spen229_T,"-37.81531435, 144.95227769"
1181820240525,118,2024-05-25,18,14,45,59,Fli114C_T,"-37.81632783, 144.97090512"
87620250705,87,2025-07-05,6,3,2,5,Errol23_T,"-37.80454949, 144.94921863"
871620250712,87,2025-07-12,16,113,85,198,Errol23_T,"-37.80454949, 144.94921863"
166520241220,166,2024-12-20,5,0,4,4,Spen484_T,"-37.80896733, 144.94931703"
63620240810,63,2024-08-10,6,11,22,33,Bou231_T,"-37.81333081, 144.96675571"
121520231219,12,2023-12-19,15,138,116,254,NewQ_T,"-37.81457988, 144.94292398"
62620250810,62,2025-08-10,6,20,18,38,Lat224_T,"-37.80996494, 144.96216521"
562220240826,56,2024-08-26,22,120,135,255,Lon364_T,"-37.81234775, 144.96153311"
861920250722,86,2025-07-22,19,26,33,59,574Qub_T,"-37.80309992, 144.94908064"
101620250727,10,2025-07-27,16,28,28,56,BouHbr_T,"-37.81876474, 144.94710545"
352120240910,35,2024-09-10,21,428,723,1151,SouthB_T,"-37.82018685, 144.96508508"
761420240628,76,2024-06-28,14,57,74,131,KenMac_T,"-37.79453803, 144.93036194"
532220240613,53,2024-06-13,22,88,106,194,Col254_T,"-37.81564191, 144.965499"
531820241031,53,2024-10-31,18,554,379,933,Col254_T,"-37.81564191, 144.965499"
21020251007,2,2025-10-07,10,306,347,653,Bou283_T,"-37.81380668, 144.96516718"
301920240316,30,2024-03-16,19,542,656,1198,Lon189_T,"-37.8112185, 144.96656806"
79820231123,79,2023-11-23,8,637,327,964,FliSS_T,"-37.81794046, 144.96616678"
92220241222,9,2024-12-22,22,11,15,26,Col700_T,"-37.81982992, 144.95102555"
23020250107,23,2025-01-07,0,14,26,40,Col623_T,"-37.81909256, 144.95452748"
30820251001,30,2025-10-01,8,99,118,217,Lon189_T,"-37.8112185, 144.96656806"
251920240803,25,2024-08-03,19,443,574,1017,MCEC_T,"-37.82401776, 144.95604426"
521820250628,52,2025-06-28,18,359,554,913,Eli263_T,"-37.81252157, 144.9619401"
137520231217,137,2023-12-17,5,1,0,1,BouHbr2353_T,"-37.81894815, 144.94612292"
1301420240113,130,2024-01-13,14,8,28,36,Bou892T,"-37.8204637, 144.94126826"
1641420250325,164,2025-03-25,14,87,89,176,Lat526_T,"-37.813005, 144.95160411"
1381320240108,138,2024-01-08,13,1,4,5,EntPark1671_T,"-37.81996544, 144.95981454"
117220250517,117,2025-05-17,2,13,4,17,Fli114F_T,"-37.81629332, 144.97090877"
49520231226,49,2023-12-26,5,14,16,30,Eli501_T,"-37.80730068, 144.95956055"
461620250310,46,2025-03-10,16,27,47,74,Pel147_T,"-37.80240719, 144.9615673"
20120231123,20,2023-11-23,1,28,11,39,LtB170_T,"-37.81172914, 144.9682466"
137120250126,137,2025-01-26,1,2,1,3,BouHbr2353_T,"-37.81894815, 144.94612292"
1411320240918,141,2024-09-18,13,196,158,354,474Fl_T,"-37.81997273, 144.95834911"
1371020240317,137,2024-03-17,10,165,353,518,BouHbr2353_T,"-37.81894815, 144.94612292"
142820241130,142,2024-11-30,8,56,75,131,Hammer1584_T,"-37.81970749, 144.96795734"
1641920250730,164,2025-07-30,19,67,83,150,Lat526_T,"-37.813005, 144.95160411"
491720250921,49,2025-09-21,17,216,169,385,Eli501_T,"-37.80730068, 144.95956055"
117620240406,117,2024-04-06,6,12,30,42,Fli114F_T,"-37.81629332, 144.97090877"
61120231120,6,2023-11-20,11,671,439,1110,FliS_T,"-37.81911705, 144.96558255"
842120240105,84,2024-01-05,21,840,1142,1982,ElFi_T,"-37.81798049, 144.96503383"
66920231228,66,2023-12-28,9,162,249,411,QVN_T,"-37.81057846, 144.96444294"
39920250705,39,2025-07-05,9,61,36,97,AlfPl_T,"-37.81379749, 144.96995745"
8420241110,8,2024-11-10,4,1,4,5,WebBN_T,"-37.82293543, 144.9471751"
781320240502,78,2024-05-02,13,45,44,89,HarEsB_T,"-37.81471642, 144.9446508"
78720240721,78,2024-07-21,7,12,1826,1838,HarEsB_T,"-37.81471642, 144.9446508"
421520240816,42,2024-08-16,15,314,423,737,UM1_T,"-37.80008566, 144.96386412"
281020240124,28,2024-01-24,10,612,209,821,VAC_T,"-37.82129925, 144.96879309"
281820240705,28,2024-07-05,18,868,702,1570,VAC_T,"-37.82129925, 144.96879309"
291720250201,29,2025-02-01,17,390,380,770,AG_T,"-37.8199817, 144.96872865"
541820240418,54,2024-04-18,18,278,551,829,Swa607_T,"-37.804024, 144.96308399"
47920240627,47,2024-06-27,9,283,586,869,Eli250_T,"-37.81258467, 144.9625775"
31320250910,31,2025-09-10,3,2,5,7,Lyg161_T,"-37.80169681, 144.96658911"
21520250316,21,2025-03-16,5,5,11,16,Bourke155_T,"-37.81267313, 144.96788288"
43720241121,43,2024-11-21,7,35,27,62,UM2_T,"-37.79844526, 144.96411782"
441620250512,44,2025-05-12,16,154,99,253,UM3_T,"-37.79698741, 144.96441306"
212320240503,21,2024-05-03,23,329,389,718,Bourke155_T,"-37.81267313, 144.96788288"
51420250622,5,2025-06-22,14,1619,1778,3397,PriNW_T,"-37.81874249, 144.96787656"
1331720231101,133,2023-11-01,17,588,591,1179,Spen229_T,"-37.81531435, 144.95227769"
1331120250425,133,2025-04-25,11,606,630,1236,Spen229_T,"-37.81531435, 144.95227769"
108720250205,108,2025-02-05,7,64,845,909,261Will_T,"-37.81295822, 144.95678789"
502020240820,50,2024-08-20,20,148,98,246,Lyg309_T,"-37.79808192, 144.96721013"
132320231219,132,2023-12-19,3,9,4,13,King335_T,"-37.81267639, 144.95386444"
852320240622,85,2024-06-22,23,4,21,25,488Mac_T,"-37.79432415, 144.92973378"
171620250401,17,2025-04-01,16,240,449,689,Col15_T,"-37.81362543, 144.97323591"
861220240130,86,2024-01-30,12,91,79,170,574Qub_T,"-37.80309992, 144.94908064"
111020250619,11,2025-06-19,10,27,44,71,WatCit_T,"-37.81564989, 144.93970694"
62520231130,62,2023-11-30,5,10,29,39,Lat224_T,"-37.80996494, 144.96216521"
56420240225,56,2024-02-25,4,76,26,102,Lon364_T,"-37.81234775, 144.96153311"
561320240905,56,2024-09-05,13,398,375,773,Lon364_T,"-37.81234775, 144.96153311"
56820250519,56,2025-05-19,8,134,211,345,Lon364_T,"-37.81234775, 144.96153311"
241320241101,24,2024-11-01,13,656,794,1450,Col620_T,"-37.81887963, 144.95449198"
102120240419,10,2024-04-19,21,36,16,52,BouHbr_T,"-37.81876474, 144.94710545"
582020240520,58,2024-05-20,20,185,230,415,Bou688_T,"-37.81686075, 144.95358075"
58120240430,58,2024-04-30,1,11,14,25,Bou688_T,"-37.81686075, 144.95358075"
761220250114,76,2025-01-14,12,78,84,162,KenMac_T,"-37.79453803, 144.93036194"
761820250608,76,2025-06-08,18,17,19,36,KenMac_T,"-37.79453803, 144.93036194"
21520250614,2,2025-06-14,15,937,758,1695,Bou283_T,"-37.81380668, 144.96516718"
1321920231031,132,2023-10-31,19,141,127,268,King335_T,"-37.81267639, 144.95386444"
131720241017,131,2024-10-17,7,92,49,141,King2_T,"-37.82009057, 144.95758725"
131320250113,131,2025-01-13,3,11,13,24,King2_T,"-37.82009057, 144.95758725"
1071320241022,107,2024-10-22,13,269,330,599,280Will_T,"-37.81246271, 144.95690188"
1331720250718,133,2025-07-18,17,697,624,1321,Spen229_T,"-37.81531435, 144.95227769"
1331320250103,133,2025-01-03,13,445,446,891,Spen229_T,"-37.81531435, 144.95227769"
118820250115,118,2025-01-15,8,29,24,53,Fli114C_T,"-37.81632783, 144.97090512"
87720240611,87,2024-06-11,7,29,24,53,Errol23_T,"-37.80454949, 144.94921863"
1811820250925,181,2025-09-25,18,1142,1316,2458,Eli368_T,"-37.81009465, 144.96143149"
1621920250929,162,2025-09-29,19,259,188,447,Eli489_T,"-37.80740397, 144.95987909"
162620241215,162,2024-12-15,6,52,33,85,Eli489_T,"-37.80740397, 144.95987909"
1621820240817,162,2024-08-17,18,320,343,663,Eli489_T,"-37.80740397, 144.95987909"
671220250502,67,2025-05-02,12,513,680,1193,FLDegS_T,"-37.81688755, 144.96562569"
68720240127,68,2024-01-27,7,30,39,69,FLDegN_T,"-37.8168479, 144.96559789"
17020240116,17,2024-01-16,0,11,9,20,Col15_T,"-37.81362543, 144.97323591"
171520240921,17,2024-09-21,15,246,208,454,Col15_T,"-37.81362543, 144.97323591"
68620241030,68,2024-10-30,6,20,17,37,FLDegN_T,"-37.8168479, 144.96559789"
861120251004,86,2025-10-04,11,94,104,198,574Qub_T,"-37.80309992, 144.94908064"
111820250226,11,2025-02-26,18,130,123,253,WatCit_T,"-37.81564989, 144.93970694"
561520240315,56,2024-03-15,15,300,290,590,Lon364_T,"-37.81234775, 144.96153311"
111020231129,11,2023-11-29,10,7,3,10,WatCit_T,"-37.81564989, 144.93970694"
241720241017,24,2024-10-17,17,632,2720,3352,Col620_T,"-37.81887963, 144.95449198"
241720250430,24,2025-04-30,17,689,2545,3234,Col620_T,"-37.81887963, 144.95449198"
72120240306,72,2024-03-06,1,5,7,12,ACMI_T,"-37.81726338, 144.96872809"
721120240326,72,2024-03-26,11,167,251,418,ACMI_T,"-37.81726338, 144.96872809"
101820250704,10,2025-07-04,18,260,186,446,BouHbr_T,"-37.81876474, 144.94710545"
10020250914,10,2025-09-14,0,14,9,23,BouHbr_T,"-37.81876474, 144.94710545"
722220231020,72,2023-10-20,22,213,305,518,ACMI_T,"-37.81726338, 144.96872809"
122320250302,12,2025-03-02,23,38,30,68,NewQ_T,"-37.81457988, 144.94292398"
76720241225,76,2024-12-25,7,13,8,21,KenMac_T,"-37.79453803, 144.93036194"
21320240402,2,2024-04-02,13,959,1039,1998,Bou283_T,"-37.81380668, 144.96516718"
27220250921,27,2025-09-21,2,15,2,17,Vic_T,"-37.80606888, 144.95644692"
91620240624,9,2024-06-24,16,1967,123,2090,Col700_T,"-37.81982992, 144.95102555"
791620231202,79,2023-12-02,16,516,465,981,FliSS_T,"-37.81794046, 144.96616678"
301820250126,30,2025-01-26,18,246,415,661,Lon189_T,"-37.8112185, 144.96656806"
52720231210,52,2023-12-10,7,18,18,36,Eli263_T,"-37.81252157, 144.9619401"
511220250624,51,2025-06-24,12,144,133,277,Fra118_T,"-37.80841815, 144.95906316"
49820240903,49,2024-09-03,8,162,193,355,Eli501_T,"-37.80730068, 144.95956055"
19220241227,19,2024-12-27,2,30,29,59,LtB210_T,"-37.81237202, 144.96550671"
481020250408,48,2025-04-08,10,272,222,494,QVMQ_T,"-37.80631581, 144.95866697"
481320250412,48,2025-04-12,13,596,399,995,QVMQ_T,"-37.80631581, 144.95866697"
481420240314,48,2024-03-14,14,402,240,642,QVMQ_T,"-37.80631581, 144.95866697"
482020240718,48,2024-07-18,20,66,100,166,QVMQ_T,"-37.80631581, 144.95866697"
48620240803,48,2024-08-03,6,41,40,81,QVMQ_T,"-37.80631581, 144.95866697"
462320251006,46,2025-10-06,23,2,0,2,Pel147_T,"-37.80240719, 144.9615673"
180720250403,180,2025-04-03,7,44,11,55,Mac330_T,"-37.79497059, 144.93530329"
1412320231221,141,2023-12-21,23,118,103,221,474Fl_T,"-37.81997273, 144.95834911"
141520250514,141,2025-05-14,5,7,3,10,474Fl_T,"-37.81997273, 144.95834911"
1392020240423,139,2024-04-23,20,9,9,18,Signal1647_T,"-37.81959923, 144.9632832"
1362020250927,136,2025-09-27,20,10,139,149,BirFed1120_T,"-37.8184141, 144.97357915"
1421120250411,142,2025-04-11,11,383,356,739,Hammer1584_T,"-37.81970749, 144.96795734"
1421320250605,142,2025-06-05,13,453,309,762,Hammer1584_T,"-37.81970749, 144.96795734"
1641220241210,164,2024-12-10,12,99,72,171,Lat526_T,"-37.813005, 144.95160411"
1382020250114,138,2025-01-14,20,4,5,9,EntPark1671_T,"-37.81996544, 144.95981454"
1611320250131,161,2025-01-31,13,268,116,384,BirArt1109_T,"-37.81851276, 144.97131336"
123720250617,123,2025-06-17,7,22,7,29,BirBridge_T,"-37.81753741, 144.97329734"
123920240520,123,2024-05-20,9,10,1,11,BirBridge_T,"-37.81753741, 144.97329734"
66720241009,66,2024-10-09,7,76,232,308,QVN_T,"-37.81057846, 144.96444294"
69620240624,69,2024-06-24,6,4,6,10,FLDegC_T,"-37.81687226, 144.96559144"
6720241219,6,2024-12-19,7,452,680,1132,FliS_T,"-37.81911705, 144.96558255"
53720250309,53,2025-03-09,7,47,30,77,Col254_T,"-37.81564191, 144.965499"
30820231220,30,2023-12-20,8,71,92,163,Lon189_T,"-37.8112185, 144.96656806"
531420251014,53,2025-10-14,14,686,617,1303,Col254_T,"-37.81564191, 144.965499"
51520250307,51,2025-03-07,5,10,14,24,Fra118_T,"-37.80841815, 144.95906316"
51020240901,51,2024-09-01,0,15,14,29,Fra118_T,"-37.80841815, 144.95906316"
23320240216,23,2024-02-16,3,7,13,20,Col623_T,"-37.81909256, 144.95452748"
48820250625,48,2025-06-25,8,110,92,202,QVMQ_T,"-37.80631581, 144.95866697"
301820251016,30,2025-10-16,18,381,358,739,Lon189_T,"-37.8112185, 144.96656806"
52420250107,52,2025-01-07,4,2,7,9,Eli263_T,"-37.81252157, 144.9619401"
141620250203,141,2025-02-03,6,24,24,48,474Fl_T,"-37.81997273, 144.95834911"
1391520250705,139,2025-07-05,15,68,36,104,Signal1647_T,"-37.81959923, 144.9632832"
137020241206,137,2024-12-06,0,0,1,1,BouHbr2353_T,"-37.81894815, 144.94612292"
136720240901,136,2024-09-01,7,34,33,67,BirFed1120_T,"-37.8184141, 144.97357915"
1611120250825,161,2025-08-25,11,123,171,294,BirArt1109_T,"-37.81851276, 144.97131336"
661820250625,66,2025-06-25,18,689,729,1418,QVN_T,"-37.81057846, 144.96444294"
691720250818,69,2025-08-18,17,34,32,66,FLDegC_T,"-37.81687226, 144.96559144"
841520250221,84,2025-02-21,15,889,1311,2200,ElFi_T,"-37.81798049, 144.96503383"
70020240927,70,2024-09-27,0,8,7,15,Errol20_T,"-37.80456984, 144.94946228"
751220250522,75,2025-05-22,12,71,83,154,SprFli_T,"-37.81515276, 144.97467661"
651720240626,65,2024-06-26,17,1028,1103,2131,SwaCs_T,"-37.81569416, 144.9668064"
312220241208,31,2024-12-08,22,111,176,287,Lyg161_T,"-37.80169681, 144.96658911"
541520240305,54,2024-03-05,15,252,243,495,Swa607_T,"-37.804024, 144.96308399"
21120250512,21,2025-05-12,1,15,19,34,Bourke155_T,"-37.81267313, 144.96788288"
47220251009,47,2025-10-09,2,34,21,55,Eli250_T,"-37.81258467, 144.9625775"
441120240830,44,2024-08-30,11,78,82,160,UM3_T,"-37.79698741, 144.96441306"
441620241029,44,2024-10-29,16,106,62,168,UM3_T,"-37.79698741, 144.96441306"
51720251016,5,2025-10-16,17,1251,1295,2546,PriNW_T,"-37.81874249, 144.96787656"
5220240324,5,2024-03-24,2,50,82,132,PriNW_T,"-37.81874249, 144.96787656"
124820251016,124,2025-10-16,8,2,2,4,BirBridge_T,"-37.81757416, 144.97329934"
1081020240113,108,2024-01-13,10,131,132,263,261Will_T,"-37.81295822, 144.95678789"
108120240305,108,2024-03-05,1,19,11,30,261Will_T,"-37.81295822, 144.95678789"
1082220250302,108,2025-03-02,22,68,67,135,261Will_T,"-37.81295822, 144.95678789"
871020240914,87,2024-09-14,10,86,92,178,Errol23_T,"-37.80454949, 144.94921863"
50120231111,50,2023-11-11,1,6,3,9,Lyg309_T,"-37.79808192, 144.96721013"
501920250929,50,2025-09-29,19,175,168,343,Lyg309_T,"-37.79808192, 144.96721013"
1651420241006,165,2024-10-06,14,26,32,58,Spen475_T,"-37.80953359, 144.94939004"
1651820250109,165,2025-01-09,18,47,29,76,Spen475_T,"-37.80953359, 144.94939004"
1672120250218,167,2025-02-18,21,13,28,41,Lat526_T,"-37.81304149, 144.95155955"
140720250623,140,2025-06-23,7,42,13,55,Boyd2837_T,"-37.82590962, 144.96185972"
143920241108,143,2024-11-08,9,94,207,301,Spencer_T,"-37.821728, 144.95557015"
4120240903,4,2024-09-03,1,14,10,24,Swa123_T,"-37.81487988, 144.9660878"
701920231114,70,2023-11-14,19,171,165,336,Errol20_T,"-37.80456984, 144.94946228"
3420231116,3,2023-11-16,4,32,28,60,Swa295_T,"-37.81101524, 144.96429485"
32320240904,3,2024-09-04,23,181,183,364,Swa295_T,"-37.81101524, 144.96429485"
31920250102,3,2025-01-02,19,877,878,1755,Swa295_T,"-37.81101524, 144.96429485"
75520250816,75,2025-08-16,5,7,2,9,SprFli_T,"-37.81515276, 144.97467661"
391520240311,39,2024-03-11,15,29,31,60,AlfPl_T,"-37.81379749, 144.96995745"
422020250717,42,2025-07-17,20,35,29,64,UM1_T,"-37.80008566, 144.96386412"
771820240109,77,2024-01-09,18,243,166,409,HarEsP_T,"-37.81441438, 144.94433026"
772220240317,77,2024-03-17,22,18,21,39,HarEsP_T,"-37.81441438, 144.94433026"
141620240816,14,2024-08-16,16,504,193,697,SanBri_T,"-37.82011242, 144.96291897"
712220250121,71,2025-01-21,22,3,4,7,WestWP_T,"-37.81235775, 144.97136962"
711320250729,71,2025-07-29,13,10,15,25,WestWP_T,"-37.81235775, 144.97136962"
471120240113,47,2024-01-13,11,729,807,1536,Eli250_T,"-37.81258467, 144.9625775"
401520241126,40,2024-11-26,15,153,178,331,Spr201_T,"-37.80999341, 144.97227587"
401620231101,40,2023-11-01,16,140,173,313,Spr201_T,"-37.80999341, 144.97227587"
31420250226,31,2025-02-26,4,8,0,8,Lyg161_T,"-37.80169681, 144.96658911"
372220240718,37,2024-07-18,22,25,51,76,Lyg260_T,"-37.80107122, 144.96704554"
37620250804,37,2025-08-04,6,7,6,13,Lyg260_T,"-37.80107122, 144.96704554"
371120240101,37,2024-01-01,11,37,66,103,Lyg260_T,"-37.80107122, 144.96704554"
87920240519,87,2024-05-19,9,56,75,131,Errol23_T,"-37.80454949, 144.94921863"
50920250809,50,2025-08-09,9,75,122,197,Lyg309_T,"-37.79808192, 144.96721013"
5320251006,5,2025-10-06,3,20,11,31,PriNW_T,"-37.81874249, 144.96787656"
5120241205,5,2024-12-05,1,23,54,77,PriNW_T,"-37.81874249, 144.96787656"
21720250518,21,2025-05-18,7,16,32,48,Bourke155_T,"-37.81267313, 144.96788288"
212220250819,21,2025-08-19,22,157,138,295,Bourke155_T,"-37.81267313, 144.96788288"
1621020250304,162,2025-03-04,10,366,367,733,Eli489_T,"-37.80740397, 144.95987909"
1351420250331,135,2025-03-31,14,419,415,834,Spen161_T,"-37.8172861, 144.95319102"
135720250721,135,2025-07-21,7,155,156,311,Spen161_T,"-37.8172861, 144.95319102"
1082020250915,108,2025-09-15,20,178,85,263,261Will_T,"-37.81295822, 144.95678789"
871820250325,87,2025-03-25,18,148,105,253,Errol23_T,"-37.80454949, 144.94921863"
179120250829,179,2025-08-29,1,5,7,12,Pow61_T,"-37.82392385, 144.96299677"
1661020250109,166,2025-01-09,10,38,47,85,Spen484_T,"-37.80896733, 144.94931703"
1662220250705,166,2025-07-05,22,104,6,110,Spen484_T,"-37.80896733, 144.94931703"
851020240907,85,2024-09-07,10,129,139,268,488Mac_T,"-37.79432415, 144.92973378"
85920250130,85,2025-01-30,9,116,63,179,488Mac_T,"-37.79432415, 144.92973378"
852320240415,85,2024-04-15,23,3,0,3,488Mac_T,"-37.79432415, 144.92973378"
11920240322,1,2024-03-22,19,1069,872,1941,Bou292_T,"-37.81349441, 144.96515323"
1820250228,1,2025-02-28,8,191,207,398,Bou292_T,"-37.81349441, 144.96515323"
18620240101,18,2024-01-01,6,4,6,10,Col12_T,"-37.81344862, 144.97305353"
621920240119,62,2024-01-19,19,246,202,448,Lat224_T,"-37.80996494, 144.96216521"
561020241206,56,2024-12-06,10,247,177,424,Lon364_T,"-37.81234775, 144.96153311"
24720240429,24,2024-04-29,7,848,227,1075,Col620_T,"-37.81887963, 144.95449198"
242220240731,24,2024-07-31,22,195,337,532,Col620_T,"-37.81887963, 144.95449198"
72220240213,72,2024-02-13,2,1,3,4,ACMI_T,"-37.81726338, 144.96872809"
72120250131,72,2025-01-31,1,1,6,7,ACMI_T,"-37.81726338, 144.96872809"
102220240302,10,2024-03-02,22,25,0,25,BouHbr_T,"-37.81876474, 144.94710545"
35720240521,35,2024-05-21,7,454,823,1277,SouthB_T,"-37.82018685, 144.96508508"
53920240721,53,2024-07-21,9,165,165,330,Col254_T,"-37.81564191, 144.965499"
53020241104,53,2024-11-04,0,25,11,36,Col254_T,"-37.81564191, 144.965499"
791520240520,79,2024-05-20,15,373,357,730,FliSS_T,"-37.81794046, 144.96616678"
70120240102,70,2024-01-02,1,3,2,5,Errol20_T,"-37.80456984, 144.94946228"
39020241229,39,2024-12-29,0,0,3,3,AlfPl_T,"-37.81379749, 144.96995745"
8520250131,8,2025-01-31,5,7,4,11,WebBN_T,"-37.82293543, 144.9471751"
41620250204,41,2025-02-04,6,521,148,669,Swa31,"-37.81668634, 144.96689733"
411620250224,41,2025-02-24,16,1499,2069,3568,Swa31,"-37.81668634, 144.96689733"
411020240111,41,2024-01-11,10,1209,677,1886,Swa31,"-37.81668634, 144.96689733"
8420240514,8,2024-05-14,4,0,1,1,WebBN_T,"-37.82293543, 144.9471751"
14620241113,14,2024-11-13,6,102,127,229,SanBri_T,"-37.82011242, 144.96291897"
71020240911,71,2024-09-11,0,15,7,22,WestWP_T,"-37.81235775, 144.97136962"
40120240219,40,2024-02-19,1,3,6,9,Spr201_T,"-37.80999341, 144.97227587"
61620250519,61,2025-05-19,6,17,29,46,RMIT14_T,"-37.80767455, 144.96309114"
612220250305,61,2025-03-05,22,290,206,496,RMIT14_T,"-37.80767455, 144.96309114"
45620250822,45,2025-08-22,6,39,53,92,Swa148_T,"-37.81414075, 144.96609379"
45120241223,45,2024-12-23,1,13,33,46,Swa148_T,"-37.81414075, 144.96609379"
5320250508,5,2025-05-08,3,12,17,29,PriNW_T,"-37.81874249, 144.96787656"
1321820251004,132,2025-10-04,18,185,158,343,King335_T,"-37.81267639, 144.95386444"
1341220250726,134,2025-07-26,12,376,352,728,Spen201_T,"-37.81694221, 144.95303935"
134120231202,134,2023-12-02,1,100,113,213,Spen201_T,"-37.81694221, 144.95303935"
131720240818,131,2024-08-18,7,26,28,54,King2_T,"-37.82009057, 144.95758725"
107720250113,107,2025-01-13,7,23,75,98,280Will_T,"-37.81246271, 144.95690188"
1071520250913,107,2025-09-13,15,104,228,332,280Will_T,"-37.81246271, 144.95690188"
1182120240726,118,2024-07-26,21,11,8,19,Fli114C_T,"-37.81632783, 144.97090512"
1241720250701,124,2025-07-01,17,0,1,1,BirBridge_T,"-37.81757416, 144.97329934"
872320251003,87,2025-10-03,23,11,30,41,Errol23_T,"-37.80454949, 144.94921863"
1842020251012,184,2025-10-12,20,230,330,560,Eli124_T,"-37.81512416, 144.96371988"
167220250613,167,2025-06-13,2,3,2,5,Lat526_T,"-37.81304149, 144.95155955"
181420250822,181,2025-08-22,4,31,27,58,Eli368_T,"-37.81009465, 144.96143149"
1621120241215,162,2024-12-15,11,634,736,1370,Eli489_T,"-37.80740397, 144.95987909"
162520250127,162,2025-01-27,5,17,8,25,Eli489_T,"-37.80740397, 144.95987909"
701420251002,70,2025-10-02,14,115,126,241,Errol20_T,"-37.80456984, 144.94946228"
8820241113,8,2024-11-13,8,226,146,372,WebBN_T,"-37.82293543, 144.9471751"
81220240122,8,2024-01-22,12,239,441,680,WebBN_T,"-37.82293543, 144.9471751"
141120241105,14,2024-11-05,11,330,126,456,SanBri_T,"-37.82011242, 144.96291897"
541620250728,54,2025-07-28,16,208,461,669,Swa607_T,"-37.804024, 144.96308399"
282220250716,28,2025-07-16,22,111,49,160,VAC_T,"-37.82129925, 144.96879309"
281420240122,28,2024-01-22,14,825,851,1676,VAC_T,"-37.82129925, 144.96879309"
28420240630,28,2024-06-30,4,4,9,13,VAC_T,"-37.82129925, 144.96879309"
291120250203,29,2025-02-03,11,157,199,356,AG_T,"-37.8199817, 144.96872865"
402320250812,40,2025-08-12,23,24,16,40,Spr201_T,"-37.80999341, 144.97227587"
36020250218,36,2025-02-18,0,9,9,18,Que85_T,"-37.81652527, 144.96121062"
61520250403,61,2025-04-03,5,12,15,27,RMIT14_T,"-37.80767455, 144.96309114"
501120250110,50,2025-01-10,11,165,188,353,Lyg309_T,"-37.79808192, 144.96721013"
50420250311,50,2025-03-11,4,6,1,7,Lyg309_T,"-37.79808192, 144.96721013"
51820240404,5,2024-04-04,18,974,1398,2372,PriNW_T,"-37.81874249, 144.96787656"
1322220240507,132,2024-05-07,22,56,62,118,King335_T,"-37.81267639, 144.95386444"
1342020250712,134,2025-07-12,20,321,271,592,Spen201_T,"-37.81694221, 144.95303935"
135720240324,135,2024-03-24,7,111,202,313,Spen161_T,"-37.8172861, 144.95319102"
135120250412,135,2025-04-12,1,65,69,134,Spen161_T,"-37.8172861, 144.95319102"
871520250323,87,2025-03-23,15,91,103,194,Errol23_T,"-37.80454949, 144.94921863"
1661920250806,166,2025-08-06,19,21,43,64,Spen484_T,"-37.80896733, 144.94931703"
681020250514,68,2025-05-14,10,246,232,478,FLDegN_T,"-37.8168479, 144.96559789"
1720250928,1,2025-09-28,7,27,31,58,Bou292_T,"-37.81349441, 144.96515323"
861420250928,86,2025-09-28,14,47,61,108,574Qub_T,"-37.80309992, 144.94908064"
111420240703,11,2024-07-03,14,87,58,145,WatCit_T,"-37.81564989, 144.93970694"
102220231127,10,2023-11-27,22,15,12,27,BouHbr_T,"-37.81876474, 144.94710545"
10620241213,10,2024-12-13,6,18,26,44,BouHbr_T,"-37.81876474, 144.94710545"
24520250320,24,2025-03-20,5,112,57,169,Col620_T,"-37.81887963, 144.95449198"
241420250408,24,2025-04-08,14,463,848,1311,Col620_T,"-37.81887963, 144.95449198"
35520240613,35,2024-06-13,5,94,60,154,SouthB_T,"-37.82018685, 144.96508508"
9520250824,9,2025-08-24,5,9,4,13,Col700_T,"-37.81982992, 144.95102555"
531420250219,53,2025-02-19,14,698,618,1316,Col254_T,"-37.81564191, 144.965499"
531420250902,53,2025-09-02,14,603,541,1144,Col254_T,"-37.81564191, 144.965499"
52920231231,52,2023-12-31,9,112,44,156,Eli263_T,"-37.81252157, 144.9619401"
491220240326,49,2024-03-26,12,409,582,991,Eli501_T,"-37.80730068, 144.95956055"
481720231114,48,2023-11-14,17,125,189,314,QVMQ_T,"-37.80631581, 144.95866697"
1801520250702,180,2025-07-02,15,23,19,42,Mac330_T,"-37.79497059, 144.93530329"
1361320250724,136,2025-07-24,13,124,182,306,BirFed1120_T,"-37.8184141, 144.97357915"
1361620250922,136,2025-09-22,16,86,36,122,BirFed1120_T,"-37.8184141, 144.97357915"
1421320241029,142,2024-10-29,13,511,434,945,Hammer1584_T,"-37.81970749, 144.96795734"
142920240822,142,2024-08-22,9,148,125,273,Hammer1584_T,"-37.81970749, 144.96795734"
164520240918,164,2024-09-18,5,3,1,4,Lat526_T,"-37.813005, 144.95160411"
1171120250517,117,2025-05-17,11,242,202,444,Fli114F_T,"-37.81629332, 144.97090877"
69820250127,69,2025-01-27,8,94,46,140,FLDegC_T,"-37.81687226, 144.96559144"
61920250219,6,2025-02-19,19,733,641,1374,FliS_T,"-37.81911705, 144.96558255"
841720251008,84,2025-10-08,17,1158,2232,3390,ElFi_T,"-37.81798049, 144.96503383"
42320250607,4,2025-06-07,23,653,576,1229,Swa123_T,"-37.81487988, 144.9660878"
66420240711,66,2024-07-11,4,13,14,27,QVN_T,"-37.81057846, 144.96444294"
662120250823,66,2025-08-23,21,1271,877,2148,QVN_T,"-37.81057846, 144.96444294"
61120250721,6,2025-07-21,11,543,406,949,FliS_T,"-37.81911705, 144.96558255"
4520240121,4,2024-01-21,5,38,43,81,Swa123_T,"-37.81487988, 144.9660878"
41620240222,4,2024-02-22,16,1261,1217,2478,Swa123_T,"-37.81487988, 144.9660878"
81220241011,8,2024-10-11,12,205,385,590,WebBN_T,"-37.82293543, 144.9471751"
41420250325,41,2025-03-25,4,74,106,180,Swa31,"-37.81668634, 144.96689733"
781420231111,78,2023-11-11,14,49,82,131,HarEsB_T,"-37.81471642, 144.9446508"
772120240602,77,2024-06-02,21,5,3,8,HarEsP_T,"-37.81441438, 144.94433026"
782320250206,78,2025-02-06,23,3,8,11,HarEsB_T,"-37.81471642, 144.9446508"
711220250309,71,2025-03-09,12,8,8,16,WestWP_T,"-37.81235775, 144.97136962"
71220250713,71,2025-07-13,2,1,1,2,WestWP_T,"-37.81235775, 144.97136962"
591520251010,59,2025-10-10,15,846,1100,1946,RMIT_T,"-37.80825648, 144.96304859"
40420250731,40,2025-07-31,4,4,2,6,Spr201_T,"-37.80999341, 144.97227587"
36720240515,36,2024-05-15,7,97,67,164,Que85_T,"-37.81652527, 144.96121062"
25720231223,25,2023-12-23,7,88,110,198,MCEC_T,"-37.82401776, 144.95604426"
20920240323,20,2024-03-23,9,38,66,104,LtB170_T,"-37.81172914, 144.9682466"
141120231220,141,2023-12-20,1,12,14,26,474Fl_T,"-37.81997273, 144.95834911"
117920250824,117,2025-08-24,9,69,128,197,Fli114F_T,"-37.81629332, 144.97090877"
109120240202,109,2024-02-02,1,10,19,29,LatWill_T,"-37.81193681, 144.95621105"
66020250407,66,2025-04-07,0,62,51,113,QVN_T,"-37.81057846, 144.96444294"
41920240424,4,2024-04-24,19,1000,697,1697,Swa123_T,"-37.81487988, 144.9660878"
41420250416,4,2025-04-16,14,2062,1808,3870,Swa123_T,"-37.81487988, 144.9660878"
392320250720,39,2025-07-20,23,0,1,1,AlfPl_T,"-37.81379749, 144.96995745"
31820240921,3,2024-09-21,18,855,1185,2040,Swa295_T,"-37.81101524, 144.96429485"
3020241119,3,2024-11-19,0,104,57,161,Swa295_T,"-37.81101524, 144.96429485"
81820240310,8,2024-03-10,18,129,80,209,WebBN_T,"-37.82293543, 144.9471751"
411420250621,41,2025-06-21,14,1930,1469,3399,Swa31,"-37.81668634, 144.96689733"
771020250928,77,2025-09-28,10,123,127,250,HarEsP_T,"-37.81441438, 144.94433026"
141820240305,14,2024-03-05,18,555,167,722,SanBri_T,"-37.82011242, 144.96291897"
711920240328,71,2024-03-28,19,24,16,40,WestWP_T,"-37.81235775, 144.97136962"
65620231128,65,2023-11-28,6,66,42,108,SwaCs_T,"-37.81569416, 144.9668064"
54320250313,54,2025-03-13,3,5,3,8,Swa607_T,"-37.804024, 144.96308399"
542220240206,54,2024-02-06,22,65,54,119,Swa607_T,"-37.804024, 144.96308399"
361620251008,36,2025-10-08,16,230,181,411,Que85_T,"-37.81652527, 144.96121062"
36020231120,36,2023-11-20,0,14,15,29,Que85_T,"-37.81652527, 144.96121062"
361020240504,36,2024-05-04,10,101,102,203,Que85_T,"-37.81652527, 144.96121062"
37320240911,37,2024-09-11,3,2,6,8,Lyg260_T,"-37.80107122, 144.96704554"
37420250502,37,2025-05-02,4,0,3,3,Lyg260_T,"-37.80107122, 144.96704554"
611220240401,61,2024-04-01,12,186,370,556,RMIT14_T,"-37.80767455, 144.96309114"
44120241001,44,2024-10-01,1,1,0,1,UM3_T,"-37.79698741, 144.96441306"
52320240607,5,2024-06-07,23,215,314,529,PriNW_T,"-37.81874249, 144.96787656"
1311720240920,131,2024-09-20,17,113,97,210,King2_T,"-37.82009057, 144.95758725"
1431820251013,143,2025-10-13,18,172,253,425,Spencer_T,"-37.821728, 144.95557015"
1081020250415,108,2025-04-15,10,321,395,716,261Will_T,"-37.81295822, 144.95678789"
165920241221,165,2024-12-21,9,24,28,52,Spen475_T,"-37.80953359, 144.94939004"
1661320241009,166,2024-10-09,13,79,70,149,Spen484_T,"-37.80896733, 144.94931703"
1671820250314,167,2025-03-14,18,138,124,262,Lat526_T,"-37.81304149, 144.95155955"
1402020251011,140,2025-10-11,20,0,1,1,Boyd2837_T,"-37.82590962, 144.96185972"
67420240331,67,2024-03-31,4,10,15,25,FLDegS_T,"-37.81688755, 144.96562569"
17820240601,17,2024-06-01,8,130,52,182,Col15_T,"-37.81362543, 144.97323591"
681920250416,68,2025-04-16,19,179,101,280,FLDegN_T,"-37.8168479, 144.96559789"
682020240307,68,2024-03-07,20,78,13,91,FLDegN_T,"-37.8168479, 144.96559789"
63620250221,63,2025-02-21,6,6,12,18,Bou231_T,"-37.81333081, 144.96675571"
631520250412,63,2025-04-12,15,469,663,1132,Bou231_T,"-37.81333081, 144.96675571"
111320231201,11,2023-12-01,13,93,97,190,WatCit_T,"-37.81564989, 144.93970694"
11520240226,11,2024-02-26,5,1,1,2,WatCit_T,"-37.81564989, 144.93970694"
681220240714,68,2024-07-14,12,215,169,384,FLDegN_T,"-37.8168479, 144.96559789"
18720240224,18,2024-02-24,7,5,21,26,Col12_T,"-37.81344862, 144.97305353"
362320240912,36,2024-09-12,23,37,49,86,Que85_T,"-37.81652527, 144.96121062"
37720240108,37,2024-01-08,7,2,10,12,Lyg260_T,"-37.80107122, 144.96704554"
61920241014,61,2024-10-14,9,430,404,834,RMIT14_T,"-37.80767455, 144.96309114"
501420250104,50,2025-01-04,14,169,199,368,Lyg309_T,"-37.79808192, 144.96721013"
502020250510,50,2025-05-10,20,365,294,659,Lyg309_T,"-37.79808192, 144.96721013"
501120250515,50,2025-05-15,11,136,159,295,Lyg309_T,"-37.79808192, 144.96721013"
442320231104,44,2023-11-04,23,2,7,9,UM3_T,"-37.79698741, 144.96441306"
21420240530,21,2024-05-30,4,5,12,17,Bourke155_T,"-37.81267313, 144.96788288"
1322020250524,132,2025-05-24,20,100,92,192,King335_T,"-37.81267639, 144.95386444"
1322120250730,132,2025-07-30,21,74,127,201,King335_T,"-37.81267639, 144.95386444"
131020240501,131,2024-05-01,0,26,13,39,King2_T,"-37.82009057, 144.95758725"
118920251004,118,2025-10-04,9,5,38,43,Fli114C_T,"-37.81632783, 144.97090512"
851020250205,85,2025-02-05,10,69,61,130,488Mac_T,"-37.79432415, 144.92973378"
172220250330,17,2025-03-30,22,34,29,63,Col15_T,"-37.81362543, 144.97323591"
1520250208,1,2025-02-08,5,10,10,20,Bou292_T,"-37.81349441, 144.96515323"
67420250606,67,2025-06-06,4,7,6,13,FLDegS_T,"-37.81688755, 144.96562569"
671220250321,67,2025-03-21,12,525,610,1135,FLDegS_T,"-37.81688755, 144.96562569"
681520240218,68,2024-02-18,15,226,211,437,FLDegN_T,"-37.8168479, 144.96559789"
181620250408,18,2025-04-08,16,572,117,689,Col12_T,"-37.81344862, 144.97305353"
631020241224,63,2024-12-24,10,176,299,475,Bou231_T,"-37.81333081, 144.96675571"
632220250913,63,2025-09-13,22,182,344,526,Bou231_T,"-37.81333081, 144.96675571"
63320250908,63,2025-09-08,3,0,4,4,Bou231_T,"-37.81333081, 144.96675571"
1720250317,1,2025-03-17,7,80,99,179,Bou292_T,"-37.81349441, 144.96515323"
861020240930,86,2024-09-30,10,34,36,70,574Qub_T,"-37.80309992, 144.94908064"
111320240518,11,2024-05-18,13,115,120,235,WatCit_T,"-37.81564989, 144.93970694"
56120231106,56,2023-11-06,1,7,12,19,Lon364_T,"-37.81234775, 144.96153311"
242320240229,24,2024-02-29,23,196,247,443,Col620_T,"-37.81887963, 144.95449198"
241420240719,24,2024-07-19,14,565,936,1501,Col620_T,"-37.81887963, 144.95449198"
241920250122,24,2025-01-22,19,300,530,830,Col620_T,"-37.81887963, 144.95449198"
24120250211,24,2025-02-11,1,30,29,59,Col620_T,"-37.81887963, 144.95449198"
721020241228,72,2024-12-28,10,172,162,334,ACMI_T,"-37.81726338, 144.96872809"
581120240414,58,2024-04-14,11,566,229,795,Bou688_T,"-37.81686075, 144.95358075"
35620240426,35,2024-04-26,6,183,133,316,SouthB_T,"-37.82018685, 144.96508508"
76620231222,76,2023-12-22,6,9,5,14,KenMac_T,"-37.79453803, 144.93036194"
72420240827,72,2024-08-27,4,0,1,1,ACMI_T,"-37.81726338, 144.96872809"
91520240609,9,2024-06-09,15,79,94,173,Col700_T,"-37.81982992, 144.95102555"
30720240329,30,2024-03-29,7,14,18,32,Lon189_T,"-37.8112185, 144.96656806"
9720241016,9,2024-10-16,7,54,1381,1435,Col700_T,"-37.81982992, 144.95102555"
531420231217,53,2023-12-17,14,990,657,1647,Col254_T,"-37.81564191, 144.965499"
791220250912,79,2025-09-12,12,418,389,807,FliSS_T,"-37.81794046, 144.96616678"
792020251004,79,2025-10-04,20,378,485,863,FliSS_T,"-37.81794046, 144.96616678"
301220250104,30,2025-01-04,12,214,250,464,Lon189_T,"-37.8112185, 144.96656806"
521820250602,52,2025-06-02,18,269,299,568,Eli263_T,"-37.81252157, 144.9619401"
52720250614,52,2025-06-14,7,16,16,32,Eli263_T,"-37.81252157, 144.9619401"
251820241106,25,2024-11-06,18,763,452,1215,MCEC_T,"-37.82401776, 144.95604426"
191420250302,19,2025-03-02,14,578,571,1149,LtB210_T,"-37.81237202, 144.96550671"
1422120250228,142,2025-02-28,21,92,84,176,Hammer1584_T,"-37.81970749, 144.96795734"
123720250506,123,2025-05-06,7,46,31,77,BirBridge_T,"-37.81753741, 144.97329734"
182320250519,18,2025-05-19,23,3,1,4,Col12_T,"-37.81344862, 144.97305353"
63620250108,63,2025-01-08,6,14,23,37,Bou231_T,"-37.81333081, 144.96675571"
1520250613,1,2025-06-13,5,8,15,23,Bou292_T,"-37.81349441, 144.96515323"
1120250716,1,2025-07-16,1,11,19,30,Bou292_T,"-37.81349441, 144.96515323"
111120240417,11,2024-04-17,11,32,44,76,WatCit_T,"-37.81564989, 144.93970694"
621220241230,62,2024-12-30,12,169,97,266,Lat224_T,"-37.80996494, 144.96216521"
1351220231122,135,2023-11-22,12,540,692,1232,Spen161_T,"-37.8172861, 144.95319102"
851420231106,85,2023-11-06,14,68,58,126,488Mac_T,"-37.79432415, 144.92973378"
171820231105,17,2023-11-05,18,120,133,253,Col15_T,"-37.81362543, 144.97323591"
17020250711,17,2025-07-11,0,4,6,10,Col15_T,"-37.81362543, 144.97323591"
1120241008,1,2024-10-08,1,8,29,37,Bou292_T,"-37.81349441, 144.96515323"
632020241016,63,2024-10-16,20,96,287,383,Bou231_T,"-37.81333081, 144.96675571"
63520240816,63,2024-08-16,5,7,13,20,Bou231_T,"-37.81333081, 144.96675571"
681920240907,68,2024-09-07,19,168,65,233,FLDegN_T,"-37.8168479, 144.96559789"
181720250531,18,2025-05-31,17,53,80,133,Col12_T,"-37.81344862, 144.97305353"
181820250912,18,2025-09-12,18,105,51,156,Col12_T,"-37.81344862, 144.97305353"
631120250809,63,2025-08-09,11,367,410,777,Bou231_T,"-37.81333081, 144.96675571"
861020240222,86,2024-02-22,10,40,39,79,574Qub_T,"-37.80309992, 144.94908064"
11220240209,11,2024-02-09,2,3,7,10,WatCit_T,"-37.81564989, 144.93970694"
621020241020,62,2024-10-20,10,89,128,217,Lat224_T,"-37.80996494, 144.96216521"
12120241127,12,2024-11-27,1,3,7,10,NewQ_T,"-37.81457988, 144.94292398"
121720250422,12,2025-04-22,17,208,315,523,NewQ_T,"-37.81457988, 144.94292398"
121920250908,12,2025-09-08,19,63,83,146,NewQ_T,"-37.81457988, 144.94292398"
72520240317,72,2024-03-17,5,3,14,17,ACMI_T,"-37.81726338, 144.96872809"
721420240405,72,2024-04-05,14,269,454,723,ACMI_T,"-37.81726338, 144.96872809"
10120250810,10,2025-08-10,1,0,1,1,BouHbr_T,"-37.81876474, 144.94710545"
581120250102,58,2025-01-02,11,797,193,990,Bou688_T,"-37.81686075, 144.95358075"
2020240204,2,2024-02-04,0,49,122,171,Bou283_T,"-37.81380668, 144.96516718"
351720231210,35,2023-12-10,17,1395,1866,3261,SouthB_T,"-37.82018685, 144.96508508"
351020231221,35,2023-12-21,10,722,651,1373,SouthB_T,"-37.82018685, 144.96508508"
21420240720,2,2024-07-20,14,818,724,1542,Bou283_T,"-37.81380668, 144.96516718"
53120240822,53,2024-08-22,1,5,3,8,Col254_T,"-37.81564191, 144.965499"
9520231030,9,2023-10-30,5,13,32,45,Col700_T,"-37.81982992, 144.95102555"
30420250203,30,2025-02-03,4,6,23,29,Lon189_T,"-37.8112185, 144.96656806"
481820240310,48,2024-03-10,18,68,95,163,QVMQ_T,"-37.80631581, 144.95866697"
482020240410,48,2024-04-10,20,181,287,468,QVMQ_T,"-37.80631581, 144.95866697"
48120241126,48,2024-11-26,1,14,7,21,QVMQ_T,"-37.80631581, 144.95866697"
46520240521,46,2024-05-21,5,6,3,9,Pel147_T,"-37.80240719, 144.9615673"
251620240809,25,2024-08-09,16,856,665,1521,MCEC_T,"-37.82401776, 144.95604426"
521920240913,52,2024-09-13,19,365,301,666,Eli263_T,"-37.81252157, 144.9619401"
1392320250618,139,2025-06-18,23,7,1,8,Signal1647_T,"-37.81959923, 144.9632832"
161820250219,161,2025-02-19,8,120,196,316,BirArt1109_T,"-37.81851276, 144.97131336"
491820250203,49,2025-02-03,18,147,179,326,Eli501_T,"-37.80730068, 144.95956055"
1171020250401,117,2025-04-01,10,152,120,272,Fli114F_T,"-37.81629332, 144.97090877"
117320231126,117,2023-11-26,3,20,10,30,Fli114F_T,"-37.81629332, 144.97090877"
109820240107,109,2024-01-07,8,30,18,48,LatWill_T,"-37.81193681, 144.95621105"
61720231214,6,2023-12-14,17,2583,1380,3963,FliS_T,"-37.81911705, 144.96558255"
61420240527,6,2024-05-27,14,705,523,1228,FliS_T,"-37.81911705, 144.96558255"
84520240501,84,2024-05-01,5,59,48,107,ElFi_T,"-37.81798049, 144.96503383"
84620250102,84,2025-01-02,6,124,71,195,ElFi_T,"-37.81798049, 144.96503383"
70820250516,70,2025-05-16,8,71,76,147,Errol20_T,"-37.80456984, 144.94946228"
392220240907,39,2024-09-07,22,3,6,9,AlfPl_T,"-37.81379749, 144.96995745"
81820250929,8,2025-09-29,18,119,133,252,WebBN_T,"-37.82293543, 144.9471751"
81720250617,8,2025-06-17,17,126,230,356,WebBN_T,"-37.82293543, 144.9471751"
81220240830,8,2024-08-30,12,159,284,443,WebBN_T,"-37.82293543, 144.9471751"
411820241110,41,2024-11-10,18,832,948,1780,Swa31,"-37.81668634, 144.96689733"
421720241211,42,2024-12-11,17,113,160,273,UM1_T,"-37.80008566, 144.96386412"
59420250405,59,2025-04-05,4,14,10,24,RMIT_T,"-37.80825648, 144.96304859"
591920240407,59,2024-04-07,19,488,372,860,RMIT_T,"-37.80825648, 144.96304859"
652020240203,65,2024-02-03,20,309,630,939,SwaCs_T,"-37.81569416, 144.9668064"
282120231201,28,2023-12-01,21,378,512,890,VAC_T,"-37.82129925, 144.96879309"
141820241123,14,2024-11-23,18,419,152,571,SanBri_T,"-37.82011242, 144.96291897"
28820241108,28,2024-11-08,8,411,243,654,VAC_T,"-37.82129925, 144.96879309"
47620250813,47,2025-08-13,6,52,117,169,Eli250_T,"-37.81258467, 144.9625775"
102320241103,10,2024-11-03,23,557,274,831,BouHbr_T,"-37.81876474, 144.94710545"
241920240113,24,2024-01-13,19,308,453,761,Col620_T,"-37.81887963, 144.95449198"
721020240616,72,2024-06-16,10,80,139,219,ACMI_T,"-37.81726338, 144.96872809"
10120250905,10,2025-09-05,1,2,2,4,BouHbr_T,"-37.81876474, 144.94710545"
102220250227,10,2025-02-27,22,17,18,35,BouHbr_T,"-37.81876474, 144.94710545"
581620240303,58,2024-03-03,16,428,298,726,Bou688_T,"-37.81686075, 144.95358075"
9920240107,9,2024-01-07,9,25,35,60,Col700_T,"-37.81982992, 144.95102555"
791720241121,79,2024-11-21,17,989,657,1646,FliSS_T,"-37.81794046, 144.96616678"
531520250806,53,2025-08-06,15,577,519,1096,Col254_T,"-37.81564191, 144.965499"
531620231202,53,2023-12-02,16,706,719,1425,Col254_T,"-37.81564191, 144.965499"
79420250718,79,2025-07-18,4,7,9,16,FliSS_T,"-37.81794046, 144.96616678"
23520240424,23,2024-04-24,5,19,7,26,Col623_T,"-37.81909256, 144.95452748"
51020250622,51,2025-06-22,0,11,18,29,Fra118_T,"-37.80841815, 144.95906316"
201820250919,20,2025-09-19,18,593,437,1030,LtB170_T,"-37.81172914, 144.9682466"
48820240211,48,2024-02-11,8,71,107,178,QVMQ_T,"-37.80631581, 144.95866697"
462220240928,46,2024-09-28,22,3,0,3,Pel147_T,"-37.80240719, 144.9615673"
201420231225,20,2023-12-25,14,151,211,362,LtB170_T,"-37.81172914, 144.9682466"
1392220250914,139,2025-09-14,22,1,3,4,Signal1647_T,"-37.81959923, 144.9632832"
137720241012,137,2024-10-12,7,6,3,9,BouHbr2353_T,"-37.81894815, 144.94612292"
142120240503,142,2024-05-03,1,3,4,7,Hammer1584_T,"-37.81970749, 144.96795734"
1641220251011,164,2025-10-11,12,136,77,213,Lat526_T,"-37.813005, 144.95160411"
1381120250826,138,2025-08-26,11,6,12,18,EntPark1671_T,"-37.81996544, 144.95981454"
1611820241223,161,2024-12-23,18,512,129,641,BirArt1109_T,"-37.81851276, 144.97131336"
1612320250331,161,2025-03-31,23,0,1,1,BirArt1109_T,"-37.81851276, 144.97131336"
130820240225,130,2024-02-25,8,21,17,38,Bou892T,"-37.8204637, 144.94126826"
61720250912,6,2025-09-12,17,1777,1148,2925,FliS_T,"-37.81911705, 144.96558255"
42220240210,4,2024-02-10,22,1229,780,2009,Swa123_T,"-37.81487988, 144.9660878"
42020240521,4,2024-05-21,20,494,355,849,Swa123_T,"-37.81487988, 144.9660878"
41920241217,4,2024-12-17,19,1317,1236,2553,Swa123_T,"-37.81487988, 144.9660878"
4920250118,4,2025-01-18,9,693,496,1189,Swa123_T,"-37.81487988, 144.9660878"
32220250418,3,2025-04-18,22,614,521,1135,Swa295_T,"-37.81101524, 144.96429485"
3220231209,3,2023-12-09,2,294,184,478,Swa295_T,"-37.81101524, 144.96429485"
8920240514,8,2024-05-14,9,238,111,349,WebBN_T,"-37.82293543, 144.9471751"
752120240214,75,2024-02-14,21,11,30,41,SprFli_T,"-37.81515276, 144.97467661"
42620240609,42,2024-06-09,6,7,2,9,UM1_T,"-37.80008566, 144.96386412"
782020251007,78,2025-10-07,20,5,12,17,HarEsB_T,"-37.81471642, 144.9446508"
712320250831,71,2025-08-31,23,1,1,2,WestWP_T,"-37.81235775, 144.97136962"
59320231113,59,2023-11-13,3,12,11,23,RMIT_T,"-37.80825648, 144.96304859"
65320240712,65,2024-07-12,3,4,13,17,SwaCs_T,"-37.81569416, 144.9668064"
281920240518,28,2024-05-18,19,436,785,1221,VAC_T,"-37.82129925, 144.96879309"
28920240619,28,2024-06-19,9,584,199,783,VAC_T,"-37.82129925, 144.96879309"
291220250107,29,2025-01-07,12,421,471,892,AG_T,"-37.8199817, 144.96872865"
40620240811,40,2024-08-11,6,1,7,8,Spr201_T,"-37.80999341, 144.97227587"
54020240603,54,2024-06-03,0,22,33,55,Swa607_T,"-37.804024, 144.96308399"
361220231027,36,2023-10-27,12,376,247,623,Que85_T,"-37.81652527, 144.96121062"
471120240208,47,2024-02-08,11,590,666,1256,Eli250_T,"-37.81258467, 144.9625775"
612120250422,61,2025-04-22,21,278,106,384,RMIT14_T,"-37.80767455, 144.96309114"
451220250430,45,2025-04-30,12,644,782,1426,Swa148_T,"-37.81414075, 144.96609379"
45720240713,45,2024-07-13,7,33,43,76,Swa148_T,"-37.81414075, 144.96609379"
45020241214,45,2024-12-14,0,191,377,568,Swa148_T,"-37.81414075, 144.96609379"
132220250815,132,2025-08-15,2,13,7,20,King335_T,"-37.81267639, 144.95386444"
1322020231019,132,2023-10-19,20,101,94,195,King335_T,"-37.81267639, 144.95386444"
135720240211,135,2024-02-11,7,74,63,137,Spen161_T,"-37.8172861, 144.95319102"
1351220240310,135,2024-03-10,12,266,281,547,Spen161_T,"-37.8172861, 144.95319102"
1351920240909,135,2024-09-09,19,128,148,276,Spen161_T,"-37.8172861, 144.95319102"
1181120241031,118,2024-10-31,11,22,19,41,Fli114C_T,"-37.81632783, 144.97090512"
1181020241210,118,2024-12-10,10,16,25,41,Fli114C_T,"-37.81632783, 144.97090512"
118920250209,118,2025-02-09,9,5,15,20,Fli114C_T,"-37.81632783, 144.97090512"
107620240826,107,2024-08-26,6,11,21,32,280Will_T,"-37.81246271, 144.95690188"
87020241122,87,2024-11-22,0,2,9,11,Errol23_T,"-37.80454949, 144.94921863"
66020240524,66,2024-05-24,0,68,61,129,QVN_T,"-37.81057846, 144.96444294"
691520240115,69,2024-01-15,15,144,171,315,FLDegC_T,"-37.81687226, 144.96559144"
6020240630,6,2024-06-30,0,336,229,565,FliS_T,"-37.81911705, 144.96558255"
84220250504,84,2025-05-04,2,80,135,215,ElFi_T,"-37.81798049, 144.96503383"
662320240516,66,2024-05-16,23,140,125,265,QVN_T,"-37.81057846, 144.96444294"
41620240608,4,2024-06-08,16,2259,1719,3978,Swa123_T,"-37.81487988, 144.9660878"
42320240719,4,2024-07-19,23,357,410,767,Swa123_T,"-37.81487988, 144.9660878"
82220250215,8,2025-02-15,22,6,4,10,WebBN_T,"-37.82293543, 144.9471751"
8920250219,8,2025-02-19,9,257,163,420,WebBN_T,"-37.82293543, 144.9471751"
39120241127,39,2024-11-27,1,1,0,1,AlfPl_T,"-37.81379749, 144.96995745"
771620240227,77,2024-02-27,16,135,85,220,HarEsP_T,"-37.81441438, 144.94433026"
772020250922,77,2025-09-22,20,85,60,145,HarEsP_T,"-37.81441438, 144.94433026"
14420250217,14,2025-02-17,4,20,6,26,SanBri_T,"-37.82011242, 144.96291897"
28820250911,28,2025-09-11,8,588,281,869,VAC_T,"-37.82129925, 144.96879309"
281420250113,28,2025-01-13,14,1432,1017,2449,VAC_T,"-37.82129925, 144.96879309"
401920231209,40,2023-12-09,19,134,323,457,Spr201_T,"-37.80999341, 144.97227587"
40620240203,40,2024-02-03,6,9,15,24,Spr201_T,"-37.80999341, 144.97227587"
401520240206,40,2024-02-06,15,203,151,354,Spr201_T,"-37.80999341, 144.97227587"
40120240722,40,2024-07-22,1,1,2,3,Spr201_T,"-37.80999341, 144.97227587"
31220240502,31,2024-05-02,2,7,1,8,Lyg161_T,"-37.80169681, 144.96658911"
361920250504,36,2025-05-04,19,64,64,128,Que85_T,"-37.81652527, 144.96121062"
37120240210,37,2024-02-10,1,21,15,36,Lyg260_T,"-37.80107122, 144.96704554"
471820250204,47,2025-02-04,18,692,585,1277,Eli250_T,"-37.81258467, 144.9625775"
5720240901,5,2024-09-01,7,96,78,174,PriNW_T,"-37.81874249, 144.96787656"
21020240412,21,2024-04-12,0,136,126,262,Bourke155_T,"-37.81267313, 144.96788288"
21320250115,21,2025-01-15,3,2,7,9,Bourke155_T,"-37.81267313, 144.96788288"
1181520241212,118,2024-12-12,15,16,26,42,Fli114C_T,"-37.81632783, 144.97090512"
1241620250903,124,2025-09-03,16,3,2,5,BirBridge_T,"-37.81757416, 144.97329934"
185020250717,185,2025-07-17,0,48,40,88,Eli197_T,"-37.81374643, 144.96276183"
1401620250404,140,2025-04-04,16,21,39,60,Boyd2837_T,"-37.82590962, 144.96185972"
132820241116,132,2024-11-16,8,87,55,142,King335_T,"-37.81267639, 144.95386444"
1321020231025,132,2023-10-25,10,130,75,205,King335_T,"-37.81267639, 144.95386444"
134920240513,134,2024-05-13,9,248,279,527,Spen201_T,"-37.81694221, 144.95303935"
1342320240804,134,2024-08-04,23,77,87,164,Spen201_T,"-37.81694221, 144.95303935"
1311820231117,131,2023-11-17,18,100,115,215,King2_T,"-37.82009057, 144.95758725"
1071620250309,107,2025-03-09,16,75,92,167,280Will_T,"-37.81246271, 144.95690188"
1071820250918,107,2025-09-18,18,135,115,250,280Will_T,"-37.81246271, 144.95690188"
107720251008,107,2025-10-08,7,33,94,127,280Will_T,"-37.81246271, 144.95690188"
1072120240928,107,2024-09-28,21,89,60,149,280Will_T,"-37.81246271, 144.95690188"
11220240825,1,2024-08-25,12,1342,981,2323,Bou292_T,"-37.81349441, 144.96515323"
671220231224,67,2023-12-24,12,220,366,586,FLDegS_T,"-37.81688755, 144.96562569"
121720240430,12,2024-04-30,17,85,142,227,NewQ_T,"-37.81457988, 144.94292398"
622120240817,62,2024-08-17,21,274,114,388,Lat224_T,"-37.80996494, 144.96216521"
211720241108,21,2024-11-08,17,368,260,628,Bourke155_T,"-37.81267313, 144.96788288"
441420240824,44,2024-08-24,14,78,65,143,UM3_T,"-37.79698741, 144.96441306"
211820250916,21,2025-09-16,18,272,254,526,Bourke155_T,"-37.81267313, 144.96788288"
1331820241229,133,2024-12-29,18,628,561,1189,Spen229_T,"-37.81531435, 144.95227769"
1321820250506,132,2025-05-06,18,165,207,372,King335_T,"-37.81267639, 144.95386444"
132520250822,132,2025-08-22,5,12,9,21,King335_T,"-37.81267639, 144.95386444"
124820250126,124,2025-01-26,8,2,3,5,BirBridge_T,"-37.81757416, 144.97329934"
107720240907,107,2024-09-07,7,24,32,56,280Will_T,"-37.81246271, 144.95690188"
108820240514,108,2024-05-14,8,96,2202,2298,261Will_T,"-37.81295822, 144.95678789"
611720241222,61,2024-12-22,17,260,309,569,RMIT14_T,"-37.80767455, 144.96309114"
182820250712,182,2025-07-12,8,58,95,153,King163_T,"-37.81627451, 144.95550503"
167820241025,167,2024-10-25,8,8,70,78,Lat526_T,"-37.81304149, 144.95155955"
167020250120,167,2025-01-20,0,5,8,13,Lat526_T,"-37.81304149, 144.95155955"
1401520241025,140,2024-10-25,15,126,119,245,Boyd2837_T,"-37.82590962, 144.96185972"
1311520250814,131,2025-08-14,15,143,137,280,King2_T,"-37.82009057, 144.95758725"
1621220241007,162,2024-10-07,12,415,492,907,Eli489_T,"-37.80740397, 144.95987909"
1321020240706,132,2024-07-06,10,203,71,274,King335_T,"-37.81267639, 144.95386444"
132620250911,132,2025-09-11,6,24,13,37,King335_T,"-37.81267639, 144.95386444"
67820240724,67,2024-07-24,8,353,268,621,FLDegS_T,"-37.81688755, 144.96562569"
171920240827,17,2024-08-27,19,100,109,209,Col15_T,"-37.81362543, 144.97323591"
171420240922,17,2024-09-22,14,148,110,258,Col15_T,"-37.81362543, 144.97323591"
68920251016,68,2025-10-16,9,174,184,358,FLDegN_T,"-37.8168479, 144.96559789"
62420231225,62,2023-12-25,4,5,3,8,Lat224_T,"-37.80996494, 144.96216521"
62220240704,62,2024-07-04,2,15,9,24,Lat224_T,"-37.80996494, 144.96216521"
561920240528,56,2024-05-28,19,252,306,558,Lon364_T,"-37.81234775, 144.96153311"
12220250313,12,2025-03-13,2,5,7,12,NewQ_T,"-37.81457988, 144.94292398"
86220250710,86,2025-07-10,2,0,2,2,574Qub_T,"-37.80309992, 144.94908064"
17320250428,17,2025-04-28,3,4,0,4,Col15_T,"-37.81362543, 144.97323591"
242020240722,24,2024-07-22,20,227,338,565,Col620_T,"-37.81887963, 144.95449198"
241520250907,24,2025-09-07,15,353,488,841,Col620_T,"-37.81887963, 144.95449198"
58120241109,58,2024-11-09,1,57,80,137,Bou688_T,"-37.81686075, 144.95358075"
271620241025,27,2024-10-25,16,142,114,256,Vic_T,"-37.80606888, 144.95644692"
53420240901,53,2024-09-01,4,11,4,15,Col254_T,"-37.81564191, 144.965499"
791420250616,79,2025-06-16,14,325,360,685,FliSS_T,"-37.81794046, 144.96616678"
53020251001,53,2025-10-01,0,13,22,35,Col254_T,"-37.81564191, 144.965499"
512120241110,51,2024-11-10,21,44,56,100,Fra118_T,"-37.80841815, 144.95906316"
231220241214,23,2024-12-14,12,162,208,370,Col623_T,"-37.81909256, 144.95452748"
232320250326,23,2025-03-26,23,18,49,67,Col623_T,"-37.81909256, 144.95452748"
20420250721,20,2025-07-21,4,1,2,3,LtB170_T,"-37.81172914, 144.9682466"
201820241023,20,2024-10-23,18,585,259,844,LtB170_T,"-37.81172914, 144.9682466"
20120231107,20,2023-11-07,1,48,42,90,LtB170_T,"-37.81172914, 144.9682466"
52120240531,52,2024-05-31,1,3,17,20,Eli263_T,"-37.81252157, 144.9619401"
1361120241103,136,2024-11-03,11,73,93,166,BirFed1120_T,"-37.8184141, 144.97357915"
1641320250426,164,2025-04-26,13,138,89,227,Lat526_T,"-37.813005, 144.95160411"
492220250926,49,2025-09-26,22,175,115,290,Eli501_T,"-37.80730068, 144.95956055"
117220241214,117,2024-12-14,2,37,30,67,Fli114F_T,"-37.81629332, 144.97090877"
117020251012,117,2025-10-12,0,94,55,149,Fli114F_T,"-37.81629332, 144.97090877"
561720241203,56,2024-12-03,17,419,354,773,Lon364_T,"-37.81234775, 144.96153311"
10720250128,10,2025-01-28,7,21,117,138,BouHbr_T,"-37.81876474, 144.94710545"
86120250914,86,2025-09-14,1,0,4,4,574Qub_T,"-37.80309992, 144.94908064"
762120240311,76,2024-03-11,21,11,5,16,KenMac_T,"-37.79453803, 144.93036194"
76720240424,76,2024-04-24,7,33,20,53,KenMac_T,"-37.79453803, 144.93036194"
581120240106,58,2024-01-06,11,604,202,806,Bou688_T,"-37.81686075, 144.95358075"
35320240602,35,2024-06-02,3,34,80,114,SouthB_T,"-37.82018685, 144.96508508"
351220250202,35,2025-02-02,12,776,887,1663,SouthB_T,"-37.82018685, 144.96508508"
21320250926,2,2025-09-26,13,1026,1102,2128,Bou283_T,"-37.81380668, 144.96516718"
791120250426,79,2025-04-26,11,518,346,864,FliSS_T,"-37.81794046, 144.96616678"
302020240212,30,2024-02-12,20,222,375,597,Lon189_T,"-37.8112185, 144.96656806"
791320240906,79,2024-09-06,13,526,351,877,FliSS_T,"-37.81794046, 144.96616678"
53120250819,53,2025-08-19,1,3,8,11,Col254_T,"-37.81564191, 144.965499"
53120251005,53,2025-10-05,1,42,68,110,Col254_T,"-37.81564191, 144.965499"
481320240115,48,2024-01-15,13,158,144,302,QVMQ_T,"-37.80631581, 144.95866697"
1392120250417,139,2025-04-17,21,28,29,57,Signal1647_T,"-37.81959923, 144.9632832"
130920240520,130,2024-05-20,9,13,11,24,Bou892T,"-37.8204637, 144.94126826"
61220240503,6,2024-05-03,12,780,695,1475,FliS_T,"-37.81911705, 144.96558255"
6320250314,6,2025-03-14,3,12,11,23,FliS_T,"-37.81911705, 144.96558255"
6720251004,6,2025-10-04,7,174,139,313,FliS_T,"-37.81911705, 144.96558255"
41220250114,4,2025-01-14,12,2097,1436,3533,Swa123_T,"-37.81487988, 144.9660878"
702320250323,70,2025-03-23,23,8,4,12,Errol20_T,"-37.80456984, 144.94946228"
391320241209,39,2024-12-09,13,170,162,332,AlfPl_T,"-37.81379749, 144.96995745"
751620250626,75,2025-06-26,16,48,45,93,SprFli_T,"-37.81515276, 144.97467661"
65420240801,65,2024-08-01,4,19,18,37,SwaCs_T,"-37.81569416, 144.9668064"
28820250125,28,2025-01-25,8,167,75,242,VAC_T,"-37.82129925, 144.96879309"
281820250402,28,2025-04-02,18,615,467,1082,VAC_T,"-37.82129925, 144.96879309"
281120240501,28,2024-05-01,11,464,426,890,VAC_T,"-37.82129925, 144.96879309"
291320241221,29,2024-12-21,13,441,644,1085,AG_T,"-37.8199817, 144.96872865"
292120231206,29,2023-12-06,21,152,227,379,AG_T,"-37.8199817, 144.96872865"
40320240314,40,2024-03-14,3,1,1,2,Spr201_T,"-37.80999341, 144.97227587"
311320240306,31,2024-03-06,13,191,216,407,Lyg161_T,"-37.80169681, 144.96658911"
541820241123,54,2024-11-23,18,85,85,170,Swa607_T,"-37.804024, 144.96308399"
54620250101,54,2025-01-01,6,9,2,11,Swa607_T,"-37.804024, 144.96308399"
37620250327,37,2025-03-27,6,4,10,14,Lyg260_T,"-37.80107122, 144.96704554"
211220240306,21,2024-03-06,12,551,496,1047,Bourke155_T,"-37.81267313, 144.96788288"
1241620250117,124,2025-01-17,16,22,35,57,BirBridge_T,"-37.81757416, 144.97329934"
87120240922,87,2024-09-22,1,7,5,12,Errol23_T,"-37.80454949, 144.94921863"
611220240822,61,2024-08-22,12,528,689,1217,RMIT14_T,"-37.80767455, 144.96309114"
501920240321,50,2024-03-21,19,206,290,496,Lyg309_T,"-37.79808192, 144.96721013"
432220240423,43,2024-04-23,22,8,27,35,UM2_T,"-37.79844526, 144.96411782"
181620250414,181,2025-04-14,6,97,170,267,Eli368_T,"-37.81009465, 144.96143149"
1662220250527,166,2025-05-27,22,1,2,3,Spen484_T,"-37.80896733, 144.94931703"
1322220240502,132,2024-05-02,22,83,61,144,King335_T,"-37.81267639, 144.95386444"
134120250813,134,2025-08-13,1,10,16,26,Spen201_T,"-37.81694221, 144.95303935"
1332320240322,133,2024-03-22,23,215,124,339,Spen229_T,"-37.81531435, 144.95227769"
17920240314,17,2024-03-14,9,1014,359,1373,Col15_T,"-37.81362543, 144.97323591"
11320231114,1,2023-11-14,13,1566,1343,2909,Bou292_T,"-37.81349441, 144.96515323"
681520240501,68,2024-05-01,15,203,117,320,FLDegN_T,"-37.8168479, 144.96559789"
68320250212,68,2025-02-12,3,2,1,3,FLDegN_T,"-37.8168479, 144.96559789"
181520250306,18,2025-03-06,15,367,154,521,Col12_T,"-37.81344862, 144.97305353"
86620250604,86,2025-06-04,6,4,6,10,574Qub_T,"-37.80309992, 144.94908064"
861420250923,86,2025-09-23,14,62,46,108,574Qub_T,"-37.80309992, 144.94908064"
111620240209,11,2024-02-09,16,64,77,141,WatCit_T,"-37.81564989, 144.93970694"
24620240807,24,2024-08-07,6,403,128,531,Col620_T,"-37.81887963, 144.95449198"
72920240703,72,2024-07-03,9,288,59,347,ACMI_T,"-37.81726338, 144.96872809"
582120240906,58,2024-09-06,21,280,271,551,Bou688_T,"-37.81686075, 144.95358075"
2020240720,2,2024-07-20,0,42,49,91,Bou283_T,"-37.81380668, 144.96516718"
2520241021,2,2024-10-21,5,2,6,8,Bou283_T,"-37.81380668, 144.96516718"
21920240422,2,2024-04-22,19,106,150,256,Bou283_T,"-37.81380668, 144.96516718"
531520231030,53,2023-10-30,15,461,461,922,Col254_T,"-37.81564191, 144.965499"
21220250927,2,2025-09-27,12,829,667,1496,Bou283_T,"-37.81380668, 144.96516718"
79820240618,79,2024-06-18,8,588,303,891,FliSS_T,"-37.81794046, 144.96616678"
511020231204,51,2023-12-04,10,77,56,133,Fra118_T,"-37.80841815, 144.95906316"
30220250424,30,2025-04-24,2,40,39,79,Lon189_T,"-37.8112185, 144.96656806"
52320240412,52,2024-04-12,3,2,9,11,Eli263_T,"-37.81252157, 144.9619401"
252320250127,25,2025-01-27,23,42,36,78,MCEC_T,"-37.82401776, 144.95604426"
481020241222,48,2024-12-22,10,291,337,628,QVMQ_T,"-37.80631581, 144.95866697"
20020250529,20,2025-05-29,0,5,25,30,LtB170_T,"-37.81172914, 144.9682466"
164220241007,164,2024-10-07,2,3,9,12,Lat526_T,"-37.813005, 144.95160411"
1361720240508,136,2024-05-08,17,184,59,243,BirFed1120_T,"-37.8184141, 144.97357915"
1302320250410,130,2025-04-10,23,4,2,6,Bou892T,"-37.8204637, 144.94126826"
161320240708,161,2024-07-08,3,1,0,1,BirArt1109_T,"-37.81851276, 144.97131336"
1171820250308,117,2025-03-08,18,299,293,592,Fli114F_T,"-37.81629332, 144.97090877"
49420250203,49,2025-02-03,4,11,17,28,Eli501_T,"-37.80730068, 144.95956055"
61920240506,6,2024-05-06,19,531,458,989,FliS_T,"-37.81911705, 144.96558255"
41620240422,4,2024-04-22,16,1430,1197,2627,Swa123_T,"-37.81487988, 144.9660878"
3720250515,3,2025-05-15,7,62,133,195,Swa295_T,"-37.81101524, 144.96429485"
4020240623,4,2024-06-23,0,172,259,431,Swa123_T,"-37.81487988, 144.9660878"
41920250117,4,2025-01-17,19,1735,1104,2839,Swa123_T,"-37.81487988, 144.9660878"
701720240524,70,2024-05-24,17,200,180,380,Errol20_T,"-37.80456984, 144.94946228"
19220241005,19,2024-10-05,2,53,84,137,LtB210_T,"-37.81237202, 144.96550671"
61020240304,6,2024-03-04,10,475,396,871,FliS_T,"-37.81911705, 144.96558255"
701820251003,70,2025-10-03,18,196,233,429,Errol20_T,"-37.80456984, 144.94946228"
3920250414,3,2025-04-14,9,297,269,566,Swa295_T,"-37.81101524, 144.96429485"
39920250911,39,2025-09-11,9,110,82,192,AlfPl_T,"-37.81379749, 144.96995745"
8820240406,8,2024-04-06,8,61,84,145,WebBN_T,"-37.82293543, 144.9471751"
8820250708,8,2025-07-08,8,281,125,406,WebBN_T,"-37.82293543, 144.9471751"
421020250829,42,2025-08-29,10,235,178,413,UM1_T,"-37.80008566, 144.96386412"
422020241208,42,2024-12-08,20,40,52,92,UM1_T,"-37.80008566, 144.96386412"
772320241010,77,2024-10-10,23,41,19,60,HarEsP_T,"-37.81441438, 144.94433026"
421920240722,42,2024-07-22,19,80,182,262,UM1_T,"-37.80008566, 144.96386412"
771320240311,77,2024-03-11,13,64,31,95,HarEsP_T,"-37.81441438, 144.94433026"
291320250608,29,2025-06-08,13,355,648,1003,AG_T,"-37.8199817, 144.96872865"
291220231213,29,2023-12-13,12,213,216,429,AG_T,"-37.8199817, 144.96872865"
29120231024,29,2023-10-24,1,1,11,12,AG_T,"-37.8199817, 144.96872865"
54020240905,54,2024-09-05,0,32,35,67,Swa607_T,"-37.804024, 144.96308399"
47920250317,47,2025-03-17,9,266,553,819,Eli250_T,"-37.81258467, 144.9625775"
37920240311,37,2024-03-11,9,38,42,80,Lyg260_T,"-37.80107122, 144.96704554"
441920231109,44,2023-11-09,19,19,14,33,UM3_T,"-37.79698741, 144.96441306"
432120240817,43,2024-08-17,21,27,30,57,UM2_T,"-37.79844526, 144.96411782"
44720250612,44,2025-06-12,7,16,39,55,UM3_T,"-37.79698741, 144.96441306"
133020240828,133,2024-08-28,0,38,26,64,Spen229_T,"-37.81531435, 144.95227769"
133620241107,133,2024-11-07,6,314,208,522,Spen229_T,"-37.81531435, 144.95227769"
1181620240522,118,2024-05-22,16,17,35,52,Fli114C_T,"-37.81632783, 144.97090512"
118520240715,118,2024-07-15,5,0,2,2,Fli114C_T,"-37.81632783, 144.97090512"
87520250806,87,2025-08-06,5,4,2,6,Errol23_T,"-37.80454949, 144.94921863"
50720241225,50,2024-12-25,7,5,7,12,Lyg309_T,"-37.79808192, 144.96721013"
181920250502,181,2025-05-02,9,421,584,1005,Eli368_T,"-37.81009465, 144.96143149"
1432020240618,143,2024-06-18,20,91,107,198,Spencer_T,"-37.821728, 144.95557015"
1351620250424,135,2025-04-24,16,527,590,1117,Spen161_T,"-37.8172861, 144.95319102"
771420240625,77,2024-06-25,14,119,90,209,HarEsP_T,"-37.81441438, 144.94433026"
591520250716,59,2025-07-16,15,762,742,1504,RMIT_T,"-37.80825648, 144.96304859"
591520240414,59,2024-04-14,15,796,587,1383,RMIT_T,"-37.80825648, 144.96304859"
291020241219,29,2024-12-19,10,136,185,321,AG_T,"-37.8199817, 144.96872865"
281720240517,28,2024-05-17,17,374,827,1201,VAC_T,"-37.82129925, 144.96879309"
311720241022,31,2024-10-22,17,148,117,265,Lyg161_T,"-37.80169681, 144.96658911"
471620240423,47,2024-04-23,16,1143,815,1958,Eli250_T,"-37.81258467, 144.9625775"
36920250422,36,2025-04-22,9,158,138,296,Que85_T,"-37.81652527, 144.96121062"
372220250521,37,2025-05-21,22,40,60,100,Lyg260_T,"-37.80107122, 144.96704554"
371720240627,37,2024-06-27,17,150,127,277,Lyg260_T,"-37.80107122, 144.96704554"
51320241228,5,2024-12-28,13,1584,2322,3906,PriNW_T,"-37.81874249, 144.96787656"
1072320250427,107,2025-04-27,23,24,28,52,280Will_T,"-37.81246271, 144.95690188"
1341620240112,134,2024-01-12,16,406,400,806,Spen201_T,"-37.81694221, 144.95303935"
1342320241111,134,2024-11-11,23,113,119,232,Spen201_T,"-37.81694221, 144.95303935"
107720231219,107,2023-12-19,7,25,36,61,280Will_T,"-37.81246271, 144.95690188"
3320250803,3,2025-08-03,3,109,126,235,Swa295_T,"-37.81101524, 144.96429485"
75820250328,75,2025-03-28,8,79,60,139,SprFli_T,"-37.81515276, 144.97467661"
41920250304,41,2025-03-04,9,394,190,584,Swa31,"-37.81668634, 144.96689733"
412120240104,41,2024-01-04,21,936,1111,2047,Swa31,"-37.81668634, 144.96689733"
41220250317,41,2025-03-17,2,21,24,45,Swa31,"-37.81668634, 144.96689733"
771220241107,77,2024-11-07,12,232,107,339,HarEsP_T,"-37.81441438, 144.94433026"
77020250924,77,2025-09-24,0,10,14,24,HarEsP_T,"-37.81441438, 144.94433026"
782020250413,78,2025-04-13,20,36,30,66,HarEsB_T,"-37.81471642, 144.9446508"
772120231104,77,2023-11-04,21,218,112,330,HarEsP_T,"-37.81441438, 144.94433026"
591020240122,59,2024-01-22,10,276,354,630,RMIT_T,"-37.80825648, 144.96304859"
591320240724,59,2024-07-24,13,1497,1597,3094,RMIT_T,"-37.80825648, 144.96304859"
652020240316,65,2024-03-16,20,221,525,746,SwaCs_T,"-37.81569416, 144.9668064"
65220231218,65,2023-12-18,2,3,5,8,SwaCs_T,"-37.81569416, 144.9668064"
421620250704,42,2025-07-04,16,96,144,240,UM1_T,"-37.80008566, 144.96386412"
292020250309,29,2025-03-09,20,3500,4112,7612,AG_T,"-37.8199817, 144.96872865"
401420240524,40,2024-05-24,14,271,166,437,Spr201_T,"-37.80999341, 144.97227587"
401720241021,40,2024-10-21,17,150,171,321,Spr201_T,"-37.80999341, 144.97227587"
36420231031,36,2023-10-31,4,1,2,3,Que85_T,"-37.81652527, 144.96121062"
371220240522,37,2024-05-22,12,193,115,308,Lyg260_T,"-37.80107122, 144.96704554"
452220240430,45,2024-04-30,22,45,162,207,Swa148_T,"-37.81414075, 144.96609379"
5520240713,5,2024-07-13,5,5,13,18,PriNW_T,"-37.81874249, 144.96787656"
5020240216,5,2024-02-16,0,105,101,206,PriNW_T,"-37.81874249, 144.96787656"
118720241017,118,2024-10-17,7,11,4,15,Fli114C_T,"-37.81632783, 144.97090512"
1182220250801,118,2025-08-01,22,14,3,17,Fli114C_T,"-37.81632783, 144.97090512"
124720250728,124,2025-07-28,7,1,0,1,BirBridge_T,"-37.81757416, 144.97329934"
1081720241012,108,2024-10-12,17,118,153,271,261Will_T,"-37.81295822, 144.95678789"
612020250810,61,2025-08-10,20,220,204,424,RMIT14_T,"-37.80767455, 144.96309114"
431820241231,43,2024-12-31,18,27,10,37,UM2_T,"-37.79844526, 144.96411782"
431320240404,43,2024-04-04,13,111,126,237,UM2_T,"-37.79844526, 144.96411782"
442020240422,44,2024-04-22,20,22,42,64,UM3_T,"-37.79698741, 144.96441306"
1791520250320,179,2025-03-20,15,69,66,135,Pow61_T,"-37.82392385, 144.96299677"
167520241230,167,2024-12-30,5,0,4,4,Lat526_T,"-37.81304149, 144.95155955"
1621520240923,162,2024-09-23,15,281,388,669,Eli489_T,"-37.80740397, 144.95987909"
132520241024,132,2024-10-24,5,9,9,18,King335_T,"-37.81267639, 144.95386444"
68120250726,68,2025-07-26,1,4,2,6,FLDegN_T,"-37.8168479, 144.96559789"
681520240522,68,2024-05-22,15,166,89,255,FLDegN_T,"-37.8168479, 144.96559789"
11020231229,1,2023-12-29,10,609,957,1566,Bou292_T,"-37.81349441, 144.96515323"
1720250508,1,2025-05-08,7,92,100,192,Bou292_T,"-37.81349441, 144.96515323"
631420240424,63,2024-04-24,14,282,361,643,Bou231_T,"-37.81333081, 144.96675571"
181220231119,18,2023-11-19,12,101,47,148,Col12_T,"-37.81344862, 144.97305353"
622020250404,62,2025-04-04,20,254,234,488,Lat224_T,"-37.80996494, 144.96216521"
241820240608,24,2024-06-08,18,517,859,1376,Col620_T,"-37.81887963, 144.95449198"
112020250801,11,2025-08-01,20,81,49,130,WatCit_T,"-37.81564989, 144.93970694"
112320250911,11,2025-09-11,23,12,16,28,WatCit_T,"-37.81564989, 144.93970694"
122120241118,12,2024-11-18,21,117,115,232,NewQ_T,"-37.81457988, 144.94292398"
562220250831,56,2025-08-31,22,54,83,137,Lon364_T,"-37.81234775, 144.96153311"
76520240305,76,2024-03-05,5,5,3,8,KenMac_T,"-37.79453803, 144.93036194"
111820250523,11,2025-05-23,18,36,30,66,WatCit_T,"-37.81564989, 144.93970694"
35020250226,35,2025-02-26,0,71,156,227,SouthB_T,"-37.82018685, 144.96508508"
352320250324,35,2025-03-24,23,143,203,346,SouthB_T,"-37.82018685, 144.96508508"
79020240320,79,2024-03-20,0,44,45,89,FliSS_T,"-37.81794046, 144.96616678"
521220240428,52,2024-04-28,12,348,281,629,Eli263_T,"-37.81252157, 144.9619401"
46220240305,46,2024-03-05,2,1,1,2,Pel147_T,"-37.80240719, 144.9615673"
461320240927,46,2024-09-27,13,42,49,91,Pel147_T,"-37.80240719, 144.9615673"
511920250307,51,2025-03-07,19,77,94,171,Fra118_T,"-37.80841815, 144.95906316"
49820240331,49,2024-03-31,8,150,100,250,Eli501_T,"-37.80730068, 144.95956055"
182220250911,182,2025-09-11,2,10,7,17,King163_T,"-37.81627451, 144.95550503"
166620241102,166,2024-11-02,6,3,7,10,Spen484_T,"-37.80896733, 144.94931703"
143520241012,143,2024-10-12,5,18,22,40,Spencer_T,"-37.821728, 144.95557015"
143320250425,143,2025-04-25,3,67,24,91,Spencer_T,"-37.821728, 144.95557015"
1321120240530,132,2024-05-30,11,156,110,266,King335_T,"-37.81267639, 144.95386444"
1352320240706,135,2024-07-06,23,57,55,112,Spen161_T,"-37.8172861, 144.95319102"
1351120240812,135,2024-08-12,11,328,347,675,Spen161_T,"-37.8172861, 144.95319102"
141820240105,141,2024-01-05,8,71,37,108,474Fl_T,"-37.81997273, 144.95834911"
141420240309,141,2024-03-09,4,47,15,62,474Fl_T,"-37.81997273, 144.95834911"
139420250826,139,2025-08-26,4,3,3,6,Signal1647_T,"-37.81959923, 144.9632832"
1361420250718,136,2025-07-18,14,310,83,393,BirFed1120_T,"-37.8184141, 144.97357915"
1231420250731,123,2025-07-31,14,33,14,47,BirBridge_T,"-37.81753741, 144.97329734"
1611020250529,161,2025-05-29,10,74,84,158,BirArt1109_T,"-37.81851276, 144.97131336"
49620241130,49,2024-11-30,6,43,31,74,Eli501_T,"-37.80730068, 144.95956055"
49820241211,49,2024-12-11,8,134,139,273,Eli501_T,"-37.80730068, 144.95956055"
671820250622,67,2025-06-22,18,272,248,520,FLDegS_T,"-37.81688755, 144.96562569"
851420250206,85,2025-02-06,14,48,59,107,488Mac_T,"-37.79432415, 144.92973378"
85620250308,85,2025-03-08,6,6,7,13,488Mac_T,"-37.79432415, 144.92973378"
171620250316,17,2025-03-16,16,75,87,162,Col15_T,"-37.81362543, 144.97323591"
631120240508,63,2024-05-08,11,249,255,504,Bou231_T,"-37.81333081, 144.96675571"
672220240904,67,2024-09-04,22,71,186,257,FLDegS_T,"-37.81688755, 144.96562569"
86120231125,86,2023-11-25,1,0,3,3,574Qub_T,"-37.80309992, 144.94908064"
56320250405,56,2025-04-05,3,53,48,101,Lon364_T,"-37.81234775, 144.96153311"
24520250405,24,2025-04-05,5,39,34,73,Col620_T,"-37.81887963, 144.95449198"
241120250110,24,2025-01-10,11,634,433,1067,Col620_T,"-37.81887963, 144.95449198"
721320240703,72,2024-07-03,13,226,391,617,ACMI_T,"-37.81726338, 144.96872809"
581020250626,58,2025-06-26,10,642,162,804,Bou688_T,"-37.81686075, 144.95358075"
272220240804,27,2024-08-04,22,44,19,63,Vic_T,"-37.80606888, 144.95644692"
271120231223,27,2023-12-23,11,263,228,491,Vic_T,"-37.80606888, 144.95644692"
302320241209,30,2024-12-09,23,75,131,206,Lon189_T,"-37.8112185, 144.96656806"
791920231212,79,2023-12-12,19,448,388,836,FliSS_T,"-37.81794046, 144.96616678"
791720240414,79,2024-04-14,17,536,470,1006,FliSS_T,"-37.81794046, 144.96616678"
511220250330,51,2025-03-30,12,177,142,319,Fra118_T,"-37.80841815, 144.95906316"
51120250505,51,2025-05-05,1,24,21,45,Fra118_T,"-37.80841815, 144.95906316"
51620240319,51,2024-03-19,6,10,12,22,Fra118_T,"-37.80841815, 144.95906316"
19220240919,19,2024-09-19,2,12,16,28,LtB210_T,"-37.81237202, 144.96550671"
46620240321,46,2024-03-21,6,6,60,66,Pel147_T,"-37.80240719, 144.9615673"
251920231114,25,2023-11-14,19,333,265,598,MCEC_T,"-37.82401776, 144.95604426"
202220231206,20,2023-12-06,22,178,503,681,LtB170_T,"-37.81172914, 144.9682466"
521220241122,52,2024-11-22,12,404,349,753,Eli263_T,"-37.81252157, 144.9619401"
462020241222,46,2024-12-22,20,13,10,23,Pel147_T,"-37.80240719, 144.9615673"
69620240805,69,2024-08-05,6,18,8,26,FLDegC_T,"-37.81687226, 144.96559144"
841520250626,84,2025-06-26,15,909,1278,2187,ElFi_T,"-37.81798049, 144.96503383"
31620240516,3,2024-05-16,16,1102,1141,2243,Swa295_T,"-37.81101524, 144.96429485"
8620240620,8,2024-06-20,6,34,29,63,WebBN_T,"-37.82293543, 144.9471751"
69620241027,69,2024-10-27,6,5,5,10,FLDegC_T,"-37.81687226, 144.96559144"
69920250610,69,2025-06-10,9,193,102,295,FLDegC_T,"-37.81687226, 144.96559144"
691520250629,69,2025-06-29,15,244,237,481,FLDegC_T,"-37.81687226, 144.96559144"
4120240929,4,2024-09-29,1,71,119,190,Swa123_T,"-37.81487988, 144.9660878"
202220240626,20,2024-06-26,22,223,301,524,LtB170_T,"-37.81172914, 144.9682466"
201220231126,20,2023-11-26,12,426,274,700,LtB170_T,"-37.81172914, 144.9682466"
1641020250801,164,2025-08-01,10,156,34,190,Lat526_T,"-37.813005, 144.95160411"
1411120240603,141,2024-06-03,11,99,102,201,474Fl_T,"-37.81997273, 144.95834911"
1411320240923,141,2024-09-23,13,208,190,398,474Fl_T,"-37.81997273, 144.95834911"
1371920250715,137,2025-07-15,19,2,3,5,BouHbr2353_T,"-37.81894815, 144.94612292"
142020240806,142,2024-08-06,0,2,2,4,Hammer1584_T,"-37.81970749, 144.96795734"
1301020250314,130,2025-03-14,10,47,38,85,Bou892T,"-37.8204637, 144.94126826"
1381220250213,138,2025-02-13,12,8,10,18,EntPark1671_T,"-37.81996544, 144.95981454"
1611020240622,161,2024-06-22,10,102,136,238,BirArt1109_T,"-37.81851276, 144.97131336"
109820240223,109,2024-02-23,8,79,630,709,LatWill_T,"-37.81193681, 144.95621105"
1091220240617,109,2024-06-17,12,204,207,411,LatWill_T,"-37.81193681, 144.95621105"
691520240831,69,2024-08-31,15,226,243,469,FLDegC_T,"-37.81687226, 144.96559144"
691220240919,69,2024-09-19,12,296,249,545,FLDegC_T,"-37.81687226, 144.96559144"
691320250505,69,2025-05-05,13,259,316,575,FLDegC_T,"-37.81687226, 144.96559144"
691520250624,69,2025-06-24,15,167,213,380,FLDegC_T,"-37.81687226, 144.96559144"
42120240111,4,2024-01-11,21,911,725,1636,Swa123_T,"-37.81487988, 144.9660878"
8420240418,8,2024-04-18,4,2,1,3,WebBN_T,"-37.82293543, 144.9471751"
751720240131,75,2024-01-31,17,66,72,138,SprFli_T,"-37.81515276, 144.97467661"
771620241013,77,2024-10-13,16,176,91,267,HarEsP_T,"-37.81441438, 144.94433026"
142020250415,14,2025-04-15,20,270,102,372,SanBri_T,"-37.82011242, 144.96291897"
591020240907,59,2024-09-07,10,343,379,722,RMIT_T,"-37.80825648, 144.96304859"
652320240205,65,2024-02-05,23,21,87,108,SwaCs_T,"-37.81569416, 144.9668064"
42020250822,42,2025-08-22,0,4,6,10,UM1_T,"-37.80008566, 144.96386412"
40120240515,40,2024-05-15,1,9,5,14,Spr201_T,"-37.80999341, 144.97227587"
47820250901,47,2025-09-01,8,307,522,829,Eli250_T,"-37.81258467, 144.9625775"
5220241013,5,2024-10-13,2,24,55,79,PriNW_T,"-37.81874249, 144.96787656"
5720240729,5,2024-07-29,7,74,259,333,PriNW_T,"-37.81874249, 144.96787656"
212220250729,21,2025-07-29,22,86,101,187,Bourke155_T,"-37.81267313, 144.96788288"
1241220250928,124,2025-09-28,12,2,2,4,BirBridge_T,"-37.81757416, 144.97329934"
87920250807,87,2025-08-07,9,66,52,118,Errol23_T,"-37.80454949, 144.94921863"
61820250117,61,2025-01-17,8,216,265,481,RMIT14_T,"-37.80767455, 144.96309114"
611620250508,61,2025-05-08,16,729,858,1587,RMIT14_T,"-37.80767455, 144.96309114"
502320240403,50,2024-04-03,23,26,11,37,Lyg309_T,"-37.79808192, 144.96721013"
431420241013,43,2024-10-13,14,84,55,139,UM2_T,"-37.79844526, 144.96411782"
166920241001,166,2024-10-01,9,22,37,59,Spen484_T,"-37.80896733, 144.94931703"
167120241012,167,2024-10-12,1,1,7,8,Lat526_T,"-37.81304149, 144.95155955"
1311120250130,131,2025-01-30,11,95,106,201,King2_T,"-37.82009057, 144.95758725"
1842220250909,184,2025-09-09,22,125,170,295,Eli124_T,"-37.81512416, 144.96371988"
1621220241102,162,2024-11-02,12,708,1060,1768,Eli489_T,"-37.80740397, 144.95987909"
1341120240112,134,2024-01-12,11,273,344,617,Spen201_T,"-37.81694221, 144.95303935"
1341520240506,134,2024-05-06,15,347,395,742,Spen201_T,"-37.81694221, 144.95303935"
134020240618,134,2024-06-18,0,24,44,68,Spen201_T,"-37.81694221, 144.95303935"
133920231217,133,2023-12-17,9,387,428,815,Spen229_T,"-37.81531435, 144.95227769"
67620241028,67,2024-10-28,6,97,54,151,FLDegS_T,"-37.81688755, 144.96562569"
68720250904,68,2025-09-04,7,102,81,183,FLDegN_T,"-37.8168479, 144.96559789"
851720240119,85,2024-01-19,17,94,106,200,488Mac_T,"-37.79432415, 144.92973378"
1520250226,1,2025-02-26,5,5,7,12,Bou292_T,"-37.81349441, 144.96515323"
63820240506,63,2024-05-06,8,129,152,281,Bou231_T,"-37.81333081, 144.96675571"
67620250821,67,2025-08-21,6,72,48,120,FLDegS_T,"-37.81688755, 144.96562569"
861720240809,86,2024-08-09,17,61,61,122,574Qub_T,"-37.80309992, 144.94908064"
86620250418,86,2025-04-18,6,3,6,9,574Qub_T,"-37.80309992, 144.94908064"
762320240814,76,2024-08-14,23,2,0,2,KenMac_T,"-37.79453803, 144.93036194"
721820241209,72,2024-12-09,18,180,357,537,ACMI_T,"-37.81726338, 144.96872809"
721820251002,72,2025-10-02,18,144,377,521,ACMI_T,"-37.81726338, 144.96872809"
9720231123,9,2023-11-23,7,64,1027,1091,Col700_T,"-37.81982992, 144.95102555"
27320240518,27,2024-05-18,3,17,3,20,Vic_T,"-37.80606888, 144.95644692"
27620250220,27,2025-02-20,6,14,16,30,Vic_T,"-37.80606888, 144.95644692"
511120240319,51,2024-03-19,11,97,115,212,Fra118_T,"-37.80841815, 144.95906316"
51820240407,51,2024-04-07,8,36,53,89,Fra118_T,"-37.80841815, 144.95906316"
46220240213,46,2024-02-13,2,2,1,3,Pel147_T,"-37.80240719, 144.9615673"
52820231028,52,2023-10-28,8,79,109,188,Eli263_T,"-37.81252157, 144.9619401"
49620231116,49,2023-11-16,6,44,38,82,Eli501_T,"-37.80730068, 144.95956055"
191320240206,19,2024-02-06,13,543,516,1059,LtB210_T,"-37.81237202, 144.96550671"
20820240319,20,2024-03-19,8,89,77,166,LtB170_T,"-37.81172914, 144.9682466"
49820250908,49,2025-09-08,8,97,164,261,Eli501_T,"-37.80730068, 144.95956055"
164920250718,164,2025-07-18,9,109,54,163,Lat526_T,"-37.813005, 144.95160411"
141420240207,141,2024-02-07,4,7,2,9,474Fl_T,"-37.81997273, 144.95834911"
1412220240123,141,2024-01-23,22,40,111,151,474Fl_T,"-37.81997273, 144.95834911"
1392020241203,139,2024-12-03,20,27,45,72,Signal1647_T,"-37.81959923, 144.9632832"
130920250104,130,2025-01-04,9,40,16,56,Bou892T,"-37.8204637, 144.94126826"
491020240919,49,2024-09-19,10,226,293,519,Eli501_T,"-37.80730068, 144.95956055"
491120241130,49,2024-11-30,11,330,503,833,Eli501_T,"-37.80730068, 144.95956055"
42120240827,4,2024-08-27,21,306,166,472,Swa123_T,"-37.81487988, 144.9660878"
42220241229,4,2024-12-29,22,597,625,1222,Swa123_T,"-37.81487988, 144.9660878"
702220240428,70,2024-04-28,22,14,21,35,Errol20_T,"-37.80456984, 144.94946228"
701420240927,70,2024-09-27,14,122,114,236,Errol20_T,"-37.80456984, 144.94946228"
81420250704,8,2025-07-04,14,162,310,472,WebBN_T,"-37.82293543, 144.9471751"
75120250410,75,2025-04-10,1,1,0,1,SprFli_T,"-37.81515276, 144.97467661"
78820241127,78,2024-11-27,8,13,23,36,HarEsB_T,"-37.81471642, 144.9446508"
591820240628,59,2024-06-28,18,699,486,1185,RMIT_T,"-37.80825648, 144.96304859"
591220240815,59,2024-08-15,12,1602,1724,3326,RMIT_T,"-37.80825648, 144.96304859"
591820250305,59,2025-03-05,18,582,1394,1976,RMIT_T,"-37.80825648, 144.96304859"
711720240117,71,2024-01-17,17,23,48,71,WestWP_T,"-37.81235775, 144.97136962"
421020250924,42,2025-09-24,10,209,153,362,UM1_T,"-37.80008566, 144.96386412"
281320231119,28,2023-11-19,13,705,1570,2275,VAC_T,"-37.82129925, 144.96879309"
281720240806,28,2024-08-06,17,539,1087,1626,VAC_T,"-37.82129925, 144.96879309"
31220250120,31,2025-01-20,2,2,4,6,Lyg161_T,"-37.80169681, 144.96658911"
312220250103,31,2025-01-03,22,267,275,542,Lyg161_T,"-37.80169681, 144.96658911"
361220250708,36,2025-07-08,12,414,328,742,Que85_T,"-37.81652527, 144.96121062"
362220250428,36,2025-04-28,22,32,15,47,Que85_T,"-37.81652527, 144.96121062"
212020240604,21,2024-06-04,20,283,353,636,Bourke155_T,"-37.81267313, 144.96788288"
45420250308,45,2025-03-08,4,7,39,46,Swa148_T,"-37.81414075, 144.96609379"
45320231121,45,2023-11-21,3,10,3,13,Swa148_T,"-37.81414075, 144.96609379"
451120240311,45,2024-03-11,11,308,432,740,Swa148_T,"-37.81414075, 144.96609379"
451520240704,45,2024-07-04,15,789,796,1585,Swa148_T,"-37.81414075, 144.96609379"
52220240823,5,2024-08-23,22,205,298,503,PriNW_T,"-37.81874249, 144.96787656"
5620240309,5,2024-03-09,6,41,53,94,PriNW_T,"-37.81874249, 144.96787656"
782120250315,78,2025-03-15,21,11,27,38,HarEsB_T,"-37.81471642, 144.9446508"
41920240606,41,2024-06-06,9,1491,514,2005,Swa31,"-37.81668634, 144.96689733"
771820240722,77,2024-07-22,18,147,110,257,HarEsP_T,"-37.81441438, 144.94433026"
591420240821,59,2024-08-21,14,1472,1524,2996,RMIT_T,"-37.80825648, 144.96304859"
591520240206,59,2024-02-06,15,654,890,1544,RMIT_T,"-37.80825648, 144.96304859"
42220240529,42,2024-05-29,2,7,6,13,UM1_T,"-37.80008566, 144.96386412"
291420250311,29,2025-03-11,14,169,206,375,AG_T,"-37.8199817, 144.96872865"
29020240608,29,2024-06-08,0,9,29,38,AG_T,"-37.8199817, 144.96872865"
402120241216,40,2024-12-16,21,65,25,90,Spr201_T,"-37.80999341, 144.97227587"
212120241205,21,2024-12-05,21,238,328,566,Bourke155_T,"-37.81267313, 144.96788288"
471020240817,47,2024-08-17,10,378,536,914,Eli250_T,"-37.81258467, 144.9625775"
432120231128,43,2023-11-28,21,28,52,80,UM2_T,"-37.79844526, 144.96411782"
431020250423,43,2025-04-23,10,58,48,106,UM2_T,"-37.79844526, 144.96411782"
211820240408,21,2024-04-08,18,418,391,809,Bourke155_T,"-37.81267313, 144.96788288"
212120231222,21,2023-12-22,21,548,671,1219,Bourke155_T,"-37.81267313, 144.96788288"
1331120240402,133,2024-04-02,11,431,424,855,Spen229_T,"-37.81531435, 144.95227769"
1071920250311,107,2025-03-11,19,124,126,250,280Will_T,"-37.81246271, 144.95690188"
871620250823,87,2025-08-23,16,96,94,190,Errol23_T,"-37.80454949, 144.94921863"
611620250513,61,2025-05-13,16,779,889,1668,RMIT14_T,"-37.80767455, 144.96309114"
50720240806,50,2024-08-06,7,14,26,40,Lyg309_T,"-37.79808192, 144.96721013"
1792220250318,179,2025-03-18,22,48,52,100,Pow61_T,"-37.82392385, 144.96299677"
179520251010,179,2025-10-10,5,9,13,22,Pow61_T,"-37.82392385, 144.96299677"
1652220250819,165,2025-08-19,22,5,2,7,Spen475_T,"-37.80953359, 144.94939004"
162120241221,162,2024-12-21,1,58,29,87,Eli489_T,"-37.80740397, 144.95987909"
131220231231,131,2023-12-31,2,71,96,167,King2_T,"-37.82009057, 144.95758725"
135420240217,135,2024-02-17,4,43,13,56,Spen161_T,"-37.8172861, 144.95319102"
135220250502,135,2025-05-02,2,12,11,23,Spen161_T,"-37.8172861, 144.95319102"
851020250528,85,2025-05-28,10,75,66,141,488Mac_T,"-37.79432415, 144.92973378"
17020240201,17,2024-02-01,0,11,5,16,Col15_T,"-37.81362543, 144.97323591"
181620250814,18,2025-08-14,16,548,139,687,Col12_T,"-37.81344862, 144.97305353"
862020250204,86,2025-02-04,20,33,46,79,574Qub_T,"-37.80309992, 144.94908064"
111820240704,11,2024-07-04,18,86,81,167,WatCit_T,"-37.81564989, 144.93970694"
24220241225,24,2024-12-25,2,31,20,51,Col620_T,"-37.81887963, 144.95449198"
72920240522,72,2024-05-22,9,288,132,420,ACMI_T,"-37.81726338, 144.96872809"
582120250710,58,2025-07-10,21,449,224,673,Bou688_T,"-37.81686075, 144.95358075"
2520240406,2,2024-04-06,5,8,7,15,Bou283_T,"-37.81380668, 144.96516718"
532220240502,53,2024-05-02,22,87,120,207,Col254_T,"-37.81564191, 144.965499"
9520240106,9,2024-01-06,5,9,2,11,Col700_T,"-37.81982992, 144.95102555"
30520231117,30,2023-11-17,5,9,16,25,Lon189_T,"-37.8112185, 144.96656806"
301520240506,30,2024-05-06,15,202,331,533,Lon189_T,"-37.8112185, 144.96656806"
51420250515,51,2025-05-15,4,10,1,11,Fra118_T,"-37.80841815, 144.95906316"
51320231207,51,2023-12-07,3,25,14,39,Fra118_T,"-37.80841815, 144.95906316"
51020231213,51,2023-12-13,0,15,26,41,Fra118_T,"-37.80841815, 144.95906316"
23120240829,23,2024-08-29,1,2,13,15,Col623_T,"-37.81909256, 144.95452748"
231620231113,23,2023-11-13,16,230,472,702,Col623_T,"-37.81909256, 144.95452748"
48720240730,48,2024-07-30,7,63,44,107,QVMQ_T,"-37.80631581, 144.95866697"
202120250412,20,2025-04-12,21,501,903,1404,LtB170_T,"-37.81172914, 144.9682466"
20920240726,20,2024-07-26,9,48,63,111,LtB170_T,"-37.81172914, 144.9682466"
52720250715,52,2025-07-15,7,70,61,131,Eli263_T,"-37.81252157, 144.9619401"
521720250925,52,2025-09-25,17,476,448,924,Eli263_T,"-37.81252157, 144.9619401"
1181120231027,118,2023-10-27,11,17,15,32,Fli114C_T,"-37.81632783, 144.97090512"
1361420241002,136,2024-10-02,14,77,62,139,BirFed1120_T,"-37.8184141, 144.97357915"
1612320240615,161,2024-06-15,23,3,0,3,BirArt1109_T,"-37.81851276, 144.97131336"
12320241014,1,2024-10-14,23,48,59,107,Bou292_T,"-37.81349441, 144.96515323"
182020250623,18,2025-06-23,20,7,1,8,Col12_T,"-37.81344862, 144.97305353"
621220250924,62,2025-09-24,12,326,249,575,Lat224_T,"-37.80996494, 144.96216521"
621620251003,62,2025-10-03,16,335,292,627,Lat224_T,"-37.80996494, 144.96216521"
63620240910,63,2024-09-10,6,33,36,69,Bou231_T,"-37.81333081, 144.96675571"
63220250507,63,2025-05-07,2,1,13,14,Bou231_T,"-37.81333081, 144.96675571"
631520250513,63,2025-05-13,15,267,335,602,Bou231_T,"-37.81333081, 144.96675571"
621020250302,62,2025-03-02,10,97,112,209,Lat224_T,"-37.80996494, 144.96216521"
621320250730,62,2025-07-30,13,325,257,582,Lat224_T,"-37.80996494, 144.96216521"
112120250326,11,2025-03-26,21,118,118,236,WatCit_T,"-37.81564989, 144.93970694"
761020231111,76,2023-11-11,10,72,59,131,KenMac_T,"-37.79453803, 144.93036194"
76820240210,76,2024-02-10,8,47,34,81,KenMac_T,"-37.79453803, 144.93036194"
351020240711,35,2024-07-11,10,587,513,1100,SouthB_T,"-37.82018685, 144.96508508"
531120240408,53,2024-04-08,11,708,596,1304,Col254_T,"-37.81564191, 144.965499"
531220231222,53,2023-12-22,12,1083,902,1985,Col254_T,"-37.81564191, 144.965499"
22220250911,2,2025-09-11,22,24,128,152,Bou283_T,"-37.81380668, 144.96516718"
79720250603,79,2025-06-03,7,260,100,360,FliSS_T,"-37.81794046, 144.96616678"
53220240911,53,2024-09-11,2,2,5,7,Col254_T,"-37.81564191, 144.965499"
792020250929,79,2025-09-29,20,198,225,423,FliSS_T,"-37.81794046, 144.96616678"
30120250111,30,2025-01-11,1,228,226,454,Lon189_T,"-37.8112185, 144.96656806"
52020240522,52,2024-05-22,0,12,16,28,Eli263_T,"-37.81252157, 144.9619401"
461320250708,46,2025-07-08,13,89,90,179,Pel147_T,"-37.80240719, 144.9615673"
191020250113,19,2025-01-13,10,138,109,247,LtB210_T,"-37.81237202, 144.96550671"
192020250215,19,2025-02-15,20,510,626,1136,LtB210_T,"-37.81237202, 144.96550671"
48420240218,48,2024-02-18,4,6,9,15,QVMQ_T,"-37.80631581, 144.95866697"
202020241010,20,2024-10-10,20,291,532,823,LtB170_T,"-37.81172914, 144.9682466"
191220250807,19,2025-08-07,12,467,411,878,LtB210_T,"-37.81237202, 144.96550671"
19220250911,19,2025-09-11,2,11,17,28,LtB210_T,"-37.81237202, 144.96550671"
1411120250327,141,2025-03-27,11,157,102,259,474Fl_T,"-37.81997273, 144.95834911"
1392320250817,139,2025-08-17,23,2,1,3,Signal1647_T,"-37.81959923, 144.9632832"
1081520240128,108,2024-01-28,15,117,138,255,261Will_T,"-37.81295822, 144.95678789"
108320240221,108,2024-02-21,3,7,3,10,261Will_T,"-37.81295822, 144.95678789"
612120241223,61,2024-12-23,21,209,160,369,RMIT14_T,"-37.80767455, 144.96309114"
611720231122,61,2023-11-22,17,466,462,928,RMIT14_T,"-37.80767455, 144.96309114"
612020240128,61,2024-01-28,20,156,164,320,RMIT14_T,"-37.80767455, 144.96309114"
182820250526,182,2025-05-26,8,128,172,300,King163_T,"-37.81627451, 144.95550503"
1852020250715,185,2025-07-15,20,335,438,773,Eli197_T,"-37.81374643, 144.96276183"
1312320241112,131,2024-11-12,23,47,34,81,King2_T,"-37.82009057, 144.95758725"
1312220250528,131,2025-05-28,22,30,27,57,King2_T,"-37.82009057, 144.95758725"
162520240713,162,2024-07-13,5,24,16,40,Eli489_T,"-37.80740397, 144.95987909"
1621220241012,162,2024-10-12,12,711,978,1689,Eli489_T,"-37.80740397, 144.95987909"
132120241013,132,2024-10-13,1,34,20,54,King335_T,"-37.81267639, 144.95386444"
135120240718,135,2024-07-18,1,7,9,16,Spen161_T,"-37.8172861, 144.95319102"
1331720231218,133,2023-12-18,17,547,559,1106,Spen229_T,"-37.81531435, 144.95227769"
11320240721,1,2024-07-21,13,1506,1251,2757,Bou292_T,"-37.81349441, 144.96515323"
86920250325,86,2025-03-25,9,31,22,53,574Qub_T,"-37.80309992, 144.94908064"
862220250403,86,2025-04-03,22,2,27,29,574Qub_T,"-37.80309992, 144.94908064"
561620241119,56,2024-11-19,16,315,349,664,Lon364_T,"-37.81234775, 144.96153311"
1361920250415,136,2025-04-15,19,20,3,23,BirFed1120_T,"-37.8184141, 144.97357915"
1421920240413,142,2024-04-13,19,403,333,736,Hammer1584_T,"-37.81970749, 144.96795734"
49320250302,49,2025-03-02,3,42,43,85,Eli501_T,"-37.80730068, 144.95956055"
1381820250821,138,2025-08-21,18,1,4,5,EntPark1671_T,"-37.81996544, 144.95981454"
1171520250411,117,2025-04-11,15,169,257,426,Fli114F_T,"-37.81629332, 144.97090877"
1171720250531,117,2025-05-31,17,229,272,501,Fli114F_T,"-37.81629332, 144.97090877"
49720240324,49,2024-03-24,7,67,64,131,Eli501_T,"-37.80730068, 144.95956055"
192120250818,19,2025-08-18,21,201,358,559,LtB210_T,"-37.81237202, 144.96550671"
692320250806,69,2025-08-06,23,5,3,8,FLDegC_T,"-37.81687226, 144.96559144"
842020231216,84,2023-12-16,20,1231,1836,3067,ElFi_T,"-37.81798049, 144.96503383"
661020240510,66,2024-05-10,10,491,465,956,QVN_T,"-37.81057846, 144.96444294"
4020250416,4,2025-04-16,0,131,197,328,Swa123_T,"-37.81487988, 144.9660878"
701020231124,70,2023-11-24,10,119,105,224,Errol20_T,"-37.80456984, 144.94946228"
31220250811,3,2025-08-11,12,1025,1334,2359,Swa295_T,"-37.81101524, 144.96429485"
82220240424,8,2024-04-24,22,20,19,39,WebBN_T,"-37.82293543, 144.9471751"
411620240428,41,2024-04-28,16,1347,1434,2781,Swa31,"-37.81668634, 144.96689733"
411920250131,41,2025-01-31,19,1357,1084,2441,Swa31,"-37.81668634, 144.96689733"
591620240811,59,2024-08-11,16,853,1172,2025,RMIT_T,"-37.80825648, 144.96304859"
59420240607,59,2024-06-07,4,4,7,11,RMIT_T,"-37.80825648, 144.96304859"
31320240609,31,2024-06-09,3,2,2,4,Lyg161_T,"-37.80169681, 144.96658911"
37120231225,37,2023-12-25,1,9,8,17,Lyg260_T,"-37.80107122, 144.96704554"
37220250218,37,2025-02-18,2,1,1,2,Lyg260_T,"-37.80107122, 144.96704554"
1081920250729,108,2025-07-29,19,261,135,396,261Will_T,"-37.81295822, 144.95678789"
1181820250721,118,2025-07-21,18,14,9,23,Fli114C_T,"-37.81632783, 144.97090512"
50120231021,50,2023-10-21,1,15,3,18,Lyg309_T,"-37.79808192, 144.96721013"
1671220250318,167,2025-03-18,12,47,100,147,Lat526_T,"-37.81304149, 144.95155955"
140720241228,140,2024-12-28,7,40,8,48,Boyd2837_T,"-37.82590962, 144.96185972"
1321120240105,132,2024-01-05,11,188,94,282,King335_T,"-37.81267639, 144.95386444"
1352120251002,135,2025-10-02,21,127,162,289,Spen161_T,"-37.8172861, 144.95319102"
1241120250612,124,2025-06-12,11,4,3,7,BirBridge_T,"-37.81757416, 144.97329934"
672320240330,67,2024-03-30,23,160,322,482,FLDegS_T,"-37.81688755, 144.96562569"
17520250522,17,2025-05-22,5,63,27,90,Col15_T,"-37.81362543, 144.97323591"
1520240712,1,2024-07-12,5,6,5,11,Bou292_T,"-37.81349441, 144.96515323"
671020250811,67,2025-08-11,10,329,374,703,FLDegS_T,"-37.81688755, 144.96562569"
68120250713,68,2025-07-13,1,4,2,6,FLDegN_T,"-37.8168479, 144.96559789"
11020241204,11,2024-12-04,0,4,2,6,WatCit_T,"-37.81564989, 144.93970694"
241920250426,24,2025-04-26,19,352,431,783,Col620_T,"-37.81887963, 144.95449198"
35720241223,35,2024-12-23,7,280,269,549,SouthB_T,"-37.82018685, 144.96508508"
351520250114,35,2025-01-14,15,1139,1214,2353,SouthB_T,"-37.82018685, 144.96508508"
2820240211,2,2024-02-11,8,42,56,98,Bou283_T,"-37.81380668, 144.96516718"
271820241002,27,2024-10-02,18,265,144,409,Vic_T,"-37.80606888, 144.95644692"
531220231023,53,2023-10-23,12,823,699,1522,Col254_T,"-37.81564191, 144.965499"
792020240504,79,2024-05-04,20,484,775,1259,FliSS_T,"-37.81794046, 144.96616678"
79820240605,79,2024-06-05,8,609,351,960,FliSS_T,"-37.81794046, 144.96616678"
30920250502,30,2025-05-02,9,73,97,170,Lon189_T,"-37.8112185, 144.96656806"
79320250904,79,2025-09-04,3,16,14,30,FliSS_T,"-37.81794046, 144.96616678"
51520240410,51,2024-04-10,5,11,11,22,Fra118_T,"-37.80841815, 144.95906316"
231520250823,23,2025-08-23,15,190,220,410,Col623_T,"-37.81909256, 144.95452748"
231920250824,23,2025-08-24,19,127,140,267,Col623_T,"-37.81909256, 144.95452748"
511520250427,51,2025-04-27,15,115,124,239,Fra118_T,"-37.80841815, 144.95906316"
201620240803,20,2024-08-03,16,363,532,895,LtB170_T,"-37.81172914, 144.9682466"
130920240602,130,2024-06-02,9,13,11,24,Bou892T,"-37.8204637, 144.94126826"
19420241108,19,2024-11-08,4,1,8,9,LtB210_T,"-37.81237202, 144.96550671"
191020240322,19,2024-03-22,10,199,108,307,LtB210_T,"-37.81237202, 144.96550671"
180820250428,180,2025-04-28,8,108,48,156,Mac330_T,"-37.79497059, 144.93530329"
137620241129,137,2024-11-29,6,10,6,16,BouHbr2353_T,"-37.81894815, 144.94612292"
1392020240405,139,2024-04-05,20,35,23,58,Signal1647_T,"-37.81959923, 144.9632832"
1392220250703,139,2025-07-03,22,16,9,25,Signal1647_T,"-37.81959923, 144.9632832"
69320240924,69,2024-09-24,3,1,5,6,FLDegC_T,"-37.81687226, 144.96559144"
6020240713,6,2024-07-13,0,259,142,401,FliS_T,"-37.81911705, 144.96558255"
42120250525,4,2025-05-25,21,653,568,1221,Swa123_T,"-37.81487988, 144.9660878"
70520240226,70,2024-02-26,5,5,3,8,Errol20_T,"-37.80456984, 144.94946228"
70320240519,70,2024-05-19,3,1,6,7,Errol20_T,"-37.80456984, 144.94946228"
42120240811,42,2024-08-11,1,0,2,2,UM1_T,"-37.80008566, 144.96386412"
291820241208,29,2024-12-08,18,633,970,1603,AG_T,"-37.8199817, 144.96872865"
142020240816,14,2024-08-16,20,268,99,367,SanBri_T,"-37.82011242, 144.96291897"
591820240706,59,2024-07-06,18,490,360,850,RMIT_T,"-37.80825648, 144.96304859"
40320240327,40,2024-03-27,3,3,2,5,Spr201_T,"-37.80999341, 144.97227587"
47420250217,47,2025-02-17,4,9,10,19,Eli250_T,"-37.81258467, 144.9625775"
451720240629,45,2024-06-29,17,748,747,1495,Swa148_T,"-37.81414075, 144.96609379"
211020240419,21,2024-04-19,10,218,182,400,Bourke155_T,"-37.81267313, 144.96788288"
1181520240311,118,2024-03-11,15,13,16,29,Fli114C_T,"-37.81632783, 144.97090512"
118120250507,118,2025-05-07,1,0,2,2,Fli114C_T,"-37.81632783, 144.97090512"
1181320250721,118,2025-07-21,13,20,14,34,Fli114C_T,"-37.81632783, 144.97090512"
432120241116,43,2024-11-16,21,8,26,34,UM2_T,"-37.79844526, 144.96411782"
1811820250422,181,2025-04-22,18,1029,971,2000,Eli368_T,"-37.81009465, 144.96143149"
1431020250203,143,2025-02-03,10,85,105,190,Spencer_T,"-37.821728, 144.95557015"
1431720250701,143,2025-07-01,17,193,239,432,Spencer_T,"-37.821728, 144.95557015"
143720241028,143,2024-10-28,7,78,131,209,Spencer_T,"-37.821728, 144.95557015"
1351220250601,135,2025-06-01,12,319,380,699,Spen161_T,"-37.8172861, 144.95319102"
851520241103,85,2024-11-03,15,57,60,117,488Mac_T,"-37.79432415, 144.92973378"
11320241211,11,2024-12-11,3,2,0,2,WatCit_T,"-37.81564989, 144.93970694"
241420250919,24,2025-09-19,14,532,830,1362,Col620_T,"-37.81887963, 144.95449198"
58320250108,58,2025-01-08,3,8,2,10,Bou688_T,"-37.81686075, 144.95358075"
58220240403,58,2024-04-03,2,18,19,37,Bou688_T,"-37.81686075, 144.95358075"
351020250225,35,2025-02-25,10,702,776,1478,SouthB_T,"-37.82018685, 144.96508508"
532020231210,53,2023-12-10,20,200,195,395,Col254_T,"-37.81564191, 144.965499"
791120250405,79,2025-04-05,11,621,502,1123,FliSS_T,"-37.81794046, 144.96616678"
30620240202,30,2024-02-02,6,14,22,36,Lon189_T,"-37.8112185, 144.96656806"
30420240815,30,2024-08-15,4,18,31,49,Lon189_T,"-37.8112185, 144.96656806"
791020250930,79,2025-09-30,10,407,223,630,FliSS_T,"-37.81794046, 144.96616678"
301520241004,30,2024-10-04,15,211,479,690,Lon189_T,"-37.8112185, 144.96656806"
46020250119,46,2025-01-19,0,1,2,3,Pel147_T,"-37.80240719, 144.9615673"
461020250904,46,2025-09-04,10,149,55,204,Pel147_T,"-37.80240719, 144.9615673"
511120250806,51,2025-08-06,11,92,66,158,Fra118_T,"-37.80841815, 144.95906316"
191920241017,19,2024-10-17,19,528,413,941,LtB210_T,"-37.81237202, 144.96550671"
481520250731,48,2025-07-31,15,277,159,436,QVMQ_T,"-37.80631581, 144.95866697"
202220240605,20,2024-06-05,22,69,138,207,LtB170_T,"-37.81172914, 144.9682466"
1411320241014,141,2024-10-14,13,190,157,347,474Fl_T,"-37.81997273, 144.95834911"
1411620250714,141,2025-07-14,16,146,125,271,474Fl_T,"-37.81997273, 144.95834911"
139020250928,139,2025-09-28,0,7,5,12,Signal1647_T,"-37.81959923, 144.9632832"
1391220241029,139,2024-10-29,12,65,56,121,Signal1647_T,"-37.81959923, 144.9632832"
136720240408,136,2024-04-08,7,84,117,201,BirFed1120_T,"-37.8184141, 144.97357915"
1231620231112,123,2023-11-12,16,57,81,138,BirBridge_T,"-37.81753741, 144.97329734"
491520250325,49,2025-03-25,15,230,377,607,Eli501_T,"-37.80730068, 144.95956055"
117620240114,117,2024-01-14,6,19,12,31,Fli114F_T,"-37.81629332, 144.97090877"
66220250119,66,2025-01-19,2,102,119,221,QVN_T,"-37.81057846, 144.96444294"
691620250709,69,2025-07-09,16,174,244,418,FLDegC_T,"-37.81687226, 144.96559144"
6720240323,6,2024-03-23,7,193,184,377,FliS_T,"-37.81911705, 144.96558255"
61520250324,6,2025-03-24,15,887,623,1510,FliS_T,"-37.81911705, 144.96558255"
842320250705,84,2025-07-05,23,273,351,624,ElFi_T,"-37.81798049, 144.96503383"
41320250912,4,2025-09-12,13,1682,1636,3318,Swa123_T,"-37.81487988, 144.9660878"
3020240209,3,2024-02-09,0,164,181,345,Swa295_T,"-37.81101524, 144.96429485"
701120240217,70,2024-02-17,11,171,179,350,Errol20_T,"-37.80456984, 144.94946228"
391020240725,39,2024-07-25,10,79,60,139,AlfPl_T,"-37.81379749, 144.96995745"
3220250626,3,2025-06-26,2,17,19,36,Swa295_T,"-37.81101524, 144.96429485"
82220240507,8,2024-05-07,22,8,9,17,WebBN_T,"-37.82293543, 144.9471751"
41720240529,41,2024-05-29,7,794,221,1015,Swa31,"-37.81668634, 144.96689733"
411520240620,41,2024-06-20,15,399,320,719,Swa31,"-37.81668634, 144.96689733"
41320231107,41,2023-11-07,3,81,137,218,Swa31,"-37.81668634, 144.96689733"
421720240924,42,2024-09-24,17,144,276,420,UM1_T,"-37.80008566, 144.96386412"
14020240818,14,2024-08-18,0,191,47,238,SanBri_T,"-37.82011242, 144.96291897"
71920241108,71,2024-11-08,9,38,40,78,WestWP_T,"-37.81235775, 144.97136962"
65520240710,65,2024-07-10,5,15,7,22,SwaCs_T,"-37.81569416, 144.9668064"
29120231210,29,2023-12-10,1,26,31,57,AG_T,"-37.8199817, 144.96872865"
291420231219,29,2023-12-19,14,216,360,576,AG_T,"-37.8199817, 144.96872865"
31020250318,31,2025-03-18,0,24,39,63,Lyg161_T,"-37.80169681, 144.96658911"
542020250201,54,2025-02-01,20,76,111,187,Swa607_T,"-37.804024, 144.96308399"
47620240729,47,2024-07-29,6,29,170,199,Eli250_T,"-37.81258467, 144.9625775"
472020231223,47,2023-12-23,20,760,1017,1777,Eli250_T,"-37.81258467, 144.9625775"
45620240701,45,2024-07-01,6,50,41,91,Swa148_T,"-37.81414075, 144.96609379"
67920231212,67,2023-12-12,9,378,317,695,FLDegS_T,"-37.81688755, 144.96562569"
112020240422,11,2024-04-22,20,75,83,158,WatCit_T,"-37.81564989, 144.93970694"
241920240729,24,2024-07-29,19,303,492,795,Col620_T,"-37.81887963, 144.95449198"
24420250401,24,2025-04-01,4,18,16,34,Col620_T,"-37.81887963, 144.95449198"
242220250503,24,2025-05-03,22,223,434,657,Col620_T,"-37.81887963, 144.95449198"
241020250611,24,2025-06-11,10,633,248,881,Col620_T,"-37.81887963, 144.95449198"
35920240511,35,2024-05-11,9,619,470,1089,SouthB_T,"-37.82018685, 144.96508508"
761920250331,76,2025-03-31,19,20,33,53,KenMac_T,"-37.79453803, 144.93036194"
2620250106,2,2025-01-06,6,18,27,45,Bou283_T,"-37.81380668, 144.96516718"
21520240426,2,2024-04-26,15,829,757,1586,Bou283_T,"-37.81380668, 144.96516718"
532220240618,53,2024-06-18,22,56,59,115,Col254_T,"-37.81564191, 144.965499"
791120240530,79,2024-05-30,11,337,249,586,FliSS_T,"-37.81794046, 144.96616678"
51320250529,51,2025-05-29,3,4,6,10,Fra118_T,"-37.80841815, 144.95906316"
251720241205,25,2024-12-05,17,934,529,1463,MCEC_T,"-37.82401776, 144.95604426"
1422020250507,142,2025-05-07,20,16,7,23,Hammer1584_T,"-37.81970749, 144.96795734"
1421020250611,142,2025-06-11,10,139,181,320,Hammer1584_T,"-37.81970749, 144.96795734"
1362220251011,136,2025-10-11,22,0,1,1,BirFed1120_T,"-37.8184141, 144.97357915"
1611120250523,161,2025-05-23,11,86,57,143,BirArt1109_T,"-37.81851276, 144.97131336"
164220241123,164,2024-11-23,2,2,11,13,Lat526_T,"-37.813005, 144.95160411"
117020250519,117,2025-05-19,0,8,19,27,Fli114F_T,"-37.81629332, 144.97090877"
1231320231020,123,2023-10-20,13,71,48,119,BirBridge_T,"-37.81753741, 144.97329734"
109020240801,109,2024-08-01,0,9,20,29,LatWill_T,"-37.81193681, 144.95621105"
1801420250416,180,2025-04-16,14,38,20,58,Mac330_T,"-37.79497059, 144.93530329"
1392120250327,139,2025-03-27,21,18,18,36,Signal1647_T,"-37.81959923, 144.9632832"
661920250203,66,2025-02-03,19,732,663,1395,QVN_T,"-37.81057846, 144.96444294"
691320240112,69,2024-01-12,13,199,245,444,FLDegC_T,"-37.81687226, 144.96559144"
3420231121,3,2023-11-21,4,23,28,51,Swa295_T,"-37.81101524, 144.96429485"
4120240102,4,2024-01-02,1,42,19,61,Swa123_T,"-37.81487988, 144.9660878"
39920250204,39,2025-02-04,9,134,117,251,AlfPl_T,"-37.81379749, 144.96995745"
752120250406,75,2025-04-06,21,1,1,2,SprFli_T,"-37.81515276, 144.97467661"
82320231031,8,2023-10-31,23,7,4,11,WebBN_T,"-37.82293543, 144.9471751"
77820250216,77,2025-02-16,8,44,51,95,HarEsP_T,"-37.81441438, 144.94433026"
781120250824,78,2025-08-24,11,103,129,232,HarEsB_T,"-37.81471642, 144.9446508"
77220240206,77,2024-02-06,2,4,2,6,HarEsP_T,"-37.81441438, 144.94433026"
711220241004,71,2024-10-04,12,43,38,81,WestWP_T,"-37.81235775, 144.97136962"
71520250317,71,2025-03-17,5,1,0,1,WestWP_T,"-37.81235775, 144.97136962"
54620240517,54,2024-05-17,6,19,15,34,Swa607_T,"-37.804024, 144.96308399"
541820241102,54,2024-11-02,18,90,119,209,Swa607_T,"-37.804024, 144.96308399"
371720240325,37,2024-03-25,17,92,108,200,Lyg260_T,"-37.80107122, 144.96704554"
47520250904,47,2025-09-04,5,12,41,53,Eli250_T,"-37.81258467, 144.9625775"
441620240214,44,2024-02-14,16,30,24,54,UM3_T,"-37.79698741, 144.96441306"
45020250307,45,2025-03-07,0,65,152,217,Swa148_T,"-37.81414075, 144.96609379"
21320250819,21,2025-08-19,3,1,2,3,Bourke155_T,"-37.81267313, 144.96788288"
87920240415,87,2024-04-15,9,66,67,133,Errol23_T,"-37.80454949, 144.94921863"
87220241117,87,2024-11-17,2,4,4,8,Errol23_T,"-37.80454949, 144.94921863"
50920250814,50,2025-08-14,9,55,107,162,Lyg309_T,"-37.79808192, 144.96721013"
1811420250829,181,2025-08-29,14,591,831,1422,Eli368_T,"-37.81009465, 144.96143149"
1401720250315,140,2025-03-15,17,102,116,218,Boyd2837_T,"-37.82590962, 144.96185972"
1182320240519,118,2024-05-19,23,3,2,5,Fli114C_T,"-37.81632783, 144.97090512"
872220241126,87,2024-11-26,22,19,13,32,Errol23_T,"-37.80454949, 144.94921863"
61520250316,61,2025-03-16,5,35,39,74,RMIT14_T,"-37.80767455, 144.96309114"
611820231106,61,2023-11-06,18,327,424,751,RMIT14_T,"-37.80767455, 144.96309114"
441920250705,44,2025-07-05,19,13,13,26,UM3_T,"-37.79698741, 144.96441306"
431920250220,43,2025-02-20,19,85,120,205,UM2_T,"-37.79844526, 144.96411782"
432020250518,43,2025-05-18,20,22,17,39,UM2_T,"-37.79844526, 144.96411782"
1851020250716,185,2025-07-16,10,340,421,761,Eli197_T,"-37.81374643, 144.96276183"
166320241031,166,2024-10-31,3,1,0,1,Spen484_T,"-37.80896733, 144.94931703"
1661120250407,166,2025-04-07,11,53,65,118,Spen484_T,"-37.80896733, 144.94931703"
162720250418,162,2025-04-18,7,75,64,139,Eli489_T,"-37.80740397, 144.95987909"
1341420241016,134,2024-10-16,14,402,364,766,Spen201_T,"-37.81694221, 144.95303935"
1311520240119,131,2024-01-19,15,173,117,290,King2_T,"-37.82009057, 144.95758725"
135620241109,135,2024-11-09,6,53,58,111,Spen161_T,"-37.8172861, 144.95319102"
1071220240714,107,2024-07-14,12,114,138,252,280Will_T,"-37.81246271, 144.95690188"
681420240122,68,2024-01-22,14,243,185,428,FLDegN_T,"-37.8168479, 144.96559789"
85920240305,85,2024-03-05,9,94,63,157,488Mac_T,"-37.79432415, 144.92973378"
17020240419,17,2024-04-19,0,26,27,53,Col15_T,"-37.81362543, 144.97323591"
671020240324,67,2024-03-24,10,331,403,734,FLDegS_T,"-37.81688755, 144.96562569"
182020240830,18,2024-08-30,20,3,10,13,Col12_T,"-37.81344862, 144.97305353"
18320250412,18,2025-04-12,3,1,1,2,Col12_T,"-37.81344862, 144.97305353"
671720240819,67,2024-08-19,17,322,651,973,FLDegS_T,"-37.81688755, 144.96562569"
621620240322,62,2024-03-22,16,285,168,453,Lat224_T,"-37.80996494, 144.96216521"
56720241103,56,2024-11-03,7,63,21,84,Lon364_T,"-37.81234775, 144.96153311"
86120241225,86,2024-12-25,1,1,0,1,574Qub_T,"-37.80309992, 144.94908064"
12920240602,12,2024-06-02,9,70,68,138,NewQ_T,"-37.81457988, 144.94292398"
721820240424,72,2024-04-24,18,334,548,882,ACMI_T,"-37.81726338, 144.96872809"
72120250719,72,2025-07-19,1,20,29,49,ACMI_T,"-37.81726338, 144.96872809"
581620250816,58,2025-08-16,16,1363,351,1714,Bou688_T,"-37.81686075, 144.95358075"
581420231106,58,2023-11-06,14,616,418,1034,Bou688_T,"-37.81686075, 144.95358075"
22020250304,2,2025-03-04,20,124,194,318,Bou283_T,"-37.81380668, 144.96516718"
22220240313,2,2024-03-13,22,29,101,130,Bou283_T,"-37.81380668, 144.96516718"
27220250926,27,2025-09-26,2,10,8,18,Vic_T,"-37.80606888, 144.95644692"
202220250419,20,2025-04-19,22,315,599,914,LtB170_T,"-37.81172914, 144.9682466"
49020240920,49,2024-09-20,0,56,42,98,Eli501_T,"-37.80730068, 144.95956055"
492120241021,49,2024-10-21,21,190,88,278,Eli501_T,"-37.80730068, 144.95956055"
1091920250331,109,2025-03-31,19,90,106,196,LatWill_T,"-37.81193681, 144.95621105"
1092020250502,109,2025-05-02,20,82,107,189,LatWill_T,"-37.81193681, 144.95621105"
1092120250708,109,2025-07-08,21,34,88,122,LatWill_T,"-37.81193681, 144.95621105"
109420250131,109,2025-01-31,4,3,3,6,LatWill_T,"-37.81193681, 144.95621105"
66820240912,66,2024-09-12,8,295,655,950,QVN_T,"-37.81057846, 144.96444294"
66720241208,66,2024-12-08,7,32,60,92,QVN_T,"-37.81057846, 144.96444294"
61820240406,6,2024-04-06,18,903,1120,2023,FliS_T,"-37.81911705, 144.96558255"
62020240628,6,2024-06-28,20,728,604,1332,FliS_T,"-37.81911705, 144.96558255"
841920240713,84,2024-07-13,19,632,981,1613,ElFi_T,"-37.81798049, 144.96503383"
32320241124,3,2024-11-24,23,254,141,395,Swa295_T,"-37.81101524, 144.96429485"
81120240929,8,2024-09-29,11,43,135,178,WebBN_T,"-37.82293543, 144.9471751"
751720240916,75,2024-09-16,17,67,45,112,SprFli_T,"-37.81515276, 144.97467661"
82320231113,8,2023-11-13,23,9,6,15,WebBN_T,"-37.82293543, 144.9471751"
134520241126,134,2024-11-26,5,60,54,114,Spen201_T,"-37.81694221, 144.95303935"
133720240923,133,2024-09-23,7,783,380,1163,Spen229_T,"-37.81531435, 144.95227769"
1421120241106,142,2024-11-06,11,357,353,710,Hammer1584_T,"-37.81970749, 144.96795734"
1422120241126,142,2024-11-26,21,15,12,27,Hammer1584_T,"-37.81970749, 144.96795734"
164620250729,164,2025-07-29,6,25,27,52,Lat526_T,"-37.813005, 144.95160411"
1412320250120,141,2025-01-20,23,30,220,250,474Fl_T,"-37.81997273, 144.95834911"
1411520250905,141,2025-09-05,15,132,118,250,474Fl_T,"-37.81997273, 144.95834911"
1381820250212,138,2025-02-12,18,15,5,20,EntPark1671_T,"-37.81996544, 144.95981454"
117520240428,117,2024-04-28,5,6,4,10,Fli114F_T,"-37.81629332, 144.97090877"
492020231126,49,2023-11-26,20,138,86,224,Eli501_T,"-37.80730068, 144.95956055"
191520241228,19,2024-12-28,15,599,495,1094,LtB210_T,"-37.81237202, 144.96550671"
137020250908,137,2025-09-08,0,0,2,2,BouHbr2353_T,"-37.81894815, 144.94612292"
1391220240209,139,2024-02-09,12,41,46,87,Signal1647_T,"-37.81959923, 144.9632832"
681320240519,68,2024-05-19,13,145,101,246,FLDegN_T,"-37.8168479, 144.96559789"
1420240803,1,2024-08-03,4,6,12,18,Bou292_T,"-37.81349441, 144.96515323"
181520240707,18,2024-07-07,15,123,65,188,Col12_T,"-37.81344862, 144.97305353"
631520250629,63,2025-06-29,15,312,420,732,Bou231_T,"-37.81333081, 144.96675571"
86020240823,86,2024-08-23,0,1,2,3,574Qub_T,"-37.80309992, 144.94908064"
56320240413,56,2024-04-13,3,55,35,90,Lon364_T,"-37.81234775, 144.96153311"
112020250814,11,2025-08-14,20,47,55,102,WatCit_T,"-37.81564989, 144.93970694"
242220250412,24,2025-04-12,22,274,389,663,Col620_T,"-37.81887963, 144.95449198"
35920240420,35,2024-04-20,9,700,557,1257,SouthB_T,"-37.82018685, 144.96508508"
351020231104,35,2023-11-04,10,909,646,1555,SouthB_T,"-37.82018685, 144.96508508"
76920250218,76,2025-02-18,9,42,48,90,KenMac_T,"-37.79453803, 144.93036194"
722020250310,72,2025-03-10,20,134,345,479,ACMI_T,"-37.81726338, 144.96872809"
58820250608,58,2025-06-08,8,169,65,234,Bou688_T,"-37.81686075, 144.95358075"
58920251015,58,2025-10-15,9,1126,196,1322,Bou688_T,"-37.81686075, 144.95358075"
53320250502,53,2025-05-02,3,2,1,3,Col254_T,"-37.81564191, 144.965499"
232220250818,23,2025-08-18,22,31,75,106,Col623_T,"-37.81909256, 144.95452748"
201920250508,20,2025-05-08,19,394,457,851,LtB170_T,"-37.81172914, 144.9682466"
25120231126,25,2023-11-26,1,110,81,191,MCEC_T,"-37.82401776, 144.95604426"
66720250828,66,2025-08-28,7,63,235,298,QVN_T,"-37.81057846, 144.96444294"
66420250104,66,2025-01-04,4,13,10,23,QVN_T,"-37.81057846, 144.96444294"
69420231217,69,2023-12-17,4,5,4,9,FLDegC_T,"-37.81687226, 144.96559144"
69720240809,69,2024-08-09,7,66,22,88,FLDegC_T,"-37.81687226, 144.96559144"
692120250128,69,2025-01-28,21,15,18,33,FLDegC_T,"-37.81687226, 144.96559144"
842320240829,84,2024-08-29,23,125,221,346,ElFi_T,"-37.81798049, 144.96503383"
31820231116,3,2023-11-16,18,1240,1255,2495,Swa295_T,"-37.81101524, 144.96429485"
702320231027,70,2023-10-27,23,107,30,137,Errol20_T,"-37.80456984, 144.94946228"
31920240904,3,2024-09-04,19,646,954,1600,Swa295_T,"-37.81101524, 144.96429485"
751320250603,75,2025-06-03,13,47,61,108,SprFli_T,"-37.81515276, 144.97467661"
771820241011,77,2024-10-11,18,238,115,353,HarEsP_T,"-37.81441438, 144.94433026"
29420250910,29,2025-09-10,4,7,2,9,AG_T,"-37.8199817, 144.96872865"
29820240816,29,2024-08-16,8,118,93,211,AG_T,"-37.8199817, 144.96872865"
592020250527,59,2025-05-27,20,234,378,612,RMIT_T,"-37.80825648, 144.96304859"
54320250115,54,2025-01-15,3,3,2,5,Swa607_T,"-37.804024, 144.96308399"
542220250816,54,2025-08-16,22,93,103,196,Swa607_T,"-37.804024, 144.96308399"
401320231231,40,2023-12-31,13,79,114,193,Spr201_T,"-37.80999341, 144.97227587"
451820240510,45,2024-05-10,18,558,790,1348,Swa148_T,"-37.81414075, 144.96609379"
21320250909,21,2025-09-09,3,3,2,5,Bourke155_T,"-37.81267313, 144.96788288"
1081420240618,108,2024-06-18,14,193,187,380,261Will_T,"-37.81295822, 144.95678789"
621520250818,62,2025-08-18,15,269,228,497,Lat224_T,"-37.80996494, 144.96216521"
1020250802,1,2025-08-02,0,60,83,143,Bou292_T,"-37.81349441, 144.96515323"
861120231109,86,2023-11-09,11,38,39,77,574Qub_T,"-37.80309992, 144.94908064"
681720250916,68,2025-09-16,17,114,91,205,FLDegN_T,"-37.8168479, 144.96559789"
722220250329,72,2025-03-29,22,170,255,425,ACMI_T,"-37.81726338, 144.96872809"
101520250702,10,2025-07-02,15,77,19,96,BouHbr_T,"-37.81876474, 144.94710545"
352020250918,35,2025-09-18,20,373,538,911,SouthB_T,"-37.82018685, 144.96508508"
531120240331,53,2024-03-31,11,530,461,991,Col254_T,"-37.81564191, 144.965499"
51220240711,51,2024-07-11,2,1,5,6,Fra118_T,"-37.80841815, 144.95906316"
482020240702,48,2024-07-02,20,73,91,164,QVMQ_T,"-37.80631581, 144.95866697"
252020250408,25,2025-04-08,20,177,201,378,MCEC_T,"-37.82401776, 144.95604426"
201120250331,20,2025-03-31,11,197,134,331,LtB170_T,"-37.81172914, 144.9682466"
201820240703,20,2024-07-03,18,484,331,815,LtB170_T,"-37.81172914, 144.9682466"
191620250824,19,2025-08-24,16,652,487,1139,LtB210_T,"-37.81237202, 144.96550671"
139320240610,139,2024-06-10,3,4,4,8,Signal1647_T,"-37.81959923, 144.9632832"
1361520240621,136,2024-06-21,15,130,50,180,BirFed1120_T,"-37.8184141, 144.97357915"
1232020250228,123,2025-02-28,20,20,6,26,BirBridge_T,"-37.81753741, 144.97329734"
1301720240910,130,2024-09-10,17,45,58,103,Bou892T,"-37.8204637, 144.94126826"
1611320250409,161,2025-04-09,13,207,240,447,BirArt1109_T,"-37.81851276, 144.97131336"
164120240907,164,2024-09-07,1,8,12,20,Lat526_T,"-37.813005, 144.95160411"
164920240919,164,2024-09-19,9,113,63,176,Lat526_T,"-37.813005, 144.95160411"
1232020231128,123,2023-11-28,20,17,1,18,BirBridge_T,"-37.81753741, 144.97329734"
123220240502,123,2024-05-02,2,1,0,1,BirBridge_T,"-37.81753741, 144.97329734"
691620240508,69,2024-05-08,16,103,135,238,FLDegC_T,"-37.81687226, 144.96559144"
84920240124,84,2024-01-24,9,986,428,1414,ElFi_T,"-37.81798049, 144.96503383"
66820240422,66,2024-04-22,8,197,482,679,QVN_T,"-37.81057846, 144.96444294"
701320240902,70,2024-09-02,13,110,111,221,Errol20_T,"-37.80456984, 144.94946228"
781720240209,78,2024-02-09,17,44,128,172,HarEsB_T,"-37.81471642, 144.9446508"
77220231107,77,2023-11-07,2,2,3,5,HarEsP_T,"-37.81441438, 144.94433026"
78220241002,78,2024-10-02,2,0,2,2,HarEsB_T,"-37.81471642, 144.9446508"
71920240206,71,2024-02-06,9,31,32,63,WestWP_T,"-37.81235775, 144.97136962"
711520240309,71,2024-03-09,15,12,8,20,WestWP_T,"-37.81235775, 144.97136962"
592120240726,59,2024-07-26,21,425,335,760,RMIT_T,"-37.80825648, 144.96304859"
54020240629,54,2024-06-29,0,28,24,52,Swa607_T,"-37.804024, 144.96308399"
1801320250725,180,2025-07-25,13,13,23,36,Mac330_T,"-37.79497059, 144.93530329"
68820250509,68,2025-05-09,8,188,153,341,FLDegN_T,"-37.8168479, 144.96559789"
682120251013,68,2025-10-13,21,68,64,132,FLDegN_T,"-37.8168479, 144.96559789"
631520250815,63,2025-08-15,15,207,234,441,Bou231_T,"-37.81333081, 144.96675571"
1520250518,1,2025-05-18,5,4,18,22,Bou292_T,"-37.81349441, 144.96515323"
63820250511,63,2025-05-11,8,36,53,89,Bou231_T,"-37.81333081, 144.96675571"
11120240102,11,2024-01-02,1,4,5,9,WatCit_T,"-37.81564989, 144.93970694"
681520250328,68,2025-03-28,15,283,232,515,FLDegN_T,"-37.8168479, 144.96559789"
682320250714,68,2025-07-14,23,9,4,13,FLDegN_T,"-37.8168479, 144.96559789"
12620241106,12,2024-11-06,6,47,35,82,NewQ_T,"-37.81457988, 144.94292398"
11820240718,11,2024-07-18,8,49,37,86,WatCit_T,"-37.81564989, 144.93970694"
621220241023,62,2024-10-23,12,204,241,445,Lat224_T,"-37.80996494, 144.96216521"
611020241005,61,2024-10-05,10,249,303,552,RMIT14_T,"-37.80767455, 144.96309114"
612120240322,61,2024-03-22,21,308,258,566,RMIT14_T,"-37.80767455, 144.96309114"
1651020250429,165,2025-04-29,10,34,41,75,Spen475_T,"-37.80953359, 144.94939004"
181620250531,181,2025-05-31,6,43,85,128,Eli368_T,"-37.81009465, 144.96143149"
162720250604,162,2025-06-04,7,94,56,150,Eli489_T,"-37.80740397, 144.95987909"
1401820250312,140,2025-03-12,18,114,151,265,Boyd2837_T,"-37.82590962, 144.96185972"
132220250312,132,2025-03-12,2,8,10,18,King335_T,"-37.81267639, 144.95386444"
1322120241022,132,2024-10-22,21,115,117,232,King335_T,"-37.81267639, 144.95386444"
133620240226,133,2024-02-26,6,374,218,592,Spen229_T,"-37.81531435, 144.95227769"
1331420240430,133,2024-04-30,14,423,391,814,Spen229_T,"-37.81531435, 144.95227769"
118620251002,118,2025-10-02,6,4,0,4,Fli114C_T,"-37.81632783, 144.97090512"
672320241114,67,2024-11-14,23,60,109,169,FLDegS_T,"-37.81688755, 144.96562569"
851720250904,85,2025-09-04,17,85,128,213,488Mac_T,"-37.79432415, 144.92973378"
17420240902,17,2024-09-02,4,12,6,18,Col15_T,"-37.81362543, 144.97323591"
1520250311,1,2025-03-11,5,5,10,15,Bou292_T,"-37.81349441, 144.96515323"
63820250111,63,2025-01-11,8,25,30,55,Bou231_T,"-37.81333081, 144.96675571"
67220241017,67,2024-10-17,2,7,12,19,FLDegS_T,"-37.81688755, 144.96562569"
86220231119,86,2023-11-19,2,0,1,1,574Qub_T,"-37.80309992, 144.94908064"
621420240912,62,2024-09-12,14,253,170,423,Lat224_T,"-37.80996494, 144.96216521"
621820241221,62,2024-12-21,18,150,142,292,Lat224_T,"-37.80996494, 144.96216521"
562220240205,56,2024-02-05,22,65,102,167,Lon364_T,"-37.81234775, 144.96153311"
562320240507,56,2024-05-07,23,42,45,87,Lon364_T,"-37.81234775, 144.96153311"
86120251005,86,2025-10-05,1,0,1,1,574Qub_T,"-37.80309992, 144.94908064"
101520231111,10,2023-11-11,15,90,50,140,BouHbr_T,"-37.81876474, 144.94710545"
121420241214,12,2024-12-14,14,141,184,325,NewQ_T,"-37.81457988, 144.94292398"
72120250801,72,2025-08-01,1,7,8,15,ACMI_T,"-37.81726338, 144.96872809"
21820240323,2,2024-03-23,18,585,532,1117,Bou283_T,"-37.81380668, 144.96516718"
58220240520,58,2024-05-20,2,23,27,50,Bou688_T,"-37.81686075, 144.95358075"
27320240531,27,2024-05-31,3,2,4,6,Vic_T,"-37.80606888, 144.95644692"
791320240108,79,2024-01-08,13,393,276,669,FliSS_T,"-37.81794046, 144.96616678"
53520240322,53,2024-03-22,5,1,9,10,Col254_T,"-37.81564191, 144.965499"
531520240602,53,2024-06-02,15,522,553,1075,Col254_T,"-37.81564191, 144.965499"
53320240109,53,2024-01-09,3,5,6,11,Col254_T,"-37.81564191, 144.965499"
23720241103,23,2024-11-03,7,39,50,89,Col623_T,"-37.81909256, 144.95452748"
48520240809,48,2024-08-09,5,10,16,26,QVMQ_T,"-37.80631581, 144.95866697"
25320240415,25,2024-04-15,3,1,4,5,MCEC_T,"-37.82401776, 144.95604426"
1301120241008,130,2024-10-08,11,47,67,114,Bou892T,"-37.8204637, 144.94126826"
1171220250309,117,2025-03-09,12,151,267,418,Fli114F_T,"-37.81629332, 144.97090877"
109820250918,109,2025-09-18,8,86,514,600,LatWill_T,"-37.81193681, 144.95621105"
49520250919,49,2025-09-19,5,22,22,44,Eli501_T,"-37.80730068, 144.95956055"
141420231209,141,2023-12-09,4,27,20,47,474Fl_T,"-37.81997273, 144.95834911"
1371920241025,137,2024-10-25,19,6,12,18,BouHbr2353_T,"-37.81894815, 144.94612292"
1391920240212,139,2024-02-12,19,95,54,149,Signal1647_T,"-37.81959923, 144.9632832"
661620240310,66,2024-03-10,16,1164,1134,2298,QVN_T,"-37.81057846, 144.96444294"
66220251009,66,2025-10-09,2,15,12,27,QVN_T,"-37.81057846, 144.96444294"
31320240107,3,2024-01-07,13,807,849,1656,Swa295_T,"-37.81101524, 144.96429485"
4420241127,4,2024-11-27,4,18,16,34,Swa123_T,"-37.81487988, 144.9660878"
82020250407,8,2025-04-07,20,13,22,35,WebBN_T,"-37.82293543, 144.9471751"
411120250619,41,2025-06-19,11,1294,936,2230,Swa31,"-37.81668634, 144.96689733"
24720250911,24,2025-09-11,7,1123,256,1379,Col620_T,"-37.81887963, 144.95449198"
2720250409,2,2025-04-09,7,45,85,130,Bou283_T,"-37.81380668, 144.96516718"
302320240502,30,2024-05-02,23,122,182,304,Lon189_T,"-37.8112185, 144.96656806"
136820231225,136,2023-12-25,8,31,17,48,BirFed1120_T,"-37.8184141, 144.97357915"
1301720240508,130,2024-05-08,17,10,6,16,Bou892T,"-37.8204637, 144.94126826"
1381420240423,138,2024-04-23,14,8,6,14,EntPark1671_T,"-37.81996544, 144.95981454"
281420250301,28,2025-03-01,14,1210,1077,2287,VAC_T,"-37.82129925, 144.96879309"
401520231104,40,2023-11-04,15,130,103,233,Spr201_T,"-37.80999341, 144.97227587"
31420231224,31,2023-12-24,4,20,15,35,Lyg161_T,"-37.80169681, 144.96658911"
362220250718,36,2025-07-18,22,151,228,379,Que85_T,"-37.81652527, 144.96121062"
361220231122,36,2023-11-22,12,430,330,760,Que85_T,"-37.81652527, 144.96121062"
37720250829,37,2025-08-29,7,20,15,35,Lyg260_T,"-37.80107122, 144.96704554"
441420250125,44,2025-01-25,14,29,38,67,UM3_T,"-37.79698741, 144.96441306"
441220250921,44,2025-09-21,12,43,45,88,UM3_T,"-37.79698741, 144.96441306"
431720240609,43,2024-06-09,17,42,88,130,UM2_T,"-37.79844526, 144.96411782"
451620240914,45,2024-09-14,16,637,809,1446,Swa148_T,"-37.81414075, 144.96609379"
162020241031,162,2024-10-31,0,80,59,139,Eli489_T,"-37.80740397, 144.95987909"
1341820240614,134,2024-06-14,18,328,324,652,Spen201_T,"-37.81694221, 144.95303935"
1071320240926,107,2024-09-26,13,238,262,500,280Will_T,"-37.81246271, 144.95690188"
1181920250707,118,2025-07-07,19,10,12,22,Fli114C_T,"-37.81632783, 144.97090512"
1651320250813,165,2025-08-13,13,33,27,60,Spen475_T,"-37.80953359, 144.94939004"
181920250724,181,2025-07-24,9,364,470,834,Eli368_T,"-37.81009465, 144.96143149"
1401420250329,140,2025-03-29,14,132,90,222,Boyd2837_T,"-37.82590962, 144.96185972"
17120240418,17,2024-04-18,1,7,6,13,Col15_T,"-37.81362543, 144.97323591"
17820251014,17,2025-10-14,8,1564,244,1808,Col15_T,"-37.81362543, 144.97323591"
11420240624,1,2024-06-24,14,1038,948,1986,Bou292_T,"-37.81349441, 144.96515323"
11820240803,1,2024-08-03,18,1196,684,1880,Bou292_T,"-37.81349441, 144.96515323"
63420241231,63,2024-12-31,4,0,1,1,Bou231_T,"-37.81333081, 144.96675571"
112220240228,11,2024-02-28,22,60,144,204,WatCit_T,"-37.81564989, 144.93970694"
121520241019,12,2024-10-19,15,1190,1100,2290,NewQ_T,"-37.81457988, 144.94292398"
111420241204,11,2024-12-04,14,81,66,147,WatCit_T,"-37.81564989, 144.93970694"
622020240312,62,2024-03-12,20,188,93,281,Lat224_T,"-37.80996494, 144.96216521"
621720250325,62,2025-03-25,17,347,238,585,Lat224_T,"-37.80996494, 144.96216521"
10120250407,10,2025-04-07,1,0,1,1,BouHbr_T,"-37.81876474, 144.94710545"
241220250428,24,2025-04-28,12,658,681,1339,Col620_T,"-37.81887963, 144.95449198"
762020250515,76,2025-05-15,20,15,32,47,KenMac_T,"-37.79453803, 144.93036194"
761020250723,76,2025-07-23,10,42,36,78,KenMac_T,"-37.79453803, 144.93036194"
791720240804,79,2024-08-04,17,394,382,776,FliSS_T,"-37.81794046, 144.96616678"
512220250224,51,2025-02-24,22,35,31,66,Fra118_T,"-37.80841815, 144.95906316"
30720250906,30,2025-09-06,7,11,52,63,Lon189_T,"-37.8112185, 144.96656806"
141820250506,141,2025-05-06,8,127,168,295,474Fl_T,"-37.81997273, 144.95834911"
1371920240527,137,2024-05-27,19,7,10,17,BouHbr2353_T,"-37.81894815, 144.94612292"
142820241229,142,2024-12-29,8,274,180,454,Hammer1584_T,"-37.81970749, 144.96795734"
1641620250710,164,2025-07-10,16,125,102,227,Lat526_T,"-37.813005, 144.95160411"
1172020240224,117,2024-02-24,20,135,194,329,Fli114F_T,"-37.81629332, 144.97090877"
109120240606,109,2024-06-06,1,4,3,7,LatWill_T,"-37.81193681, 144.95621105"
49720250917,49,2025-09-17,7,58,72,130,Eli501_T,"-37.80730068, 144.95956055"
19420250308,19,2025-03-08,4,14,26,40,LtB210_T,"-37.81237202, 144.96550671"
19920240116,19,2024-01-16,9,78,66,144,LtB210_T,"-37.81237202, 144.96550671"
1802020250928,180,2025-09-28,20,3,2,5,Mac330_T,"-37.79497059, 144.93530329"
661220250213,66,2025-02-13,12,845,1201,2046,QVN_T,"-37.81057846, 144.96444294"
661520241005,66,2024-10-05,15,1456,1457,2913,QVN_T,"-37.81057846, 144.96444294"
61320241212,6,2024-12-12,13,960,1008,1968,FliS_T,"-37.81911705, 144.96558255"
84720250323,84,2025-03-23,7,150,125,275,ElFi_T,"-37.81798049, 144.96503383"
4220231110,4,2023-11-10,2,22,23,45,Swa123_T,"-37.81487988, 144.9660878"
42320250228,4,2025-02-28,23,724,581,1305,Swa123_T,"-37.81487988, 144.9660878"
702020241106,70,2024-11-06,20,136,132,268,Errol20_T,"-37.80456984, 144.94946228"
391420240423,39,2024-04-23,14,122,179,301,AlfPl_T,"-37.81379749, 144.96995745"
41720241223,41,2024-12-23,7,369,128,497,Swa31,"-37.81668634, 144.96689733"
41620250109,41,2025-01-09,6,209,128,337,Swa31,"-37.81668634, 144.96689733"
411820250201,41,2025-02-01,18,1312,1175,2487,Swa31,"-37.81668634, 144.96689733"
781420250227,78,2025-02-27,14,32,76,108,HarEsB_T,"-37.81471642, 144.9446508"
77720240724,77,2024-07-24,7,67,126,193,HarEsP_T,"-37.81441438, 144.94433026"
771120250711,77,2025-07-11,11,147,97,244,HarEsP_T,"-37.81441438, 144.94433026"
141620240302,14,2024-03-02,16,512,168,680,SanBri_T,"-37.82011242, 144.96291897"
14920240118,14,2024-01-18,9,388,231,619,SanBri_T,"-37.82011242, 144.96291897"
54120240623,54,2024-06-23,1,34,40,74,Swa607_T,"-37.804024, 144.96308399"
36420240120,36,2024-01-20,4,15,5,20,Que85_T,"-37.81652527, 144.96121062"
611720250731,61,2025-07-31,17,614,776,1390,RMIT14_T,"-37.80767455, 144.96309114"
501220240226,50,2024-02-26,12,224,295,519,Lyg309_T,"-37.79808192, 144.96721013"
44920250424,44,2025-04-24,9,24,38,62,UM3_T,"-37.79698741, 144.96441306"
441320250507,44,2025-05-07,13,109,114,223,UM3_T,"-37.79698741, 144.96441306"
52220250103,5,2025-01-03,22,1194,751,1945,PriNW_T,"-37.81874249, 144.96787656"
212020250601,21,2025-06-01,20,187,223,410,Bourke155_T,"-37.81267313, 144.96788288"
1311020250414,131,2025-04-14,10,57,110,167,King2_T,"-37.82009057, 144.95758725"
131620240809,131,2024-08-09,6,6,10,16,King2_T,"-37.82009057, 144.95758725"
143820240823,143,2024-08-23,8,124,223,347,Spencer_T,"-37.821728, 144.95557015"
134520240416,134,2024-04-16,5,39,30,69,Spen201_T,"-37.81694221, 144.95303935"
1331420240508,133,2024-05-08,14,451,431,882,Spen229_T,"-37.81531435, 144.95227769"
1332220240824,133,2024-08-24,22,213,183,396,Spen229_T,"-37.81531435, 144.95227769"
771720241027,77,2024-10-27,17,147,133,280,HarEsP_T,"-37.81441438, 144.94433026"
281520231122,28,2023-11-22,15,457,953,1410,VAC_T,"-37.82129925, 144.96879309"
40620250816,40,2025-08-16,6,6,11,17,Spr201_T,"-37.80999341, 144.97227587"
361220240108,36,2024-01-08,12,159,153,312,Que85_T,"-37.81652527, 144.96121062"
361520240205,36,2024-02-05,15,156,193,349,Que85_T,"-37.81652527, 144.96121062"
44620240322,44,2024-03-22,6,5,7,12,UM3_T,"-37.79698741, 144.96441306"
451620250326,45,2025-03-26,16,408,771,1179,Swa148_T,"-37.81414075, 144.96609379"
52220240905,5,2024-09-05,22,898,247,1145,PriNW_T,"-37.81874249, 144.96787656"
21820231203,21,2023-12-03,8,45,59,104,Bourke155_T,"-37.81267313, 144.96788288"
108920240309,108,2024-03-09,9,84,91,175,261Will_T,"-37.81295822, 144.95678789"
50520240824,50,2024-08-24,5,9,1,10,Lyg309_T,"-37.79808192, 144.96721013"
501820241122,50,2024-11-22,18,224,233,457,Lyg309_T,"-37.79808192, 144.96721013"
431120241006,43,2024-10-06,11,44,41,85,UM2_T,"-37.79844526, 144.96411782"
85320240417,85,2024-04-17,3,1,0,1,488Mac_T,"-37.79432415, 144.92973378"
171020241203,17,2024-12-03,10,353,245,598,Col15_T,"-37.81362543, 144.97323591"
1820250308,1,2025-03-08,8,100,155,255,Bou292_T,"-37.81349441, 144.96515323"
631520231225,63,2023-12-25,15,97,107,204,Bou231_T,"-37.81333081, 144.96675571"
672020240302,67,2024-03-02,20,292,251,543,FLDegS_T,"-37.81688755, 144.96562569"
18220231107,18,2023-11-07,2,2,2,4,Col12_T,"-37.81344862, 144.97305353"
862020231210,86,2023-12-10,20,29,34,63,574Qub_T,"-37.80309992, 144.94908064"
56620250116,56,2025-01-16,6,27,19,46,Lon364_T,"-37.81234775, 144.96153311"
101420241008,10,2024-10-08,14,70,46,116,BouHbr_T,"-37.81876474, 144.94710545"
351520240612,35,2024-06-12,15,646,671,1317,SouthB_T,"-37.82018685, 144.96508508"
76620231031,76,2023-10-31,6,12,11,23,KenMac_T,"-37.79453803, 144.93036194"
761920240512,76,2024-05-12,19,21,19,40,KenMac_T,"-37.79453803, 144.93036194"
76220240812,76,2024-08-12,2,0,1,1,KenMac_T,"-37.79453803, 144.93036194"
72920240612,72,2024-06-12,9,404,112,516,ACMI_T,"-37.81726338, 144.96872809"
58520240218,58,2024-02-18,5,29,56,85,Bou688_T,"-37.81686075, 144.95358075"
58420250724,58,2025-07-24,4,16,14,30,Bou688_T,"-37.81686075, 144.95358075"
2420250810,2,2025-08-10,4,15,23,38,Bou283_T,"-37.81380668, 144.96516718"
21320240514,2,2024-05-14,13,703,795,1498,Bou283_T,"-37.81380668, 144.96516718"
91720240924,9,2024-09-24,17,2727,188,2915,Col700_T,"-37.81982992, 144.95102555"
91520241102,9,2024-11-02,15,78,99,177,Col700_T,"-37.81982992, 144.95102555"
531720250313,53,2025-03-13,17,960,573,1533,Col254_T,"-37.81564191, 144.965499"
51320240831,51,2024-08-31,3,16,11,27,Fra118_T,"-37.80841815, 144.95906316"
23620241221,23,2024-12-21,6,19,18,37,Col623_T,"-37.81909256, 144.95452748"
232320250120,23,2025-01-20,23,20,51,71,Col623_T,"-37.81909256, 144.95452748"
52320240425,52,2024-04-25,3,47,37,84,Eli263_T,"-37.81252157, 144.9619401"
142520241219,142,2024-12-19,5,22,8,30,Hammer1584_T,"-37.81970749, 144.96795734"
1421820240526,142,2024-05-26,18,222,150,372,Hammer1584_T,"-37.81970749, 144.96795734"
1611720250206,161,2025-02-06,17,173,79,252,BirArt1109_T,"-37.81851276, 144.97131336"
161920250311,161,2025-03-11,9,104,131,235,BirArt1109_T,"-37.81851276, 144.97131336"
1411520241216,141,2024-12-16,15,93,80,173,474Fl_T,"-37.81997273, 144.95834911"
1381420240307,138,2024-03-07,14,13,9,22,EntPark1671_T,"-37.81996544, 144.95981454"
138920240803,138,2024-08-03,9,1,4,5,EntPark1671_T,"-37.81996544, 144.95981454"
117020241002,117,2024-10-02,0,15,6,21,Fli114F_T,"-37.81629332, 144.97090877"
141420240220,141,2024-02-20,4,13,3,16,474Fl_T,"-37.81997273, 144.95834911"
109620231126,109,2023-11-26,6,3,3,6,LatWill_T,"-37.81193681, 144.95621105"
1091220240630,109,2024-06-30,12,56,100,156,LatWill_T,"-37.81193681, 144.95621105"
1372020240308,137,2024-03-08,20,5,7,12,BouHbr2353_T,"-37.81894815, 144.94612292"
1391020240329,139,2024-03-29,10,61,43,104,Signal1647_T,"-37.81959923, 144.9632832"
771620241116,77,2024-11-16,16,281,136,417,HarEsP_T,"-37.81441438, 144.94433026"
591820250421,59,2025-04-21,18,229,319,548,RMIT_T,"-37.80825648, 144.96304859"
54220240506,54,2024-05-06,2,2,3,5,Swa607_T,"-37.804024, 144.96308399"
292020240619,29,2024-06-19,20,63,84,147,AG_T,"-37.8199817, 144.96872865"
54020250920,54,2025-09-20,0,34,27,61,Swa607_T,"-37.804024, 144.96308399"
47420250302,47,2025-03-02,4,32,32,64,Eli250_T,"-37.81258467, 144.9625775"
871620250918,87,2025-09-18,16,94,122,216,Errol23_T,"-37.80454949, 144.94921863"
108820240630,108,2024-06-30,8,18,60,78,261Will_T,"-37.81295822, 144.95678789"
501220240318,50,2024-03-18,12,196,207,403,Lyg309_T,"-37.79808192, 144.96721013"
441820240825,44,2024-08-25,18,27,18,45,UM3_T,"-37.79698741, 144.96441306"
181320250524,181,2025-05-24,3,98,93,191,Eli368_T,"-37.81009465, 144.96143149"
166920250621,166,2025-06-21,9,33,28,61,Spen484_T,"-37.80896733, 144.94931703"
1791920250502,179,2025-05-02,19,78,63,141,Pow61_T,"-37.82392385, 144.96299677"
1311720250520,131,2025-05-20,17,72,182,254,King2_T,"-37.82009057, 144.95758725"
1321820250929,132,2025-09-29,18,158,187,345,King335_T,"-37.81267639, 144.95386444"
131220240126,131,2024-01-26,2,24,30,54,King2_T,"-37.82009057, 144.95758725"
1351720231225,135,2023-12-25,17,172,279,451,Spen161_T,"-37.8172861, 144.95319102"
107520241129,107,2024-11-29,5,6,15,21,280Will_T,"-37.81246271, 144.95690188"
851520240227,85,2024-02-27,15,85,118,203,488Mac_T,"-37.79432415, 144.92973378"
17720250724,17,2025-07-24,7,415,90,505,Col15_T,"-37.81362543, 144.97323591"
11820231019,1,2023-10-19,18,1337,995,2332,Bou292_T,"-37.81349441, 144.96515323"
12020240131,1,2024-01-31,20,303,300,603,Bou292_T,"-37.81349441, 144.96515323"
11920240828,1,2024-08-28,19,442,325,767,Bou292_T,"-37.81349441, 144.96515323"
11220240928,1,2024-09-28,12,1188,988,2176,Bou292_T,"-37.81349441, 144.96515323"
631820240712,63,2024-07-12,18,397,406,803,Bou231_T,"-37.81333081, 144.96675571"
681720250921,68,2025-09-21,17,181,197,378,FLDegN_T,"-37.8168479, 144.96559789"
181920250222,18,2025-02-22,19,59,35,94,Col12_T,"-37.81344862, 144.97305353"
1820251010,1,2025-10-10,8,168,199,367,Bou292_T,"-37.81349441, 144.96515323"
861220240820,86,2024-08-20,12,61,52,113,574Qub_T,"-37.80309992, 144.94908064"
67920250611,67,2025-06-11,9,428,312,740,FLDegS_T,"-37.81688755, 144.96562569"
621820241117,62,2024-11-17,18,241,263,504,Lat224_T,"-37.80996494, 144.96216521"
11820250420,11,2025-04-20,8,48,49,97,WatCit_T,"-37.81564989, 144.93970694"
10620250322,10,2025-03-22,6,3,2,5,BouHbr_T,"-37.81876474, 144.94710545"
111220250813,11,2025-08-13,12,46,30,76,WatCit_T,"-37.81564989, 144.93970694"
582320250222,58,2025-02-22,23,170,154,324,Bou688_T,"-37.81686075, 144.95358075"
9920240112,9,2024-01-12,9,107,668,775,Col700_T,"-37.81982992, 144.95102555"
2120250617,2,2025-06-17,1,2,0,2,Bou283_T,"-37.81380668, 144.96516718"
9320241217,9,2024-12-17,3,3,4,7,Col700_T,"-37.81982992, 144.95102555"
79220241115,79,2024-11-15,2,17,18,35,FliSS_T,"-37.81794046, 144.96616678"
79520231230,79,2023-12-30,5,21,24,45,FliSS_T,"-37.81794046, 144.96616678"
79420240121,79,2024-01-21,4,62,58,120,FliSS_T,"-37.81794046, 144.96616678"
511620231120,51,2023-11-20,16,92,85,177,Fra118_T,"-37.80841815, 144.95906316"
1662020250611,166,2025-06-11,20,5,6,11,Spen484_T,"-37.80896733, 144.94931703"
166120250509,166,2025-05-09,1,3,0,3,Spen484_T,"-37.80896733, 144.94931703"
1672020250203,167,2025-02-03,20,53,72,125,Lat526_T,"-37.81304149, 144.95155955"
681120231220,68,2023-12-20,11,170,115,285,FLDegN_T,"-37.8168479, 144.96559789"
85220250713,85,2025-07-13,2,2,2,4,488Mac_T,"-37.79432415, 144.92973378"
63420231209,63,2023-12-09,4,12,55,67,Bou231_T,"-37.81333081, 144.96675571"
12720240522,12,2024-05-22,7,104,55,159,NewQ_T,"-37.81457988, 144.94292398"
111220240501,11,2024-05-01,12,112,120,232,WatCit_T,"-37.81564989, 144.93970694"
111320250817,11,2025-08-17,13,102,104,206,WatCit_T,"-37.81564989, 144.93970694"
10920240409,10,2024-04-09,9,62,111,173,BouHbr_T,"-37.81876474, 144.94710545"
12120250108,12,2025-01-08,1,0,4,4,NewQ_T,"-37.81457988, 144.94292398"
122020250210,12,2025-02-10,20,294,294,588,NewQ_T,"-37.81457988, 144.94292398"
72820231214,72,2023-12-14,8,712,117,829,ACMI_T,"-37.81726338, 144.96872809"
72720240614,72,2024-06-14,7,112,52,164,ACMI_T,"-37.81726338, 144.96872809"
72520250603,72,2025-06-03,5,7,7,14,ACMI_T,"-37.81726338, 144.96872809"
581720240327,58,2024-03-27,17,718,1241,1959,Bou688_T,"-37.81686075, 144.95358075"
351120250103,35,2025-01-03,11,1012,615,1627,SouthB_T,"-37.82018685, 144.96508508"
76520240108,76,2024-01-08,5,1,2,3,KenMac_T,"-37.79453803, 144.93036194"
581520250414,58,2025-04-14,15,526,528,1054,Bou688_T,"-37.81686075, 144.95358075"
271020251013,27,2025-10-13,10,160,162,322,Vic_T,"-37.80606888, 144.95644692"
92220240708,9,2024-07-08,22,34,10,44,Col700_T,"-37.81982992, 144.95102555"
21920250925,2,2025-09-25,19,589,570,1159,Bou283_T,"-37.81380668, 144.96516718"
91220250112,9,2025-01-12,12,26,38,64,Col700_T,"-37.81982992, 144.95102555"
53020250905,53,2025-09-05,0,20,37,57,Col254_T,"-37.81564191, 144.965499"
231120240521,23,2024-05-21,11,201,248,449,Col623_T,"-37.81909256, 144.95452748"
231420250719,23,2025-07-19,14,122,269,391,Col623_T,"-37.81909256, 144.95452748"
51020250718,51,2025-07-18,0,16,12,28,Fra118_T,"-37.80841815, 144.95906316"
511720240516,51,2024-05-16,17,89,126,215,Fra118_T,"-37.80841815, 144.95906316"
25920250803,25,2025-08-03,9,193,731,924,MCEC_T,"-37.82401776, 144.95604426"
20220250511,20,2025-05-11,2,122,162,284,LtB170_T,"-37.81172914, 144.9682466"
141820250728,141,2025-07-28,8,107,146,253,474Fl_T,"-37.81997273, 144.95834911"
139520240414,139,2024-04-14,5,2,2,4,Signal1647_T,"-37.81959923, 144.9632832"
1391720240507,139,2024-05-07,17,257,42,299,Signal1647_T,"-37.81959923, 144.9632832"
139920240705,139,2024-07-05,9,11,85,96,Signal1647_T,"-37.81959923, 144.9632832"
1391020241005,139,2024-10-05,10,51,41,92,Signal1647_T,"-37.81959923, 144.9632832"
1422020250602,142,2025-06-02,20,17,6,23,Hammer1584_T,"-37.81970749, 144.96795734"
1361520240217,136,2024-02-17,15,888,461,1349,BirFed1120_T,"-37.8184141, 144.97357915"
161620240923,161,2024-09-23,6,47,64,111,BirArt1109_T,"-37.81851276, 144.97131336"
109820240218,109,2024-02-18,8,29,41,70,LatWill_T,"-37.81193681, 144.95621105"
192020241222,19,2024-12-22,20,588,454,1042,LtB210_T,"-37.81237202, 144.96550671"
69820250101,69,2025-01-01,8,56,30,86,FLDegC_T,"-37.81687226, 144.96559144"
84920231213,84,2023-12-13,9,1004,432,1436,ElFi_T,"-37.81798049, 144.96503383"
39020250519,39,2025-05-19,0,3,4,7,AlfPl_T,"-37.81379749, 144.96995745"
75520240515,75,2024-05-15,5,6,2,8,SprFli_T,"-37.81515276, 144.97467661"
8720240715,8,2024-07-15,7,88,66,154,WebBN_T,"-37.82293543, 144.9471751"
81920241119,8,2024-11-19,19,85,128,213,WebBN_T,"-37.82293543, 144.9471751"
411520240901,41,2024-09-01,15,205,185,390,Swa31,"-37.81668634, 144.96689733"
422220240911,42,2024-09-11,22,37,81,118,UM1_T,"-37.80008566, 144.96386412"
29220240125,29,2024-01-25,2,12,37,49,AG_T,"-37.8199817, 144.96872865"
591820250104,59,2025-01-04,18,306,249,555,RMIT_T,"-37.80825648, 144.96304859"
59420250504,59,2025-05-04,4,35,9,44,RMIT_T,"-37.80825648, 144.96304859"
712320240625,71,2024-06-25,23,13,7,20,WestWP_T,"-37.81235775, 144.97136962"
181320250710,181,2025-07-10,3,17,21,38,Eli368_T,"-37.81009465, 144.96143149"
1621520241109,162,2024-11-09,15,522,854,1376,Eli489_T,"-37.80740397, 144.95987909"
143620240422,143,2024-04-22,6,30,71,101,Spencer_T,"-37.821728, 144.95557015"
1321620240630,132,2024-06-30,16,112,120,232,King335_T,"-37.81267639, 144.95386444"
1331720240203,133,2024-02-03,17,554,510,1064,Spen229_T,"-37.81531435, 144.95227769"
1331520240208,133,2024-02-08,15,529,670,1199,Spen229_T,"-37.81531435, 144.95227769"
124820231110,124,2023-11-10,8,0,3,3,BirBridge_T,"-37.81757416, 144.97329934"
672120250203,67,2025-02-03,21,103,175,278,FLDegS_T,"-37.81688755, 144.96562569"
85120231020,85,2023-10-20,1,0,3,3,488Mac_T,"-37.79432415, 144.92973378"
632320240901,63,2024-09-01,23,56,73,129,Bou231_T,"-37.81333081, 144.96675571"
181320250115,18,2025-01-15,13,230,202,432,Col12_T,"-37.81344862, 144.97305353"
181920250302,18,2025-03-02,19,32,19,51,Col12_T,"-37.81344862, 144.97305353"
18920250403,18,2025-04-03,9,146,736,882,Col12_T,"-37.81344862, 144.97305353"
181020250508,18,2025-05-08,10,209,317,526,Col12_T,"-37.81344862, 144.97305353"
72620231203,72,2023-12-03,6,7,22,29,ACMI_T,"-37.81726338, 144.96872809"
76520250916,76,2025-09-16,5,2,2,4,KenMac_T,"-37.79453803, 144.93036194"
352320250303,35,2025-03-03,23,158,220,378,SouthB_T,"-37.82018685, 144.96508508"
22020250219,2,2025-02-19,20,147,205,352,Bou283_T,"-37.81380668, 144.96516718"
21320250905,2,2025-09-05,13,867,1022,1889,Bou283_T,"-37.81380668, 144.96516718"
35720250809,35,2025-08-09,7,243,156,399,SouthB_T,"-37.82018685, 144.96508508"
351720250826,35,2025-08-26,17,879,450,1329,SouthB_T,"-37.82018685, 144.96508508"
27120250628,27,2025-06-28,1,18,7,25,Vic_T,"-37.80606888, 144.95644692"
79220240413,79,2024-04-13,2,60,86,146,FliSS_T,"-37.81794046, 144.96616678"
91120250219,9,2025-02-19,11,269,275,544,Col700_T,"-37.81982992, 144.95102555"
79520240828,79,2024-08-28,5,31,22,53,FliSS_T,"-37.81794046, 144.96616678"
511120241207,51,2024-12-07,11,121,87,208,Fra118_T,"-37.80841815, 144.95906316"
23920250714,23,2025-07-14,9,400,257,657,Col623_T,"-37.81909256, 144.95452748"
191720240101,19,2024-01-01,17,619,470,1089,LtB210_T,"-37.81237202, 144.96550671"
48820240716,48,2024-07-16,8,141,108,249,QVMQ_T,"-37.80631581, 144.95866697"
461120250426,46,2025-04-26,11,18,45,63,Pel147_T,"-37.80240719, 144.9615673"
251120240106,25,2024-01-06,11,350,626,976,MCEC_T,"-37.82401776, 144.95604426"
521620250821,52,2025-08-21,16,379,394,773,Eli263_T,"-37.81252157, 144.9619401"
46320240309,46,2024-03-09,3,0,7,7,Pel147_T,"-37.80240719, 144.9615673"
1361420241015,136,2024-10-15,14,99,36,135,BirFed1120_T,"-37.8184141, 144.97357915"
1421320240526,142,2024-05-26,13,727,520,1247,Hammer1584_T,"-37.81970749, 144.96795734"
142220240528,142,2024-05-28,2,3,0,3,Hammer1584_T,"-37.81970749, 144.96795734"
1612220250905,161,2025-09-05,22,1,1374,1375,BirArt1109_T,"-37.81851276, 144.97131336"
1641620241028,164,2024-10-28,16,141,111,252,Lat526_T,"-37.813005, 144.95160411"
1611120240915,161,2024-09-15,11,138,153,291,BirArt1109_T,"-37.81851276, 144.97131336"
1171420241128,117,2024-11-28,14,212,250,462,Fli114F_T,"-37.81629332, 144.97090877"
491020240113,49,2024-01-13,10,283,328,611,Eli501_T,"-37.80730068, 144.95956055"
1092020240109,109,2024-01-09,20,122,102,224,LatWill_T,"-37.81193681, 144.95621105"
109820240210,109,2024-02-10,8,27,40,67,LatWill_T,"-37.81193681, 144.95621105"
191620250829,19,2025-08-29,16,415,351,766,LtB210_T,"-37.81237202, 144.96550671"
19320241226,19,2024-12-26,3,17,31,48,LtB210_T,"-37.81237202, 144.96550671"
137920240321,137,2024-03-21,9,112,33,145,BouHbr2353_T,"-37.81894815, 144.94612292"
61020240616,6,2024-06-16,10,584,346,930,FliS_T,"-37.81911705, 144.96558255"
841620231030,84,2023-10-30,16,872,1270,2142,ElFi_T,"-37.81798049, 144.96503383"
84020240919,84,2024-09-19,0,36,46,82,ElFi_T,"-37.81798049, 144.96503383"
31120250224,3,2025-02-24,11,619,643,1262,Swa295_T,"-37.81101524, 144.96429485"
70820240202,70,2024-02-02,8,69,88,157,Errol20_T,"-37.80456984, 144.94946228"
8520241119,8,2024-11-19,5,15,22,37,WebBN_T,"-37.82293543, 144.9471751"
231520240328,23,2024-03-28,15,264,420,684,Col623_T,"-37.81909256, 144.95452748"
52120231110,52,2023-11-10,1,17,42,59,Eli263_T,"-37.81252157, 144.9619401"
19520240921,19,2024-09-21,5,1,18,19,LtB210_T,"-37.81237202, 144.96550671"
20220231127,20,2023-11-27,2,39,17,56,LtB170_T,"-37.81172914, 144.9682466"
20520240412,20,2024-04-12,5,4,27,31,LtB170_T,"-37.81172914, 144.9682466"
180020251005,180,2025-10-05,0,0,8,8,Mac330_T,"-37.79497059, 144.93530329"
1412020240322,141,2024-03-22,20,135,132,267,474Fl_T,"-37.81997273, 144.95834911"
1411220250829,141,2025-08-29,12,128,117,245,474Fl_T,"-37.81997273, 144.95834911"
1371720240920,137,2024-09-20,17,5,29,34,BouHbr2353_T,"-37.81894815, 144.94612292"
1372020250816,137,2025-08-16,20,2,5,7,BouHbr2353_T,"-37.81894815, 144.94612292"
1391820240808,139,2024-08-08,18,61,38,99,Signal1647_T,"-37.81959923, 144.9632832"
1361420250622,136,2025-06-22,14,82,70,152,BirFed1120_T,"-37.8184141, 144.97357915"
117120240322,117,2024-03-22,1,21,11,32,Fli114F_T,"-37.81629332, 144.97090877"
1091920250122,109,2025-01-22,19,85,106,191,LatWill_T,"-37.81193681, 144.95621105"
661420250521,66,2025-05-21,14,1239,1306,2545,QVN_T,"-37.81057846, 144.96444294"
841620231112,84,2023-11-12,16,1024,1407,2431,ElFi_T,"-37.81798049, 144.96503383"
84020231127,84,2023-11-27,0,92,67,159,ElFi_T,"-37.81798049, 144.96503383"
3420231225,3,2023-12-25,4,19,17,36,Swa295_T,"-37.81101524, 144.96429485"
70720241222,70,2024-12-22,7,13,10,23,Errol20_T,"-37.80456984, 144.94946228"
752020241226,75,2024-12-26,20,13,7,20,SprFli_T,"-37.81515276, 144.97467661"
8720240330,8,2024-03-30,7,21,33,54,WebBN_T,"-37.82293543, 144.9471751"
412320240828,41,2024-08-28,23,90,72,162,Swa31,"-37.81668634, 144.96689733"
771020250820,77,2025-08-20,10,107,128,235,HarEsP_T,"-37.81441438, 144.94433026"
78920250310,78,2025-03-10,9,39,62,101,HarEsB_T,"-37.81471642, 144.9446508"
71020250916,71,2025-09-16,0,4,0,4,WestWP_T,"-37.81235775, 144.97136962"
711320231030,71,2023-10-30,13,14,19,33,WestWP_T,"-37.81235775, 144.97136962"
651820231030,65,2023-10-30,18,246,454,700,SwaCs_T,"-37.81569416, 144.9668064"
541220240401,54,2024-04-01,12,73,69,142,Swa607_T,"-37.804024, 144.96308399"
40320241119,40,2024-11-19,3,5,4,9,Spr201_T,"-37.80999341, 144.97227587"
541120250325,54,2025-03-25,11,176,180,356,Swa607_T,"-37.804024, 144.96308399"
471020250429,47,2025-04-29,10,441,484,925,Eli250_T,"-37.81258467, 144.9625775"
52320250718,5,2025-07-18,23,377,379,756,PriNW_T,"-37.81874249, 144.96787656"
51720250505,5,2025-05-05,17,1047,801,1848,PriNW_T,"-37.81874249, 144.96787656"
51320250507,5,2025-05-07,13,572,574,1146,PriNW_T,"-37.81874249, 144.96787656"
211020251010,21,2025-10-10,10,161,156,317,Bourke155_T,"-37.81267313, 144.96788288"
21020240503,21,2024-05-03,0,92,75,167,Bourke155_T,"-37.81267313, 144.96788288"
1181720240214,118,2024-02-14,17,38,78,116,Fli114C_T,"-37.81632783, 144.97090512"
87620250127,87,2025-01-27,6,12,10,22,Errol23_T,"-37.80454949, 144.94921863"
611320250420,61,2025-04-20,13,645,424,1069,RMIT14_T,"-37.80767455, 144.96309114"
501020240410,50,2024-04-10,10,140,165,305,Lyg309_T,"-37.79808192, 144.96721013"
166120250323,166,2025-03-23,1,2,4,6,Spen484_T,"-37.80896733, 144.94931703"
1312220240907,131,2024-09-07,22,140,86,226,King2_T,"-37.82009057, 144.95758725"
1311020240127,131,2024-01-27,10,81,160,241,King2_T,"-37.82009057, 144.95758725"
1072020250529,107,2025-05-29,20,68,109,177,280Will_T,"-37.81246271, 144.95690188"
133920250629,133,2025-06-29,9,240,300,540,Spen229_T,"-37.81531435, 144.95227769"
851720241008,85,2024-10-08,17,77,137,214,488Mac_T,"-37.79432415, 144.92973378"
1020240918,1,2024-09-18,0,10,35,45,Bou292_T,"-37.81349441, 144.96515323"
11620250627,1,2025-06-27,16,1310,1149,2459,Bou292_T,"-37.81349441, 144.96515323"
411520250302,41,2025-03-02,15,1491,1754,3245,Swa31,"-37.81668634, 144.96689733"
77820250417,77,2025-04-17,8,136,167,303,HarEsP_T,"-37.81441438, 144.94433026"
65320240207,65,2024-02-07,3,1,6,7,SwaCs_T,"-37.81569416, 144.9668064"
28720250221,28,2025-02-21,7,272,135,407,VAC_T,"-37.82129925, 144.96879309"
47920240519,47,2024-05-19,9,265,340,605,Eli250_T,"-37.81258467, 144.9625775"
401520240103,40,2024-01-03,15,158,141,299,Spr201_T,"-37.80999341, 144.97227587"
362320241026,36,2024-10-26,23,177,171,348,Que85_T,"-37.81652527, 144.96121062"
361720250420,36,2025-04-20,17,116,85,201,Que85_T,"-37.81652527, 144.96121062"
362020240304,36,2024-03-04,20,103,107,210,Que85_T,"-37.81652527, 144.96121062"
37220240523,37,2024-05-23,2,1,3,4,Lyg260_T,"-37.80107122, 144.96704554"
372320240620,37,2024-06-20,23,33,32,65,Lyg260_T,"-37.80107122, 144.96704554"
431420240214,43,2024-02-14,14,112,116,228,UM2_T,"-37.79844526, 144.96411782"
21520231123,21,2023-11-23,5,10,12,22,Bourke155_T,"-37.81267313, 144.96788288"
1081920250517,108,2025-05-17,19,93,92,185,261Will_T,"-37.81295822, 144.95678789"
441920250808,44,2025-08-08,19,34,71,105,UM3_T,"-37.79698741, 144.96441306"
43720251010,43,2025-10-10,7,43,23,66,UM2_T,"-37.79844526, 144.96411782"
1621320240825,162,2024-08-25,13,1017,1088,2105,Eli489_T,"-37.80740397, 144.95987909"
1432220250722,143,2025-07-22,22,72,361,433,Spencer_T,"-37.821728, 144.95557015"
1341820240407,134,2024-04-07,18,322,255,577,Spen201_T,"-37.81694221, 144.95303935"
67520240531,67,2024-05-31,5,16,11,27,FLDegS_T,"-37.81688755, 144.96562569"
67020250902,67,2025-09-02,0,10,9,19,FLDegS_T,"-37.81688755, 144.96562569"
171620250623,17,2025-06-23,16,214,362,576,Col15_T,"-37.81362543, 144.97323591"
172320251002,17,2025-10-02,23,21,13,34,Col15_T,"-37.81362543, 144.97323591"
11820231101,1,2023-11-01,18,1324,776,2100,Bou292_T,"-37.81349441, 144.96515323"
11320240617,1,2024-06-17,13,1264,1126,2390,Bou292_T,"-37.81349441, 144.96515323"
631420251010,63,2025-10-10,14,380,442,822,Bou231_T,"-37.81333081, 144.96675571"
12920240520,12,2024-05-20,9,54,57,111,NewQ_T,"-37.81457988, 144.94292398"
86320240817,86,2024-08-17,3,0,1,1,574Qub_T,"-37.80309992, 144.94908064"
62020250210,62,2025-02-10,0,41,27,68,Lat224_T,"-37.80996494, 144.96216521"
621320250717,62,2025-07-17,13,383,255,638,Lat224_T,"-37.80996494, 144.96216521"
56820241007,56,2024-10-07,8,88,149,237,Lon364_T,"-37.81234775, 144.96153311"
112220231212,11,2023-12-12,22,17,34,51,WatCit_T,"-37.81564989, 144.93970694"
24120250828,24,2025-08-28,1,21,14,35,Col620_T,"-37.81887963, 144.95449198"
122120241105,12,2024-11-05,21,184,147,331,NewQ_T,"-37.81457988, 144.94292398"
351120241107,35,2024-11-07,11,763,689,1452,SouthB_T,"-37.82018685, 144.96508508"
76820250106,76,2025-01-06,8,21,11,32,KenMac_T,"-37.79453803, 144.93036194"
721920251006,72,2025-10-06,19,58,126,184,ACMI_T,"-37.81726338, 144.96872809"
72420251007,72,2025-10-07,4,2,7,9,ACMI_T,"-37.81726338, 144.96872809"
58320251011,58,2025-10-11,3,25,25,50,Bou688_T,"-37.81686075, 144.95358075"
27120240809,27,2024-08-09,1,16,5,21,Vic_T,"-37.80606888, 144.95644692"
27220250810,27,2025-08-10,2,14,1,15,Vic_T,"-37.80606888, 144.95644692"
791820240108,79,2024-01-08,18,371,268,639,FliSS_T,"-37.81794046, 144.96616678"
92220231218,9,2023-12-18,22,57,29,86,Col700_T,"-37.81982992, 144.95102555"
532320231212,53,2023-12-12,23,41,35,76,Col254_T,"-37.81564191, 144.965499"
79820250515,79,2025-05-15,8,909,395,1304,FliSS_T,"-37.81794046, 144.96616678"
30220240722,30,2024-07-22,2,52,52,104,Lon189_T,"-37.8112185, 144.96656806"
512320231114,51,2023-11-14,23,36,24,60,Fra118_T,"-37.80841815, 144.95906316"
461620250808,46,2025-08-08,16,59,139,198,Pel147_T,"-37.80240719, 144.9615673"
521320241026,52,2024-10-26,13,416,343,759,Eli263_T,"-37.81252157, 144.9619401"
521520241220,52,2024-12-20,15,339,321,660,Eli263_T,"-37.81252157, 144.9619401"
52620241225,52,2024-12-25,6,12,8,20,Eli263_T,"-37.81252157, 144.9619401"
142220250416,142,2025-04-16,2,1,0,1,Hammer1584_T,"-37.81970749, 144.96795734"
1361820241228,136,2024-12-28,18,55,1999,2054,BirFed1120_T,"-37.8184141, 144.97357915"
138620240525,138,2024-05-25,6,0,1,1,EntPark1671_T,"-37.81996544, 144.95981454"
1411920240116,141,2024-01-16,19,92,201,293,474Fl_T,"-37.81997273, 144.95834911"
1092120241031,109,2024-10-31,21,80,111,191,LatWill_T,"-37.81193681, 144.95621105"
109320250312,109,2025-03-12,3,3,0,3,LatWill_T,"-37.81193681, 144.95621105"
191920250913,19,2025-09-13,19,736,631,1367,LtB210_T,"-37.81237202, 144.96550671"
67420240808,67,2024-08-08,4,4,2,6,FLDegS_T,"-37.81688755, 144.96562569"
182320231205,18,2023-12-05,23,9,7,16,Col12_T,"-37.81344862, 144.97305353"
182220240516,18,2024-05-16,22,2,3,5,Col12_T,"-37.81344862, 144.97305353"
63220250623,63,2025-06-23,2,0,4,4,Bou231_T,"-37.81333081, 144.96675571"
111520250704,11,2025-07-04,15,136,139,275,WatCit_T,"-37.81564989, 144.93970694"
37220250623,37,2025-06-23,2,2,3,5,Lyg260_T,"-37.80107122, 144.96704554"
671920231025,67,2023-10-25,19,231,296,527,FLDegS_T,"-37.81688755, 144.96562569"
11820250617,1,2025-06-17,18,927,495,1422,Bou292_T,"-37.81349441, 144.96515323"
72920241219,72,2024-12-19,9,262,104,366,ACMI_T,"-37.81726338, 144.96872809"
72620250711,72,2025-07-11,6,61,22,83,ACMI_T,"-37.81726338, 144.96872809"
35020240717,35,2024-07-17,0,30,44,74,SouthB_T,"-37.82018685, 144.96508508"
351220250909,35,2025-09-09,12,1160,1001,2161,SouthB_T,"-37.82018685, 144.96508508"
27720241101,27,2024-11-01,7,30,40,70,Vic_T,"-37.80606888, 144.95644692"
91420240820,9,2024-08-20,14,594,234,828,Col700_T,"-37.81982992, 144.95102555"
23120240721,23,2024-07-21,1,22,46,68,Col623_T,"-37.81909256, 144.95452748"
301420250321,30,2025-03-21,14,211,337,548,Lon189_T,"-37.8112185, 144.96656806"
511520250923,51,2025-09-23,15,118,102,220,Fra118_T,"-37.80841815, 144.95906316"
511720241003,51,2024-10-03,17,90,116,206,Fra118_T,"-37.80841815, 144.95906316"
481120240428,48,2024-04-28,11,521,476,997,QVMQ_T,"-37.80631581, 144.95866697"
201420240720,20,2024-07-20,14,279,352,631,LtB170_T,"-37.81172914, 144.9682466"
20120240508,20,2024-05-08,1,11,15,26,LtB170_T,"-37.81172914, 144.9682466"
25120240409,25,2024-04-09,1,1,2,3,MCEC_T,"-37.82401776, 144.95604426"
251920240514,25,2024-05-14,19,236,228,464,MCEC_T,"-37.82401776, 144.95604426"
52720250823,52,2025-08-23,7,30,19,49,Eli263_T,"-37.81252157, 144.9619401"
49820250913,49,2025-09-13,8,161,141,302,Eli501_T,"-37.80730068, 144.95956055"
141320240924,141,2024-09-24,3,9,6,15,474Fl_T,"-37.81997273, 144.95834911"
1371620241212,137,2024-12-12,16,16,134,150,BouHbr2353_T,"-37.81894815, 144.94612292"
1421020250209,142,2025-02-09,10,470,464,934,Hammer1584_T,"-37.81970749, 144.96795734"
1421620240613,142,2024-06-13,16,129,105,234,Hammer1584_T,"-37.81970749, 144.96795734"
1301620240222,130,2024-02-22,16,19,29,48,Bou892T,"-37.8204637, 144.94126826"
1611920250711,161,2025-07-11,19,3,2,5,BirArt1109_T,"-37.81851276, 144.97131336"
1382120241229,138,2024-12-29,21,0,2,2,EntPark1671_T,"-37.81996544, 144.95981454"
662220241228,66,2024-12-28,22,548,437,985,QVN_T,"-37.81057846, 144.96444294"
66520250912,66,2025-09-12,5,10,26,36,QVN_T,"-37.81057846, 144.96444294"
4220250711,4,2025-07-11,2,7,21,28,Swa123_T,"-37.81487988, 144.9660878"
701220250129,70,2025-01-29,12,150,175,325,Errol20_T,"-37.80456984, 144.94946228"
701820250920,70,2025-09-20,18,161,210,371,Errol20_T,"-37.80456984, 144.94946228"
391720250314,39,2025-03-14,17,151,77,228,AlfPl_T,"-37.81379749, 144.96995745"
81320250201,8,2025-02-01,13,138,232,370,WebBN_T,"-37.82293543, 144.9471751"
412120231219,41,2023-12-19,21,1115,2144,3259,Swa31,"-37.81668634, 144.96689733"
59920250207,59,2025-02-07,9,173,85,258,RMIT_T,"-37.80825648, 144.96304859"
28720240626,28,2024-06-26,7,292,116,408,VAC_T,"-37.82129925, 144.96879309"
471920241223,47,2024-12-23,19,763,687,1450,Eli250_T,"-37.81258467, 144.9625775"
211320250426,21,2025-04-26,13,411,444,855,Bourke155_T,"-37.81267313, 144.96788288"
211520240906,21,2024-09-06,15,266,280,546,Bourke155_T,"-37.81267313, 144.96788288"
211720241026,21,2024-10-26,17,433,393,826,Bourke155_T,"-37.81267313, 144.96788288"
1081220231120,108,2023-11-20,12,379,390,769,261Will_T,"-37.81295822, 144.95678789"
1081820240624,108,2024-06-24,18,112,113,225,261Will_T,"-37.81295822, 144.95678789"
871920250215,87,2025-02-15,19,100,86,186,Errol23_T,"-37.80454949, 144.94921863"
502020250912,50,2025-09-12,20,222,234,456,Lyg309_T,"-37.79808192, 144.96721013"
50120250717,50,2025-07-17,1,4,2,6,Lyg309_T,"-37.79808192, 144.96721013"
502220231129,50,2023-11-29,22,60,31,91,Lyg309_T,"-37.79808192, 144.96721013"
431420240812,43,2024-08-12,14,259,316,575,UM2_T,"-37.79844526, 144.96411782"
1852320250725,185,2025-07-25,23,302,308,610,Eli197_T,"-37.81374643, 144.96276183"
1651620250302,165,2025-03-02,16,52,36,88,Spen475_T,"-37.80953359, 144.94939004"
1401620231124,140,2023-11-24,16,56,42,98,Boyd2837_T,"-37.82590962, 144.96185972"
134620250111,134,2025-01-11,6,66,80,146,Spen201_T,"-37.81694221, 144.95303935"
1351920250405,135,2025-04-05,19,667,387,1054,Spen161_T,"-37.8172861, 144.95319102"
1071120231209,107,2023-12-09,11,71,94,165,280Will_T,"-37.81246271, 144.95690188"
1071820241030,107,2024-10-30,18,188,169,357,280Will_T,"-37.81246271, 144.95690188"
118720240918,118,2024-09-18,7,11,8,19,Fli114C_T,"-37.81632783, 144.97090512"
851920250407,85,2025-04-07,19,32,40,72,488Mac_T,"-37.79432415, 144.92973378"
1920240713,1,2024-07-13,9,224,335,559,Bou292_T,"-37.81349441, 144.96515323"
11320240729,1,2024-07-29,13,999,907,1906,Bou292_T,"-37.81349441, 144.96515323"
18120240110,18,2024-01-10,1,0,1,1,Col12_T,"-37.81344862, 144.97305353"
561120240626,56,2024-06-26,11,307,181,488,Lon364_T,"-37.81234775, 144.96153311"
86620251012,86,2025-10-12,6,2,7,9,574Qub_T,"-37.80309992, 144.94908064"
101120240420,10,2024-04-20,11,82,77,159,BouHbr_T,"-37.81876474, 144.94710545"
241820250508,24,2025-05-08,18,526,1104,1630,Col620_T,"-37.81887963, 144.95449198"
761520231227,76,2023-12-27,15,35,31,66,KenMac_T,"-37.79453803, 144.93036194"
76720240729,76,2024-07-29,7,32,11,43,KenMac_T,"-37.79453803, 144.93036194"
72220250916,72,2025-09-16,2,3,6,9,ACMI_T,"-37.81726338, 144.96872809"
581920240202,58,2024-02-02,19,449,289,738,Bou688_T,"-37.81686075, 144.95358075"
2620241015,2,2024-10-15,6,16,43,59,Bou283_T,"-37.81380668, 144.96516718"
35720250430,35,2025-04-30,7,505,836,1341,SouthB_T,"-37.82018685, 144.96508508"
21720250831,2,2025-08-31,17,506,356,862,Bou283_T,"-37.81380668, 144.96516718"
79820240523,79,2024-05-23,8,609,310,919,FliSS_T,"-37.81794046, 144.96616678"
531120250715,53,2025-07-15,11,674,432,1106,Col254_T,"-37.81564191, 144.965499"
531620250731,53,2025-07-31,16,606,504,1110,Col254_T,"-37.81564191, 144.965499"
231920240308,23,2024-03-08,19,126,159,285,Col623_T,"-37.81909256, 144.95452748"
461420250621,46,2025-06-21,14,52,48,100,Pel147_T,"-37.80240719, 144.9615673"
52620231227,52,2023-12-27,6,15,13,28,Eli263_T,"-37.81252157, 144.9619401"
201020250704,20,2025-07-04,10,133,123,256,LtB170_T,"-37.81172914, 144.9682466"
252220250809,25,2025-08-09,22,354,265,619,MCEC_T,"-37.82401776, 144.95604426"
20720240202,20,2024-02-02,7,13,25,38,LtB170_T,"-37.81172914, 144.9682466"
491220250811,49,2025-08-11,12,335,380,715,Eli501_T,"-37.80730068, 144.95956055"
1411820241122,141,2024-11-22,18,153,128,281,474Fl_T,"-37.81997273, 144.95834911"
1391120250823,139,2025-08-23,11,34,41,75,Signal1647_T,"-37.81959923, 144.9632832"
139720240603,139,2024-06-03,7,4,62,66,Signal1647_T,"-37.81959923, 144.9632832"
1391720240829,139,2024-08-29,17,240,48,288,Signal1647_T,"-37.81959923, 144.9632832"
1301220250222,130,2025-02-22,12,61,70,131,Bou892T,"-37.8204637, 144.94126826"
1171220241216,117,2024-12-16,12,166,159,325,Fli114F_T,"-37.81629332, 144.97090877"
1231220240919,123,2024-09-19,12,13,3,16,BirBridge_T,"-37.81753741, 144.97329734"
1381520240822,138,2024-08-22,15,9,5,14,EntPark1671_T,"-37.81996544, 144.95981454"
117520240425,117,2024-04-25,5,10,67,77,Fli114F_T,"-37.81629332, 144.97090877"
1171320240329,117,2024-03-29,13,170,148,318,Fli114F_T,"-37.81629332, 144.97090877"
661220250115,66,2025-01-15,12,754,1058,1812,QVN_T,"-37.81057846, 144.96444294"
61220241223,6,2024-12-23,12,915,908,1823,FliS_T,"-37.81911705, 144.96558255"
841820250112,84,2025-01-12,18,841,1061,1902,ElFi_T,"-37.81798049, 144.96503383"
841920250813,84,2025-08-13,19,612,1031,1643,ElFi_T,"-37.81798049, 144.96503383"
4820240710,4,2024-07-10,8,328,263,591,Swa123_T,"-37.81487988, 144.9660878"
70020250313,70,2025-03-13,0,5,8,13,Errol20_T,"-37.80456984, 144.94946228"
32020240621,3,2024-06-21,20,1130,1042,2172,Swa295_T,"-37.81101524, 144.96429485"
391520250401,39,2025-04-01,15,131,98,229,AlfPl_T,"-37.81379749, 144.96995745"
391220250407,39,2025-04-07,12,319,159,478,AlfPl_T,"-37.81379749, 144.96995745"
75220240828,75,2024-08-28,2,1,2,3,SprFli_T,"-37.81515276, 144.97467661"
411120250810,41,2025-08-10,11,1596,909,2505,Swa31,"-37.81668634, 144.96689733"
411320240713,41,2024-07-13,13,468,439,907,Swa31,"-37.81668634, 144.96689733"
411220240725,41,2024-07-25,12,414,421,835,Swa31,"-37.81668634, 144.96689733"
781220250624,78,2025-06-24,12,33,34,67,HarEsB_T,"-37.81471642, 144.9446508"
29920240810,29,2024-08-10,9,128,160,288,AG_T,"-37.8199817, 144.96872865"
14020250511,14,2025-05-11,0,215,36,251,SanBri_T,"-37.82011242, 144.96291897"
14720241208,14,2024-12-08,7,76,26,102,SanBri_T,"-37.82011242, 144.96291897"
14920231029,14,2023-10-29,9,164,62,226,SanBri_T,"-37.82011242, 144.96291897"
711220240215,71,2024-02-15,12,30,18,48,WestWP_T,"-37.81235775, 144.97136962"
59620240116,59,2024-01-16,6,91,92,183,RMIT_T,"-37.80825648, 144.96304859"
107720241212,107,2024-12-12,7,41,84,125,280Will_T,"-37.81246271, 144.95690188"
1182120240624,118,2024-06-24,21,2,15,17,Fli114C_T,"-37.81632783, 144.97090512"
1081120240606,108,2024-06-06,11,90,260,350,261Will_T,"-37.81295822, 144.95678789"
871320241125,87,2024-11-25,13,112,141,253,Errol23_T,"-37.80454949, 144.94921863"
61720241008,61,2024-10-08,7,176,117,293,RMIT14_T,"-37.80767455, 144.96309114"
50920250207,50,2025-02-07,9,76,108,184,Lyg309_T,"-37.79808192, 144.96721013"
165620250214,165,2025-02-14,6,6,11,17,Spen475_T,"-37.80953359, 144.94939004"
1312120241226,131,2024-12-26,21,182,121,303,King2_T,"-37.82009057, 144.95758725"
1312020250305,131,2025-03-05,20,115,91,206,King2_T,"-37.82009057, 144.95758725"
143020250209,143,2025-02-09,0,507,193,700,Spencer_T,"-37.821728, 144.95557015"
134520240819,134,2024-08-19,5,32,23,55,Spen201_T,"-37.81694221, 144.95303935"
1352220241112,135,2024-11-12,22,164,167,331,Spen161_T,"-37.8172861, 144.95319102"
85920250310,85,2025-03-10,9,77,63,140,488Mac_T,"-37.79432415, 144.92973378"
172120240523,17,2024-05-23,21,72,104,176,Col15_T,"-37.81362543, 144.97323591"
1920241004,1,2024-10-04,9,593,453,1046,Bou292_T,"-37.81349441, 144.96515323"
181820240207,18,2024-02-07,18,422,69,491,Col12_T,"-37.81344862, 144.97305353"
682020250915,68,2025-09-15,20,82,57,139,FLDegN_T,"-37.8168479, 144.96559789"
562120240620,56,2024-06-20,21,201,271,472,Lon364_T,"-37.81234775, 144.96153311"
86720250624,86,2025-06-24,7,21,18,39,574Qub_T,"-37.80309992, 144.94908064"
111420240319,11,2024-03-19,14,54,30,84,WatCit_T,"-37.81564989, 144.93970694"
24720240319,24,2024-03-19,7,1013,205,1218,Col620_T,"-37.81887963, 144.95449198"
121620240919,12,2024-09-19,16,113,121,234,NewQ_T,"-37.81457988, 144.94292398"
121120250617,12,2025-06-17,11,87,76,163,NewQ_T,"-37.81457988, 144.94292398"
101620250602,10,2025-06-02,16,191,53,244,BouHbr_T,"-37.81876474, 144.94710545"
24320241004,24,2024-10-04,3,15,17,32,Col620_T,"-37.81887963, 144.95449198"
35120240625,35,2024-06-25,1,12,11,23,SouthB_T,"-37.82018685, 144.96508508"
351620240805,35,2024-08-05,16,1167,985,2152,SouthB_T,"-37.82018685, 144.96508508"
76020240229,76,2024-02-29,0,1,4,5,KenMac_T,"-37.79453803, 144.93036194"
53120250413,53,2025-04-13,1,18,54,72,Col254_T,"-37.81564191, 144.965499"
91420241130,9,2024-11-30,14,74,117,191,Col700_T,"-37.81982992, 144.95102555"
531220231206,53,2023-12-06,12,1122,851,1973,Col254_T,"-37.81564191, 144.965499"
791520240620,79,2024-06-20,15,466,471,937,FliSS_T,"-37.81794046, 144.96616678"
23420240731,23,2024-07-31,4,1,9,10,Col623_T,"-37.81909256, 144.95452748"
232120231216,23,2023-12-16,21,60,160,220,Col623_T,"-37.81909256, 144.95452748"
232320240219,23,2024-02-19,23,7,54,61,Col623_T,"-37.81909256, 144.95452748"
191720250430,19,2025-04-30,17,549,385,934,LtB210_T,"-37.81237202, 144.96550671"
30220250912,30,2025-09-12,2,16,45,61,Lon189_T,"-37.8112185, 144.96656806"
461120250627,46,2025-06-27,11,49,39,88,Pel147_T,"-37.80240719, 144.9615673"
46920231125,46,2023-11-25,9,16,14,30,Pel147_T,"-37.80240719, 144.9615673"
522020240816,52,2024-08-16,20,362,305,667,Eli263_T,"-37.81252157, 144.9619401"
1371320240209,137,2024-02-09,13,27,57,84,BouHbr2353_T,"-37.81894815, 144.94612292"
137820250208,137,2025-02-08,8,7,16,23,BouHbr2353_T,"-37.81894815, 144.94612292"
1611520250529,161,2025-05-29,15,80,136,216,BirArt1109_T,"-37.81851276, 144.97131336"
1231120250904,123,2025-09-04,11,16,7,23,BirBridge_T,"-37.81753741, 144.97329734"
138720241231,138,2024-12-31,7,1,0,1,EntPark1671_T,"-37.81996544, 144.95981454"
61220250611,6,2025-06-11,12,793,638,1431,FliS_T,"-37.81911705, 144.96558255"
78820240220,78,2024-02-20,8,232,56,288,HarEsB_T,"-37.81471642, 144.9446508"
42920250420,42,2025-04-20,9,35,32,67,UM1_T,"-37.80008566, 144.96386412"
771520250303,77,2025-03-03,15,131,101,232,HarEsP_T,"-37.81441438, 144.94433026"
451020240613,45,2024-06-13,10,253,258,511,Swa148_T,"-37.81414075, 144.96609379"
5720250402,5,2025-04-02,7,179,459,638,PriNW_T,"-37.81874249, 144.96787656"
611420250115,61,2025-01-15,14,315,529,844,RMIT14_T,"-37.80767455, 144.96309114"
431120241127,43,2024-11-27,11,60,70,130,UM2_T,"-37.79844526, 144.96411782"
182020250606,182,2025-06-06,0,70,61,131,King163_T,"-37.81627451, 144.95550503"
1672220250425,167,2025-04-25,22,2,11,13,Lat526_T,"-37.81304149, 144.95155955"
1401820250330,140,2025-03-30,18,89,87,176,Boyd2837_T,"-37.82590962, 144.96185972"
1401720240423,140,2024-04-23,17,107,168,275,Boyd2837_T,"-37.82590962, 144.96185972"
143420250701,143,2025-07-01,4,16,2,18,Spencer_T,"-37.821728, 144.95557015"
1431720241104,143,2024-11-04,17,251,233,484,Spencer_T,"-37.821728, 144.95557015"
1431020250529,143,2025-05-29,10,68,125,193,Spencer_T,"-37.821728, 144.95557015"
118020240126,118,2024-01-26,0,18,5,23,Fli114C_T,"-37.81632783, 144.97090512"
1361620250419,136,2025-04-19,16,145,2396,2541,BirFed1120_T,"-37.8184141, 144.97357915"
142620241027,142,2024-10-27,6,58,68,126,Hammer1584_T,"-37.81970749, 144.96795734"
1171720241226,117,2024-12-26,17,135,192,327,Fli114F_T,"-37.81629332, 144.97090877"
1231020240417,123,2024-04-17,10,10,4,14,BirBridge_T,"-37.81753741, 144.97329734"
85720250513,85,2025-05-13,7,86,31,117,488Mac_T,"-37.79432415, 144.92973378"
181420240324,18,2024-03-24,14,88,61,149,Col12_T,"-37.81344862, 144.97305353"
18420240122,18,2024-01-22,4,0,1,1,Col12_T,"-37.81344862, 144.97305353"
67420250117,67,2025-01-17,4,0,2,2,FLDegS_T,"-37.81688755, 144.96562569"
621420240409,62,2024-04-09,14,311,209,520,Lat224_T,"-37.80996494, 144.96216521"
72520240315,72,2024-03-15,5,17,27,44,ACMI_T,"-37.81726338, 144.96872809"
761520250707,76,2025-07-07,15,41,67,108,KenMac_T,"-37.79453803, 144.93036194"
72120250422,72,2025-04-22,1,1,5,6,ACMI_T,"-37.81726338, 144.96872809"
532220250719,53,2025-07-19,22,133,225,358,Col254_T,"-37.81564191, 144.965499"
791820250127,79,2025-01-27,18,237,226,463,FliSS_T,"-37.81794046, 144.96616678"
51220250819,51,2025-08-19,2,5,5,10,Fra118_T,"-37.80841815, 144.95906316"
46220231024,46,2023-10-24,2,1,3,4,Pel147_T,"-37.80240719, 144.9615673"
511520250406,51,2025-04-06,15,127,124,251,Fra118_T,"-37.80841815, 144.95906316"
23620251001,23,2025-10-01,6,93,69,162,Col623_T,"-37.81909256, 144.95452748"
48720240510,48,2024-05-10,7,62,57,119,QVMQ_T,"-37.80631581, 144.95866697"
30020250617,30,2025-06-17,0,37,36,73,Lon189_T,"-37.8112185, 144.96656806"
481020231112,48,2023-11-12,10,318,309,627,QVMQ_T,"-37.80631581, 144.95866697"
521820241217,52,2024-12-17,18,348,342,690,Eli263_T,"-37.81252157, 144.9619401"
1411820240104,141,2024-01-04,18,125,132,257,474Fl_T,"-37.81997273, 144.95834911"
112120241028,11,2024-10-28,21,29,40,69,WatCit_T,"-37.81564989, 144.93970694"
862120250624,86,2025-06-24,21,10,35,45,574Qub_T,"-37.80309992, 144.94908064"
121420240826,12,2024-08-26,14,109,111,220,NewQ_T,"-37.81457988, 144.94292398"
241220241209,24,2024-12-09,12,658,634,1292,Col620_T,"-37.81887963, 144.95449198"
10320231027,10,2023-10-27,3,0,2,2,BouHbr_T,"-37.81876474, 144.94710545"
101620241024,10,2024-10-24,16,163,41,204,BouHbr_T,"-37.81876474, 144.94710545"
35320240209,35,2024-02-09,3,14,12,26,SouthB_T,"-37.82018685, 144.96508508"
79020250505,79,2025-05-05,0,19,55,74,FliSS_T,"-37.81794046, 144.96616678"
301120250329,30,2025-03-29,11,184,233,417,Lon189_T,"-37.8112185, 144.96656806"
91620250301,9,2025-03-01,16,160,282,442,Col700_T,"-37.81982992, 144.95102555"
232320240427,23,2024-04-27,23,44,103,147,Col623_T,"-37.81909256, 144.95452748"
481620231023,48,2023-10-23,16,109,109,218,QVMQ_T,"-37.80631581, 144.95866697"
46320240523,46,2024-05-23,3,2,0,2,Pel147_T,"-37.80240719, 144.9615673"
1411320240309,141,2024-03-09,13,215,198,413,474Fl_T,"-37.81997273, 144.95834911"
1371120250721,137,2025-07-21,11,15,64,79,BouHbr2353_T,"-37.81894815, 144.94612292"
137820250725,137,2025-07-25,8,78,15,93,BouHbr2353_T,"-37.81894815, 144.94612292"
1361620250225,136,2025-02-25,16,194,62,256,BirFed1120_T,"-37.8184141, 144.97357915"
491720241020,49,2024-10-20,17,224,232,456,Eli501_T,"-37.80730068, 144.95956055"
491520241125,49,2024-11-25,15,179,165,344,Eli501_T,"-37.80730068, 144.95956055"
191020250316,19,2025-03-16,10,187,100,287,LtB210_T,"-37.81237202, 144.96550671"
49120250828,49,2025-08-28,1,37,39,76,Eli501_T,"-37.80730068, 144.95956055"
391720250811,39,2025-08-11,17,115,46,161,AlfPl_T,"-37.81379749, 144.96995745"
39020251017,39,2025-10-17,0,2,7,9,AlfPl_T,"-37.81379749, 144.96995745"
392220231023,39,2023-10-23,22,23,13,36,AlfPl_T,"-37.81379749, 144.96995745"
75820240421,75,2024-04-21,8,14,24,38,SprFli_T,"-37.81515276, 144.97467661"
411320240228,41,2024-02-28,13,1730,1641,3371,Swa31,"-37.81668634, 144.96689733"
782320240410,78,2024-04-10,23,0,4,4,HarEsB_T,"-37.81471642, 144.9446508"
651120240321,65,2024-03-21,11,485,533,1018,SwaCs_T,"-37.81569416, 144.9668064"
141420231214,14,2023-12-14,14,534,200,734,SanBri_T,"-37.82011242, 144.96291897"
541320241022,54,2024-10-22,13,184,187,371,Swa607_T,"-37.804024, 144.96308399"
281720250916,28,2025-09-16,17,215,404,619,VAC_T,"-37.82129925, 144.96879309"
40620250112,40,2025-01-12,6,7,8,15,Spr201_T,"-37.80999341, 144.97227587"
47320240116,47,2024-01-16,3,24,14,38,Eli250_T,"-37.81258467, 144.9625775"
47920240418,47,2024-04-18,9,213,617,830,Eli250_T,"-37.81258467, 144.9625775"
361120240731,36,2024-07-31,11,149,173,322,Que85_T,"-37.81652527, 144.96121062"
362220241110,36,2024-11-10,22,35,37,72,Que85_T,"-37.81652527, 144.96121062"
361220240116,36,2024-01-16,12,327,279,606,Que85_T,"-37.81652527, 144.96121062"
502120240504,50,2024-05-04,21,342,201,543,Lyg309_T,"-37.79808192, 144.96721013"
212320231214,21,2023-12-14,23,195,268,463,Bourke155_T,"-37.81267313, 144.96788288"
1241720250618,124,2025-06-18,17,0,1,1,BirBridge_T,"-37.81757416, 144.97329934"
14020240503,14,2024-05-03,0,56,33,89,SanBri_T,"-37.82011242, 144.96291897"
711220240423,71,2024-04-23,12,35,41,76,WestWP_T,"-37.81235775, 144.97136962"
591220241004,59,2024-10-04,12,863,1158,2021,RMIT_T,"-37.80825648, 144.96304859"
592120241128,59,2024-11-28,21,149,134,283,RMIT_T,"-37.80825648, 144.96304859"
59820240209,59,2024-02-09,8,791,224,1015,RMIT_T,"-37.80825648, 144.96304859"
542120250303,54,2025-03-03,21,137,104,241,Swa607_T,"-37.804024, 144.96308399"
401420241115,40,2024-11-15,14,313,187,500,Spr201_T,"-37.80999341, 144.97227587"
31220240414,31,2024-04-14,2,8,7,15,Lyg161_T,"-37.80169681, 144.96658911"
311920240924,31,2024-09-24,19,158,184,342,Lyg161_T,"-37.80169681, 144.96658911"
36420250531,36,2025-05-31,4,13,3,16,Que85_T,"-37.81652527, 144.96121062"
36620240508,36,2024-05-08,6,32,20,52,Que85_T,"-37.81652527, 144.96121062"
37820250216,37,2025-02-16,8,15,4,19,Lyg260_T,"-37.80107122, 144.96704554"
451820250722,45,2025-07-22,18,335,595,930,Swa148_T,"-37.81414075, 144.96609379"
45920240401,45,2024-04-01,9,121,187,308,Swa148_T,"-37.81414075, 144.96609379"
1071720240423,107,2024-04-23,17,239,166,405,280Will_T,"-37.81246271, 144.95690188"
107720250429,107,2025-04-29,7,36,97,133,280Will_T,"-37.81246271, 144.95690188"
1081520250216,108,2025-02-16,15,120,126,246,261Will_T,"-37.81295822, 144.95678789"
1081320240603,108,2024-06-03,13,167,340,507,261Will_T,"-37.81295822, 144.95678789"
61720241215,61,2024-12-15,7,24,58,82,RMIT14_T,"-37.80767455, 144.96309114"
50320250214,50,2025-02-14,3,1,4,5,Lyg309_T,"-37.79808192, 144.96721013"
44920240807,44,2024-08-07,9,86,165,251,UM3_T,"-37.79698741, 144.96441306"
50320231114,50,2023-11-14,3,2,0,2,Lyg309_T,"-37.79808192, 144.96721013"
431520240921,43,2024-09-21,15,66,88,154,UM2_T,"-37.79844526, 144.96411782"
441620240429,44,2024-04-29,16,132,90,222,UM3_T,"-37.79698741, 144.96441306"
1851820250718,185,2025-07-18,18,816,628,1444,Eli197_T,"-37.81374643, 144.96276183"
165120250204,165,2025-02-04,1,3,1,4,Spen475_T,"-37.80953359, 144.94939004"
1661520241128,166,2024-11-28,15,44,43,87,Spen484_T,"-37.80896733, 144.94931703"
165120241126,165,2024-11-26,1,2,2,4,Spen475_T,"-37.80953359, 144.94939004"
184320250719,184,2025-07-19,3,22,54,76,Eli124_T,"-37.81512416, 144.96371988"
1331220240427,133,2024-04-27,12,457,508,965,Spen229_T,"-37.81531435, 144.95227769"
1241420250820,124,2025-08-20,14,13,12,25,BirBridge_T,"-37.81757416, 144.97329934"
851720231107,85,2023-11-07,17,73,68,141,488Mac_T,"-37.79432415, 144.92973378"
17920240526,17,2024-05-26,9,89,83,172,Col15_T,"-37.81362543, 144.97323591"
1220231119,1,2023-11-19,2,25,54,79,Bou292_T,"-37.81349441, 144.96515323"
1620240610,1,2024-06-10,6,8,18,26,Bou292_T,"-37.81349441, 144.96515323"
1920241023,1,2024-10-23,9,301,404,705,Bou292_T,"-37.81349441, 144.96515323"
671220240411,67,2024-04-11,12,456,746,1202,FLDegS_T,"-37.81688755, 144.96562569"
67620240801,67,2024-08-01,6,109,37,146,FLDegS_T,"-37.81688755, 144.96562569"
181020241127,18,2024-11-27,10,174,270,444,Col12_T,"-37.81344862, 144.97305353"
62320240819,62,2024-08-19,3,11,11,22,Lat224_T,"-37.80996494, 144.96216521"
561120250221,56,2025-02-21,11,317,221,538,Lon364_T,"-37.81234775, 144.96153311"
241020250526,24,2025-05-26,10,773,378,1151,Col620_T,"-37.81887963, 144.95449198"
721320241010,72,2024-10-10,13,208,314,522,ACMI_T,"-37.81726338, 144.96872809"
72820241122,72,2024-11-22,8,474,109,583,ACMI_T,"-37.81726338, 144.96872809"
72020231103,72,2023-11-03,0,22,39,61,ACMI_T,"-37.81726338, 144.96872809"
58320241012,58,2024-10-12,3,27,31,58,Bou688_T,"-37.81686075, 144.95358075"
351920241008,35,2024-10-08,19,832,1007,1839,SouthB_T,"-37.82018685, 144.96508508"
27420241107,27,2024-11-07,4,10,0,10,Vic_T,"-37.80606888, 144.95644692"
35220250730,35,2025-07-30,2,6,9,15,SouthB_T,"-37.82018685, 144.96508508"
30220240717,30,2024-07-17,2,18,13,31,Lon189_T,"-37.8112185, 144.96656806"
791120250109,79,2025-01-09,11,581,350,931,FliSS_T,"-37.81794046, 144.96616678"
46620241015,46,2024-10-15,6,9,5,14,Pel147_T,"-37.80240719, 144.9615673"
51820231207,51,2023-12-07,8,64,46,110,Fra118_T,"-37.80841815, 144.95906316"
231320240225,23,2024-02-25,13,95,183,278,Col623_T,"-37.81909256, 144.95452748"
19020250412,19,2025-04-12,0,342,354,696,LtB210_T,"-37.81237202, 144.96550671"
192120231202,19,2023-12-02,21,556,608,1164,LtB210_T,"-37.81237202, 144.96550671"
201320250315,20,2025-03-15,13,271,230,501,LtB170_T,"-37.81172914, 144.9682466"
201020240316,20,2024-03-16,10,95,95,190,LtB170_T,"-37.81172914, 144.9682466"
251020250118,25,2025-01-18,10,331,659,990,MCEC_T,"-37.82401776, 144.95604426"
1641120241129,164,2024-11-29,11,131,77,208,Lat526_T,"-37.813005, 144.95160411"
139820240321,139,2024-03-21,8,23,454,477,Signal1647_T,"-37.81959923, 144.9632832"
142320240102,142,2024-01-02,3,8,3,11,Hammer1584_T,"-37.81970749, 144.96795734"
1611220250604,161,2025-06-04,12,141,167,308,BirArt1109_T,"-37.81851276, 144.97131336"
1231120240308,123,2024-03-08,11,22,9,31,BirBridge_T,"-37.81753741, 144.97329734"
1302220250513,130,2025-05-13,22,9,3,12,Bou892T,"-37.8204637, 144.94126826"
1381220240104,138,2024-01-04,12,9,4,13,EntPark1671_T,"-37.81996544, 144.95981454"
1172020240824,117,2024-08-24,20,233,218,451,Fli114F_T,"-37.81629332, 144.97090877"
1171620240830,117,2024-08-30,16,153,179,332,Fli114F_T,"-37.81629332, 144.97090877"
84120250430,84,2025-04-30,1,12,13,25,ElFi_T,"-37.81798049, 144.96503383"
751420231107,75,2023-11-07,14,21,20,41,SprFli_T,"-37.81515276, 144.97467661"
41220250725,41,2025-07-25,2,45,64,109,Swa31,"-37.81668634, 144.96689733"
412320250210,41,2025-02-10,23,432,285,717,Swa31,"-37.81668634, 144.96689733"
781420240416,78,2024-04-16,14,47,64,111,HarEsB_T,"-37.81471642, 144.9446508"
771620241119,77,2024-11-19,16,212,131,343,HarEsP_T,"-37.81441438, 144.94433026"
77420250904,77,2025-09-04,4,2,3,5,HarEsP_T,"-37.81441438, 144.94433026"
771920251001,77,2025-10-01,19,150,131,281,HarEsP_T,"-37.81441438, 144.94433026"
14320250505,14,2025-05-05,3,7,3,10,SanBri_T,"-37.82011242, 144.96291897"
591720240322,59,2024-03-22,17,995,1932,2927,RMIT_T,"-37.80825648, 144.96304859"
59420240326,59,2024-03-26,4,5,8,13,RMIT_T,"-37.80825648, 144.96304859"
592020250708,59,2025-07-08,20,394,264,658,RMIT_T,"-37.80825648, 144.96304859"
65720240606,65,2024-06-06,7,235,88,323,SwaCs_T,"-37.81569416, 144.9668064"
40520240805,40,2024-08-05,5,7,12,19,Spr201_T,"-37.80999341, 144.97227587"
401420250831,40,2025-08-31,14,159,144,303,Spr201_T,"-37.80999341, 144.97227587"
37220231107,37,2023-11-07,2,13,7,20,Lyg260_T,"-37.80107122, 144.96704554"
45620251016,45,2025-10-16,6,42,62,104,Swa148_T,"-37.81414075, 144.96609379"
44920240427,44,2024-04-27,9,32,32,64,UM3_T,"-37.79698741, 144.96441306"
452120240224,45,2024-02-24,21,474,943,1417,Swa148_T,"-37.81414075, 144.96609379"
5720241031,5,2024-10-31,7,212,444,656,PriNW_T,"-37.81874249, 144.96787656"
612020240508,61,2024-05-08,20,274,356,630,RMIT14_T,"-37.80767455, 144.96309114"
441020250823,44,2025-08-23,10,26,41,67,UM3_T,"-37.79698741, 144.96441306"
1672320250323,167,2025-03-23,23,1,15,16,Lat526_T,"-37.81304149, 144.95155955"
1311620250604,131,2025-06-04,16,118,98,216,King2_T,"-37.82009057, 144.95758725"
134120250426,134,2025-04-26,1,54,35,89,Spen201_T,"-37.81694221, 144.95303935"
1341920240301,134,2024-03-01,19,431,317,748,Spen201_T,"-37.81694221, 144.95303935"
1351720250531,135,2025-05-31,17,400,404,804,Spen161_T,"-37.8172861, 144.95319102"
133120250901,133,2025-09-01,1,13,9,22,Spen229_T,"-37.81531435, 144.95227769"
85020240919,85,2024-09-19,0,1,2,3,488Mac_T,"-37.79432415, 144.92973378"
171820250121,17,2025-01-21,18,159,365,524,Col15_T,"-37.81362543, 144.97323591"
111120231214,11,2023-12-14,11,63,92,155,WatCit_T,"-37.81564989, 144.93970694"
86320250327,86,2025-03-27,3,0,1,1,574Qub_T,"-37.80309992, 144.94908064"
561720250619,56,2025-06-19,17,453,453,906,Lon364_T,"-37.81234775, 144.96153311"
24620240707,24,2024-07-07,6,50,66,116,Col620_T,"-37.81887963, 144.95449198"
35020240201,35,2024-02-01,0,70,112,182,SouthB_T,"-37.82018685, 144.96508508"
761120241008,76,2024-10-08,11,48,48,96,KenMac_T,"-37.79453803, 144.93036194"
582320240218,58,2024-02-18,23,159,108,267,Bou688_T,"-37.81686075, 144.95358075"
35120240916,35,2024-09-16,1,15,33,48,SouthB_T,"-37.82018685, 144.96508508"
352020240921,35,2024-09-21,20,873,3906,4779,SouthB_T,"-37.82018685, 144.96508508"
581720241006,58,2024-10-06,17,567,355,922,Bou688_T,"-37.81686075, 144.95358075"
531920250725,53,2025-07-25,19,395,198,593,Col254_T,"-37.81564191, 144.965499"
53520250827,53,2025-08-27,5,9,5,14,Col254_T,"-37.81564191, 144.965499"
301620241129,30,2024-11-29,16,284,423,707,Lon189_T,"-37.8112185, 144.96656806"
461720240324,46,2024-03-24,17,65,44,109,Pel147_T,"-37.80240719, 144.9615673"
51820240717,51,2024-07-17,8,57,48,105,Fra118_T,"-37.80841815, 144.95906316"
512320250501,51,2025-05-01,23,30,34,64,Fra118_T,"-37.80841815, 144.95906316"
251620241228,25,2024-12-28,16,1342,919,2261,MCEC_T,"-37.82401776, 144.95604426"
1411020240625,141,2024-06-25,10,121,93,214,474Fl_T,"-37.81997273, 144.95834911"
139720250904,139,2025-09-04,7,22,130,152,Signal1647_T,"-37.81959923, 144.9632832"
1361820250523,136,2025-05-23,18,527,5,532,BirFed1120_T,"-37.8184141, 144.97357915"
1421620251015,142,2025-10-15,16,444,302,746,Hammer1584_T,"-37.81970749, 144.96795734"
1851620250907,185,2025-09-07,16,508,626,1134,Eli197_T,"-37.81374643, 144.96276183"
1792320250607,179,2025-06-07,23,31,26,57,Pow61_T,"-37.82392385, 144.96299677"
1661020241116,166,2024-11-16,10,57,58,115,Spen484_T,"-37.80896733, 144.94931703"
1661920250612,166,2025-06-12,19,28,45,73,Spen484_T,"-37.80896733, 144.94931703"
1822120250911,182,2025-09-11,21,162,185,347,King163_T,"-37.81627451, 144.95550503"
143620240814,143,2024-08-14,6,36,78,114,Spencer_T,"-37.821728, 144.95557015"
1322120240513,132,2024-05-13,21,94,71,165,King335_T,"-37.81267639, 144.95386444"
85920240718,85,2024-07-18,9,98,66,164,488Mac_T,"-37.79432415, 144.92973378"
17720241005,17,2024-10-05,7,90,50,140,Col15_T,"-37.81362543, 144.97323591"
11620240229,1,2024-02-29,16,1266,1254,2520,Bou292_T,"-37.81349441, 144.96515323"
11920250319,1,2025-03-19,19,731,437,1168,Bou292_T,"-37.81349441, 144.96515323"
11520250326,1,2025-03-26,15,1058,1034,2092,Bou292_T,"-37.81349441, 144.96515323"
681520240927,68,2024-09-27,15,276,256,532,FLDegN_T,"-37.8168479, 144.96559789"
18920250128,18,2025-01-28,9,165,574,739,Col12_T,"-37.81344862, 144.97305353"
18320241027,18,2024-10-27,3,0,3,3,Col12_T,"-37.81344862, 144.97305353"
671020240615,67,2024-06-15,10,300,313,613,FLDegS_T,"-37.81688755, 144.96562569"
241720250608,24,2025-06-08,17,574,626,1200,Col620_T,"-37.81887963, 144.95449198"
11320251014,11,2025-10-14,3,3,4,7,WatCit_T,"-37.81564989, 144.93970694"
351520250625,35,2025-06-25,15,499,468,967,SouthB_T,"-37.82018685, 144.96508508"
761420250528,76,2025-05-28,14,38,41,79,KenMac_T,"-37.79453803, 144.93036194"
352020251001,35,2025-10-01,20,431,504,935,SouthB_T,"-37.82018685, 144.96508508"
21920241111,2,2024-11-11,19,159,198,357,Bou283_T,"-37.81380668, 144.96516718"
53420240206,53,2024-02-06,4,2,2,4,Col254_T,"-37.81564191, 144.965499"
301120250605,30,2025-06-05,11,162,229,391,Lon189_T,"-37.8112185, 144.96656806"
302020250907,30,2025-09-07,20,210,359,569,Lon189_T,"-37.8112185, 144.96656806"
30820250124,30,2025-01-24,8,73,87,160,Lon189_T,"-37.8112185, 144.96656806"
791420240509,79,2024-05-09,14,431,341,772,FliSS_T,"-37.81794046, 144.96616678"
791120240724,79,2024-07-24,11,461,297,758,FliSS_T,"-37.81794046, 144.96616678"
512320251001,51,2025-10-01,23,41,33,74,Fra118_T,"-37.80841815, 144.95906316"
23420250309,23,2025-03-09,4,8,3,11,Col623_T,"-37.81909256, 144.95452748"
192220231211,19,2023-12-11,22,234,321,555,LtB210_T,"-37.81237202, 144.96550671"
461920240404,46,2024-04-04,19,53,48,101,Pel147_T,"-37.80240719, 144.9615673"
1362320250823,136,2025-08-23,23,10,217,227,BirFed1120_T,"-37.8184141, 144.97357915"
1231120250107,123,2025-01-07,11,18,23,41,BirBridge_T,"-37.81753741, 144.97329734"
191120241201,19,2024-12-01,11,432,299,731,LtB210_T,"-37.81237202, 144.96550671"
691720240903,69,2024-09-03,17,91,124,215,FLDegC_T,"-37.81687226, 144.96559144"
841020231222,84,2023-12-22,10,901,662,1563,ElFi_T,"-37.81798049, 144.96503383"
32020240828,3,2024-08-28,20,762,674,1436,Swa295_T,"-37.81101524, 144.96429485"
392220250610,39,2025-06-10,22,6,3,9,AlfPl_T,"-37.81379749, 144.96995745"
392220240309,39,2024-03-09,22,55,43,98,AlfPl_T,"-37.81379749, 144.96995745"
81720250326,8,2025-03-26,17,254,480,734,WebBN_T,"-37.82293543, 144.9471751"
411420231115,41,2023-11-15,14,1413,1477,2890,Swa31,"-37.81668634, 144.96689733"
78820240720,78,2024-07-20,8,8,19,27,HarEsB_T,"-37.81471642, 144.9446508"
652020240830,65,2024-08-30,20,613,608,1221,SwaCs_T,"-37.81569416, 144.9668064"
29620241122,29,2024-11-22,6,101,159,260,AG_T,"-37.8199817, 144.96872865"
591420240402,59,2024-04-02,14,559,592,1151,RMIT_T,"-37.80825648, 144.96304859"
59720250204,59,2025-02-04,7,128,62,190,RMIT_T,"-37.80825648, 144.96304859"
1361820240220,136,2024-02-20,18,202,57,259,BirFed1120_T,"-37.8184141, 144.97357915"
142820250626,142,2025-06-26,8,121,266,387,Hammer1584_T,"-37.81970749, 144.96795734"
1422320240724,142,2024-07-24,23,9,5,14,Hammer1584_T,"-37.81970749, 144.96795734"
130820240629,130,2024-06-29,8,4,4,8,Bou892T,"-37.8204637, 144.94126826"
164220240818,164,2024-08-18,2,0,3,3,Lat526_T,"-37.813005, 144.95160411"
138920231212,138,2023-12-12,9,6,4,10,EntPark1671_T,"-37.81996544, 144.95981454"
1381220241106,138,2024-11-06,12,12,12,24,EntPark1671_T,"-37.81996544, 144.95981454"
109420240215,109,2024-02-15,4,3,1,4,LatWill_T,"-37.81193681, 144.95621105"
69720251010,69,2025-10-10,7,100,29,129,FLDegC_T,"-37.81687226, 144.96559144"
62020241108,6,2024-11-08,20,909,785,1694,FliS_T,"-37.81911705, 144.96558255"
841920240703,84,2024-07-03,19,643,1078,1721,ElFi_T,"-37.81798049, 144.96503383"
841420250713,84,2025-07-13,14,955,1273,2228,ElFi_T,"-37.81798049, 144.96503383"
61120250914,6,2025-09-14,11,677,651,1328,FliS_T,"-37.81911705, 144.96558255"
70520241004,70,2024-10-04,5,4,4,8,Errol20_T,"-37.80456984, 144.94946228"
75820231119,75,2023-11-19,8,21,11,32,SprFli_T,"-37.81515276, 144.97467661"
78320250124,78,2025-01-24,3,0,2,2,HarEsB_T,"-37.81471642, 144.9446508"
78920240729,78,2024-07-29,9,24,16,40,HarEsB_T,"-37.81471642, 144.9446508"
14820240512,14,2024-05-12,8,95,56,151,SanBri_T,"-37.82011242, 144.96291897"
141620241105,14,2024-11-05,16,434,161,595,SanBri_T,"-37.82011242, 144.96291897"
59520250116,59,2025-01-16,5,14,17,31,RMIT_T,"-37.80825648, 144.96304859"
71320250121,71,2025-01-21,3,1,1,2,WestWP_T,"-37.81235775, 144.97136962"
28720250706,28,2025-07-06,7,19,20,39,VAC_T,"-37.82129925, 144.96879309"
54720240505,54,2024-05-05,7,7,13,20,Swa607_T,"-37.804024, 144.96308399"
371320240701,37,2024-07-01,13,132,147,279,Lyg260_T,"-37.80107122, 144.96704554"
471520240507,47,2024-05-07,15,873,740,1613,Eli250_T,"-37.81258467, 144.9625775"
51220240905,5,2024-09-05,12,777,650,1427,PriNW_T,"-37.81874249, 144.96787656"
21220231018,21,2023-10-18,2,19,13,32,Bourke155_T,"-37.81267313, 144.96788288"
1081220240716,108,2024-07-16,12,183,379,562,261Will_T,"-37.81295822, 144.95678789"
108320240216,108,2024-02-16,3,8,1,9,261Will_T,"-37.81295822, 144.95678789"
501820241011,50,2024-10-11,18,234,350,584,Lyg309_T,"-37.79808192, 144.96721013"
1661020250901,166,2025-09-01,10,26,24,50,Spen484_T,"-37.80896733, 144.94931703"
1811820250602,181,2025-06-02,18,880,905,1785,Eli368_T,"-37.81009465, 144.96143149"
181320250728,181,2025-07-28,3,13,17,30,Eli368_T,"-37.81009465, 144.96143149"
1311120250310,131,2025-03-10,11,92,128,220,King2_T,"-37.82009057, 144.95758725"
1311720241113,131,2024-11-13,17,130,193,323,King2_T,"-37.82009057, 144.95758725"
1431020250113,143,2025-01-13,10,274,200,474,Spencer_T,"-37.821728, 144.95557015"
132420250405,132,2025-04-05,4,16,7,23,King335_T,"-37.81267639, 144.95386444"
1321620250921,132,2025-09-21,16,80,136,216,King335_T,"-37.81267639, 144.95386444"
1342320241126,134,2024-11-26,23,169,123,292,Spen201_T,"-37.81694221, 144.95303935"
1181620250312,118,2025-03-12,16,19,51,70,Fli114C_T,"-37.81632783, 144.97090512"
32120250210,3,2025-02-10,21,542,371,913,Swa295_T,"-37.81101524, 144.96429485"
392120240107,39,2024-01-07,21,35,22,57,AlfPl_T,"-37.81379749, 144.96995745"
751420250207,75,2025-02-07,14,53,70,123,SprFli_T,"-37.81515276, 144.97467661"
751120250511,75,2025-05-11,11,50,54,104,SprFli_T,"-37.81515276, 144.97467661"
751720250921,75,2025-09-21,17,31,20,51,SprFli_T,"-37.81515276, 144.97467661"
751720240205,75,2024-02-05,17,64,65,129,SprFli_T,"-37.81515276, 144.97467661"
751120240913,75,2024-09-13,11,35,39,74,SprFli_T,"-37.81515276, 144.97467661"
411120231124,41,2023-11-24,11,1872,1111,2983,Swa31,"-37.81668634, 144.96689733"
141620250924,14,2025-09-24,16,576,112,688,SanBri_T,"-37.82011242, 144.96291897"
65120240619,65,2024-06-19,1,1,14,15,SwaCs_T,"-37.81569416, 144.9668064"
542020250511,54,2025-05-11,20,120,115,235,Swa607_T,"-37.804024, 144.96308399"
37220250207,37,2025-02-07,2,5,7,12,Lyg260_T,"-37.80107122, 144.96704554"
37220250917,37,2025-09-17,2,1,0,1,Lyg260_T,"-37.80107122, 144.96704554"
661020250907,66,2025-09-07,10,397,460,857,QVN_T,"-37.81057846, 144.96444294"
3620250309,3,2025-03-09,6,33,32,65,Swa295_T,"-37.81101524, 144.96429485"
392020250326,39,2025-03-26,20,8,16,24,AlfPl_T,"-37.81379749, 144.96995745"
391320250604,39,2025-06-04,13,167,185,352,AlfPl_T,"-37.81379749, 144.96995745"
81420250304,8,2025-03-04,14,107,222,329,WebBN_T,"-37.82293543, 144.9471751"
81820250501,8,2025-05-01,18,78,74,152,WebBN_T,"-37.82293543, 144.9471751"
81120240511,8,2024-05-11,11,130,303,433,WebBN_T,"-37.82293543, 144.9471751"
65820240912,65,2024-09-12,8,1023,293,1316,SwaCs_T,"-37.81569416, 144.9668064"
771520240912,77,2024-09-12,15,149,141,290,HarEsP_T,"-37.81441438, 144.94433026"
42020250228,42,2025-02-28,0,0,1,1,UM1_T,"-37.80008566, 144.96386412"
29320240424,29,2024-04-24,3,5,4,9,AG_T,"-37.8199817, 144.96872865"
71020240827,71,2024-08-27,0,6,5,11,WestWP_T,"-37.81235775, 144.97136962"
471120240210,47,2024-02-10,11,788,890,1678,Eli250_T,"-37.81258467, 144.9625775"
40120240303,40,2024-03-03,1,39,5,44,Spr201_T,"-37.80999341, 144.97227587"
40720240410,40,2024-04-10,7,103,121,224,Spr201_T,"-37.80999341, 144.97227587"
361620240606,36,2024-06-06,16,211,208,419,Que85_T,"-37.81652527, 144.96121062"
37120250322,37,2025-03-22,1,20,33,53,Lyg260_T,"-37.80107122, 144.96704554"
21420250913,21,2025-09-13,4,15,27,42,Bourke155_T,"-37.81267313, 144.96788288"
5920241227,5,2024-12-27,9,400,544,944,PriNW_T,"-37.81874249, 144.96787656"
1072220250315,107,2025-03-15,22,87,63,150,280Will_T,"-37.81246271, 144.95690188"
1071520250831,107,2025-08-31,15,70,104,174,280Will_T,"-37.81246271, 144.95690188"
611220250213,61,2025-02-13,12,675,954,1629,RMIT14_T,"-37.80767455, 144.96309114"
184320250925,184,2025-09-25,3,3,8,11,Eli124_T,"-37.81512416, 144.96371988"
165820240919,165,2024-09-19,8,20,70,90,Spen475_T,"-37.80953359, 144.94939004"
1651120241002,165,2024-10-02,11,36,32,68,Spen475_T,"-37.80953359, 144.94939004"
1811720250513,181,2025-05-13,17,1106,1568,2674,Eli368_T,"-37.81009465, 144.96143149"
134920240307,134,2024-03-07,9,375,420,795,Spen201_T,"-37.81694221, 144.95303935"
133720250424,133,2025-04-24,7,605,327,932,Spen229_T,"-37.81531435, 144.95227769"
5720240310,5,2024-03-10,7,100,95,195,PriNW_T,"-37.81874249, 144.96787656"
21820231025,21,2023-10-25,8,151,164,315,Bourke155_T,"-37.81267313, 144.96788288"
61420241115,61,2024-11-15,4,14,19,33,RMIT14_T,"-37.80767455, 144.96309114"
87420240112,87,2024-01-12,4,1,0,1,Errol23_T,"-37.80454949, 144.94921863"
441320231110,44,2023-11-10,13,50,67,117,UM3_T,"-37.79698741, 144.96441306"
44220250212,44,2025-02-12,2,0,1,1,UM3_T,"-37.79698741, 144.96441306"
1671420250313,167,2025-03-13,14,1,6,7,Lat526_T,"-37.81304149, 144.95155955"
1401420241124,140,2024-11-24,14,99,74,173,Boyd2837_T,"-37.82590962, 144.96185972"
1311520250104,131,2025-01-04,15,176,93,269,King2_T,"-37.82009057, 144.95758725"
1621920241020,162,2024-10-20,19,277,216,493,Eli489_T,"-37.80740397, 144.95987909"
1431420250831,143,2025-08-31,14,148,163,311,Spencer_T,"-37.821728, 144.95557015"
1352120240224,135,2024-02-24,21,101,140,241,Spen161_T,"-37.8172861, 144.95319102"
712120250421,71,2025-04-21,21,7,1,8,WestWP_T,"-37.81235775, 144.97136962"
28620250330,28,2025-03-30,6,26,40,66,VAC_T,"-37.82129925, 144.96879309"
281020240724,28,2024-07-24,10,459,197,656,VAC_T,"-37.82129925, 144.96879309"
472320250502,47,2025-05-02,23,283,194,477,Eli250_T,"-37.81258467, 144.9625775"
40020250404,40,2025-04-04,0,19,7,26,Spr201_T,"-37.80999341, 144.97227587"
31220250128,31,2025-01-28,2,4,2,6,Lyg161_T,"-37.80169681, 144.96658911"
312220250704,31,2025-07-04,22,153,176,329,Lyg161_T,"-37.80169681, 144.96658911"
371620240925,37,2024-09-25,16,117,93,210,Lyg260_T,"-37.80107122, 144.96704554"
37820250702,37,2025-07-02,8,23,47,70,Lyg260_T,"-37.80107122, 144.96704554"
43220240817,43,2024-08-17,2,6,1,7,UM2_T,"-37.79844526, 144.96411782"
431920250423,43,2025-04-23,19,31,101,132,UM2_T,"-37.79844526, 144.96411782"
44020231109,44,2023-11-09,0,27,2,29,UM3_T,"-37.79698741, 144.96441306"
441720231111,44,2023-11-11,17,18,9,27,UM3_T,"-37.79698741, 144.96441306"
451920240810,45,2024-08-10,19,919,1129,2048,Swa148_T,"-37.81414075, 144.96609379"
51920250122,5,2025-01-22,19,615,1426,2041,PriNW_T,"-37.81874249, 144.96787656"
211520231106,21,2023-11-06,15,390,462,852,Bourke155_T,"-37.81267313, 144.96788288"
107420240720,107,2024-07-20,4,9,4,13,280Will_T,"-37.81246271, 144.95690188"
124720250129,124,2025-01-29,7,3,1,4,BirBridge_T,"-37.81757416, 144.97329934"
108420240104,108,2024-01-04,4,8,9,17,261Will_T,"-37.81295822, 144.95678789"
87920231105,87,2023-11-05,9,51,58,109,Errol23_T,"-37.80454949, 144.94921863"
162920240925,162,2024-09-25,9,63,90,153,Eli489_T,"-37.80740397, 144.95987909"
1431420240906,143,2024-09-06,14,152,200,352,Spencer_T,"-37.821728, 144.95557015"
851720240214,85,2024-02-14,17,90,142,232,488Mac_T,"-37.79432415, 144.92973378"
17320231116,17,2023-11-16,3,9,8,17,Col15_T,"-37.81362543, 144.97323591"
17020241230,17,2024-12-30,0,10,8,18,Col15_T,"-37.81362543, 144.97323591"
181820250216,18,2025-02-16,18,56,24,80,Col12_T,"-37.81344862, 144.97305353"
62720250628,62,2025-06-28,7,23,21,44,Lat224_T,"-37.80996494, 144.96216521"
562220240716,56,2024-07-16,22,105,147,252,Lon364_T,"-37.81234775, 144.96153311"
12720250127,12,2025-01-27,7,52,52,104,NewQ_T,"-37.81457988, 144.94292398"
24220240822,24,2024-08-22,2,19,28,47,Col620_T,"-37.81887963, 144.95449198"
10120251004,10,2025-10-04,1,17,6,23,BouHbr_T,"-37.81876474, 144.94710545"
581620240401,58,2024-04-01,16,466,256,722,Bou688_T,"-37.81686075, 144.95358075"
35420231127,35,2023-11-27,4,22,16,38,SouthB_T,"-37.82018685, 144.96508508"
76220231208,76,2023-12-08,2,1,2,3,KenMac_T,"-37.79453803, 144.93036194"
271020250205,27,2025-02-05,10,62,72,134,Vic_T,"-37.80606888, 144.95644692"
791520250110,79,2025-01-10,15,563,440,1003,FliSS_T,"-37.81794046, 144.96616678"
91320251004,9,2025-10-04,13,64,97,161,Col700_T,"-37.81982992, 144.95102555"
19720231116,19,2023-11-16,7,27,18,45,LtB210_T,"-37.81237202, 144.96550671"
252320241113,25,2024-11-13,23,258,122,380,MCEC_T,"-37.82401776, 144.95604426"
461220250804,46,2025-08-04,12,161,126,287,Pel147_T,"-37.80240719, 144.9615673"
137820240425,137,2024-04-25,8,7,7,14,BouHbr2353_T,"-37.81894815, 144.94612292"
1372020250423,137,2025-04-23,20,3,5,8,BouHbr2353_T,"-37.81894815, 144.94612292"
141920231217,141,2023-12-17,9,75,60,135,474Fl_T,"-37.81997273, 144.95834911"
1362120250705,136,2025-07-05,21,7,0,7,BirFed1120_T,"-37.8184141, 144.97357915"
164520250820,164,2025-08-20,5,2,4,6,Lat526_T,"-37.813005, 144.95160411"
1641120250913,164,2025-09-13,11,151,62,213,Lat526_T,"-37.813005, 144.95160411"
85520250425,85,2025-04-25,5,5,1,6,488Mac_T,"-37.79432415, 144.92973378"
11120240213,1,2024-02-13,11,668,606,1274,Bou292_T,"-37.81349441, 144.96515323"
18720231025,18,2023-10-25,7,50,356,406,Col12_T,"-37.81344862, 144.97305353"
181620231112,18,2023-11-12,16,115,46,161,Col12_T,"-37.81344862, 144.97305353"
861820250214,86,2025-02-14,18,58,45,103,574Qub_T,"-37.80309992, 144.94908064"
62520231210,62,2023-12-10,5,16,14,30,Lat224_T,"-37.80996494, 144.96216521"
621720241104,62,2024-11-04,17,335,348,683,Lat224_T,"-37.80996494, 144.96216521"
62920250422,62,2025-04-22,9,59,86,145,Lat224_T,"-37.80996494, 144.96216521"
72020240423,72,2024-04-23,0,3,3,6,ACMI_T,"-37.81726338, 144.96872809"
722120250928,72,2025-09-28,21,24,54,78,ACMI_T,"-37.81726338, 144.96872809"
761820250930,76,2025-09-30,18,49,48,97,KenMac_T,"-37.79453803, 144.93036194"
351820250611,35,2025-06-11,18,675,496,1171,SouthB_T,"-37.82018685, 144.96508508"
91120250613,9,2025-06-13,11,189,247,436,Col700_T,"-37.81982992, 144.95102555"
79520241111,79,2024-11-11,5,27,30,57,FliSS_T,"-37.81794046, 144.96616678"
511020240611,51,2024-06-11,10,67,60,127,Fra118_T,"-37.80841815, 144.95906316"
231820250707,23,2025-07-07,18,193,342,535,Col623_T,"-37.81909256, 144.95452748"
23720240727,23,2024-07-27,7,39,62,101,Col623_T,"-37.81909256, 144.95452748"
23020240124,23,2024-01-24,0,12,30,42,Col623_T,"-37.81909256, 144.95452748"
481520240601,48,2024-06-01,15,622,324,946,QVMQ_T,"-37.80631581, 144.95866697"
461420240110,46,2024-01-10,14,66,91,157,Pel147_T,"-37.80240719, 144.9615673"
251020241215,25,2024-12-15,10,407,763,1170,MCEC_T,"-37.82401776, 144.95604426"
164220241113,164,2024-11-13,2,0,2,2,Lat526_T,"-37.813005, 144.95160411"
1412120240322,141,2024-03-22,21,148,142,290,474Fl_T,"-37.81997273, 144.95834911"
1411020250412,141,2025-04-12,10,112,165,277,474Fl_T,"-37.81997273, 144.95834911"
1392020250124,139,2025-01-24,20,63,40,103,Signal1647_T,"-37.81959923, 144.9632832"
1371220240513,137,2024-05-13,12,28,78,106,BouHbr2353_T,"-37.81894815, 144.94612292"
1372020240708,137,2024-07-08,20,4,9,13,BouHbr2353_T,"-37.81894815, 144.94612292"
1421020241205,142,2024-12-05,10,279,214,493,Hammer1584_T,"-37.81970749, 144.96795734"
1171120231219,117,2023-12-19,11,92,137,229,Fli114F_T,"-37.81629332, 144.97090877"
66720240616,66,2024-06-16,7,34,40,74,QVN_T,"-37.81057846, 144.96444294"
6020240405,6,2024-04-05,0,153,80,233,FliS_T,"-37.81911705, 144.96558255"
66020231127,66,2023-11-27,0,64,66,130,QVN_T,"-37.81057846, 144.96444294"
31720250910,3,2025-09-10,17,995,1227,2222,Swa295_T,"-37.81101524, 144.96429485"
751420240116,75,2024-01-16,14,67,62,129,SprFli_T,"-37.81515276, 144.97467661"
412020240226,41,2024-02-26,20,688,681,1369,Swa31,"-37.81668634, 144.96689733"
771920241113,77,2024-11-13,19,238,181,419,HarEsP_T,"-37.81441438, 144.94433026"
77520250725,77,2025-07-25,5,2,14,16,HarEsP_T,"-37.81441438, 144.94433026"
14120241217,14,2024-12-17,1,11,7,18,SanBri_T,"-37.82011242, 144.96291897"
29320240405,29,2024-04-05,3,6,15,21,AG_T,"-37.8199817, 144.96872865"
54020241213,54,2024-12-13,0,17,11,28,Swa607_T,"-37.804024, 144.96308399"
1301720240120,130,2024-01-20,17,12,15,27,Bou892T,"-37.8204637, 144.94126826"
1171020240422,117,2024-04-22,10,84,119,203,Fli114F_T,"-37.81629332, 144.97090877"
1091120240130,109,2024-01-30,11,134,151,285,LatWill_T,"-37.81193681, 144.95621105"
1091920240416,109,2024-04-16,19,98,100,198,LatWill_T,"-37.81193681, 144.95621105"
661920240923,66,2024-09-23,19,982,827,1809,QVN_T,"-37.81057846, 144.96444294"
691320240728,69,2024-07-28,13,229,204,433,FLDegC_T,"-37.81687226, 144.96559144"
692020250508,69,2025-05-08,20,21,23,44,FLDegC_T,"-37.81687226, 144.96559144"
6520240726,6,2024-07-26,5,66,83,149,FliS_T,"-37.81911705, 144.96558255"
6520240728,6,2024-07-28,5,32,57,89,FliS_T,"-37.81911705, 144.96558255"
21820250625,21,2025-06-25,8,63,84,147,Bourke155_T,"-37.81267313, 144.96788288"
45320240929,45,2024-09-29,3,37,117,154,Swa148_T,"-37.81414075, 144.96609379"
108220240605,108,2024-06-05,2,2,6,8,261Will_T,"-37.81295822, 144.95678789"
871020250316,87,2025-03-16,10,52,61,113,Errol23_T,"-37.80454949, 144.94921863"
1791820250203,179,2025-02-03,18,51,72,123,Pow61_T,"-37.82392385, 144.96299677"
1651220250118,165,2025-01-18,12,43,37,80,Spen475_T,"-37.80953359, 144.94939004"
1671720250108,167,2025-01-08,17,71,68,139,Lat526_T,"-37.81304149, 144.95155955"
1671620250712,167,2025-07-12,16,98,105,203,Lat526_T,"-37.81304149, 144.95155955"
1821720250830,182,2025-08-30,17,273,221,494,King163_T,"-37.81627451, 144.95550503"
143620250613,143,2025-06-13,6,25,58,83,Spencer_T,"-37.821728, 144.95557015"
1351020250710,135,2025-07-10,10,353,341,694,Spen161_T,"-37.8172861, 144.95319102"
1241720250115,124,2025-01-15,17,4,11,15,BirBridge_T,"-37.81757416, 144.97329934"
1181020241016,118,2024-10-16,10,15,19,34,Fli114C_T,"-37.81632783, 144.97090512"
85020250808,85,2025-08-08,0,0,6,6,488Mac_T,"-37.79432415, 144.92973378"
1320231126,1,2023-11-26,3,12,64,76,Bou292_T,"-37.81349441, 144.96515323"
681920241126,68,2024-11-26,19,190,95,285,FLDegN_T,"-37.8168479, 144.96559789"
181420250402,18,2025-04-02,14,274,209,483,Col12_T,"-37.81344862, 144.97305353"
67820250316,67,2025-03-16,8,52,59,111,FLDegS_T,"-37.81688755, 144.96562569"
621620240915,62,2024-09-15,16,245,147,392,Lat224_T,"-37.80996494, 144.96216521"
861620250629,86,2025-06-29,16,38,51,89,574Qub_T,"-37.80309992, 144.94908064"
122020240812,12,2024-08-12,20,133,129,262,NewQ_T,"-37.81457988, 144.94292398"
10820250315,10,2025-03-15,8,20,22,42,BouHbr_T,"-37.81876474, 144.94710545"
72620231022,72,2023-10-22,6,5,17,22,ACMI_T,"-37.81726338, 144.96872809"
58220240607,58,2024-06-07,2,17,25,42,Bou688_T,"-37.81686075, 144.95358075"
58220250115,58,2025-01-15,2,18,28,46,Bou688_T,"-37.81686075, 144.95358075"
35120250926,35,2025-09-26,1,50,73,123,SouthB_T,"-37.82018685, 144.96508508"
91520250508,9,2025-05-08,15,972,206,1178,Col700_T,"-37.81982992, 144.95102555"
79920241030,79,2024-10-30,9,484,235,719,FliSS_T,"-37.81794046, 144.96616678"
302020250115,30,2025-01-15,20,198,299,497,Lon189_T,"-37.8112185, 144.96656806"
461720250817,46,2025-08-17,17,48,59,107,Pel147_T,"-37.80240719, 144.9615673"
52420231022,52,2023-10-22,4,30,35,65,Eli263_T,"-37.81252157, 144.9619401"
51320250224,51,2025-02-24,3,8,18,26,Fra118_T,"-37.80841815, 144.95906316"
23920250308,23,2025-03-08,9,154,121,275,Col623_T,"-37.81909256, 144.95452748"
231920250904,23,2025-09-04,19,145,288,433,Col623_T,"-37.81909256, 144.95452748"
481520250122,48,2025-01-22,15,170,175,345,QVMQ_T,"-37.80631581, 144.95866697"
481220250128,48,2025-01-28,12,380,301,681,QVMQ_T,"-37.80631581, 144.95866697"
48920250831,48,2025-08-31,9,180,162,342,QVMQ_T,"-37.80631581, 144.95866697"
19620231227,19,2023-12-27,6,13,11,24,LtB210_T,"-37.81237202, 144.96550671"
202320240210,20,2024-02-10,23,299,539,838,LtB170_T,"-37.81172914, 144.9682466"
521020241220,52,2024-12-20,10,254,151,405,Eli263_T,"-37.81252157, 144.9619401"
1641020250505,164,2025-05-05,10,87,49,136,Lat526_T,"-37.813005, 144.95160411"
1421220241222,142,2024-12-22,12,1024,771,1795,Hammer1584_T,"-37.81970749, 144.96795734"
142620240304,142,2024-03-04,6,52,10,62,Hammer1584_T,"-37.81970749, 144.96795734"
142020240525,142,2024-05-25,0,26,24,50,Hammer1584_T,"-37.81970749, 144.96795734"
161720241118,161,2024-11-18,7,70,147,217,BirArt1109_T,"-37.81851276, 144.97131336"
1611620250925,161,2025-09-25,16,199,227,426,BirArt1109_T,"-37.81851276, 144.97131336"
1171020250221,117,2025-02-21,10,92,137,229,Fli114F_T,"-37.81629332, 144.97090877"
49620240522,49,2024-05-22,6,53,54,107,Eli501_T,"-37.80730068, 144.95956055"
661120240501,66,2024-05-01,11,781,924,1705,QVN_T,"-37.81057846, 144.96444294"
66620250127,66,2025-01-27,6,8,23,31,QVN_T,"-37.81057846, 144.96444294"
691120241127,69,2024-11-27,11,239,185,424,FLDegC_T,"-37.81687226, 144.96559144"
84820250725,84,2025-07-25,8,1172,308,1480,ElFi_T,"-37.81798049, 144.96503383"
41320231225,4,2023-12-25,13,738,513,1251,Swa123_T,"-37.81487988, 144.9660878"
1231520250714,123,2025-07-14,15,31,15,46,BirBridge_T,"-37.81753741, 144.97329734"
492120240909,49,2024-09-09,21,148,86,234,Eli501_T,"-37.80730068, 144.95956055"
1171020240905,117,2024-09-05,10,110,94,204,Fli114F_T,"-37.81629332, 144.97090877"
66720231108,66,2023-11-08,7,66,225,291,QVN_T,"-37.81057846, 144.96444294"
702020240802,70,2024-08-02,20,151,135,286,Errol20_T,"-37.80456984, 144.94946228"
391820251002,39,2025-10-02,18,64,25,89,AlfPl_T,"-37.81379749, 144.96995745"
75320250413,75,2025-04-13,3,1,2,3,SprFli_T,"-37.81515276, 144.97467661"
651320240127,65,2024-01-27,13,715,707,1422,SwaCs_T,"-37.81569416, 144.9668064"
29420241004,29,2024-10-04,4,5,9,14,AG_T,"-37.8199817, 144.96872865"
29520240114,29,2024-01-14,5,7,17,24,AG_T,"-37.8199817, 144.96872865"
541520240321,54,2024-03-21,15,204,290,494,Swa607_T,"-37.804024, 144.96308399"
401720240314,40,2024-03-14,17,203,457,660,Spr201_T,"-37.80999341, 144.97227587"
43820240703,43,2024-07-03,8,99,65,164,UM2_T,"-37.79844526, 144.96411782"
43120231231,43,2023-12-31,1,1,1,2,UM2_T,"-37.79844526, 144.96411782"
441620250318,44,2025-03-18,16,179,122,301,UM3_T,"-37.79698741, 144.96441306"
44820250529,44,2025-05-29,8,45,92,137,UM3_T,"-37.79698741, 144.96441306"
45920241230,45,2024-12-30,9,206,183,389,Swa148_T,"-37.81414075, 144.96609379"
451420250318,45,2025-03-18,14,365,799,1164,Swa148_T,"-37.81414075, 144.96609379"
21220250910,21,2025-09-10,2,4,7,11,Bourke155_T,"-37.81267313, 144.96788288"
134220250505,134,2025-05-05,2,22,13,35,Spen201_T,"-37.81694221, 144.95303935"
1351220250919,135,2025-09-19,12,338,414,752,Spen161_T,"-37.8172861, 144.95319102"
133820250919,133,2025-09-19,8,357,392,749,Spen229_T,"-37.81531435, 144.95227769"
133820240618,133,2024-06-18,8,527,538,1065,Spen229_T,"-37.81531435, 144.95227769"
1331020240719,133,2024-07-19,10,418,458,876,Spen229_T,"-37.81531435, 144.95227769"
1081920240129,108,2024-01-29,19,180,89,269,261Will_T,"-37.81295822, 144.95678789"
1082220240403,108,2024-04-03,22,65,66,131,261Will_T,"-37.81295822, 144.95678789"
1081720240519,108,2024-05-19,17,35,93,128,261Will_T,"-37.81295822, 144.95678789"
1841420250723,184,2025-07-23,14,798,990,1788,Eli124_T,"-37.81512416, 144.96371988"
1791220250225,179,2025-02-25,12,61,40,101,Pow61_T,"-37.82392385, 144.96299677"
1401220231219,140,2023-12-19,12,77,36,113,Boyd2837_T,"-37.82590962, 144.96185972"
131720250720,131,2025-07-20,7,15,33,48,King2_T,"-37.82009057, 144.95758725"
131020240919,131,2024-09-19,0,9,16,25,King2_T,"-37.82009057, 144.95758725"
671720250517,67,2025-05-17,17,352,534,886,FLDegS_T,"-37.81688755, 144.96562569"
17520250926,17,2025-09-26,5,16,7,23,Col15_T,"-37.81362543, 144.97323591"
181620240706,18,2024-07-06,16,102,109,211,Col12_T,"-37.81344862, 144.97305353"
721120250504,72,2025-05-04,11,178,282,460,ACMI_T,"-37.81726338, 144.96872809"
721620240527,72,2024-05-27,16,99,471,570,ACMI_T,"-37.81726338, 144.96872809"
2320231206,2,2023-12-06,3,3,10,13,Bou283_T,"-37.81380668, 144.96516718"
58620240422,58,2024-04-22,6,255,64,319,Bou688_T,"-37.81686075, 144.95358075"
761120231209,76,2023-12-09,11,50,60,110,KenMac_T,"-37.79453803, 144.93036194"
762020241019,76,2024-10-19,20,22,35,57,KenMac_T,"-37.79453803, 144.93036194"
21220241124,2,2024-11-24,12,640,656,1296,Bou283_T,"-37.81380668, 144.96516718"
272020250625,27,2025-06-25,20,136,157,293,Vic_T,"-37.80606888, 144.95644692"
232220250603,23,2025-06-03,22,54,77,131,Col623_T,"-37.81909256, 144.95452748"
701920240315,70,2024-03-15,19,241,336,577,Errol20_T,"-37.80456984, 144.94946228"
66620250906,66,2025-09-06,6,5,28,33,QVN_T,"-37.81057846, 144.96444294"
691320231201,69,2023-12-01,13,220,237,457,FLDegC_T,"-37.81687226, 144.96559144"
69420250219,69,2025-02-19,4,1,2,3,FLDegC_T,"-37.81687226, 144.96559144"
61120241113,6,2024-11-13,11,365,458,823,FliS_T,"-37.81911705, 144.96558255"
4020231123,4,2023-11-23,0,98,77,175,Swa123_T,"-37.81487988, 144.9660878"
391420241213,39,2024-12-13,14,140,124,264,AlfPl_T,"-37.81379749, 144.96995745"
781020240511,78,2024-05-11,10,42,43,85,HarEsB_T,"-37.81471642, 144.9446508"
41620250831,41,2025-08-31,6,130,132,262,Swa31,"-37.81668634, 144.96689733"
421420250329,42,2025-03-29,14,50,80,130,UM1_T,"-37.80008566, 144.96386412"
291820241107,29,2024-11-07,18,187,180,367,AG_T,"-37.8199817, 144.96872865"
141120250325,14,2025-03-25,11,214,105,319,SanBri_T,"-37.82011242, 144.96291897"
14320231211,14,2023-12-11,3,12,2,14,SanBri_T,"-37.82011242, 144.96291897"
711420240826,71,2024-08-26,14,11,11,22,WestWP_T,"-37.81235775, 144.97136962"
541420250719,54,2025-07-19,14,107,134,241,Swa607_T,"-37.804024, 144.96308399"
45120250521,45,2025-05-21,1,15,34,49,Swa148_T,"-37.81414075, 144.96609379"
451720231120,45,2023-11-20,17,510,792,1302,Swa148_T,"-37.81414075, 144.96609379"
871720240628,87,2024-06-28,17,106,109,215,Errol23_T,"-37.80454949, 144.94921863"
87820241206,87,2024-12-06,8,94,46,140,Errol23_T,"-37.80454949, 144.94921863"
441720250715,44,2025-07-15,17,104,91,195,UM3_T,"-37.79698741, 144.96441306"
442120250724,44,2025-07-24,21,42,15,57,UM3_T,"-37.79698741, 144.96441306"
162920240719,162,2024-07-19,9,248,215,463,Eli489_T,"-37.80740397, 144.95987909"
1431820250110,143,2025-01-10,18,190,373,563,Spencer_T,"-37.821728, 144.95557015"
132420250111,132,2025-01-11,4,11,5,16,King335_T,"-37.81267639, 144.95386444"
134920250507,134,2025-05-07,9,307,377,684,Spen201_T,"-37.81694221, 144.95303935"
1341520241015,134,2024-10-15,15,557,609,1166,Spen201_T,"-37.81694221, 144.95303935"
133020250910,133,2025-09-10,0,80,19,99,Spen229_T,"-37.81531435, 144.95227769"
133920231018,133,2023-10-18,9,436,411,847,Spen229_T,"-37.81531435, 144.95227769"
1182020240901,118,2024-09-01,20,3,1,4,Fli114C_T,"-37.81632783, 144.97090512"
1181220250303,118,2025-03-03,12,6,37,43,Fli114C_T,"-37.81632783, 144.97090512"
118520240312,118,2024-03-12,5,1,0,1,Fli114C_T,"-37.81632783, 144.97090512"
671620240126,67,2024-01-26,16,370,394,764,FLDegS_T,"-37.81688755, 144.96562569"
681320250709,68,2025-07-09,13,511,461,972,FLDegN_T,"-37.8168479, 144.96559789"
17420231126,17,2023-11-26,4,6,2,8,Col15_T,"-37.81362543, 144.97323591"
631420240504,63,2024-05-04,14,353,491,844,Bou231_T,"-37.81333081, 144.96675571"
56320231109,56,2023-11-09,3,3,1,4,Lon364_T,"-37.81234775, 144.96153311"
12020241107,12,2024-11-07,0,10,8,18,NewQ_T,"-37.81457988, 144.94292398"
10320250506,10,2025-05-06,3,0,1,1,BouHbr_T,"-37.81876474, 144.94710545"
241820240910,24,2024-09-10,18,467,1213,1680,Col620_T,"-37.81887963, 144.95449198"
121320250909,12,2025-09-09,13,190,159,349,NewQ_T,"-37.81457988, 144.94292398"
2820231221,2,2023-12-21,8,193,234,427,Bou283_T,"-37.81380668, 144.96516718"
91120231026,9,2023-10-26,11,258,360,618,Col700_T,"-37.81982992, 144.95102555"
25920231117,25,2023-11-17,9,177,498,675,MCEC_T,"-37.82401776, 144.95604426"
461720240531,46,2024-05-31,17,134,68,202,Pel147_T,"-37.80240719, 144.9615673"
20420241225,20,2024-12-25,4,16,15,31,LtB170_T,"-37.81172914, 144.9682466"
461620250504,46,2025-05-04,16,56,68,124,Pel147_T,"-37.80240719, 144.9615673"
130620241019,130,2024-10-19,6,2,4,6,Bou892T,"-37.8204637, 144.94126826"
1641320250705,164,2025-07-05,13,125,87,212,Lat526_T,"-37.813005, 144.95160411"
491920240825,49,2024-08-25,19,162,156,318,Eli501_T,"-37.80730068, 144.95956055"
69120231124,69,2023-11-24,1,2,1,3,FLDegC_T,"-37.81687226, 144.96559144"
841620240724,84,2024-07-24,16,961,1649,2610,ElFi_T,"-37.81798049, 144.96503383"
61120250917,6,2025-09-17,11,587,448,1035,FliS_T,"-37.81911705, 144.96558255"
702220250404,70,2025-04-04,22,104,101,205,Errol20_T,"-37.80456984, 144.94946228"
39620240411,39,2024-04-11,6,34,9,43,AlfPl_T,"-37.81379749, 144.96995745"
391820240615,39,2024-06-15,18,78,59,137,AlfPl_T,"-37.81379749, 144.96995745"
75820240922,75,2024-09-22,8,24,15,39,SprFli_T,"-37.81515276, 144.97467661"
75920241223,75,2024-12-23,9,29,30,59,SprFli_T,"-37.81515276, 144.97467661"
782020250424,78,2025-04-24,20,4,12,16,HarEsB_T,"-37.81471642, 144.9446508"
29020250213,29,2025-02-13,0,40,54,94,AG_T,"-37.8199817, 144.96872865"
591520231213,59,2023-12-13,15,485,490,975,RMIT_T,"-37.80825648, 144.96304859"
59920240216,59,2024-02-16,9,804,396,1200,RMIT_T,"-37.80825648, 144.96304859"
591020241225,59,2024-12-25,10,69,113,182,RMIT_T,"-37.80825648, 144.96304859"
31220231028,31,2023-10-28,2,5,1,6,Lyg161_T,"-37.80169681, 144.96658911"
28420250124,28,2025-01-24,4,4,35,39,VAC_T,"-37.82129925, 144.96879309"
47520240825,47,2024-08-25,5,25,51,76,Eli250_T,"-37.81258467, 144.9625775"
471120241126,47,2024-11-26,11,610,639,1249,Eli250_T,"-37.81258467, 144.9625775"
472220241214,47,2024-12-14,22,645,453,1098,Eli250_T,"-37.81258467, 144.9625775"
37720240610,37,2024-06-10,7,11,4,15,Lyg260_T,"-37.80107122, 144.96704554"
43820240617,43,2024-06-17,8,91,62,153,UM2_T,"-37.79844526, 144.96411782"
44720241201,44,2024-12-01,7,8,2,10,UM3_T,"-37.79698741, 144.96441306"
441720250211,44,2025-02-11,17,136,81,217,UM3_T,"-37.79698741, 144.96441306"
451720250221,45,2025-02-21,17,502,888,1390,Swa148_T,"-37.81414075, 144.96609379"
1351520250912,135,2025-09-12,15,374,386,760,Spen161_T,"-37.8172861, 144.95319102"
133020250324,133,2025-03-24,0,48,27,75,Spen229_T,"-37.81531435, 144.95227769"
133820240116,133,2024-01-16,8,541,514,1055,Spen229_T,"-37.81531435, 144.95227769"
1332120240122,133,2024-01-22,21,367,287,654,Spen229_T,"-37.81531435, 144.95227769"
1331720240303,133,2024-03-03,17,516,529,1045,Spen229_T,"-37.81531435, 144.95227769"
1181020240516,118,2024-05-16,10,11,18,29,Fli114C_T,"-37.81632783, 144.97090512"
108020240602,108,2024-06-02,0,7,38,45,261Will_T,"-37.81295822, 144.95678789"
1811020250606,181,2025-06-06,10,352,624,976,Eli368_T,"-37.81009465, 144.96143149"
185420250823,185,2025-08-23,4,42,21,63,Eli197_T,"-37.81374643, 144.96276183"
681020240224,68,2024-02-24,10,236,190,426,FLDegN_T,"-37.8168479, 144.96559789"
68720240822,68,2024-08-22,7,38,26,64,FLDegN_T,"-37.8168479, 144.96559789"
85520240915,85,2024-09-15,5,0,1,1,488Mac_T,"-37.79432415, 144.92973378"
851420241211,85,2024-12-11,14,76,76,152,488Mac_T,"-37.79432415, 144.92973378"
671820240405,67,2024-04-05,18,443,529,972,FLDegS_T,"-37.81688755, 144.96562569"
841220250101,84,2025-01-01,12,767,785,1552,ElFi_T,"-37.81798049, 144.96503383"
752220250721,75,2025-07-21,22,6,10,16,SprFli_T,"-37.81515276, 144.97467661"
78220231120,78,2023-11-20,2,2,1,3,HarEsB_T,"-37.81471642, 144.9446508"
77220240327,77,2024-03-27,2,4,0,4,HarEsP_T,"-37.81441438, 144.94433026"
711720240815,71,2024-08-15,17,22,18,40,WestWP_T,"-37.81235775, 144.97136962"
651020240925,65,2024-09-25,10,492,193,685,SwaCs_T,"-37.81569416, 144.9668064"
591720240615,59,2024-06-15,17,560,504,1064,RMIT_T,"-37.80825648, 144.96304859"
452120250818,45,2025-08-18,21,177,297,474,Swa148_T,"-37.81414075, 144.96609379"
45520240428,45,2024-04-28,5,19,38,57,Swa148_T,"-37.81414075, 144.96609379"
5820250118,5,2025-01-18,8,192,298,490,PriNW_T,"-37.81874249, 144.96787656"
1182020240418,118,2024-04-18,20,11,13,24,Fli114C_T,"-37.81632783, 144.97090512"
442220250805,44,2025-08-05,22,9,6,15,UM3_T,"-37.79698741, 144.96441306"
44820231119,44,2023-11-19,8,1,4,5,UM3_T,"-37.79698741, 144.96441306"
44920240704,44,2024-07-04,9,50,50,100,UM3_T,"-37.79698741, 144.96441306"
1842320250923,184,2025-09-23,23,85,76,161,Eli124_T,"-37.81512416, 144.96371988"
179420250619,179,2025-06-19,4,1,0,1,Pow61_T,"-37.82392385, 144.96299677"
167220250628,167,2025-06-28,2,3,4,7,Lat526_T,"-37.81304149, 144.95155955"
181520250918,181,2025-09-18,5,31,66,97,Eli368_T,"-37.81009465, 144.96143149"
131520240120,131,2024-01-20,5,14,39,53,King2_T,"-37.82009057, 144.95758725"
162920250311,162,2025-03-11,9,321,256,577,Eli489_T,"-37.80740397, 144.95987909"
1321520240605,132,2024-06-05,15,144,119,263,King335_T,"-37.81267639, 144.95386444"
1322120240820,132,2024-08-20,21,56,72,128,King335_T,"-37.81267639, 144.95386444"
135920231031,135,2023-10-31,9,229,356,585,Spen161_T,"-37.8172861, 144.95319102"
1352320240924,135,2024-09-24,23,49,59,108,Spen161_T,"-37.8172861, 144.95319102"
1332220240323,133,2024-03-23,22,260,220,480,Spen229_T,"-37.81531435, 144.95227769"
118720241125,118,2024-11-25,7,12,5,17,Fli114C_T,"-37.81632783, 144.97090512"
68920250728,68,2025-07-28,9,217,191,408,FLDegN_T,"-37.8168479, 144.96559789"
851220240826,85,2024-08-26,12,127,116,243,488Mac_T,"-37.79432415, 144.92973378"
671620250926,67,2025-09-26,16,342,593,935,FLDegS_T,"-37.81688755, 144.96562569"
1220250217,1,2025-02-17,2,5,2,7,Bou292_T,"-37.81349441, 144.96515323"
18420231031,18,2023-10-31,4,0,1,1,Col12_T,"-37.81344862, 144.97305353"
861220240920,86,2024-09-20,12,72,62,134,574Qub_T,"-37.80309992, 144.94908064"
62720240602,62,2024-06-02,7,12,16,28,Lat224_T,"-37.80996494, 144.96216521"
622020241203,62,2024-12-03,20,173,166,339,Lat224_T,"-37.80996494, 144.96216521"
11520240126,11,2024-01-26,5,1,1,2,WatCit_T,"-37.81564989, 144.93970694"
11620250508,11,2025-05-08,6,15,16,31,WatCit_T,"-37.81564989, 144.93970694"
121120240108,12,2024-01-08,11,5,11,16,NewQ_T,"-37.81457988, 144.94292398"
721720240409,72,2024-04-09,17,248,970,1218,ACMI_T,"-37.81726338, 144.96872809"
91420231020,9,2023-10-20,14,352,163,515,Col700_T,"-37.81982992, 144.95102555"
79020250812,79,2025-08-12,0,16,21,37,FliSS_T,"-37.81794046, 144.96616678"
79720231124,79,2023-11-24,7,248,120,368,FliSS_T,"-37.81794046, 144.96616678"
79220231215,79,2023-12-15,2,26,26,52,FliSS_T,"-37.81794046, 144.96616678"
301020241118,30,2024-11-18,10,86,192,278,Lon189_T,"-37.8112185, 144.96656806"
481220240329,48,2024-03-29,12,203,166,369,QVMQ_T,"-37.80631581, 144.95866697"
201520241105,20,2024-11-05,15,154,153,307,LtB170_T,"-37.81172914, 144.9682466"
164820250125,164,2025-01-25,8,35,30,65,Lat526_T,"-37.813005, 144.95160411"
1372320240112,137,2024-01-12,23,1,4,5,BouHbr2353_T,"-37.81894815, 144.94612292"
1371920250524,137,2025-05-24,19,1,21,22,BouHbr2353_T,"-37.81894815, 144.94612292"
1421620241127,142,2024-11-27,16,215,272,487,Hammer1584_T,"-37.81970749, 144.96795734"
271820250721,27,2025-07-21,18,118,52,170,Vic_T,"-37.80606888, 144.95644692"
91020250307,9,2025-03-07,10,193,442,635,Col700_T,"-37.81982992, 144.95102555"
792120250619,79,2025-06-19,21,207,174,381,FliSS_T,"-37.81794046, 144.96616678"
301320241111,30,2024-11-11,13,272,337,609,Lon189_T,"-37.8112185, 144.96656806"
461520240119,46,2024-01-19,15,84,47,131,Pel147_T,"-37.80240719, 144.9615673"
231920250609,23,2025-06-09,19,70,189,259,Col623_T,"-37.81909256, 144.95452748"
481420240523,48,2024-05-23,14,369,189,558,QVMQ_T,"-37.80631581, 144.95866697"
251720250216,25,2025-02-16,17,853,335,1188,MCEC_T,"-37.82401776, 144.95604426"
252220250309,25,2025-03-09,22,225,321,546,MCEC_T,"-37.82401776, 144.95604426"
20320240420,20,2024-04-20,3,43,33,76,LtB170_T,"-37.81172914, 144.9682466"
251420240103,25,2024-01-03,14,827,730,1557,MCEC_T,"-37.82401776, 144.95604426"
522220241202,52,2024-12-02,22,74,85,159,Eli263_T,"-37.81252157, 144.9619401"
1421320250927,142,2025-09-27,13,597,523,1120,Hammer1584_T,"-37.81970749, 144.96795734"
130720250125,130,2025-01-25,7,19,7,26,Bou892T,"-37.8204637, 144.94126826"
161720240618,161,2024-06-18,7,72,109,181,BirArt1109_T,"-37.81851276, 144.97131336"
491920241204,49,2024-12-04,19,281,320,601,Eli501_T,"-37.80730068, 144.95956055"
69020231030,69,2023-10-30,0,2,1,3,FLDegC_T,"-37.81687226, 144.96559144"
41620250120,4,2025-01-20,16,1292,1195,2487,Swa123_T,"-37.81487988, 144.9660878"
41220250408,4,2025-04-08,12,2347,1615,3962,Swa123_T,"-37.81487988, 144.9660878"
70720231224,70,2023-12-24,7,13,11,24,Errol20_T,"-37.80456984, 144.94946228"
701420250308,70,2025-03-08,14,120,114,234,Errol20_T,"-37.80456984, 144.94946228"
391720231125,39,2023-11-25,17,123,73,196,AlfPl_T,"-37.81379749, 144.96995745"
39120240502,39,2024-05-02,1,0,4,4,AlfPl_T,"-37.81379749, 144.96995745"
8220241231,8,2024-12-31,2,2,1,3,WebBN_T,"-37.82293543, 144.9471751"
8720250529,8,2025-05-29,7,117,94,211,WebBN_T,"-37.82293543, 144.9471751"
78320241119,78,2024-11-19,3,0,2,2,HarEsB_T,"-37.81471642, 144.9446508"
291220231226,29,2023-12-26,12,311,392,703,AG_T,"-37.8199817, 144.96872865"
591020251010,59,2025-10-10,10,842,724,1566,RMIT_T,"-37.80825648, 144.96304859"
401520240224,40,2024-02-24,15,159,145,304,Spr201_T,"-37.80999341, 144.97227587"
471120250705,47,2025-07-05,11,785,888,1673,Eli250_T,"-37.81258467, 144.9625775"
21120250403,21,2025-04-03,1,13,13,26,Bourke155_T,"-37.81267313, 144.96788288"
51320241119,5,2024-11-19,13,184,345,529,PriNW_T,"-37.81874249, 144.96787656"
1081820250214,108,2025-02-14,18,410,210,620,261Will_T,"-37.81295822, 144.95678789"
871420250129,87,2025-01-29,14,79,94,173,Errol23_T,"-37.80454949, 144.94921863"
442320250721,44,2025-07-21,23,0,1,1,UM3_T,"-37.79698741, 144.96441306"
1671620241119,167,2024-11-19,16,18,19,37,Lat526_T,"-37.81304149, 144.95155955"
1321920250121,132,2025-01-21,19,145,137,282,King335_T,"-37.81267639, 144.95386444"
135120241219,135,2024-12-19,1,11,19,30,Spen161_T,"-37.8172861, 144.95319102"
18220231219,18,2023-12-19,2,0,2,2,Col12_T,"-37.81344862, 144.97305353"
112020241026,11,2024-10-26,20,168,168,336,WatCit_T,"-37.81564989, 144.93970694"
241820240412,24,2024-04-12,18,743,1186,1929,Col620_T,"-37.81887963, 144.95449198"
2920250402,2,2025-04-02,9,202,242,444,Bou283_T,"-37.81380668, 144.96516718"
9520250811,9,2025-08-11,5,14,34,48,Col700_T,"-37.81982992, 144.95102555"
51920240518,51,2024-05-18,9,98,99,197,Fra118_T,"-37.80841815, 144.95906316"
232120240725,23,2024-07-25,21,98,182,280,Col623_T,"-37.81909256, 144.95452748"
231220250711,23,2025-07-11,12,333,467,800,Col623_T,"-37.81909256, 144.95452748"
202120250813,20,2025-08-13,21,151,352,503,LtB170_T,"-37.81172914, 144.9682466"
25220240416,25,2024-04-16,2,6,7,13,MCEC_T,"-37.82401776, 144.95604426"
20820241024,20,2024-10-24,8,75,62,137,LtB170_T,"-37.81172914, 144.9682466"
1411720250304,141,2025-03-04,17,173,180,353,474Fl_T,"-37.81997273, 144.95834911"
1391520250926,139,2025-09-26,15,72,45,117,Signal1647_T,"-37.81959923, 144.9632832"
1391520240625,139,2024-06-25,15,60,49,109,Signal1647_T,"-37.81959923, 144.9632832"
1421520240907,142,2024-09-07,15,695,678,1373,Hammer1584_T,"-37.81970749, 144.96795734"
1421420250323,142,2025-03-23,14,832,827,1659,Hammer1584_T,"-37.81970749, 144.96795734"
1611820250306,161,2025-03-06,18,980,768,1748,BirArt1109_T,"-37.81851276, 144.97131336"
1611020250723,161,2025-07-23,10,106,83,189,BirArt1109_T,"-37.81851276, 144.97131336"
3720250906,3,2025-09-06,7,59,56,115,Swa295_T,"-37.81101524, 144.96429485"
751820240312,75,2024-03-12,18,47,46,93,SprFli_T,"-37.81515276, 144.97467661"
81220240204,8,2024-02-04,12,95,166,261,WebBN_T,"-37.82293543, 144.9471751"
8920240527,8,2024-05-27,9,172,99,271,WebBN_T,"-37.82293543, 144.9471751"
651620240421,65,2024-04-21,16,1085,748,1833,SwaCs_T,"-37.81569416, 144.9668064"
141320240226,14,2024-02-26,13,283,123,406,SanBri_T,"-37.82011242, 144.96291897"
71120231021,71,2023-10-21,1,1,1,2,WestWP_T,"-37.81235775, 144.97136962"
471320241211,47,2024-12-11,13,1006,1001,2007,Eli250_T,"-37.81258467, 144.9625775"
471920250316,47,2025-03-16,19,572,545,1117,Eli250_T,"-37.81258467, 144.9625775"
40620231221,40,2023-12-21,6,22,43,65,Spr201_T,"-37.80999341, 144.97227587"
361020250723,36,2025-07-23,10,144,128,272,Que85_T,"-37.81652527, 144.96121062"
36320240219,36,2024-02-19,3,2,2,4,Que85_T,"-37.81652527, 144.96121062"
442120250310,44,2025-03-10,21,16,6,22,UM3_T,"-37.79698741, 144.96441306"
51820240401,5,2024-04-01,18,153,339,492,PriNW_T,"-37.81874249, 144.96787656"
1351420241016,135,2024-10-16,14,434,395,829,Spen161_T,"-37.8172861, 144.95319102"
131220231106,131,2023-11-06,2,15,9,24,King2_T,"-37.82009057, 144.95758725"
108820250119,108,2025-01-19,8,51,65,116,261Will_T,"-37.81295822, 144.95678789"
871520241217,87,2024-12-17,15,69,92,161,Errol23_T,"-37.80454949, 144.94921863"
87320240825,87,2024-08-25,3,2,0,2,Errol23_T,"-37.80454949, 144.94921863"
181620250928,181,2025-09-28,6,30,68,98,Eli368_T,"-37.81009465, 144.96143149"
1651020250822,165,2025-08-22,10,22,24,46,Spen475_T,"-37.80953359, 144.94939004"
1431220250601,143,2025-06-01,12,168,280,448,Spencer_T,"-37.821728, 144.95557015"
66820250220,66,2025-02-20,8,219,623,842,QVN_T,"-37.81057846, 144.96444294"
66120250429,66,2025-04-29,1,32,19,51,QVN_T,"-37.81057846, 144.96444294"
691220240321,69,2024-03-21,12,248,242,490,FLDegC_T,"-37.81687226, 144.96559144"
1332020250702,133,2025-07-02,20,331,262,593,Spen229_T,"-37.81531435, 144.95227769"
1072120241006,107,2024-10-06,21,84,42,126,280Will_T,"-37.81246271, 144.95690188"
1181720250414,118,2025-04-14,17,24,36,60,Fli114C_T,"-37.81632783, 144.97090512"
681720240826,68,2024-08-26,17,179,68,247,FLDegN_T,"-37.8168479, 144.96559789"
851520240406,85,2024-04-06,15,65,71,136,488Mac_T,"-37.79432415, 144.92973378"
851420251012,85,2025-10-12,14,87,83,170,488Mac_T,"-37.79432415, 144.92973378"
671920240828,67,2024-08-28,19,207,290,497,FLDegS_T,"-37.81688755, 144.96562569"
671720250101,67,2025-01-01,17,293,386,679,FLDegS_T,"-37.81688755, 144.96562569"
631620231224,63,2023-12-24,16,379,367,746,Bou231_T,"-37.81333081, 144.96675571"
631620250326,63,2025-03-26,16,317,413,730,Bou231_T,"-37.81333081, 144.96675571"
67020240712,67,2024-07-12,0,12,20,32,FLDegS_T,"-37.81688755, 144.96562569"
11220231213,11,2023-12-13,2,0,2,2,WatCit_T,"-37.81564989, 144.93970694"
111620250123,11,2025-01-23,16,64,60,124,WatCit_T,"-37.81564989, 144.93970694"
10620241128,10,2024-11-28,6,28,39,67,BouHbr_T,"-37.81876474, 144.94710545"
102220250726,10,2025-07-26,22,75,112,187,BouHbr_T,"-37.81876474, 144.94710545"
241120240516,24,2024-05-16,11,583,413,996,Col620_T,"-37.81887963, 144.95449198"
76320250802,76,2025-08-02,3,2,1,3,KenMac_T,"-37.79453803, 144.93036194"
582220231018,58,2023-10-18,22,208,154,362,Bou688_T,"-37.81686075, 144.95358075"
351420240923,35,2024-09-23,14,866,1103,1969,SouthB_T,"-37.82018685, 144.96508508"
791820231027,79,2023-10-27,18,594,419,1013,FliSS_T,"-37.81794046, 144.96616678"
531220240730,53,2024-07-30,12,860,725,1585,Col254_T,"-37.81564191, 144.965499"
531720240605,53,2024-06-05,17,655,474,1129,Col254_T,"-37.81564191, 144.965499"
30920250203,30,2025-02-03,9,62,118,180,Lon189_T,"-37.8112185, 144.96656806"
462320241107,46,2024-11-07,23,4,1,5,Pel147_T,"-37.80240719, 144.9615673"
191520231209,19,2023-12-09,15,521,591,1112,LtB210_T,"-37.81237202, 144.96550671"
25420250912,25,2025-09-12,4,9,5,14,MCEC_T,"-37.82401776, 144.95604426"
251720240125,25,2024-01-25,17,440,207,647,MCEC_T,"-37.82401776, 144.95604426"
1371520250515,137,2025-05-15,15,11,137,148,BouHbr2353_T,"-37.81894815, 144.94612292"
1371120250705,137,2025-07-05,11,21,84,105,BouHbr2353_T,"-37.81894815, 144.94612292"
1391920250210,139,2025-02-10,19,58,43,101,Signal1647_T,"-37.81959923, 144.9632832"
137420240421,137,2024-04-21,4,1,0,1,BouHbr2353_T,"-37.81894815, 144.94612292"
139220231220,139,2023-12-20,2,2,0,2,Signal1647_T,"-37.81959923, 144.9632832"
142220240303,142,2024-03-03,2,29,9,38,Hammer1584_T,"-37.81970749, 144.96795734"
1302220250720,130,2025-07-20,22,5,1,6,Bou892T,"-37.8204637, 144.94126826"
491120241022,49,2024-10-22,11,287,374,661,Eli501_T,"-37.80730068, 144.95956055"
492320231020,49,2023-10-20,23,91,79,170,Eli501_T,"-37.80730068, 144.95956055"
692120250228,69,2025-02-28,21,63,58,121,FLDegC_T,"-37.81687226, 144.96559144"
6920250415,6,2025-04-15,9,691,946,1637,FliS_T,"-37.81911705, 144.96558255"
84820231123,84,2023-11-23,8,1657,423,2080,ElFi_T,"-37.81798049, 144.96503383"
66520231105,66,2023-11-05,5,22,13,35,QVN_T,"-37.81057846, 144.96444294"
751620241001,75,2024-10-01,16,57,50,107,SprFli_T,"-37.81515276, 144.97467661"
41820240724,41,2024-07-24,8,92,101,193,Swa31,"-37.81668634, 144.96689733"
781620250806,78,2025-08-06,16,28,158,186,HarEsB_T,"-37.81471642, 144.9446508"
28020250707,28,2025-07-07,0,24,9,33,VAC_T,"-37.82129925, 144.96879309"
312020241114,31,2024-11-14,20,224,162,386,Lyg161_T,"-37.80169681, 144.96658911"
311520231217,31,2023-12-17,15,289,227,516,Lyg161_T,"-37.80169681, 144.96658911"
311320240204,31,2024-02-04,13,156,173,329,Lyg161_T,"-37.80169681, 144.96658911"
311720240412,31,2024-04-12,17,184,153,337,Lyg161_T,"-37.80169681, 144.96658911"
6620250105,6,2025-01-05,6,59,66,125,FliS_T,"-37.81911705, 144.96558255"
84420240416,84,2024-04-16,4,18,18,36,ElFi_T,"-37.81798049, 144.96503383"
66520240627,66,2024-06-27,5,16,23,39,QVN_T,"-37.81057846, 144.96444294"
84320250913,84,2025-09-13,3,47,76,123,ElFi_T,"-37.81798049, 144.96503383"
86520240717,86,2024-07-17,5,1,1,2,574Qub_T,"-37.80309992, 144.94908064"
86820240819,86,2024-08-19,8,48,20,68,574Qub_T,"-37.80309992, 144.94908064"
622120240411,62,2024-04-11,21,207,122,329,Lat224_T,"-37.80996494, 144.96216521"
62920250801,62,2025-08-01,9,112,105,217,Lat224_T,"-37.80996494, 144.96216521"
561120240404,56,2024-04-04,11,237,203,440,Lon364_T,"-37.81234775, 144.96153311"
241520250226,24,2025-02-26,15,471,1236,1707,Col620_T,"-37.81887963, 144.95449198"
101020240530,10,2024-05-30,10,52,56,108,BouHbr_T,"-37.81876474, 144.94710545"
581320241105,58,2024-11-05,13,401,205,606,Bou688_T,"-37.81686075, 144.95358075"
35220241203,35,2024-12-03,2,12,31,43,SouthB_T,"-37.82018685, 144.96508508"
35720231107,35,2023-11-07,7,313,262,575,SouthB_T,"-37.82018685, 144.96508508"
762220240529,76,2024-05-29,22,3,7,10,KenMac_T,"-37.79453803, 144.93036194"
9520240526,9,2024-05-26,5,9,4,13,Col700_T,"-37.81982992, 144.95102555"
791720250523,79,2025-05-23,17,698,426,1124,FliSS_T,"-37.81794046, 144.96616678"
231520250704,23,2025-07-04,15,203,371,574,Col623_T,"-37.81909256, 144.95452748"
232120240602,23,2024-06-02,21,42,202,244,Col623_T,"-37.81909256, 144.95452748"
25320241114,25,2024-11-14,3,10,4,14,MCEC_T,"-37.82401776, 144.95604426"
46120240316,46,2024-03-16,1,3,10,13,Pel147_T,"-37.80240719, 144.9615673"
139520241013,139,2024-10-13,5,12,0,12,Signal1647_T,"-37.81959923, 144.9632832"
1421820240923,142,2024-09-23,18,67,58,125,Hammer1584_T,"-37.81970749, 144.96795734"
1421920241107,142,2024-11-07,19,591,252,843,Hammer1584_T,"-37.81970749, 144.96795734"
1641620241214,164,2024-12-14,16,134,112,246,Lat526_T,"-37.813005, 144.95160411"
1231920240126,123,2024-01-26,19,125,53,178,BirBridge_T,"-37.81753741, 144.97329734"
492220240402,49,2024-04-02,22,120,84,204,Eli501_T,"-37.80730068, 144.95956055"
691620240730,69,2024-07-30,16,92,138,230,FLDegC_T,"-37.81687226, 144.96559144"
41620250605,4,2025-06-05,16,1459,1150,2609,Swa123_T,"-37.81487988, 144.9660878"
701320241027,70,2024-10-27,13,146,165,311,Errol20_T,"-37.80456984, 144.94946228"
751420251003,75,2025-10-03,14,66,49,115,SprFli_T,"-37.81515276, 144.97467661"
41520250701,41,2025-07-01,5,130,103,233,Swa31,"-37.81668634, 144.96689733"
82320250801,8,2025-08-01,23,0,1,1,WebBN_T,"-37.82293543, 144.9471751"
771120250406,77,2025-04-06,11,795,344,1139,HarEsP_T,"-37.81441438, 144.94433026"
42620240708,42,2024-07-08,6,12,19,31,UM1_T,"-37.80008566, 144.96386412"
422320240730,42,2024-07-30,23,15,29,44,UM1_T,"-37.80008566, 144.96386412"
591820240221,59,2024-02-21,18,901,923,1824,RMIT_T,"-37.80825648, 144.96304859"
712120250627,71,2025-06-27,21,5,8,13,WestWP_T,"-37.81235775, 144.97136962"
54720250304,54,2025-03-04,7,55,12,67,Swa607_T,"-37.804024, 144.96308399"
281320240715,28,2024-07-15,13,482,484,966,VAC_T,"-37.82129925, 144.96879309"
28520240814,28,2024-08-14,5,20,28,48,VAC_T,"-37.82129925, 144.96879309"
40620250307,40,2025-03-07,6,41,46,87,Spr201_T,"-37.80999341, 144.97227587"
40020250627,40,2025-06-27,0,13,12,25,Spr201_T,"-37.80999341, 144.97227587"
362120250904,36,2025-09-04,21,66,150,216,Que85_T,"-37.81652527, 144.96121062"
37920240923,37,2024-09-23,9,47,53,100,Lyg260_T,"-37.80107122, 144.96704554"
50720250413,50,2025-04-13,7,23,12,35,Lyg309_T,"-37.79808192, 144.96721013"
44720241116,44,2024-11-16,7,11,4,15,UM3_T,"-37.79698741, 144.96441306"
21820250917,21,2025-09-17,8,80,85,165,Bourke155_T,"-37.81267313, 144.96788288"
1352320250813,135,2025-08-13,23,30,64,94,Spen161_T,"-37.8172861, 144.95319102"
1311120231107,131,2023-11-07,11,59,126,185,King2_T,"-37.82009057, 144.95758725"
131920240507,131,2024-05-07,9,102,106,208,King2_T,"-37.82009057, 144.95758725"
1071620240821,107,2024-08-21,16,185,108,293,280Will_T,"-37.81246271, 144.95690188"
133320250107,133,2025-01-07,3,7,21,28,Spen229_T,"-37.81531435, 144.95227769"
1332320250123,133,2025-01-23,23,199,117,316,Spen229_T,"-37.81531435, 144.95227769"
1332120250424,133,2025-04-24,21,374,237,611,Spen229_T,"-37.81531435, 144.95227769"
1181420250702,118,2025-07-02,14,9,5,14,Fli114C_T,"-37.81632783, 144.97090512"
124620250827,124,2025-08-27,6,1,1,2,BirBridge_T,"-37.81757416, 144.97329934"
612220240602,61,2024-06-02,22,112,31,143,RMIT14_T,"-37.80767455, 144.96309114"
611820240908,61,2024-09-08,18,287,294,581,RMIT14_T,"-37.80767455, 144.96309114"
167020250901,167,2025-09-01,0,1,0,1,Lat526_T,"-37.81304149, 144.95155955"
1401920250218,140,2025-02-18,19,79,83,162,Boyd2837_T,"-37.82590962, 144.96185972"
1311920250526,131,2025-05-26,19,43,52,95,King2_T,"-37.82009057, 144.95758725"
143420250509,143,2025-05-09,4,21,2,23,Spencer_T,"-37.821728, 144.95557015"
1432320250705,143,2025-07-05,23,240,314,554,Spencer_T,"-37.821728, 144.95557015"
691020231225,69,2023-12-25,10,27,15,42,FLDegC_T,"-37.81687226, 144.96559144"
69220241003,69,2024-10-03,2,1,3,4,FLDegC_T,"-37.81687226, 144.96559144"
84320240820,84,2024-08-20,3,10,8,18,ElFi_T,"-37.81798049, 144.96503383"
662120240302,66,2024-03-02,21,1389,755,2144,QVN_T,"-37.81057846, 144.96444294"
84120250915,84,2025-09-15,1,21,37,58,ElFi_T,"-37.81798049, 144.96503383"
41920250808,4,2025-08-08,19,1666,1263,2929,Swa123_T,"-37.81487988, 144.9660878"
701220250425,70,2025-04-25,12,168,151,319,Errol20_T,"-37.80456984, 144.94946228"
70920250830,70,2025-08-30,9,86,83,169,Errol20_T,"-37.80456984, 144.94946228"
8320251010,8,2025-10-10,3,4,0,4,WebBN_T,"-37.82293543, 144.9471751"
752120250505,75,2025-05-05,21,5,10,15,SprFli_T,"-37.81515276, 144.97467661"
751320250815,75,2025-08-15,13,42,61,103,SprFli_T,"-37.81515276, 144.97467661"
751020250824,75,2025-08-24,10,26,45,71,SprFli_T,"-37.81515276, 144.97467661"
81920240314,8,2024-03-14,19,91,137,228,WebBN_T,"-37.82293543, 144.9471751"
75920231129,75,2023-11-29,9,43,29,72,SprFli_T,"-37.81515276, 144.97467661"
411720250207,41,2025-02-07,17,1931,2142,4073,Swa31,"-37.81668634, 144.96689733"
781320240727,78,2024-07-27,13,13,40,53,HarEsB_T,"-37.81471642, 144.9446508"
78020240123,78,2024-01-23,0,0,1,1,HarEsB_T,"-37.81471642, 144.9446508"
781720240125,78,2024-01-25,17,33,204,237,HarEsB_T,"-37.81471642, 144.9446508"
711720240107,71,2024-01-07,17,5,5,10,WestWP_T,"-37.81235775, 144.97136962"
542320240427,54,2024-04-27,23,40,58,98,Swa607_T,"-37.804024, 144.96308399"
281220231216,28,2023-12-16,12,782,1100,1882,VAC_T,"-37.82129925, 144.96879309"
40420241123,40,2024-11-23,4,11,3,14,Spr201_T,"-37.80999341, 144.97227587"
31720240116,31,2024-01-16,7,24,33,57,Lyg161_T,"-37.80169681, 144.96658911"
31420250422,31,2025-04-22,4,7,3,10,Lyg161_T,"-37.80169681, 144.96658911"
312020250709,31,2025-07-09,20,145,153,298,Lyg161_T,"-37.80169681, 144.96658911"
21020241106,21,2024-11-06,0,24,43,67,Bourke155_T,"-37.81267313, 144.96788288"
43420231105,43,2023-11-05,4,4,0,4,UM2_T,"-37.79844526, 144.96411782"
21920231103,21,2023-11-03,9,160,128,288,Bourke155_T,"-37.81267313, 144.96788288"
134520250411,134,2025-04-11,5,53,65,118,Spen201_T,"-37.81694221, 144.95303935"
1651020250324,165,2025-03-24,10,28,56,84,Spen475_T,"-37.80953359, 144.94939004"
165120250706,165,2025-07-06,1,6,4,10,Spen475_T,"-37.80953359, 144.94939004"
166820250106,166,2025-01-06,8,6,19,25,Spen484_T,"-37.80896733, 144.94931703"
1671720250818,167,2025-08-18,17,64,98,162,Lat526_T,"-37.81304149, 144.95155955"
140920240423,140,2024-04-23,9,134,50,184,Boyd2837_T,"-37.82590962, 144.96185972"
851120250328,85,2025-03-28,11,115,74,189,488Mac_T,"-37.79432415, 144.92973378"
1620240714,1,2024-07-14,6,8,8,16,Bou292_T,"-37.81349441, 144.96515323"
671320250617,67,2025-06-17,13,427,597,1024,FLDegS_T,"-37.81688755, 144.96562569"
671720240523,67,2024-05-23,17,367,555,922,FLDegS_T,"-37.81688755, 144.96562569"
672320240807,67,2024-08-07,23,19,53,72,FLDegS_T,"-37.81688755, 144.96562569"
562120240222,56,2024-02-22,21,204,255,459,Lon364_T,"-37.81234775, 144.96153311"
101820240611,10,2024-06-11,18,57,29,86,BouHbr_T,"-37.81876474, 144.94710545"
24620240928,24,2024-09-28,6,78,137,215,Col620_T,"-37.81887963, 144.95449198"
721020250110,72,2025-01-10,10,177,155,332,ACMI_T,"-37.81726338, 144.96872809"
721220231217,72,2023-12-17,12,238,301,539,ACMI_T,"-37.81726338, 144.96872809"
72320250510,72,2025-05-10,3,7,15,22,ACMI_T,"-37.81726338, 144.96872809"
56520250919,56,2025-09-19,5,13,4,17,Lon364_T,"-37.81234775, 144.96153311"
272120240118,27,2024-01-18,21,85,63,148,Vic_T,"-37.80606888, 144.95644692"
792220240103,79,2024-01-03,22,209,212,421,FliSS_T,"-37.81794046, 144.96616678"
511520240521,51,2024-05-21,15,90,86,176,Fra118_T,"-37.80841815, 144.95906316"
232120250613,23,2025-06-13,21,73,142,215,Col623_T,"-37.81909256, 144.95452748"
231920241015,23,2024-10-15,19,105,191,296,Col623_T,"-37.81909256, 144.95452748"
251120250131,25,2025-01-31,11,286,492,778,MCEC_T,"-37.82401776, 144.95604426"
521620250429,52,2025-04-29,16,374,235,609,Eli263_T,"-37.81252157, 144.9619401"
1801220250824,180,2025-08-24,12,49,40,89,Mac330_T,"-37.79497059, 144.93530329"
1801920250517,180,2025-05-17,19,0,4,4,Mac330_T,"-37.79497059, 144.93530329"
142320240310,142,2024-03-10,3,4,2,6,Hammer1584_T,"-37.81970749, 144.96795734"
1231520240120,123,2024-01-20,15,62,50,112,BirBridge_T,"-37.81753741, 144.97329734"
1231120240603,123,2024-06-03,11,12,5,17,BirBridge_T,"-37.81753741, 144.97329734"
117820231020,117,2023-10-20,8,301,104,405,Fli114F_T,"-37.81629332, 144.97090877"
1171420231215,117,2023-12-15,14,176,161,337,Fli114F_T,"-37.81629332, 144.97090877"
49520240721,49,2024-07-21,5,28,25,53,Eli501_T,"-37.80730068, 144.95956055"
1092220240721,109,2024-07-21,22,37,99,136,LatWill_T,"-37.81193681, 144.95621105"
6120241119,6,2024-11-19,1,14,21,35,FliS_T,"-37.81911705, 144.96558255"
41720250209,4,2025-02-09,17,1601,1127,2728,Swa123_T,"-37.81487988, 144.9660878"
4120250802,4,2025-08-02,1,122,161,283,Swa123_T,"-37.81487988, 144.9660878"
70120250820,70,2025-08-20,1,1,3,4,Errol20_T,"-37.80456984, 144.94946228"
3620231101,3,2023-11-01,6,53,96,149,Swa295_T,"-37.81101524, 144.96429485"
751920231226,75,2023-12-26,19,40,17,57,SprFli_T,"-37.81515276, 144.97467661"
39620240719,39,2024-07-19,6,17,12,29,AlfPl_T,"-37.81379749, 144.96995745"
39620241202,39,2024-12-02,6,10,9,19,AlfPl_T,"-37.81379749, 144.96995745"
82120250129,8,2025-01-29,21,18,28,46,WebBN_T,"-37.82293543, 144.9471751"
412120250804,41,2025-08-04,21,280,433,713,Swa31,"-37.81668634, 144.96689733"
77920231110,77,2023-11-10,9,112,111,223,HarEsP_T,"-37.81441438, 144.94433026"
65920231119,65,2023-11-19,9,140,165,305,SwaCs_T,"-37.81569416, 144.9668064"
42020250507,42,2025-05-07,0,9,26,35,UM1_T,"-37.80008566, 144.96386412"
311420240321,31,2024-03-21,14,163,161,324,Lyg161_T,"-37.80169681, 144.96658911"
541420240624,54,2024-06-24,14,98,110,208,Swa607_T,"-37.804024, 144.96308399"
281820241028,28,2024-10-28,18,294,340,634,VAC_T,"-37.82129925, 144.96879309"
47020250216,47,2025-02-16,0,120,160,280,Eli250_T,"-37.81258467, 144.9625775"
37620240101,37,2024-01-01,6,6,6,12,Lyg260_T,"-37.80107122, 144.96704554"
51820250218,5,2025-02-18,18,724,964,1688,PriNW_T,"-37.81874249, 144.96787656"
51220240405,5,2024-04-05,12,1032,1442,2474,PriNW_T,"-37.81874249, 144.96787656"
1071020241102,107,2024-11-02,10,80,109,189,280Will_T,"-37.81246271, 144.95690188"
107020250930,107,2025-09-30,0,16,11,27,280Will_T,"-37.81246271, 144.95690188"
108520250813,108,2025-08-13,5,12,79,91,261Will_T,"-37.81295822, 144.95678789"
1082120240116,108,2024-01-16,21,193,63,256,261Will_T,"-37.81295822, 144.95678789"
611720231210,61,2023-12-10,17,308,302,610,RMIT14_T,"-37.80767455, 144.96309114"
43920250430,43,2025-04-30,9,231,76,307,UM2_T,"-37.79844526, 144.96411782"
1312020240917,131,2024-09-17,20,31,61,92,King2_T,"-37.82009057, 144.95758725"
143620240521,143,2024-05-21,6,42,115,157,Spencer_T,"-37.821728, 144.95557015"
852320250731,85,2025-07-31,23,0,5,5,488Mac_T,"-37.79432415, 144.92973378"
17220240925,17,2024-09-25,2,4,6,10,Col15_T,"-37.81362543, 144.97323591"
63220250809,63,2025-08-09,2,4,26,30,Bou231_T,"-37.81333081, 144.96675571"
632120250321,63,2025-03-21,21,85,344,429,Bou231_T,"-37.81333081, 144.96675571"
18520231212,18,2023-12-12,5,1,14,15,Col12_T,"-37.81344862, 144.97305353"
24520251015,24,2025-10-15,5,100,38,138,Col620_T,"-37.81887963, 144.95449198"
352120240214,35,2024-02-14,21,903,1459,2362,SouthB_T,"-37.82018685, 144.96508508"
76920250327,76,2025-03-27,9,59,52,111,KenMac_T,"-37.79453803, 144.93036194"
2020250314,2,2025-03-14,0,27,68,95,Bou283_T,"-37.81380668, 144.96516718"
92020250401,9,2025-04-01,20,115,55,170,Col700_T,"-37.81982992, 144.95102555"
9220250904,9,2025-09-04,2,0,1,1,Col700_T,"-37.81982992, 144.95102555"
301220240705,30,2024-07-05,12,368,473,841,Lon189_T,"-37.8112185, 144.96656806"
30920250118,30,2025-01-18,9,52,129,181,Lon189_T,"-37.8112185, 144.96656806"
511220231103,51,2023-11-03,12,130,155,285,Fra118_T,"-37.80841815, 144.95906316"
511520240107,51,2024-01-07,15,121,81,202,Fra118_T,"-37.80841815, 144.95906316"
201820250906,20,2025-09-06,18,547,485,1032,LtB170_T,"-37.81172914, 144.9682466"
251820231206,25,2023-12-06,18,1237,415,1652,MCEC_T,"-37.82401776, 144.95604426"
251320250925,25,2025-09-25,13,750,903,1653,MCEC_T,"-37.82401776, 144.95604426"
52820240603,52,2024-06-03,8,121,283,404,Eli263_T,"-37.81252157, 144.9619401"
141220240502,141,2024-05-02,2,6,10,16,474Fl_T,"-37.81997273, 144.95834911"
191920251012,19,2025-10-12,19,459,334,793,LtB210_T,"-37.81237202, 144.96550671"
661920231209,66,2023-12-09,19,647,604,1251,QVN_T,"-37.81057846, 144.96444294"
69620250704,69,2025-07-04,6,10,10,20,FLDegC_T,"-37.81687226, 144.96559144"
84820240130,84,2024-01-30,8,1532,344,1876,ElFi_T,"-37.81798049, 144.96503383"
32220251001,3,2025-10-01,22,467,436,903,Swa295_T,"-37.81101524, 144.96429485"
8920240803,8,2024-08-03,9,68,133,201,WebBN_T,"-37.82293543, 144.9471751"
81020241116,8,2024-11-16,10,119,319,438,WebBN_T,"-37.82293543, 144.9471751"
77820240110,77,2024-01-10,8,116,134,250,HarEsP_T,"-37.81441438, 144.94433026"
651120240113,65,2024-01-13,11,445,567,1012,SwaCs_T,"-37.81569416, 144.9668064"
292020241012,29,2024-10-12,20,111,112,223,AG_T,"-37.8199817, 144.96872865"
141920240825,14,2024-08-25,19,216,71,287,SanBri_T,"-37.82011242, 144.96291897"
14820240513,14,2024-05-13,8,288,414,702,SanBri_T,"-37.82011242, 144.96291897"
592320231029,59,2023-10-29,23,189,79,268,RMIT_T,"-37.80825648, 144.96304859"
311420231022,31,2023-10-22,14,205,149,354,Lyg161_T,"-37.80169681, 144.96658911"
501520250606,50,2025-06-06,15,167,136,303,Lyg309_T,"-37.79808192, 144.96721013"
431220231213,43,2023-12-13,12,82,97,179,UM2_T,"-37.79844526, 144.96411782"
451620250909,45,2025-09-09,16,469,665,1134,Swa148_T,"-37.81414075, 144.96609379"
1312020240711,131,2024-07-11,20,44,60,104,King2_T,"-37.82009057, 144.95758725"
45220241005,45,2024-10-05,2,49,113,162,Swa148_T,"-37.81414075, 144.96609379"
21220231223,21,2023-12-23,2,114,101,215,Bourke155_T,"-37.81267313, 144.96788288"
212020240829,21,2024-08-29,20,231,265,496,Bourke155_T,"-37.81267313, 144.96788288"
108620231202,108,2023-12-02,6,19,68,87,261Will_T,"-37.81295822, 144.95678789"
1082120240701,108,2024-07-01,21,35,65,100,261Will_T,"-37.81295822, 144.95678789"
61120241002,61,2024-10-02,1,25,16,41,RMIT14_T,"-37.80767455, 144.96309114"
612320231201,61,2023-12-01,23,122,119,241,RMIT14_T,"-37.80767455, 144.96309114"
611420240107,61,2024-01-07,14,55,125,180,RMIT14_T,"-37.80767455, 144.96309114"
44120250926,44,2025-09-26,1,4,0,4,UM3_T,"-37.79698741, 144.96441306"
165620241121,165,2024-11-21,6,9,26,35,Spen475_T,"-37.80953359, 144.94939004"
1661220250421,166,2025-04-21,12,55,54,109,Spen484_T,"-37.80896733, 144.94931703"
131220250516,131,2025-05-16,2,6,11,17,King2_T,"-37.82009057, 144.95758725"
1311220241017,131,2024-10-17,12,170,213,383,King2_T,"-37.82009057, 144.95758725"
162020250723,162,2025-07-23,0,16,17,33,Eli489_T,"-37.80740397, 144.95987909"
1342220240504,134,2024-05-04,22,212,169,381,Spen201_T,"-37.81694221, 144.95303935"
1352320250522,135,2025-05-22,23,59,215,274,Spen161_T,"-37.8172861, 144.95319102"
1351120251016,135,2025-10-16,11,292,446,738,Spen161_T,"-37.8172861, 144.95319102"
1072120250322,107,2025-03-22,21,105,108,213,280Will_T,"-37.81246271, 144.95690188"
531020250306,53,2025-03-06,10,449,416,865,Col254_T,"-37.81564191, 144.965499"
53520231225,53,2023-12-25,5,9,8,17,Col254_T,"-37.81564191, 144.965499"
79620250509,79,2025-05-09,6,144,53,197,FliSS_T,"-37.81794046, 144.96616678"
461220240125,46,2024-01-25,12,128,81,209,Pel147_T,"-37.80240719, 144.9615673"
511020241125,51,2024-11-25,10,34,35,69,Fra118_T,"-37.80841815, 144.95906316"
20220250731,20,2025-07-31,2,0,5,5,LtB170_T,"-37.81172914, 144.9682466"
251220240511,25,2024-05-11,12,686,811,1497,MCEC_T,"-37.82401776, 144.95604426"
251320241210,25,2024-12-10,13,487,583,1070,MCEC_T,"-37.82401776, 144.95604426"
46020240530,46,2024-05-30,0,8,6,14,Pel147_T,"-37.80240719, 144.9615673"
1411620241119,141,2024-11-19,16,166,135,301,474Fl_T,"-37.81997273, 144.95834911"
1392320250812,139,2025-08-12,23,2,3,5,Signal1647_T,"-37.81959923, 144.9632832"
1371020240818,137,2024-08-18,10,14,14,28,BouHbr2353_T,"-37.81894815, 144.94612292"
1372320250122,137,2025-01-22,23,0,3,3,BouHbr2353_T,"-37.81894815, 144.94612292"
1381120250729,138,2025-07-29,11,5,4,9,EntPark1671_T,"-37.81996544, 144.95981454"
49520250520,49,2025-05-20,5,23,17,40,Eli501_T,"-37.80730068, 144.95956055"
492320240528,49,2024-05-28,23,94,75,169,Eli501_T,"-37.80730068, 144.95956055"
491920240925,49,2024-09-25,19,313,344,657,Eli501_T,"-37.80730068, 144.95956055"
672020240503,67,2024-05-03,20,259,402,661,FLDegS_T,"-37.81688755, 144.96562569"
68120250824,68,2025-08-24,1,2,2,4,FLDegN_T,"-37.8168479, 144.96559789"
18320250101,18,2025-01-01,3,4,1,5,Col12_T,"-37.81344862, 144.97305353"
86820250618,86,2025-06-18,8,57,25,82,574Qub_T,"-37.80309992, 144.94908064"
11620241223,11,2024-12-23,6,31,18,49,WatCit_T,"-37.81564989, 144.93970694"
12420240526,12,2024-05-26,4,2,8,10,NewQ_T,"-37.81457988, 144.94292398"
862220250617,86,2025-06-17,22,0,7,7,574Qub_T,"-37.80309992, 144.94908064"
24520240421,24,2024-04-21,5,24,43,67,Col620_T,"-37.81887963, 144.95449198"
2620240913,2,2024-09-13,6,17,43,60,Bou283_T,"-37.81380668, 144.96516718"
22320250322,2,2025-03-22,23,36,144,180,Bou283_T,"-37.81380668, 144.96516718"
21320240323,2,2024-03-23,13,819,794,1613,Bou283_T,"-37.81380668, 144.96516718"
271720240605,27,2024-06-05,17,193,112,305,Vic_T,"-37.80606888, 144.95644692"
271520250512,27,2025-05-12,15,99,109,208,Vic_T,"-37.80606888, 144.95644692"
69720250213,69,2025-02-13,7,108,30,138,FLDegC_T,"-37.81687226, 144.96559144"
6220241028,6,2024-10-28,2,20,12,32,FliS_T,"-37.81911705, 144.96558255"
6920241201,6,2024-12-01,9,447,337,784,FliS_T,"-37.81911705, 144.96558255"
841420240703,84,2024-07-03,14,1056,1212,2268,ElFi_T,"-37.81798049, 144.96503383"
84920240914,84,2024-09-14,9,527,353,880,ElFi_T,"-37.81798049, 144.96503383"
32120231110,3,2023-11-10,21,1299,1112,2411,Swa295_T,"-37.81101524, 144.96429485"
118620250107,118,2025-01-07,6,0,2,2,Fli114C_T,"-37.81632783, 144.97090512"
108820241112,108,2024-11-12,8,168,2550,2718,261Will_T,"-37.81295822, 144.95678789"
87620241112,87,2024-11-12,6,18,10,28,Errol23_T,"-37.80454949, 144.94921863"
611620251001,61,2025-10-01,16,560,746,1306,RMIT14_T,"-37.80767455, 144.96309114"
61720240524,61,2024-05-24,7,96,136,232,RMIT14_T,"-37.80767455, 144.96309114"
165720240910,165,2024-09-10,7,8,35,43,Spen475_T,"-37.80953359, 144.94939004"
132520240701,132,2024-07-01,5,7,4,11,King335_T,"-37.81267639, 144.95386444"
172120250824,17,2025-08-24,21,66,64,130,Col15_T,"-37.81362543, 144.97323591"
63620240130,63,2024-01-30,6,34,37,71,Bou231_T,"-37.81333081, 144.96675571"
181020250513,18,2025-05-13,10,219,303,522,Col12_T,"-37.81344862, 144.97305353"
62320240528,62,2024-05-28,3,8,13,21,Lat224_T,"-37.80996494, 144.96216521"
562320241116,56,2024-11-16,23,295,171,466,Lon364_T,"-37.81234775, 144.96153311"
861920250206,86,2025-02-06,19,52,53,105,574Qub_T,"-37.80309992, 144.94908064"
24320231220,24,2023-12-20,3,10,20,30,Col620_T,"-37.81887963, 144.95449198"
12520240808,12,2024-08-08,5,8,6,14,NewQ_T,"-37.81457988, 144.94292398"
12420250118,12,2025-01-18,4,2,4,6,NewQ_T,"-37.81457988, 144.94292398"
101920240724,10,2024-07-24,19,26,24,50,BouHbr_T,"-37.81876474, 144.94710545"
721720240923,72,2024-09-23,17,187,714,901,ACMI_T,"-37.81726338, 144.96872809"
352320251011,35,2025-10-11,23,318,382,700,SouthB_T,"-37.82018685, 144.96508508"
92020240115,9,2024-01-15,20,68,45,113,Col700_T,"-37.81982992, 144.95102555"
272220250202,27,2025-02-02,22,41,26,67,Vic_T,"-37.80606888, 144.95644692"
531320250506,53,2025-05-06,13,884,695,1579,Col254_T,"-37.81564191, 144.965499"
511020241109,51,2024-11-09,10,92,114,206,Fra118_T,"-37.80841815, 144.95906316"
481420250724,48,2025-07-24,14,395,196,591,QVMQ_T,"-37.80631581, 144.95866697"
251720231102,25,2023-11-02,17,1151,432,1583,MCEC_T,"-37.82401776, 144.95604426"
20820240730,20,2024-07-30,8,53,52,105,LtB170_T,"-37.81172914, 144.9682466"
20620240331,20,2024-03-31,6,6,17,23,LtB170_T,"-37.81172914, 144.9682466"
521020240704,52,2024-07-04,10,177,153,330,Eli263_T,"-37.81252157, 144.9619401"
461920250428,46,2025-04-28,19,5,22,27,Pel147_T,"-37.80240719, 144.9615673"
1411120240503,141,2024-05-03,11,177,120,297,474Fl_T,"-37.81997273, 144.95834911"
1362020240111,136,2024-01-11,20,97,279,376,BirFed1120_T,"-37.8184141, 144.97357915"
1301520251010,130,2025-10-10,15,79,74,153,Bou892T,"-37.8204637, 144.94126826"
1301520240917,130,2024-09-17,15,44,59,103,Bou892T,"-37.8204637, 144.94126826"
1641020240912,164,2024-09-12,10,104,45,149,Lat526_T,"-37.813005, 144.95160411"
1611120250129,161,2025-01-29,11,57,86,143,BirArt1109_T,"-37.81851276, 144.97131336"
1231320231229,123,2023-12-29,13,34,12,46,BirBridge_T,"-37.81753741, 144.97329734"
117220240520,117,2024-05-20,2,5,2,7,Fli114F_T,"-37.81629332, 144.97090877"
1091520231209,109,2023-12-09,15,37,49,86,LatWill_T,"-37.81193681, 144.95621105"
1091320240714,109,2024-07-14,13,122,153,275,LatWill_T,"-37.81193681, 144.95621105"
691820241024,69,2024-10-24,18,106,83,189,FLDegC_T,"-37.81687226, 144.96559144"
6220250413,6,2025-04-13,2,122,69,191,FliS_T,"-37.81911705, 144.96558255"
662020240423,66,2024-04-23,20,818,713,1531,QVN_T,"-37.81057846, 144.96444294"
4220240923,4,2024-09-23,2,30,27,57,Swa123_T,"-37.81487988, 144.9660878"
391420241007,39,2024-10-07,14,60,75,135,AlfPl_T,"-37.81379749, 144.96995745"
751620250303,75,2025-03-03,16,48,70,118,SprFli_T,"-37.81515276, 144.97467661"
411120250726,41,2025-07-26,11,1683,1239,2922,Swa31,"-37.81668634, 144.96689733"
771620240620,77,2024-06-20,16,192,141,333,HarEsP_T,"-37.81441438, 144.94433026"
651920240205,65,2024-02-05,19,169,345,514,SwaCs_T,"-37.81569416, 144.9668064"
291820250823,29,2025-08-23,18,267,214,481,AG_T,"-37.8199817, 144.96872865"
14520231110,14,2023-11-10,5,42,31,73,SanBri_T,"-37.82011242, 144.96291897"
14720240501,14,2024-05-01,7,233,210,443,SanBri_T,"-37.82011242, 144.96291897"
541420241003,54,2024-10-03,14,214,278,492,Swa607_T,"-37.804024, 144.96308399"
28120231027,28,2023-10-27,1,17,8,25,VAC_T,"-37.82129925, 144.96879309"
47920231202,47,2023-12-02,9,191,380,571,Eli250_T,"-37.81258467, 144.9625775"
31020250711,31,2025-07-11,0,14,7,21,Lyg161_T,"-37.80169681, 144.96658911"
371120231108,37,2023-11-08,11,148,131,279,Lyg260_T,"-37.80107122, 144.96704554"
131720240125,131,2024-01-25,7,57,25,82,King2_T,"-37.82009057, 144.95758725"
1181420240123,118,2024-01-23,14,38,37,75,Fli114C_T,"-37.81632783, 144.97090512"
1241620250806,124,2025-08-06,16,2,6,8,BirBridge_T,"-37.81757416, 144.97329934"
61820250405,61,2025-04-05,8,71,95,166,RMIT14_T,"-37.80767455, 144.96309114"
611820240924,61,2024-09-24,18,557,588,1145,RMIT14_T,"-37.80767455, 144.96309114"
70520240504,70,2024-05-04,5,0,1,1,Errol20_T,"-37.80456984, 144.94946228"
162920241202,162,2024-12-02,9,177,208,385,Eli489_T,"-37.80740397, 144.95987909"
1622220250523,162,2025-05-23,22,182,143,325,Eli489_T,"-37.80740397, 144.95987909"
1311920250820,131,2025-08-20,19,79,76,155,King2_T,"-37.82009057, 144.95758725"
131420240703,131,2024-07-03,4,0,2,2,King2_T,"-37.82009057, 144.95758725"
1431120241207,143,2024-12-07,11,168,356,524,Spencer_T,"-37.821728, 144.95557015"
1381420250516,138,2025-05-16,14,7,6,13,EntPark1671_T,"-37.81996544, 144.95981454"
491020240423,49,2024-04-23,10,268,352,620,Eli501_T,"-37.80730068, 144.95956055"
19820241221,19,2024-12-21,8,23,44,67,LtB210_T,"-37.81237202, 144.96550671"
17720240714,17,2024-07-14,7,37,25,62,Col15_T,"-37.81362543, 144.97323591"
171620240904,17,2024-09-04,16,208,428,636,Col15_T,"-37.81362543, 144.97323591"
1120250226,1,2025-02-26,1,7,17,24,Bou292_T,"-37.81349441, 144.96515323"
671520240111,67,2024-01-11,15,320,575,895,FLDegS_T,"-37.81688755, 144.96562569"
671720250310,67,2025-03-10,17,263,519,782,FLDegS_T,"-37.81688755, 144.96562569"
68120240816,68,2024-08-16,1,2,2,4,FLDegN_T,"-37.8168479, 144.96559789"
63920240510,63,2024-05-10,9,129,186,315,Bou231_T,"-37.81333081, 144.96675571"
86320241231,86,2024-12-31,3,1,1,2,574Qub_T,"-37.80309992, 144.94908064"
111120250108,11,2025-01-08,11,49,89,138,WatCit_T,"-37.81564989, 144.93970694"
101720240919,10,2024-09-19,17,188,65,253,BouHbr_T,"-37.81876474, 144.94710545"
10020250218,10,2025-02-18,0,0,1,1,BouHbr_T,"-37.81876474, 144.94710545"
581420250320,58,2025-03-20,14,453,389,842,Bou688_T,"-37.81686075, 144.95358075"
351020250127,35,2025-01-27,10,678,454,1132,SouthB_T,"-37.82018685, 144.96508508"
76220241231,76,2024-12-31,2,0,1,1,KenMac_T,"-37.79453803, 144.93036194"
35620250921,35,2025-09-21,6,115,98,213,SouthB_T,"-37.82018685, 144.96508508"
22020250101,2,2025-01-01,20,133,204,337,Bou283_T,"-37.81380668, 144.96516718"
271020250220,27,2025-02-20,10,115,111,226,Vic_T,"-37.80606888, 144.95644692"
27920250629,27,2025-06-29,9,136,142,278,Vic_T,"-37.80606888, 144.95644692"
511420240721,51,2024-07-21,14,142,227,369,Fra118_T,"-37.80841815, 144.95906316"
23920250822,23,2025-08-22,9,424,291,715,Col623_T,"-37.81909256, 144.95452748"
19720231101,19,2023-11-01,7,30,26,56,LtB210_T,"-37.81237202, 144.96550671"
48020231123,48,2023-11-23,0,13,20,33,QVMQ_T,"-37.80631581, 144.95866697"
481020240829,48,2024-08-29,10,208,176,384,QVMQ_T,"-37.80631581, 144.95866697"
52820250904,52,2025-09-04,8,164,295,459,Eli263_T,"-37.81252157, 144.9619401"
46120240314,46,2024-03-14,1,6,7,13,Pel147_T,"-37.80240719, 144.9615673"
1421220240913,142,2024-09-13,12,406,347,753,Hammer1584_T,"-37.81970749, 144.96795734"
66320240404,66,2024-04-04,3,8,7,15,QVN_T,"-37.81057846, 144.96444294"
62320250111,6,2025-01-11,23,664,428,1092,FliS_T,"-37.81911705, 144.96558255"
39120240225,39,2024-02-25,1,14,23,37,AlfPl_T,"-37.81379749, 144.96995745"
391520231107,39,2023-11-07,15,48,20,68,AlfPl_T,"-37.81379749, 144.96995745"
81220250421,8,2025-04-21,12,200,411,611,WebBN_T,"-37.82293543, 144.9471751"
751020240522,75,2024-05-22,10,50,33,83,SprFli_T,"-37.81515276, 144.97467661"
81720231224,8,2023-12-24,17,191,127,318,WebBN_T,"-37.82293543, 144.9471751"
781120241129,78,2024-11-29,11,24,51,75,HarEsB_T,"-37.81471642, 144.9446508"
78020250426,78,2025-04-26,0,1,4,5,HarEsB_T,"-37.81471642, 144.9446508"
421720240724,42,2024-07-24,17,249,598,847,UM1_T,"-37.80008566, 144.96386412"
14820250814,14,2025-08-14,8,224,423,647,SanBri_T,"-37.82011242, 144.96291897"
59520240524,59,2024-05-24,5,20,20,40,RMIT_T,"-37.80825648, 144.96304859"
592220250228,59,2025-02-28,22,121,135,256,RMIT_T,"-37.80825648, 144.96304859"
71620241021,71,2024-10-21,6,7,3,10,WestWP_T,"-37.81235775, 144.97136962"
28920250710,28,2025-07-10,9,535,248,783,VAC_T,"-37.82129925, 144.96879309"
541920240225,54,2024-02-25,19,137,145,282,Swa607_T,"-37.804024, 144.96308399"
282220240927,28,2024-09-27,22,138,520,658,VAC_T,"-37.82129925, 144.96879309"
312020250502,31,2025-05-02,20,282,332,614,Lyg161_T,"-37.80169681, 144.96658911"
211920250128,21,2025-01-28,19,296,437,733,Bourke155_T,"-37.81267313, 144.96788288"
36320240203,36,2024-02-03,3,167,107,274,Que85_T,"-37.81652527, 144.96121062"
372020250118,37,2025-01-18,20,353,407,760,Lyg260_T,"-37.80107122, 144.96704554"
501720240630,50,2024-06-30,17,162,142,304,Lyg309_T,"-37.79808192, 144.96721013"
501320250221,50,2025-02-21,13,206,199,405,Lyg309_T,"-37.79808192, 144.96721013"
1182120250428,118,2025-04-28,21,1,3,4,Fli114C_T,"-37.81632783, 144.97090512"
1182320240826,118,2024-08-26,23,2,2,4,Fli114C_T,"-37.81632783, 144.97090512"
87320250406,87,2025-04-06,3,1,0,1,Errol23_T,"-37.80454949, 144.94921863"
87120241103,87,2024-11-03,1,4,13,17,Errol23_T,"-37.80454949, 144.94921863"
871020240722,87,2024-07-22,10,84,92,176,Errol23_T,"-37.80454949, 144.94921863"
611120240307,61,2024-03-07,11,699,755,1454,RMIT14_T,"-37.80767455, 144.96309114"
1651820250305,165,2025-03-05,18,95,44,139,Spen475_T,"-37.80953359, 144.94939004"
1651120250509,165,2025-05-09,11,19,45,64,Spen475_T,"-37.80953359, 144.94939004"
1311620250810,131,2025-08-10,16,168,61,229,King2_T,"-37.82009057, 144.95758725"
1432020240824,143,2024-08-24,20,180,297,477,Spencer_T,"-37.821728, 144.95557015"
1321220250218,132,2025-02-18,12,165,152,317,King335_T,"-37.81267639, 144.95386444"
681320240130,68,2024-01-30,13,263,179,442,FLDegN_T,"-37.8168479, 144.96559789"
631420240626,63,2024-06-26,14,295,461,756,Bou231_T,"-37.81333081, 144.96675571"
562020240106,56,2024-01-06,20,247,316,563,Lon364_T,"-37.81234775, 144.96153311"
241720240307,24,2024-03-07,17,746,2453,3199,Col620_T,"-37.81887963, 144.95449198"
122020240329,12,2024-03-29,20,443,400,843,NewQ_T,"-37.81457988, 144.94292398"
121820240922,12,2024-09-22,18,262,242,504,NewQ_T,"-37.81457988, 144.94292398"
11820250911,1,2025-09-11,18,620,533,1153,Bou292_T,"-37.81349441, 144.96515323"
111920250911,11,2025-09-11,19,34,14,48,WatCit_T,"-37.81564989, 144.93970694"
721420231103,72,2023-11-03,14,316,355,671,ACMI_T,"-37.81726338, 144.96872809"
10220250515,10,2025-05-15,2,1,2,3,BouHbr_T,"-37.81876474, 144.94710545"
10220240212,10,2024-02-12,2,3,0,3,BouHbr_T,"-37.81876474, 144.94710545"
35020240409,35,2024-04-09,0,12,32,44,SouthB_T,"-37.82018685, 144.96508508"
761420231218,76,2023-12-18,14,49,54,103,KenMac_T,"-37.79453803, 144.93036194"
27720231215,27,2023-12-15,7,45,58,103,Vic_T,"-37.80606888, 144.95644692"
42320241209,4,2024-12-09,23,256,207,463,Swa123_T,"-37.81487988, 144.9660878"
70020240509,70,2024-05-09,0,3,3,6,Errol20_T,"-37.80456984, 144.94946228"
702320250320,70,2025-03-20,23,40,44,84,Errol20_T,"-37.80456984, 144.94946228"
82120231029,8,2023-10-29,21,22,19,41,WebBN_T,"-37.82293543, 144.9471751"
391020251006,39,2025-10-06,10,127,84,211,AlfPl_T,"-37.81379749, 144.96995745"
41520250716,41,2025-07-16,5,115,93,208,Swa31,"-37.81668634, 144.96689733"
77320250810,77,2025-08-10,3,12,2,14,HarEsP_T,"-37.81441438, 144.94433026"
29020240930,29,2024-09-30,0,12,13,25,AG_T,"-37.8199817, 144.96872865"
651420240831,65,2024-08-31,14,1224,765,1989,SwaCs_T,"-37.81569416, 144.9668064"
28320250408,28,2025-04-08,3,3,14,17,VAC_T,"-37.82129925, 144.96879309"
281920241212,28,2024-12-12,19,343,314,657,VAC_T,"-37.82129925, 144.96879309"
281920231204,28,2023-12-04,19,219,563,782,VAC_T,"-37.82129925, 144.96879309"
401920240718,40,2024-07-18,19,80,119,199,Spr201_T,"-37.80999341, 144.97227587"
37020250204,37,2025-02-04,0,20,23,43,Lyg260_T,"-37.80107122, 144.96704554"
37920250709,37,2025-07-09,9,22,51,73,Lyg260_T,"-37.80107122, 144.96704554"
452220250621,45,2025-06-21,22,308,475,783,Swa148_T,"-37.81414075, 144.96609379"
451820241026,45,2024-10-26,18,723,1215,1938,Swa148_T,"-37.81414075, 144.96609379"
21020241107,21,2024-11-07,0,33,33,66,Bourke155_T,"-37.81267313, 144.96788288"
108320240801,108,2024-08-01,3,0,4,4,261Will_T,"-37.81295822, 144.95678789"
612220250628,61,2025-06-28,22,93,50,143,RMIT14_T,"-37.80767455, 144.96309114"
612120240401,61,2024-04-01,21,92,89,181,RMIT14_T,"-37.80767455, 144.96309114"
441820250303,44,2025-03-03,18,160,106,266,UM3_T,"-37.79698741, 144.96441306"
179020250528,179,2025-05-28,0,2,5,7,Pow61_T,"-37.82392385, 144.96299677"
1431120240915,143,2024-09-15,11,140,238,378,Spencer_T,"-37.821728, 144.95557015"
1431020241004,143,2024-10-04,10,114,237,351,Spencer_T,"-37.821728, 144.95557015"
1321420240304,132,2024-03-04,14,153,119,272,King335_T,"-37.81267639, 144.95386444"
1321620250127,132,2025-01-27,16,86,71,157,King335_T,"-37.81267639, 144.95386444"
1331420240621,133,2024-06-21,14,498,521,1019,Spen229_T,"-37.81531435, 144.95227769"
1332220240701,133,2024-07-01,22,182,132,314,Spen229_T,"-37.81531435, 144.95227769"
107720240920,107,2024-09-20,7,34,79,113,280Will_T,"-37.81246271, 144.95690188"
1181120240406,118,2024-04-06,11,13,14,27,Fli114C_T,"-37.81632783, 144.97090512"
1181120250708,118,2025-07-08,11,27,16,43,Fli114C_T,"-37.81632783, 144.97090512"
682320241108,68,2024-11-08,23,57,34,91,FLDegN_T,"-37.8168479, 144.96559789"
851820250122,85,2025-01-22,18,64,79,143,488Mac_T,"-37.79432415, 144.92973378"
11120250220,1,2025-02-20,11,737,780,1517,Bou292_T,"-37.81349441, 144.96515323"
18920240121,18,2024-01-21,9,39,41,80,Col12_T,"-37.81344862, 144.97305353"
561420231027,56,2023-10-27,14,297,190,487,Lon364_T,"-37.81234775, 144.96153311"
861920250414,86,2025-04-14,19,29,42,71,574Qub_T,"-37.80309992, 144.94908064"
111520240120,11,2024-01-20,15,162,112,274,WatCit_T,"-37.81564989, 144.93970694"
111520240825,11,2024-08-25,15,139,123,262,WatCit_T,"-37.81564989, 144.93970694"
762120250906,76,2025-09-06,21,4,11,15,KenMac_T,"-37.79453803, 144.93036194"
581320240121,58,2024-01-21,13,578,231,809,Bou688_T,"-37.81686075, 144.95358075"
581020250915,58,2025-09-15,10,642,165,807,Bou688_T,"-37.81686075, 144.95358075"
351620250105,35,2025-01-05,16,692,908,1600,SouthB_T,"-37.82018685, 144.96508508"
9120240110,9,2024-01-10,1,0,3,3,Col700_T,"-37.81982992, 144.95102555"
53520241112,53,2024-11-12,5,7,8,15,Col254_T,"-37.81564191, 144.965499"
51320240130,51,2024-01-30,3,5,5,10,Fra118_T,"-37.80841815, 144.95906316"
232220250328,23,2025-03-28,22,145,218,363,Col623_T,"-37.81909256, 144.95452748"
231820240903,23,2024-09-03,18,233,410,643,Col623_T,"-37.81909256, 144.95452748"
511320241016,51,2024-10-16,13,125,98,223,Fra118_T,"-37.80841815, 144.95906316"
252020250213,25,2025-02-13,20,292,228,520,MCEC_T,"-37.82401776, 144.95604426"
20120250517,20,2025-05-17,1,75,122,197,LtB170_T,"-37.81172914, 144.9682466"
52620250226,52,2025-02-26,6,27,19,46,Eli263_T,"-37.81252157, 144.9619401"
461420250103,46,2025-01-03,14,34,35,69,Pel147_T,"-37.80240719, 144.9615673"
192220251005,19,2025-10-05,22,228,323,551,LtB210_T,"-37.81237202, 144.96550671"
1391220250518,139,2025-05-18,12,59,36,95,Signal1647_T,"-37.81959923, 144.9632832"
136620231216,136,2023-12-16,6,19,17,36,BirFed1120_T,"-37.8184141, 144.97357915"
1301020250722,130,2025-07-22,10,44,16,60,Bou892T,"-37.8204637, 144.94126826"
1301120240314,130,2024-03-14,11,30,50,80,Bou892T,"-37.8204637, 144.94126826"
1172120250903,117,2025-09-03,21,83,53,136,Fli114F_T,"-37.81629332, 144.97090877"
109820251006,109,2025-10-06,8,75,330,405,LatWill_T,"-37.81193681, 144.95621105"
1092020240626,109,2024-06-26,20,107,109,216,LatWill_T,"-37.81193681, 144.95621105"
109420250417,109,2025-04-17,4,13,5,18,LatWill_T,"-37.81193681, 144.95621105"
692220240718,69,2024-07-18,22,5,9,14,FLDegC_T,"-37.81687226, 144.96559144"
6320250322,6,2025-03-22,3,39,58,97,FliS_T,"-37.81911705, 144.96558255"
84520250121,84,2025-01-21,5,59,37,96,ElFi_T,"-37.81798049, 144.96503383"
4420240204,4,2024-02-04,4,54,56,110,Swa123_T,"-37.81487988, 144.9660878"
66120231118,66,2023-11-18,1,128,158,286,QVN_T,"-37.81057846, 144.96444294"
411920241019,41,2024-10-19,19,207,219,426,Swa31,"-37.81668634, 144.96689733"
41120240912,41,2024-09-12,1,15,13,28,Swa31,"-37.81668634, 144.96689733"
781220250401,78,2025-04-01,12,58,59,117,HarEsB_T,"-37.81471642, 144.9446508"
291920250105,29,2025-01-05,19,163,158,321,AG_T,"-37.8199817, 144.96872865"
14920250114,14,2025-01-14,9,309,237,546,SanBri_T,"-37.82011242, 144.96291897"
592320250407,59,2025-04-07,23,58,86,144,RMIT_T,"-37.80825648, 144.96304859"
59320250409,59,2025-04-09,3,7,9,16,RMIT_T,"-37.80825648, 144.96304859"
712220231105,71,2023-11-05,22,2,4,6,WestWP_T,"-37.81235775, 144.97136962"
312220240418,31,2024-04-18,22,52,102,154,Lyg161_T,"-37.80169681, 144.96658911"
28120241121,28,2024-11-21,1,14,4,18,VAC_T,"-37.82129925, 144.96879309"
432320250609,43,2025-06-09,23,11,11,22,UM2_T,"-37.79844526, 144.96411782"
1341820250108,134,2025-01-08,18,473,384,857,Spen201_T,"-37.81694221, 144.95303935"
1072220240515,107,2024-05-15,22,36,15,51,280Will_T,"-37.81246271, 144.95690188"
1182020231101,118,2023-11-01,20,5,9,14,Fli114C_T,"-37.81632783, 144.97090512"
1081720250820,108,2025-08-20,17,1725,320,2045,261Will_T,"-37.81295822, 144.95678789"
681120240603,68,2024-06-03,11,162,106,268,FLDegN_T,"-37.8168479, 144.96559789"
681720241102,68,2024-11-02,17,240,161,401,FLDegN_T,"-37.8168479, 144.96559789"
85720250514,85,2025-05-14,7,89,29,118,488Mac_T,"-37.79432415, 144.92973378"
17920231227,17,2023-12-27,9,163,107,270,Col15_T,"-37.81362543, 144.97323591"
172320250509,17,2025-05-09,23,76,69,145,Col15_T,"-37.81362543, 144.97323591"
12020240416,1,2024-04-16,20,318,276,594,Bou292_T,"-37.81349441, 144.96515323"
671620250619,67,2025-06-19,16,326,516,842,FLDegS_T,"-37.81688755, 144.96562569"
67820241015,67,2024-10-15,8,369,286,655,FLDegS_T,"-37.81688755, 144.96562569"
682220241123,68,2024-11-23,22,94,49,143,FLDegN_T,"-37.8168479, 144.96559789"
181720241104,18,2024-11-04,17,382,79,461,Col12_T,"-37.81344862, 144.97305353"
12920250927,12,2025-09-27,9,183,138,321,NewQ_T,"-37.81457988, 144.94292398"
241620250210,24,2025-02-10,16,462,1803,2265,Col620_T,"-37.81887963, 144.95449198"
351820240517,35,2024-05-17,18,1131,1215,2346,SouthB_T,"-37.82018685, 144.96508508"
2620241221,2,2024-12-21,6,15,16,31,Bou283_T,"-37.81380668, 144.96516718"
301320231225,30,2023-12-25,13,132,189,321,Lon189_T,"-37.8112185, 144.96656806"
531420250208,53,2025-02-08,14,814,732,1546,Col254_T,"-37.81564191, 144.965499"
20520250930,20,2025-09-30,5,5,8,13,LtB170_T,"-37.81172914, 144.9682466"
252220240921,25,2024-09-21,22,316,295,611,MCEC_T,"-37.82401776, 144.95604426"
25520250609,25,2025-06-09,5,0,3,3,MCEC_T,"-37.82401776, 144.95604426"
20520240629,20,2024-06-29,5,12,8,20,LtB170_T,"-37.81172914, 144.9682466"
202320250306,20,2025-03-06,23,92,154,246,LtB170_T,"-37.81172914, 144.9682466"
521520240922,52,2024-09-22,15,365,286,651,Eli263_T,"-37.81252157, 144.9619401"
52220240110,52,2024-01-10,2,5,9,14,Eli263_T,"-37.81252157, 144.9619401"
1411320250902,141,2025-09-02,13,98,147,245,474Fl_T,"-37.81997273, 144.95834911"
1372120250227,137,2025-02-27,21,4,4,8,BouHbr2353_T,"-37.81894815, 144.94612292"
164720240831,164,2024-08-31,7,18,15,33,Lat526_T,"-37.813005, 144.95160411"
1612320250104,161,2025-01-04,23,0,51,51,BirArt1109_T,"-37.81851276, 144.97131336"
161720250919,161,2025-09-19,7,79,145,224,BirArt1109_T,"-37.81851276, 144.97131336"
1611920251005,161,2025-10-05,19,19,18,37,BirArt1109_T,"-37.81851276, 144.97131336"
123820250325,123,2025-03-25,8,88,30,118,BirBridge_T,"-37.81753741, 144.97329734"
491720250114,49,2025-01-14,17,203,194,397,Eli501_T,"-37.80730068, 144.95956055"
491920240703,49,2024-07-03,19,660,2006,2666,Eli501_T,"-37.80730068, 144.95956055"
109620231020,109,2023-10-20,6,21,90,111,LatWill_T,"-37.81193681, 144.95621105"
871320240627,87,2024-06-27,13,133,156,289,Errol23_T,"-37.80454949, 144.94921863"
1671520250423,167,2025-04-23,15,32,35,67,Lat526_T,"-37.81304149, 144.95155955"
162120250701,162,2025-07-01,1,26,13,39,Eli489_T,"-37.80740397, 144.95987909"
672120240104,67,2024-01-04,21,201,301,502,FLDegS_T,"-37.81688755, 144.96562569"
67920250410,67,2025-04-10,9,446,319,765,FLDegS_T,"-37.81688755, 144.96562569"
632220241221,63,2024-12-21,22,148,257,405,Bou231_T,"-37.81333081, 144.96675571"
18720240808,18,2024-08-08,7,24,272,296,Col12_T,"-37.81344862, 144.97305353"
181920240630,18,2024-06-30,19,0,1,1,Col12_T,"-37.81344862, 144.97305353"
63420231126,63,2023-11-26,4,20,70,90,Bou231_T,"-37.81333081, 144.96675571"
86020240307,86,2024-03-07,0,1,3,4,574Qub_T,"-37.80309992, 144.94908064"
862120240322,86,2024-03-22,21,14,39,53,574Qub_T,"-37.80309992, 144.94908064"
68720250914,68,2025-09-14,7,24,20,44,FLDegN_T,"-37.8168479, 144.96559789"
622220250428,62,2025-04-28,22,110,83,193,Lat224_T,"-37.80996494, 144.96216521"
121220231126,12,2023-11-26,12,173,210,383,NewQ_T,"-37.81457988, 144.94292398"
72620241116,72,2024-11-16,6,16,26,42,ACMI_T,"-37.81726338, 144.96872809"
58120250330,58,2025-03-30,1,74,94,168,Bou688_T,"-37.81686075, 144.95358075"
761820241112,76,2024-11-12,18,56,59,115,KenMac_T,"-37.79453803, 144.93036194"
21120250902,2,2025-09-02,11,498,498,996,Bou283_T,"-37.81380668, 144.96516718"
2620241222,2,2024-12-22,6,7,16,23,Bou283_T,"-37.81380668, 144.96516718"
53820240212,53,2024-02-12,8,361,288,649,Col254_T,"-37.81564191, 144.965499"
30620250812,30,2025-08-12,6,17,18,35,Lon189_T,"-37.8112185, 144.96656806"
302320241016,30,2024-10-16,23,166,154,320,Lon189_T,"-37.8112185, 144.96656806"
53820250515,53,2025-05-15,8,413,266,679,Col254_T,"-37.81564191, 144.965499"
231520250410,23,2025-04-10,15,226,338,564,Col623_T,"-37.81909256, 144.95452748"
51820241025,51,2024-10-25,8,46,42,88,Fra118_T,"-37.80841815, 144.95906316"
201720250509,20,2025-05-09,17,524,329,853,LtB170_T,"-37.81172914, 144.9682466"
1391820240919,139,2024-09-19,18,43,9,52,Signal1647_T,"-37.81959923, 144.9632832"
1641120250413,164,2025-04-13,11,149,70,219,Lat526_T,"-37.813005, 144.95160411"
1641120250914,164,2025-09-14,11,102,51,153,Lat526_T,"-37.813005, 144.95160411"
1612020241101,161,2024-11-01,20,82,19,101,BirArt1109_T,"-37.81851276, 144.97131336"
1611120250424,161,2025-04-24,11,144,121,265,BirArt1109_T,"-37.81851276, 144.97131336"
162920250313,162,2025-03-13,9,330,303,633,Eli489_T,"-37.80740397, 144.95987909"
1432220241003,143,2024-10-03,22,146,90,236,Spencer_T,"-37.821728, 144.95557015"
61220240225,6,2024-02-25,12,740,885,1625,FliS_T,"-37.81911705, 144.96558255"
6620240928,6,2024-09-28,6,77,84,161,FliS_T,"-37.81911705, 144.96558255"
31020240903,3,2024-09-03,10,340,497,837,Swa295_T,"-37.81101524, 144.96429485"
4020241201,4,2024-12-01,0,418,394,812,Swa123_T,"-37.81487988, 144.9660878"
41520241205,4,2024-12-05,15,1719,1302,3021,Swa123_T,"-37.81487988, 144.9660878"
591620240927,59,2024-09-27,16,519,418,937,RMIT_T,"-37.80825648, 144.96304859"
711220240823,71,2024-08-23,12,29,27,56,WestWP_T,"-37.81235775, 144.97136962"
71320241014,71,2024-10-14,3,1,2,3,WestWP_T,"-37.81235775, 144.97136962"
71220241212,71,2024-12-12,2,1,3,4,WestWP_T,"-37.81235775, 144.97136962"
711520240225,71,2024-02-25,15,11,15,26,WestWP_T,"-37.81235775, 144.97136962"
281120250712,28,2025-07-12,11,867,699,1566,VAC_T,"-37.82129925, 144.96879309"
281720240922,28,2024-09-22,17,269,706,975,VAC_T,"-37.82129925, 144.96879309"
36520250122,36,2025-01-22,5,12,7,19,Que85_T,"-37.81652527, 144.96121062"
37620250417,37,2025-04-17,6,3,11,14,Lyg260_T,"-37.80107122, 144.96704554"
87320240709,87,2024-07-09,3,1,0,1,Errol23_T,"-37.80454949, 144.94921863"
50820240916,50,2024-09-16,8,31,97,128,Lyg309_T,"-37.79808192, 144.96721013"
44520251014,44,2025-10-14,5,3,6,9,UM3_T,"-37.79698741, 144.96441306"
432120231117,43,2023-11-17,21,26,62,88,UM2_T,"-37.79844526, 144.96411782"
1791920251010,179,2025-10-10,19,112,73,185,Pow61_T,"-37.82392385, 144.96299677"
131920250726,131,2025-07-26,9,70,114,184,King2_T,"-37.82009057, 144.95758725"
1821020250420,182,2025-04-20,10,124,170,294,King163_T,"-37.81627451, 144.95550503"
134120241227,134,2024-12-27,1,47,58,105,Spen201_T,"-37.81694221, 144.95303935"
134320250530,134,2025-05-30,3,19,13,32,Spen201_T,"-37.81694221, 144.95303935"
1351720231031,135,2023-10-31,17,498,419,917,Spen161_T,"-37.8172861, 144.95319102"
107420250402,107,2025-04-02,4,1,4,5,280Will_T,"-37.81246271, 144.95690188"
107420250506,107,2025-05-06,4,2,2,4,280Will_T,"-37.81246271, 144.95690188"
118920240628,118,2024-06-28,9,10,13,23,Fli114C_T,"-37.81632783, 144.97090512"
1081820240210,108,2024-02-10,18,112,133,245,261Will_T,"-37.81295822, 144.95678789"
671820250206,67,2025-02-06,18,353,512,865,FLDegS_T,"-37.81688755, 144.96562569"
681920240406,68,2024-04-06,19,153,36,189,FLDegN_T,"-37.8168479, 144.96559789"
11320240121,1,2024-01-21,13,1348,1302,2650,Bou292_T,"-37.81349441, 144.96515323"
35920231111,35,2023-11-11,9,786,585,1371,SouthB_T,"-37.82018685, 144.96508508"
21120231026,2,2023-10-26,11,345,389,734,Bou283_T,"-37.81380668, 144.96516718"
58320231111,58,2023-11-11,3,47,56,103,Bou688_T,"-37.81686075, 144.95358075"
58920241105,58,2024-11-05,9,296,172,468,Bou688_T,"-37.81686075, 144.95358075"
35520250530,35,2025-05-30,5,19,25,44,SouthB_T,"-37.82018685, 144.96508508"
92220240713,9,2024-07-13,22,28,53,81,Col700_T,"-37.81982992, 144.95102555"
271820250601,27,2025-06-01,18,100,62,162,Vic_T,"-37.80606888, 144.95644692"
301120241029,30,2024-10-29,11,192,250,442,Lon189_T,"-37.8112185, 144.96656806"
79820241230,79,2024-12-30,8,230,100,330,FliSS_T,"-37.81794046, 144.96616678"
117120241011,117,2024-10-11,1,8,5,13,Fli114F_T,"-37.81629332, 144.97090877"
49120240320,49,2024-03-20,1,40,34,74,Eli501_T,"-37.80730068, 144.95956055"
1091920240208,109,2024-02-08,19,147,73,220,LatWill_T,"-37.81193681, 144.95621105"
109820240707,109,2024-07-07,8,26,24,50,LatWill_T,"-37.81193681, 144.95621105"
109020250426,109,2025-04-26,0,22,12,34,LatWill_T,"-37.81193681, 144.95621105"
66220251006,66,2025-10-06,2,9,13,22,QVN_T,"-37.81057846, 144.96444294"
6120240812,6,2024-08-12,1,24,8,32,FliS_T,"-37.81911705, 144.96558255"
84120240404,84,2024-04-04,1,27,38,65,ElFi_T,"-37.81798049, 144.96503383"
41620240304,4,2024-03-04,16,1570,1372,2942,Swa123_T,"-37.81487988, 144.9660878"
751520250111,75,2025-01-11,15,34,44,78,SprFli_T,"-37.81515276, 144.97467661"
77620250819,77,2025-08-19,6,33,51,84,HarEsP_T,"-37.81441438, 144.94433026"
29120241007,29,2024-10-07,1,1,12,13,AG_T,"-37.8199817, 144.96872865"
591720250207,59,2025-02-07,17,277,272,549,RMIT_T,"-37.80825648, 144.96304859"
311820241001,31,2024-10-01,18,241,151,392,Lyg161_T,"-37.80169681, 144.96658911"
541420241001,54,2024-10-01,14,233,157,390,Swa607_T,"-37.804024, 144.96308399"
43820241118,43,2024-11-18,8,99,42,141,UM2_T,"-37.79844526, 144.96411782"
43320250818,43,2025-08-18,3,2,1,3,UM2_T,"-37.79844526, 144.96411782"
45320241205,45,2024-12-05,3,4,7,11,Swa148_T,"-37.81414075, 144.96609379"
452020241227,45,2024-12-27,20,507,788,1295,Swa148_T,"-37.81414075, 144.96609379"
135620240420,135,2024-04-20,6,28,41,69,Spen161_T,"-37.8172861, 144.95319102"
1351720240713,135,2024-07-13,17,338,312,650,Spen161_T,"-37.8172861, 144.95319102"
1351520240109,135,2024-01-09,15,399,433,832,Spen161_T,"-37.8172861, 144.95319102"
1332020231029,133,2023-10-29,20,321,292,613,Spen229_T,"-37.81531435, 144.95227769"
108720250610,108,2025-06-10,7,71,807,878,261Will_T,"-37.81295822, 144.95678789"
1081920250502,108,2025-05-02,19,250,176,426,261Will_T,"-37.81295822, 144.95678789"
872220240925,87,2024-09-25,22,21,9,30,Errol23_T,"-37.80454949, 144.94921863"
872120241208,87,2024-12-08,21,8,25,33,Errol23_T,"-37.80454949, 144.94921863"
1661520250707,166,2025-07-07,15,53,63,116,Spen484_T,"-37.80896733, 144.94931703"
179520251008,179,2025-10-08,5,8,1,9,Pow61_T,"-37.82392385, 144.96299677"
1672020250830,167,2025-08-30,20,9,31,40,Lat526_T,"-37.81304149, 144.95155955"
140920250518,140,2025-05-18,9,87,43,130,Boyd2837_T,"-37.82590962, 144.96185972"
1401620231209,140,2023-12-09,16,23,34,57,Boyd2837_T,"-37.82590962, 144.96185972"
143920240429,143,2024-04-29,9,111,237,348,Spencer_T,"-37.821728, 144.95557015"
1920240226,1,2024-02-26,9,293,354,647,Bou292_T,"-37.81349441, 144.96515323"
11020240721,11,2024-07-21,0,13,9,22,WatCit_T,"-37.81564989, 144.93970694"
62120250413,62,2025-04-13,1,105,53,158,Lat224_T,"-37.80996494, 144.96216521"
58220241230,58,2024-12-30,2,12,30,42,Bou688_T,"-37.81686075, 144.95358075"
272120240601,27,2024-06-01,21,66,73,139,Vic_T,"-37.80606888, 144.95644692"
581520250427,58,2025-04-27,15,550,496,1046,Bou688_T,"-37.81686075, 144.95358075"
301620240420,30,2024-04-20,16,394,548,942,Lon189_T,"-37.8112185, 144.96656806"
30220240510,30,2024-05-10,2,32,34,66,Lon189_T,"-37.8112185, 144.96656806"
511720250216,51,2025-02-16,17,92,82,174,Fra118_T,"-37.80841815, 144.95906316"
19420250504,19,2025-05-04,4,26,49,75,LtB210_T,"-37.81237202, 144.96550671"
20520241215,20,2024-12-15,5,35,28,63,LtB170_T,"-37.81172914, 144.9682466"
20320231105,20,2023-11-05,3,92,119,211,LtB170_T,"-37.81172914, 144.9682466"
25820240130,25,2024-01-30,8,251,360,611,MCEC_T,"-37.82401776, 144.95604426"
1642020250114,164,2025-01-14,20,54,102,156,Lat526_T,"-37.813005, 144.95160411"
141220240709,141,2024-07-09,2,2,5,7,474Fl_T,"-37.81997273, 144.95834911"
1392020250609,139,2025-06-09,20,15,13,28,Signal1647_T,"-37.81959923, 144.9632832"
1391520240901,139,2024-09-01,15,24,24,48,Signal1647_T,"-37.81959923, 144.9632832"
1301020240127,130,2024-01-27,10,33,22,55,Bou892T,"-37.8204637, 144.94126826"
691220250107,69,2025-01-07,12,425,383,808,FLDegC_T,"-37.81687226, 144.96559144"
751220250102,75,2025-01-02,12,46,40,86,SprFli_T,"-37.81515276, 144.97467661"
31520250529,3,2025-05-29,15,909,919,1828,Swa295_T,"-37.81101524, 144.96429485"
391520250709,39,2025-07-09,15,64,75,139,AlfPl_T,"-37.81379749, 144.96995745"
712220250928,71,2025-09-28,22,4,2,6,WestWP_T,"-37.81235775, 144.97136962"
591120250919,59,2025-09-19,11,821,766,1587,RMIT_T,"-37.80825648, 144.96304859"
59620241031,59,2024-10-31,6,48,46,94,RMIT_T,"-37.80825648, 144.96304859"
652320240115,65,2024-01-15,23,201,98,299,SwaCs_T,"-37.81569416, 144.9668064"
42520240922,42,2024-09-22,5,3,2,5,UM1_T,"-37.80008566, 144.96386412"
312020240324,31,2024-03-24,20,468,442,910,Lyg161_T,"-37.80169681, 144.96658911"
311520241210,31,2024-12-10,15,143,126,269,Lyg161_T,"-37.80169681, 144.96658911"
47720240913,47,2024-09-13,7,135,252,387,Eli250_T,"-37.81258467, 144.9625775"
612320240309,61,2024-03-09,23,146,90,236,RMIT14_T,"-37.80767455, 144.96309114"
502020250928,50,2025-09-28,20,192,99,291,Lyg309_T,"-37.79808192, 144.96721013"
502320240912,50,2024-09-12,23,33,11,44,Lyg309_T,"-37.79808192, 144.96721013"
452220240319,45,2024-03-19,22,137,268,405,Swa148_T,"-37.81414075, 144.96609379"
45220240507,45,2024-05-07,2,9,3,12,Swa148_T,"-37.81414075, 144.96609379"
361620250424,36,2025-04-24,16,184,212,396,Que85_T,"-37.81652527, 144.96121062"
1431520240725,143,2024-07-25,15,267,185,452,Spencer_T,"-37.821728, 144.95557015"
1401120250209,140,2025-02-09,11,128,62,190,Boyd2837_T,"-37.82590962, 144.96185972"
140820250214,140,2025-02-14,8,178,33,211,Boyd2837_T,"-37.82590962, 144.96185972"
1341320240705,134,2024-07-05,13,443,354,797,Spen201_T,"-37.81694221, 144.95303935"
131320250714,131,2025-07-14,3,10,11,21,King2_T,"-37.82009057, 144.95758725"
133120250625,133,2025-06-25,1,24,8,32,Spen229_T,"-37.81531435, 144.95227769"
1331120240110,133,2024-01-10,11,462,448,910,Spen229_T,"-37.81531435, 144.95227769"
1241120250413,124,2025-04-13,11,1,3,4,BirBridge_T,"-37.81757416, 144.97329934"
1241820231122,124,2023-11-22,18,0,4,4,BirBridge_T,"-37.81757416, 144.97329934"
1072320240430,107,2024-04-30,23,20,20,40,280Will_T,"-37.81246271, 144.95690188"
107720241006,107,2024-10-06,7,21,18,39,280Will_T,"-37.81246271, 144.95690188"
1081420231229,108,2023-12-29,14,163,140,303,261Will_T,"-37.81295822, 144.95678789"
1652220250305,165,2025-03-05,22,23,14,37,Spen475_T,"-37.80953359, 144.94939004"
1662320250730,166,2025-07-30,23,3,2,5,Spen484_T,"-37.80896733, 144.94931703"
1821820250920,182,2025-09-20,18,303,248,551,King163_T,"-37.81627451, 144.95550503"
23520250127,23,2025-01-27,5,3,19,22,Col623_T,"-37.81909256, 144.95452748"
231220240615,23,2024-06-15,12,240,278,518,Col623_T,"-37.81909256, 144.95452748"
25220240401,25,2024-04-01,2,12,30,42,MCEC_T,"-37.82401776, 144.95604426"
251820250308,25,2025-03-08,18,1104,378,1482,MCEC_T,"-37.82401776, 144.95604426"
521420250616,52,2025-06-16,14,414,287,701,Eli263_T,"-37.81252157, 144.9619401"
462220250716,46,2025-07-16,22,1,0,1,Pel147_T,"-37.80240719, 144.9615673"
461120231025,46,2023-10-25,11,58,104,162,Pel147_T,"-37.80240719, 144.9615673"
141420241003,141,2024-10-03,4,6,3,9,474Fl_T,"-37.81997273, 144.95834911"
141020231130,141,2023-11-30,0,27,25,52,474Fl_T,"-37.81997273, 144.95834911"
1371420250921,137,2025-09-21,14,17,15,32,BouHbr2353_T,"-37.81894815, 144.94612292"
1361920250219,136,2025-02-19,19,61,31,92,BirFed1120_T,"-37.8184141, 144.97357915"
117920240106,117,2024-01-06,9,64,84,148,Fli114F_T,"-37.81629332, 144.97090877"
191720240629,19,2024-06-29,17,916,417,1333,LtB210_T,"-37.81237202, 144.96550671"
662220250306,66,2025-03-06,22,534,456,990,QVN_T,"-37.81057846, 144.96444294"
70720231210,70,2023-12-10,7,5,10,15,Errol20_T,"-37.80456984, 144.94946228"
702220250611,70,2025-06-11,22,68,49,117,Errol20_T,"-37.80456984, 144.94946228"
81620250707,8,2025-07-07,16,242,409,651,WebBN_T,"-37.82293543, 144.9471751"
81020231025,8,2023-10-25,10,103,133,236,WebBN_T,"-37.82293543, 144.9471751"
75620240107,75,2024-01-07,6,6,6,12,SprFli_T,"-37.81515276, 144.97467661"
781720250427,78,2025-04-27,17,17,37,54,HarEsB_T,"-37.81471642, 144.9446508"
782020250716,78,2025-07-16,20,10,23,33,HarEsB_T,"-37.81471642, 144.9446508"
29020241207,29,2024-12-07,0,59,97,156,AG_T,"-37.8199817, 144.96872865"
29220240207,29,2024-02-07,2,2,14,16,AG_T,"-37.8199817, 144.96872865"
591620241217,59,2024-12-17,16,251,448,699,RMIT_T,"-37.80825648, 144.96304859"
311820240725,31,2024-07-25,18,201,135,336,Lyg161_T,"-37.80169681, 144.96658911"
21820240326,21,2024-03-26,8,135,187,322,Bourke155_T,"-37.81267313, 144.96788288"
361020240421,36,2024-04-21,10,61,79,140,Que85_T,"-37.81652527, 144.96121062"
371020231215,37,2023-12-15,10,71,72,143,Lyg260_T,"-37.80107122, 144.96704554"
44720240909,44,2024-09-09,7,21,19,40,UM3_T,"-37.79698741, 144.96441306"
441820250108,44,2025-01-08,18,41,72,113,UM3_T,"-37.79698741, 144.96441306"
45820250121,45,2025-01-21,8,294,349,643,Swa148_T,"-37.81414075, 144.96609379"
5920250405,5,2025-04-05,9,307,726,1033,PriNW_T,"-37.81874249, 144.96787656"
1341620240807,134,2024-08-07,16,513,536,1049,Spen201_T,"-37.81694221, 144.95303935"
1331620241213,133,2024-12-13,16,607,651,1258,Spen229_T,"-37.81531435, 144.95227769"
1181420240317,118,2024-03-17,14,25,18,43,Fli114C_T,"-37.81632783, 144.97090512"
871520240801,87,2024-08-01,15,98,150,248,Errol23_T,"-37.80454949, 144.94921863"
185420250807,185,2025-08-07,4,18,21,39,Eli197_T,"-37.81374643, 144.96276183"
166620250725,166,2025-07-25,6,2,5,7,Spen484_T,"-37.80896733, 144.94931703"
166020251013,166,2025-10-13,0,0,2,2,Spen484_T,"-37.80896733, 144.94931703"
167620250319,167,2025-03-19,6,5,16,21,Lat526_T,"-37.81304149, 144.95155955"
1311620250826,131,2025-08-26,16,80,101,181,King2_T,"-37.82009057, 144.95758725"
1431820241003,143,2024-10-03,18,263,329,592,Spencer_T,"-37.821728, 144.95557015"
139620240226,139,2024-02-26,6,3,22,25,Signal1647_T,"-37.81959923, 144.9632832"
1301820250305,130,2025-03-05,18,54,50,104,Bou892T,"-37.8204637, 144.94126826"
1612320241028,161,2024-10-28,23,0,1,1,BirArt1109_T,"-37.81851276, 144.97131336"
1381720240925,138,2024-09-25,17,12,1,13,EntPark1671_T,"-37.81996544, 144.95981454"
117120250118,117,2025-01-18,1,53,49,102,Fli114F_T,"-37.81629332, 144.97090877"
117620231203,117,2023-12-03,6,18,8,26,Fli114F_T,"-37.81629332, 144.97090877"
1171720240505,117,2024-05-05,17,182,98,280,Fli114F_T,"-37.81629332, 144.97090877"
1091720250430,109,2025-04-30,17,572,180,752,LatWill_T,"-37.81193681, 144.95621105"
109620250623,109,2025-06-23,6,11,76,87,LatWill_T,"-37.81193681, 144.95621105"
671820250913,67,2025-09-13,18,388,432,820,FLDegS_T,"-37.81688755, 144.96562569"
681220240520,68,2024-05-20,12,303,212,515,FLDegN_T,"-37.8168479, 144.96559789"
671420231217,67,2023-12-17,14,372,520,892,FLDegS_T,"-37.81688755, 144.96562569"
851820250623,85,2025-06-23,18,50,77,127,488Mac_T,"-37.79432415, 144.92973378"
17620250224,17,2025-02-24,6,113,34,147,Col15_T,"-37.81362543, 144.97323591"
181520240417,18,2024-04-17,15,312,149,461,Col12_T,"-37.81344862, 144.97305353"
18220250628,18,2025-06-28,2,0,5,5,Col12_T,"-37.81344862, 144.97305353"
632220231212,63,2023-12-12,22,97,285,382,Bou231_T,"-37.81333081, 144.96675571"
1620250914,1,2025-09-14,6,16,15,31,Bou292_T,"-37.81349441, 144.96515323"
621120240831,62,2024-08-31,11,161,142,303,Lat224_T,"-37.80996494, 144.96216521"
561020240218,56,2024-02-18,10,350,177,527,Lon364_T,"-37.81234775, 144.96153311"
561720240625,56,2024-06-25,17,420,420,840,Lon364_T,"-37.81234775, 144.96153311"
12720231027,12,2023-10-27,7,104,95,199,NewQ_T,"-37.81457988, 144.94292398"
761120240510,76,2024-05-10,11,72,96,168,KenMac_T,"-37.79453803, 144.93036194"
91220250808,9,2025-08-08,12,565,442,1007,Col700_T,"-37.81982992, 144.95102555"
91520241209,9,2024-12-09,15,831,145,976,Col700_T,"-37.81982992, 144.95102555"
791220241109,79,2024-11-09,12,590,436,1026,FliSS_T,"-37.81794046, 144.96616678"
30520240208,30,2024-02-08,5,10,16,26,Lon189_T,"-37.8112185, 144.96656806"
79520240127,79,2024-01-27,5,30,34,64,FliSS_T,"-37.81794046, 144.96616678"
231020241113,23,2024-11-13,10,239,250,489,Col623_T,"-37.81909256, 144.95452748"
511720241210,51,2024-12-10,17,110,99,209,Fra118_T,"-37.80841815, 144.95906316"
481020240119,48,2024-01-19,10,204,223,427,QVMQ_T,"-37.80631581, 144.95866697"
522220240825,52,2024-08-25,22,71,82,153,Eli263_T,"-37.81252157, 144.9619401"
521120231020,52,2023-10-20,11,341,206,547,Eli263_T,"-37.81252157, 144.9619401"
1371920240929,137,2024-09-29,19,2,0,2,BouHbr2353_T,"-37.81894815, 144.94612292"
1411320240223,141,2024-02-23,13,184,203,387,474Fl_T,"-37.81997273, 144.95834911"
139420250116,139,2025-01-16,4,1,1,2,Signal1647_T,"-37.81959923, 144.9632832"
142420231229,142,2023-12-29,4,3,5,8,Hammer1584_T,"-37.81970749, 144.96795734"
130920250212,130,2025-02-12,9,38,26,64,Bou892T,"-37.8204637, 144.94126826"
1231120240518,123,2024-05-18,11,22,7,29,BirBridge_T,"-37.81753741, 144.97329734"
49320241013,49,2024-10-13,3,36,40,76,Eli501_T,"-37.80730068, 144.95956055"
49620240521,49,2024-05-21,6,43,51,94,Eli501_T,"-37.80730068, 144.95956055"
1091220240308,109,2024-03-08,12,199,172,371,LatWill_T,"-37.81193681, 144.95621105"
1091720240405,109,2024-04-05,17,349,170,519,LatWill_T,"-37.81193681, 144.95621105"
661020250906,66,2025-09-06,10,423,461,884,QVN_T,"-37.81057846, 144.96444294"
66420240930,66,2024-09-30,4,11,15,26,QVN_T,"-37.81057846, 144.96444294"
61220240516,6,2024-05-16,12,809,749,1558,FliS_T,"-37.81911705, 144.96558255"
391820240907,39,2024-09-07,18,15,8,23,AlfPl_T,"-37.81379749, 144.96995745"
41320231112,41,2023-11-12,3,107,260,367,Swa31,"-37.81668634, 144.96689733"
411220240602,41,2024-06-02,12,1900,1010,2910,Swa31,"-37.81668634, 144.96689733"
29520250207,29,2025-02-07,5,6,15,21,AG_T,"-37.8199817, 144.96872865"
541920250904,54,2025-09-04,19,147,200,347,Swa607_T,"-37.804024, 144.96308399"
54620241115,54,2024-11-15,6,13,5,18,Swa607_T,"-37.804024, 144.96308399"
37220250123,37,2025-01-23,2,4,0,4,Lyg260_T,"-37.80107122, 144.96704554"
37320250407,37,2025-04-07,3,0,1,1,Lyg260_T,"-37.80107122, 144.96704554"
502220240428,50,2024-04-28,22,47,41,88,Lyg309_T,"-37.79808192, 144.96721013"
44020250209,44,2025-02-09,0,2,1,3,UM3_T,"-37.79698741, 144.96441306"
441120250730,44,2025-07-30,11,106,143,249,UM3_T,"-37.79698741, 144.96441306"
431820250309,43,2025-03-09,18,70,28,98,UM2_T,"-37.79844526, 144.96411782"
451120240523,45,2024-05-23,11,397,416,813,Swa148_T,"-37.81414075, 144.96609379"
45320250227,45,2025-02-27,3,5,13,18,Swa148_T,"-37.81414075, 144.96609379"
461820240311,46,2024-03-11,18,144,96,240,Pel147_T,"-37.80240719, 144.9615673"
51420240502,51,2024-05-02,4,1,0,1,Fra118_T,"-37.80841815, 144.95906316"
252220250618,25,2025-06-18,22,121,104,225,MCEC_T,"-37.82401776, 144.95604426"
191520250208,19,2025-02-08,15,659,566,1225,LtB210_T,"-37.81237202, 144.96550671"
19420240422,19,2024-04-22,4,1,0,1,LtB210_T,"-37.81237202, 144.96550671"
481020250228,48,2025-02-28,10,324,243,567,QVMQ_T,"-37.80631581, 144.95866697"
48820250530,48,2025-05-30,8,145,93,238,QVMQ_T,"-37.80631581, 144.95866697"
482320240624,48,2024-06-24,23,26,15,41,QVMQ_T,"-37.80631581, 144.95866697"
481420240815,48,2024-08-15,14,350,204,554,QVMQ_T,"-37.80631581, 144.95866697"
201520240830,20,2024-08-30,15,169,221,390,LtB170_T,"-37.81172914, 144.9682466"
201020240225,20,2024-02-25,10,140,118,258,LtB170_T,"-37.81172914, 144.9682466"
49020250714,49,2025-07-14,0,58,40,98,Eli501_T,"-37.80730068, 144.95956055"
1372120250918,137,2025-09-18,21,5,4,9,BouHbr2353_T,"-37.81894815, 144.94612292"
136620241225,136,2024-12-25,6,14,22,36,BirFed1120_T,"-37.8184141, 144.97357915"
1641220250316,164,2025-03-16,12,31,12,43,Lat526_T,"-37.813005, 144.95160411"
117120240301,117,2024-03-01,1,21,15,36,Fli114F_T,"-37.81629332, 144.97090877"
1091020250224,109,2025-02-24,10,101,144,245,LatWill_T,"-37.81193681, 144.95621105"
109420240823,109,2024-08-23,4,2,3,5,LatWill_T,"-37.81193681, 144.95621105"
661520240618,66,2024-06-18,15,1082,1131,2213,QVN_T,"-37.81057846, 144.96444294"
692120250316,69,2025-03-16,21,66,42,108,FLDegC_T,"-37.81687226, 144.96559144"
61220240330,6,2024-03-30,12,893,910,1803,FliS_T,"-37.81911705, 144.96558255"
61720240720,6,2024-07-20,17,678,781,1459,FliS_T,"-37.81911705, 144.96558255"
842020231022,84,2023-10-22,20,378,550,928,ElFi_T,"-37.81798049, 144.96503383"
41820240204,4,2024-02-04,18,881,779,1660,Swa123_T,"-37.81487988, 144.9660878"
84020250227,84,2025-02-27,0,118,90,208,ElFi_T,"-37.81798049, 144.96503383"
84320250624,84,2025-06-24,3,13,15,28,ElFi_T,"-37.81798049, 144.96503383"
4220250901,4,2025-09-01,2,20,11,31,Swa123_T,"-37.81487988, 144.9660878"
8220240407,8,2024-04-07,2,5,4,9,WebBN_T,"-37.82293543, 144.9471751"
411020240822,41,2024-08-22,10,200,247,447,Swa31,"-37.81668634, 144.96689733"
78720240328,78,2024-03-28,7,30,11,41,HarEsB_T,"-37.81471642, 144.9446508"
772320250117,77,2025-01-17,23,72,31,103,HarEsP_T,"-37.81441438, 144.94433026"
771120250906,77,2025-09-06,11,190,165,355,HarEsP_T,"-37.81441438, 144.94433026"
291620250804,29,2025-08-04,16,168,229,397,AG_T,"-37.8199817, 144.96872865"
282220240620,28,2024-06-20,22,60,73,133,VAC_T,"-37.82129925, 144.96879309"
29820250415,29,2025-04-15,8,206,131,337,AG_T,"-37.8199817, 144.96872865"
14620231221,14,2023-12-21,6,82,95,177,SanBri_T,"-37.82011242, 144.96291897"
472320231023,47,2023-10-23,23,119,123,242,Eli250_T,"-37.81258467, 144.9625775"
21720250531,21,2025-05-31,7,14,7,21,Bourke155_T,"-37.81267313, 144.96788288"
36920250820,36,2025-08-20,9,238,165,403,Que85_T,"-37.81652527, 144.96121062"
361820240521,36,2024-05-21,18,222,187,409,Que85_T,"-37.81652527, 144.96121062"
1082020231021,108,2023-10-21,20,95,96,191,261Will_T,"-37.81295822, 144.95678789"
44420240330,44,2024-03-30,4,1,0,1,UM3_T,"-37.79698741, 144.96441306"
184520250717,184,2025-07-17,5,29,42,71,Eli124_T,"-37.81512416, 144.96371988"
1652020250103,165,2025-01-03,20,53,29,82,Spen475_T,"-37.80953359, 144.94939004"
166120250831,166,2025-08-31,1,8,2,10,Spen484_T,"-37.80896733, 144.94931703"
1672320240817,167,2024-08-17,23,0,4,4,Lat526_T,"-37.81304149, 144.95155955"
1312320231113,131,2023-11-13,23,35,12,47,King2_T,"-37.82009057, 144.95758725"
1321720250321,132,2025-03-21,17,197,165,362,King335_T,"-37.81267639, 144.95386444"
134020250919,134,2025-09-19,0,52,88,140,Spen201_T,"-37.81694221, 144.95303935"
1342320231219,134,2023-12-19,23,85,111,196,Spen201_T,"-37.81694221, 144.95303935"
135620231123,135,2023-11-23,6,114,144,258,Spen161_T,"-37.8172861, 144.95319102"
1351720240302,135,2024-03-02,17,432,455,887,Spen161_T,"-37.8172861, 144.95319102"
861720250821,86,2025-08-21,17,59,80,139,574Qub_T,"-37.80309992, 144.94908064"
56520240311,56,2024-03-11,5,10,5,15,Lon364_T,"-37.81234775, 144.96153311"
56420240905,56,2024-09-05,4,9,5,14,Lon364_T,"-37.81234775, 144.96153311"
24220240531,24,2024-05-31,2,19,31,50,Col620_T,"-37.81887963, 144.95449198"
111520250905,11,2025-09-05,15,71,86,157,WatCit_T,"-37.81564989, 144.93970694"
11420231216,11,2023-12-16,4,0,1,1,WatCit_T,"-37.81564989, 144.93970694"
10020241124,10,2024-11-24,0,17,10,27,BouHbr_T,"-37.81876474, 144.94710545"
2720240526,2,2024-05-26,7,6,21,27,Bou283_T,"-37.81380668, 144.96516718"
58520240929,58,2024-09-29,5,19,18,37,Bou688_T,"-37.81686075, 144.95358075"
56720250922,56,2025-09-22,7,79,62,141,Lon364_T,"-37.81234775, 144.96153311"
761120250812,76,2025-08-12,11,53,43,96,KenMac_T,"-37.79453803, 144.93036194"
35320240610,35,2024-06-10,3,23,48,71,SouthB_T,"-37.82018685, 144.96508508"
761720240731,76,2024-07-31,17,71,89,160,KenMac_T,"-37.79453803, 144.93036194"
582220250706,58,2025-07-06,22,241,201,442,Bou688_T,"-37.81686075, 144.95358075"
22020250103,2,2025-01-03,20,402,357,759,Bou283_T,"-37.81380668, 144.96516718"
79220250522,79,2025-05-22,2,7,9,16,FliSS_T,"-37.81794046, 144.96616678"
30120240223,30,2024-02-23,1,128,89,217,Lon189_T,"-37.8112185, 144.96656806"
511420240927,51,2024-09-27,14,121,123,244,Fra118_T,"-37.80841815, 144.95906316"
481820250417,48,2025-04-17,18,142,165,307,QVMQ_T,"-37.80631581, 144.95866697"
482120231222,48,2023-12-22,21,128,128,256,QVMQ_T,"-37.80631581, 144.95866697"
252020250421,25,2025-04-21,20,68,114,182,MCEC_T,"-37.82401776, 144.95604426"
1801320250918,180,2025-09-18,13,26,33,59,Mac330_T,"-37.79497059, 144.93530329"
701820240825,70,2024-08-25,18,89,121,210,Errol20_T,"-37.80456984, 144.94946228"
70020250604,70,2025-06-04,0,2,2,4,Errol20_T,"-37.80456984, 144.94946228"
751420250502,75,2025-05-02,14,49,48,97,SprFli_T,"-37.81515276, 144.97467661"
75920231128,75,2023-11-28,9,43,38,81,SprFli_T,"-37.81515276, 144.97467661"
781720250218,78,2025-02-18,17,38,343,381,HarEsB_T,"-37.81471642, 144.9446508"
421220250929,42,2025-09-29,12,131,167,298,UM1_T,"-37.80008566, 144.96386412"
592020250428,59,2025-04-28,20,200,485,685,RMIT_T,"-37.80825648, 144.96304859"
71920250215,71,2025-02-15,9,3,3,6,WestWP_T,"-37.81235775, 144.97136962"
311720250905,31,2025-09-05,17,166,120,286,Lyg161_T,"-37.80169681, 144.96658911"
211720250328,21,2025-03-28,17,473,454,927,Bourke155_T,"-37.81267313, 144.96788288"
212120250701,21,2025-07-01,21,157,204,361,Bourke155_T,"-37.81267313, 144.96788288"
431720240803,43,2024-08-03,17,60,111,171,UM2_T,"-37.79844526, 144.96411782"
431320241109,43,2024-11-09,13,67,64,131,UM2_T,"-37.79844526, 144.96411782"
44620231026,44,2023-10-26,6,12,1,13,UM3_T,"-37.79698741, 144.96441306"
432220231106,43,2023-11-06,22,31,51,82,UM2_T,"-37.79844526, 144.96411782"
451220240910,45,2024-09-10,12,1053,1029,2082,Swa148_T,"-37.81414075, 144.96609379"
5220250821,5,2025-08-21,2,18,21,39,PriNW_T,"-37.81874249, 144.96787656"
451720231121,45,2023-11-21,17,654,845,1499,Swa148_T,"-37.81414075, 144.96609379"
52320250326,5,2025-03-26,23,83,136,219,PriNW_T,"-37.81874249, 144.96787656"
1352120240811,135,2024-08-11,21,78,154,232,Spen161_T,"-37.8172861, 144.95319102"
131620240615,131,2024-06-15,6,5,15,20,King2_T,"-37.82009057, 144.95758725"
107720251016,107,2025-10-16,7,41,99,140,280Will_T,"-37.81246271, 144.95690188"
611620240630,61,2024-06-30,16,268,345,613,RMIT14_T,"-37.80767455, 144.96309114"
1661720250808,166,2025-08-08,17,101,84,185,Spen484_T,"-37.80896733, 144.94931703"
166620251001,166,2025-10-01,6,3,10,13,Spen484_T,"-37.80896733, 144.94931703"
179820250916,179,2025-09-16,8,74,20,94,Pow61_T,"-37.82392385, 144.96299677"
182020250813,182,2025-08-13,0,28,26,54,King163_T,"-37.81627451, 144.95550503"
143420250424,143,2025-04-24,4,16,6,22,Spencer_T,"-37.821728, 144.95557015"
134420250214,134,2025-02-14,4,20,22,42,Spen201_T,"-37.81694221, 144.95303935"
1341020250112,134,2025-01-12,10,297,442,739,Spen201_T,"-37.81694221, 144.95303935"
1312120240503,131,2024-05-03,21,99,74,173,King2_T,"-37.82009057, 144.95758725"
131920250808,131,2025-08-08,9,89,121,210,King2_T,"-37.82009057, 144.95758725"
1181120240630,118,2024-06-30,11,9,17,26,Fli114C_T,"-37.81632783, 144.97090512"
871920240222,87,2024-02-22,19,102,75,177,Errol23_T,"-37.80454949, 144.94921863"
61920240821,61,2024-08-21,9,392,360,752,RMIT14_T,"-37.80767455, 144.96309114"
611020241204,61,2024-12-04,10,231,519,750,RMIT14_T,"-37.80767455, 144.96309114"
179320250801,179,2025-08-01,3,1,1,2,Pow61_T,"-37.82392385, 144.96299677"
1651320250522,165,2025-05-22,13,41,36,77,Spen475_T,"-37.80953359, 144.94939004"
1671320240908,167,2024-09-08,13,25,60,85,Lat526_T,"-37.81304149, 144.95155955"
671920231026,67,2023-10-26,19,240,350,590,FLDegS_T,"-37.81688755, 144.96562569"
171320250102,17,2025-01-02,13,232,215,447,Col15_T,"-37.81362543, 144.97323591"
621920240216,62,2024-02-16,19,279,165,444,Lat224_T,"-37.80996494, 144.96216521"
11820231222,11,2023-12-22,8,46,61,107,WatCit_T,"-37.81564989, 144.93970694"
121820250724,12,2025-07-24,18,82,109,191,NewQ_T,"-37.81457988, 144.94292398"
122220250930,12,2025-09-30,22,20,19,39,NewQ_T,"-37.81457988, 144.94292398"
101520241025,10,2024-10-25,15,108,51,159,BouHbr_T,"-37.81876474, 144.94710545"
241020250425,24,2025-04-25,10,619,324,943,Col620_T,"-37.81887963, 144.95449198"
76720240211,76,2024-02-11,7,13,5,18,KenMac_T,"-37.79453803, 144.93036194"
722320250423,72,2025-04-23,23,17,54,71,ACMI_T,"-37.81726338, 144.96872809"
582020241018,58,2024-10-18,20,237,219,456,Bou688_T,"-37.81686075, 144.95358075"
76320240429,76,2024-04-29,3,1,0,1,KenMac_T,"-37.79453803, 144.93036194"
271920240616,27,2024-06-16,19,64,53,117,Vic_T,"-37.80606888, 144.95644692"
271720240812,27,2024-08-12,17,102,103,205,Vic_T,"-37.80606888, 144.95644692"
91820240208,9,2024-02-08,18,983,124,1107,Col700_T,"-37.81982992, 144.95102555"
91620250508,9,2025-05-08,16,2432,173,2605,Col700_T,"-37.81982992, 144.95102555"
30620250728,30,2025-07-28,6,7,22,29,Lon189_T,"-37.8112185, 144.96656806"
301720241025,30,2024-10-25,17,348,384,732,Lon189_T,"-37.8112185, 144.96656806"
23020241003,23,2024-10-03,0,12,19,31,Col623_T,"-37.81909256, 144.95452748"
482020250601,48,2025-06-01,20,45,63,108,QVMQ_T,"-37.80631581, 144.95866697"
1361620250727,136,2025-07-27,16,45,1261,1306,BirFed1120_T,"-37.8184141, 144.97357915"
1611920251004,161,2025-10-04,19,7,28,35,BirArt1109_T,"-37.81851276, 144.97131336"
1232020240512,123,2024-05-12,20,2,0,2,BirBridge_T,"-37.81753741, 144.97329734"
491620241124,49,2024-11-24,16,162,335,497,Eli501_T,"-37.80730068, 144.95956055"
109220250722,109,2025-07-22,2,4,3,7,LatWill_T,"-37.81193681, 144.95621105"
491020251015,49,2025-10-15,10,228,285,513,Eli501_T,"-37.80730068, 144.95956055"
66220240913,66,2024-09-13,2,25,13,38,QVN_T,"-37.81057846, 144.96444294"
691920240222,69,2024-02-22,19,34,35,69,FLDegC_T,"-37.81687226, 144.96559144"
61420240609,6,2024-06-09,14,908,935,1843,FliS_T,"-37.81911705, 144.96558255"
84320241112,84,2024-11-12,3,16,9,25,ElFi_T,"-37.81798049, 144.96503383"
84620250701,84,2025-07-01,6,242,76,318,ElFi_T,"-37.81798049, 144.96503383"
4720250515,4,2025-05-15,7,214,162,376,Swa123_T,"-37.81487988, 144.9660878"
3520250331,3,2025-03-31,5,20,29,49,Swa295_T,"-37.81101524, 144.96429485"
8120240724,8,2024-07-24,1,2,1,3,WebBN_T,"-37.82293543, 144.9471751"
132120241230,132,2024-12-30,1,25,7,32,King335_T,"-37.81267639, 144.95386444"
672220231229,67,2023-12-29,22,157,247,404,FLDegS_T,"-37.81688755, 144.96562569"
852320240220,85,2024-02-20,23,1,1,2,488Mac_T,"-37.79432415, 144.92973378"
1020231116,1,2023-11-16,0,39,41,80,Bou292_T,"-37.81349441, 144.96515323"
11620231223,1,2023-12-23,16,1671,2311,3982,Bou292_T,"-37.81349441, 144.96515323"
68220231108,68,2023-11-08,2,1,0,1,FLDegN_T,"-37.8168479, 144.96559789"
862120240323,86,2024-03-23,21,11,45,56,574Qub_T,"-37.80309992, 144.94908064"
86920240328,86,2024-03-28,9,46,42,88,574Qub_T,"-37.80309992, 144.94908064"
62020250626,62,2025-06-26,0,53,46,99,Lat224_T,"-37.80996494, 144.96216521"
122120240328,12,2024-03-28,21,162,128,290,NewQ_T,"-37.81457988, 144.94292398"
12420240111,12,2024-01-11,4,3,3,6,NewQ_T,"-37.81457988, 144.94292398"
72920241217,72,2024-12-17,9,409,179,588,ACMI_T,"-37.81726338, 144.96872809"
722020250220,72,2025-02-20,20,114,262,376,ACMI_T,"-37.81726338, 144.96872809"
352020240508,35,2024-05-08,20,511,771,1282,SouthB_T,"-37.82018685, 144.96508508"
351720251004,35,2025-10-04,17,1996,2238,4234,SouthB_T,"-37.82018685, 144.96508508"
27420250617,27,2025-06-17,4,3,5,8,Vic_T,"-37.80606888, 144.95644692"
9420250129,9,2025-01-29,4,5,1,6,Col700_T,"-37.81982992, 144.95102555"
9920231110,9,2023-11-10,9,124,768,892,Col700_T,"-37.81982992, 144.95102555"
92120250416,9,2025-04-16,21,66,56,122,Col700_T,"-37.81982992, 144.95102555"
79720240924,79,2024-09-24,7,290,153,443,FliSS_T,"-37.81794046, 144.96616678"
531420250918,53,2025-09-18,14,681,585,1266,Col254_T,"-37.81564191, 144.965499"
512120231228,51,2023-12-28,21,68,50,118,Fra118_T,"-37.80841815, 144.95906316"
191220240310,19,2024-03-10,12,626,613,1239,LtB210_T,"-37.81237202, 144.96550671"
139020240812,139,2024-08-12,0,3,6,9,Signal1647_T,"-37.81959923, 144.9632832"
164220250913,164,2025-09-13,2,0,2,2,Lat526_T,"-37.813005, 144.95160411"
69320240410,69,2024-04-10,3,3,3,6,FLDegC_T,"-37.81687226, 144.96559144"
841620240517,84,2024-05-17,16,871,1345,2216,ElFi_T,"-37.81798049, 144.96503383"
841320250507,84,2025-05-07,13,909,1065,1974,ElFi_T,"-37.81798049, 144.96503383"
70020250519,70,2025-05-19,0,1,2,3,Errol20_T,"-37.80456984, 144.94946228"
392020240523,39,2024-05-23,20,39,31,70,AlfPl_T,"-37.81379749, 144.96995745"
772220240123,77,2024-01-23,22,85,77,162,HarEsP_T,"-37.81441438, 144.94433026"
77920240618,77,2024-06-18,9,61,116,177,HarEsP_T,"-37.81441438, 144.94433026"
592020240405,59,2024-04-05,20,538,402,940,RMIT_T,"-37.80825648, 144.96304859"
712320231228,71,2023-12-28,23,8,4,12,WestWP_T,"-37.81235775, 144.97136962"
541920250613,54,2025-06-13,19,134,186,320,Swa607_T,"-37.804024, 144.96308399"
212020241104,21,2024-11-04,20,227,321,548,Bourke155_T,"-37.81267313, 144.96788288"
361420240725,36,2024-07-25,14,229,259,488,Que85_T,"-37.81652527, 144.96121062"
37820240123,37,2024-01-23,8,39,61,100,Lyg260_T,"-37.80107122, 144.96704554"
43820241117,43,2024-11-17,8,27,7,34,UM2_T,"-37.79844526, 144.96411782"
43920250912,43,2025-09-12,9,219,114,333,UM2_T,"-37.79844526, 144.96411782"
502220240220,50,2024-02-20,22,154,50,204,Lyg309_T,"-37.79808192, 144.96721013"
452320240926,45,2024-09-26,23,236,289,525,Swa148_T,"-37.81414075, 144.96609379"
451120240301,45,2024-03-01,11,391,466,857,Swa148_T,"-37.81414075, 144.96609379"
451620240816,45,2024-08-16,16,835,799,1634,Swa148_T,"-37.81414075, 144.96609379"
134820240211,134,2024-02-11,8,168,180,348,Spen201_T,"-37.81694221, 144.95303935"
134620241104,134,2024-11-04,6,211,158,369,Spen201_T,"-37.81694221, 144.95303935"
41520240329,41,2024-03-29,5,98,92,190,Swa31,"-37.81668634, 144.96689733"
141620240121,14,2024-01-21,16,483,185,668,SanBri_T,"-37.82011242, 144.96291897"
711920240911,71,2024-09-11,19,5,12,17,WestWP_T,"-37.81235775, 144.97136962"
59720231103,59,2023-11-03,7,165,79,244,RMIT_T,"-37.80825648, 144.96304859"
592220250507,59,2025-05-07,22,113,130,243,RMIT_T,"-37.80825648, 144.96304859"
42120241229,42,2024-12-29,1,4,2,6,UM1_T,"-37.80008566, 144.96386412"
281520240803,28,2024-08-03,15,830,985,1815,VAC_T,"-37.82129925, 144.96879309"
29520240615,29,2024-06-15,5,13,5,18,AG_T,"-37.8199817, 144.96872865"
441320240427,44,2024-04-27,13,62,101,163,UM3_T,"-37.79698741, 144.96441306"
5620240420,5,2024-04-20,6,31,53,84,PriNW_T,"-37.81874249, 144.96787656"
51620241121,5,2024-11-21,16,230,443,673,PriNW_T,"-37.81874249, 144.96787656"
212220250123,21,2025-01-23,22,127,214,341,Bourke155_T,"-37.81267313, 144.96788288"
132220241224,132,2024-12-24,2,3,14,17,King335_T,"-37.81267639, 144.95386444"
1341120241205,134,2024-12-05,11,240,341,581,Spen201_T,"-37.81694221, 144.95303935"
1352320241219,135,2024-12-19,23,80,82,162,Spen161_T,"-37.8172861, 144.95319102"
1331120250412,133,2025-04-12,11,445,476,921,Spen229_T,"-37.81531435, 144.95227769"
1331620250722,133,2025-07-22,16,503,673,1176,Spen229_T,"-37.81531435, 144.95227769"
1182020240124,118,2024-01-24,20,36,17,53,Fli114C_T,"-37.81632783, 144.97090512"
118920240922,118,2024-09-22,9,7,13,20,Fli114C_T,"-37.81632783, 144.97090512"
108920250714,108,2025-07-14,9,187,772,959,261Will_T,"-37.81295822, 144.95678789"
1082220240901,108,2024-09-01,22,16,60,76,261Will_T,"-37.81295822, 144.95678789"
167020250107,167,2025-01-07,0,5,4,9,Lat526_T,"-37.81304149, 144.95155955"
162220250711,162,2025-07-11,2,14,21,35,Eli489_T,"-37.80740397, 144.95987909"
671620240402,67,2024-04-02,16,274,503,777,FLDegS_T,"-37.81688755, 144.96562569"
11920241016,1,2024-10-16,19,820,410,1230,Bou292_T,"-37.81349441, 144.96515323"
672120240312,67,2024-03-12,21,104,143,247,FLDegS_T,"-37.81688755, 144.96562569"
861220241213,86,2024-12-13,12,76,71,147,574Qub_T,"-37.80309992, 144.94908064"
62420250201,62,2025-02-01,4,10,6,16,Lat224_T,"-37.80996494, 144.96216521"
111620250208,11,2025-02-08,16,306,202,508,WatCit_T,"-37.81564989, 144.93970694"
561820250810,56,2025-08-10,18,369,583,952,Lon364_T,"-37.81234775, 144.96153311"
561220250524,56,2025-05-24,12,553,448,1001,Lon364_T,"-37.81234775, 144.96153311"
101620240523,10,2024-05-23,16,215,69,284,BouHbr_T,"-37.81876474, 144.94710545"
101420241207,10,2024-12-07,14,46,56,102,BouHbr_T,"-37.81876474, 144.94710545"
721720240116,72,2024-01-16,17,268,1049,1317,ACMI_T,"-37.81726338, 144.96872809"
21320240821,2,2024-08-21,13,751,798,1549,Bou283_T,"-37.81380668, 144.96516718"
581820241127,58,2024-11-27,18,489,509,998,Bou688_T,"-37.81686075, 144.95358075"
2420240517,2,2024-05-17,4,0,3,3,Bou283_T,"-37.81380668, 144.96516718"
9320250117,9,2025-01-17,3,6,3,9,Col700_T,"-37.81982992, 144.95102555"
27320250313,27,2025-03-13,3,6,4,10,Vic_T,"-37.80606888, 144.95644692"
531720250714,53,2025-07-14,17,547,409,956,Col254_T,"-37.81564191, 144.965499"
232320241204,23,2024-12-04,23,67,58,125,Col623_T,"-37.81909256, 144.95452748"
231520250201,23,2025-02-01,15,102,147,249,Col623_T,"-37.81909256, 144.95452748"
252320250708,25,2025-07-08,23,14,33,47,MCEC_T,"-37.82401776, 144.95604426"
252020250922,25,2025-09-22,20,192,239,431,MCEC_T,"-37.82401776, 144.95604426"
201120240517,20,2024-05-17,11,163,111,274,LtB170_T,"-37.81172914, 144.9682466"
25720231029,25,2023-10-29,7,73,109,182,MCEC_T,"-37.82401776, 144.95604426"
1392220240403,139,2024-04-03,22,15,21,36,Signal1647_T,"-37.81959923, 144.9632832"
135220241005,135,2024-10-05,2,31,27,58,Spen161_T,"-37.8172861, 144.95319102"
131620240822,131,2024-08-22,6,16,11,27,King2_T,"-37.82009057, 144.95758725"
872320250126,87,2025-01-26,23,8,13,21,Errol23_T,"-37.80454949, 144.94921863"
1822320250612,182,2025-06-12,23,93,68,161,King163_T,"-37.81627451, 144.95550503"
1852020250831,185,2025-08-31,20,252,308,560,Eli197_T,"-37.81374643, 144.96276183"
1311220250610,131,2025-06-10,12,138,172,310,King2_T,"-37.82009057, 144.95758725"
1432020240909,143,2024-09-09,20,100,112,212,Spencer_T,"-37.821728, 144.95557015"
1321220231102,132,2023-11-02,12,177,127,304,King335_T,"-37.81267639, 144.95386444"
67520250801,67,2025-08-01,5,7,10,17,FLDegS_T,"-37.81688755, 144.96562569"
67220241007,67,2024-10-07,2,3,4,7,FLDegS_T,"-37.81688755, 144.96562569"
67520240706,67,2024-07-06,5,4,4,8,FLDegS_T,"-37.81688755, 144.96562569"
181120250406,18,2025-04-06,11,122,52,174,Col12_T,"-37.81344862, 144.97305353"
111620240602,11,2024-06-02,16,101,104,205,WatCit_T,"-37.81564989, 144.93970694"
68020241114,68,2024-11-14,0,0,1,1,FLDegN_T,"-37.8168479, 144.96559789"
242020231227,24,2023-12-27,20,285,374,659,Col620_T,"-37.81887963, 144.95449198"
241620240117,24,2024-01-17,16,560,1476,2036,Col620_T,"-37.81887963, 144.95449198"
1020250926,1,2025-09-26,0,82,74,156,Bou292_T,"-37.81349441, 144.96515323"
122320240113,12,2024-01-13,23,120,1041,1161,NewQ_T,"-37.81457988, 144.94292398"
241320240613,24,2024-06-13,13,672,870,1542,Col620_T,"-37.81887963, 144.95449198"
72720250929,72,2025-09-29,7,167,32,199,ACMI_T,"-37.81726338, 144.96872809"
721920240728,72,2024-07-28,19,78,107,185,ACMI_T,"-37.81726338, 144.96872809"
581520240419,58,2024-04-19,15,560,580,1140,Bou688_T,"-37.81686075, 144.95358075"
35320250426,35,2025-04-26,3,21,27,48,SouthB_T,"-37.82018685, 144.96508508"
352220250525,35,2025-05-25,22,154,241,395,SouthB_T,"-37.82018685, 144.96508508"
351720250728,35,2025-07-28,17,1189,761,1950,SouthB_T,"-37.82018685, 144.96508508"
76020241214,76,2024-12-14,0,3,18,21,KenMac_T,"-37.79453803, 144.93036194"
27420250824,27,2025-08-24,4,10,4,14,Vic_T,"-37.80606888, 144.95644692"
91820240223,9,2024-02-23,18,573,430,1003,Col700_T,"-37.81982992, 144.95102555"
9220240327,9,2024-03-27,2,3,4,7,Col700_T,"-37.81982992, 144.95102555"
231620250909,23,2025-09-09,16,172,542,714,Col623_T,"-37.81909256, 144.95452748"
202020250522,20,2025-05-22,20,212,411,623,LtB170_T,"-37.81172914, 144.9682466"
20220240724,20,2024-07-24,2,22,10,32,LtB170_T,"-37.81172914, 144.9682466"
461520250522,46,2025-05-22,15,110,141,251,Pel147_T,"-37.80240719, 144.9615673"
522320240223,52,2024-02-23,23,243,263,506,Eli263_T,"-37.81252157, 144.9619401"
137620241108,137,2024-11-08,6,11,10,21,BouHbr2353_T,"-37.81894815, 144.94612292"
1301420231231,130,2023-12-31,14,9,22,31,Bou892T,"-37.8204637, 144.94126826"
164320250404,164,2025-04-04,3,2,2,4,Lat526_T,"-37.813005, 144.95160411"
164020250410,164,2025-04-10,0,6,12,18,Lat526_T,"-37.813005, 144.95160411"
1612320241026,161,2024-10-26,23,3,17,20,BirArt1109_T,"-37.81851276, 144.97131336"
1171120241021,117,2024-10-21,11,104,124,228,Fli114F_T,"-37.81629332, 144.97090877"
1171020241127,117,2024-11-27,10,148,115,263,Fli114F_T,"-37.81629332, 144.97090877"
191220240601,19,2024-06-01,12,510,385,895,LtB210_T,"-37.81237202, 144.96550671"
502220240413,50,2024-04-13,22,183,91,274,Lyg309_T,"-37.79808192, 144.96721013"
44920250523,44,2025-05-23,9,48,88,136,UM3_T,"-37.79698741, 144.96441306"
5420241021,5,2024-10-21,4,17,1,18,PriNW_T,"-37.81874249, 144.96787656"
1341320240428,134,2024-04-28,13,279,278,557,Spen201_T,"-37.81694221, 144.95303935"
1181020240722,118,2024-07-22,10,8,9,17,Fli114C_T,"-37.81632783, 144.97090512"
118220240128,118,2024-01-28,2,0,3,3,Fli114C_T,"-37.81632783, 144.97090512"
108620240728,108,2024-07-28,6,2,11,13,261Will_T,"-37.81295822, 144.95678789"
87520240311,87,2024-03-11,5,2,0,2,Errol23_T,"-37.80454949, 144.94921863"
61120240726,61,2024-07-26,1,35,11,46,RMIT14_T,"-37.80767455, 144.96309114"
61620241012,61,2024-10-12,6,12,36,48,RMIT14_T,"-37.80767455, 144.96309114"
1821920250426,182,2025-04-26,19,311,326,637,King163_T,"-37.81627451, 144.95550503"
1661220250713,166,2025-07-13,12,52,65,117,Spen484_T,"-37.80896733, 144.94931703"
179920250619,179,2025-06-19,9,50,26,76,Pow61_T,"-37.82392385, 144.96299677"
1671520250301,167,2025-03-01,15,14,19,33,Lat526_T,"-37.81304149, 144.95155955"
1401720250708,140,2025-07-08,17,54,72,126,Boyd2837_T,"-37.82590962, 144.96185972"
1621020250526,162,2025-05-26,10,205,264,469,Eli489_T,"-37.80740397, 144.95987909"
132320240422,132,2024-04-22,3,3,8,11,King335_T,"-37.81267639, 144.95386444"
66020250728,66,2025-07-28,0,43,29,72,QVN_T,"-37.81057846, 144.96444294"
661920240511,66,2024-05-11,19,1390,1126,2516,QVN_T,"-37.81057846, 144.96444294"
41220240313,4,2024-03-13,12,1734,1425,3159,Swa123_T,"-37.81487988, 144.9660878"
4020240907,4,2024-09-07,0,233,277,510,Swa123_T,"-37.81487988, 144.9660878"
701920250410,70,2025-04-10,19,130,129,259,Errol20_T,"-37.80456984, 144.94946228"
392120250617,39,2025-06-17,21,13,4,17,AlfPl_T,"-37.81379749, 144.96995745"
391220250717,39,2025-07-17,12,293,153,446,AlfPl_T,"-37.81379749, 144.96995745"
391920231029,39,2023-10-29,19,61,35,96,AlfPl_T,"-37.81379749, 144.96995745"
41820250228,41,2025-02-28,8,1509,495,2004,Swa31,"-37.81668634, 144.96689733"
281720250831,28,2025-08-31,17,249,363,612,VAC_T,"-37.82129925, 144.96879309"
401420240808,40,2024-08-08,14,219,167,386,Spr201_T,"-37.80999341, 144.97227587"
361120240730,36,2024-07-30,11,176,147,323,Que85_T,"-37.81652527, 144.96121062"
361620241122,36,2024-11-22,16,207,232,439,Que85_T,"-37.81652527, 144.96121062"
371720241114,37,2024-11-14,17,137,142,279,Lyg260_T,"-37.80107122, 144.96704554"
37020250120,37,2025-01-20,0,16,18,34,Lyg260_T,"-37.80107122, 144.96704554"
851220250629,85,2025-06-29,12,112,81,193,488Mac_T,"-37.79432415, 144.92973378"
171720250312,17,2025-03-12,17,283,746,1029,Col15_T,"-37.81362543, 144.97323591"
11620250325,1,2025-03-25,16,1073,946,2019,Bou292_T,"-37.81349441, 144.96515323"
181920240423,18,2024-04-23,19,2,8,10,Col12_T,"-37.81344862, 144.97305353"
111020250214,11,2025-02-14,10,48,34,82,WatCit_T,"-37.81564989, 144.93970694"
56720240414,56,2024-04-14,7,45,30,75,Lon364_T,"-37.81234775, 144.96153311"
121620240211,12,2024-02-11,16,114,143,257,NewQ_T,"-37.81457988, 144.94292398"
11720250813,11,2025-08-13,7,65,40,105,WatCit_T,"-37.81564989, 144.93970694"
72820250510,72,2025-05-10,8,80,56,136,ACMI_T,"-37.81726338, 144.96872809"
352220250527,35,2025-05-27,22,98,189,287,SouthB_T,"-37.82018685, 144.96508508"
351420241130,35,2024-11-30,14,635,902,1537,SouthB_T,"-37.82018685, 144.96508508"
76820231230,76,2023-12-30,8,25,14,39,KenMac_T,"-37.79453803, 144.93036194"
271820240625,27,2024-06-25,18,141,113,254,Vic_T,"-37.80606888, 144.95644692"
2620241206,2,2024-12-06,6,17,45,62,Bou283_T,"-37.81380668, 144.96516718"
302220240323,30,2024-03-23,22,510,629,1139,Lon189_T,"-37.8112185, 144.96656806"
232020240222,23,2024-02-22,20,82,173,255,Col623_T,"-37.81909256, 144.95452748"
191620231223,19,2023-12-23,16,703,568,1271,LtB210_T,"-37.81237202, 144.96550671"
481620250121,48,2025-01-21,16,150,110,260,QVMQ_T,"-37.80631581, 144.95866697"
251120240403,25,2024-04-03,11,344,455,799,MCEC_T,"-37.82401776, 144.95604426"
141620250427,141,2025-04-27,6,23,23,46,474Fl_T,"-37.81997273, 144.95834911"
1391420250108,139,2025-01-08,14,66,53,119,Signal1647_T,"-37.81959923, 144.9632832"
142820250420,142,2025-04-20,8,282,254,536,Hammer1584_T,"-37.81970749, 144.96795734"
136620240222,136,2024-02-22,6,21,11,32,BirFed1120_T,"-37.8184141, 144.97357915"
1391320250407,139,2025-04-07,13,62,83,145,Signal1647_T,"-37.81959923, 144.9632832"
1371420231111,137,2023-11-11,14,14,11,25,BouHbr2353_T,"-37.81894815, 144.94612292"
1381320250813,138,2025-08-13,13,18,8,26,EntPark1671_T,"-37.81996544, 144.95981454"
1171620240914,117,2024-09-14,16,155,195,350,Fli114F_T,"-37.81629332, 144.97090877"
117920250128,117,2025-01-28,9,171,99,270,Fli114F_T,"-37.81629332, 144.97090877"
491220240201,49,2024-02-01,12,266,399,665,Eli501_T,"-37.80730068, 144.95956055"
1091320231120,109,2023-11-20,13,190,198,388,LatWill_T,"-37.81193681, 144.95621105"
491220250504,49,2025-05-04,12,452,684,1136,Eli501_T,"-37.80730068, 144.95956055"
661920250603,66,2025-06-03,19,860,706,1566,QVN_T,"-37.81057846, 144.96444294"
61520250505,6,2025-05-05,15,873,604,1477,FliS_T,"-37.81911705, 144.96558255"
41720231124,4,2023-11-24,17,2159,1443,3602,Swa123_T,"-37.81487988, 144.9660878"
701920240108,70,2024-01-08,19,74,81,155,Errol20_T,"-37.80456984, 144.94946228"
70520250219,70,2025-02-19,5,3,3,6,Errol20_T,"-37.80456984, 144.94946228"
752320250706,75,2025-07-06,23,5,6,11,SprFli_T,"-37.81515276, 144.97467661"
41820240708,41,2024-07-08,8,65,83,148,Swa31,"-37.81668634, 144.96689733"
78820240427,78,2024-04-27,8,36,40,76,HarEsB_T,"-37.81471642, 144.9446508"
591820250814,59,2025-08-14,18,1143,1286,2429,RMIT_T,"-37.80825648, 144.96304859"
65320240325,65,2024-03-25,3,1,6,7,SwaCs_T,"-37.81569416, 144.9668064"
292120241013,29,2024-10-13,21,58,91,149,AG_T,"-37.8199817, 144.96872865"
40320241026,40,2024-10-26,3,8,4,12,Spr201_T,"-37.80999341, 144.97227587"
40320240319,40,2024-03-19,3,1,0,1,Spr201_T,"-37.80999341, 144.97227587"
431520250725,43,2025-07-25,15,112,215,327,UM2_T,"-37.79844526, 144.96411782"
452020240518,45,2024-05-18,20,316,837,1153,Swa148_T,"-37.81414075, 144.96609379"
451320240313,45,2024-03-13,13,572,888,1460,Swa148_T,"-37.81414075, 144.96609379"
451520241111,45,2024-11-11,15,409,649,1058,Swa148_T,"-37.81414075, 144.96609379"
51320250613,5,2025-06-13,13,813,790,1603,PriNW_T,"-37.81874249, 144.96787656"
1331120240903,133,2024-09-03,11,366,392,758,Spen229_T,"-37.81531435, 144.95227769"
107220231209,107,2023-12-09,2,16,3,19,280Will_T,"-37.81246271, 144.95690188"
61820250112,61,2025-01-12,8,45,94,139,RMIT14_T,"-37.80767455, 144.96309114"
1791720250310,179,2025-03-10,17,69,53,122,Pow61_T,"-37.82392385, 144.96299677"
1661420241225,166,2024-12-25,14,13,27,40,Spen484_T,"-37.80896733, 144.94931703"
1671820251008,167,2025-10-08,18,115,99,214,Lat526_T,"-37.81304149, 144.95155955"
165220240913,165,2024-09-13,2,1,0,1,Spen475_T,"-37.80953359, 144.94939004"
67020240506,67,2024-05-06,0,5,9,14,FLDegS_T,"-37.81688755, 144.96562569"
681720231024,68,2023-10-24,17,253,108,361,FLDegN_T,"-37.8168479, 144.96559789"
681320241130,68,2024-11-30,13,159,143,302,FLDegN_T,"-37.8168479, 144.96559789"
171820241114,17,2024-11-14,18,299,363,662,Col15_T,"-37.81362543, 144.97323591"
67620240423,67,2024-04-23,6,102,45,147,FLDegS_T,"-37.81688755, 144.96562569"
67020250807,67,2025-08-07,0,7,10,17,FLDegS_T,"-37.81688755, 144.96562569"
67720240518,67,2024-05-18,7,36,48,84,FLDegS_T,"-37.81688755, 144.96562569"
561720250412,56,2025-04-12,17,432,407,839,Lon364_T,"-37.81234775, 144.96153311"
164920250622,164,2025-06-22,9,67,33,100,Lat526_T,"-37.813005, 144.95160411"
180520250326,180,2025-03-26,5,2,2,4,Mac330_T,"-37.79497059, 144.93530329"
1611520240710,161,2024-07-10,15,162,166,328,BirArt1109_T,"-37.81851276, 144.97131336"
1231720240807,123,2024-08-07,17,10,5,15,BirBridge_T,"-37.81753741, 144.97329734"
1382020241007,138,2024-10-07,20,1,0,1,EntPark1671_T,"-37.81996544, 144.95981454"
117320240218,117,2024-02-18,3,16,13,29,Fli114F_T,"-37.81629332, 144.97090877"
6820250507,6,2025-05-07,8,1067,2439,3506,FliS_T,"-37.81911705, 144.96558255"
3520240822,3,2024-08-22,5,24,55,79,Swa295_T,"-37.81101524, 144.96429485"
39620250729,39,2025-07-29,6,7,4,11,AlfPl_T,"-37.81379749, 144.96995745"
392120240607,39,2024-06-07,21,50,37,87,AlfPl_T,"-37.81379749, 144.96995745"
751920241011,75,2024-10-11,19,41,20,61,SprFli_T,"-37.81515276, 144.97467661"
771720240601,77,2024-06-01,17,152,88,240,HarEsP_T,"-37.81441438, 144.94433026"
65320240601,65,2024-06-01,3,12,35,47,SwaCs_T,"-37.81569416, 144.9668064"
422120241013,42,2024-10-13,21,41,66,107,UM1_T,"-37.80008566, 144.96386412"
141320250405,14,2025-04-05,13,447,180,627,SanBri_T,"-37.82011242, 144.96291897"
711520231118,71,2023-11-18,15,12,7,19,WestWP_T,"-37.81235775, 144.97136962"
311020241020,31,2024-10-20,10,92,67,159,Lyg161_T,"-37.80169681, 144.96658911"
542320251006,54,2025-10-06,23,58,69,127,Swa607_T,"-37.804024, 144.96308399"
281220250318,28,2025-03-18,12,768,883,1651,VAC_T,"-37.82129925, 144.96879309"
211120240527,21,2024-05-27,11,266,204,470,Bourke155_T,"-37.81267313, 144.96788288"
371420240319,37,2024-03-19,14,86,99,185,Lyg260_T,"-37.80107122, 144.96704554"
442120240131,44,2024-01-31,21,5,6,11,UM3_T,"-37.79698741, 144.96441306"
441420251002,44,2025-10-02,14,66,64,130,UM3_T,"-37.79698741, 144.96441306"
451820240902,45,2024-09-02,18,473,599,1072,Swa148_T,"-37.81414075, 144.96609379"
1351120241231,135,2024-12-31,11,407,493,900,Spen161_T,"-37.8172861, 144.95319102"
1331720231226,133,2023-12-26,17,557,569,1126,Spen229_T,"-37.81531435, 144.95227769"
108320240302,108,2024-03-02,3,17,9,26,261Will_T,"-37.81295822, 144.95678789"
871220250318,87,2025-03-18,12,230,193,423,Errol23_T,"-37.80454949, 144.94921863"
44320250203,44,2025-02-03,3,2,0,2,UM3_T,"-37.79698741, 144.96441306"
182720250519,182,2025-05-19,7,51,79,130,King163_T,"-37.81627451, 144.95550503"
1671420240820,167,2024-08-20,14,21,71,92,Lat526_T,"-37.81304149, 144.95155955"
167120241023,167,2024-10-23,1,2,2,4,Lat526_T,"-37.81304149, 144.95155955"
131520241104,131,2024-11-04,5,3,20,23,King2_T,"-37.82009057, 144.95758725"
143820241213,143,2024-12-13,8,109,168,277,Spencer_T,"-37.821728, 144.95557015"
1432220250304,143,2025-03-04,22,116,121,237,Spencer_T,"-37.821728, 144.95557015"
632120250528,63,2025-05-28,21,16,100,116,Bou231_T,"-37.81333081, 144.96675571"
121420240827,12,2024-08-27,14,97,85,182,NewQ_T,"-37.81457988, 144.94292398"
11720250721,1,2025-07-21,17,1091,842,1933,Bou292_T,"-37.81349441, 144.96515323"
12420250414,12,2025-04-14,4,6,3,9,NewQ_T,"-37.81457988, 144.94292398"
35120250721,35,2025-07-21,1,1,9,10,SouthB_T,"-37.82018685, 144.96508508"
761220240826,76,2024-08-26,12,77,85,162,KenMac_T,"-37.79453803, 144.93036194"
2920250401,2,2025-04-01,9,152,218,370,Bou283_T,"-37.81380668, 144.96516718"
2020250521,2,2025-05-21,0,2,20,22,Bou283_T,"-37.81380668, 144.96516718"
9420240828,9,2024-08-28,4,5,1,6,Col700_T,"-37.81982992, 144.95102555"
27120250118,27,2025-01-18,1,37,15,52,Vic_T,"-37.80606888, 144.95644692"
1332320240425,133,2024-04-25,23,98,65,163,Spen229_T,"-37.81531435, 144.95227769"
118120250215,118,2025-02-15,1,2,7,9,Fli114C_T,"-37.81632783, 144.97090512"
108220240330,108,2024-03-30,2,15,11,26,261Will_T,"-37.81295822, 144.95678789"
85620250316,85,2025-03-16,6,5,0,5,488Mac_T,"-37.79432415, 144.92973378"
17620250709,17,2025-07-09,6,110,48,158,Col15_T,"-37.81362543, 144.97323591"
561620240127,56,2024-01-27,16,292,338,630,Lon364_T,"-37.81234775, 144.96153311"
35720240508,35,2024-05-08,7,517,909,1426,SouthB_T,"-37.82018685, 144.96508508"
761620231118,76,2023-11-18,16,44,45,89,KenMac_T,"-37.79453803, 144.93036194"
76820250127,76,2025-01-27,8,32,42,74,KenMac_T,"-37.79453803, 144.93036194"
722120240818,72,2024-08-18,21,90,189,279,ACMI_T,"-37.81726338, 144.96872809"
9220231028,9,2023-10-28,2,2,10,12,Col700_T,"-37.81982992, 144.95102555"
532220250112,53,2025-01-12,22,27,78,105,Col254_T,"-37.81564191, 144.965499"
9720250223,9,2025-02-23,7,30,16,46,Col700_T,"-37.81982992, 144.95102555"
53020231108,53,2023-11-08,0,17,18,35,Col254_T,"-37.81564191, 144.965499"
461320250811,46,2025-08-11,13,205,201,406,Pel147_T,"-37.80240719, 144.9615673"
461020240603,46,2024-06-03,10,47,78,125,Pel147_T,"-37.80240719, 144.9615673"
461220241226,46,2024-12-26,12,3,6,9,Pel147_T,"-37.80240719, 144.9615673"
511020240802,51,2024-08-02,10,74,73,147,Fra118_T,"-37.80841815, 144.95906316"
19920240126,19,2024-01-26,9,97,77,174,LtB210_T,"-37.81237202, 144.96550671"
137620240922,137,2024-09-22,6,1,3,4,BouHbr2353_T,"-37.81894815, 144.94612292"
136820250910,136,2025-09-10,8,119,175,294,BirFed1120_T,"-37.8184141, 144.97357915"
1421220250124,142,2025-01-24,12,569,639,1208,Hammer1584_T,"-37.81970749, 144.96795734"
491020250415,49,2025-04-15,10,293,349,642,Eli501_T,"-37.80730068, 144.95956055"
1172120250212,117,2025-02-12,21,77,116,193,Fli114F_T,"-37.81629332, 144.97090877"
842220250118,84,2025-01-18,22,764,806,1570,ElFi_T,"-37.81798049, 144.96503383"
41320240702,4,2024-07-02,13,1609,1370,2979,Swa123_T,"-37.81487988, 144.9660878"
70720240610,70,2024-06-10,7,10,5,15,Errol20_T,"-37.80456984, 144.94946228"
3520231211,3,2023-12-11,5,29,38,67,Swa295_T,"-37.81101524, 144.96429485"
39620231128,39,2023-11-28,6,38,39,77,AlfPl_T,"-37.81379749, 144.96995745"
65920240303,65,2024-03-03,9,154,160,314,SwaCs_T,"-37.81569416, 144.9668064"
421820250404,42,2025-04-04,18,148,343,491,UM1_T,"-37.80008566, 144.96386412"
78420240804,78,2024-08-04,4,1,0,1,HarEsB_T,"-37.81471642, 144.9446508"
311320231229,31,2023-12-29,13,239,178,417,Lyg161_T,"-37.80169681, 144.96658911"
54020250412,54,2025-04-12,0,75,41,116,Swa607_T,"-37.804024, 144.96308399"
281120250315,28,2025-03-15,11,1135,616,1751,VAC_T,"-37.82129925, 144.96879309"
21520241122,21,2024-11-22,5,2,11,13,Bourke155_T,"-37.81267313, 144.96788288"
361520240331,36,2024-03-31,15,90,87,177,Que85_T,"-37.81652527, 144.96121062"
36720250228,36,2025-02-28,7,63,64,127,Que85_T,"-37.81652527, 144.96121062"
1822320250426,182,2025-04-26,23,263,234,497,King163_T,"-37.81627451, 144.95550503"
140920250105,140,2025-01-05,9,101,35,136,Boyd2837_T,"-37.82590962, 144.96185972"
1321420250505,132,2025-05-05,14,118,176,294,King335_T,"-37.81267639, 144.95386444"
1341720240307,134,2024-03-07,17,595,504,1099,Spen201_T,"-37.81694221, 144.95303935"
24220240308,24,2024-03-08,2,19,29,48,Col620_T,"-37.81887963, 144.95449198"
241920240403,24,2024-04-03,19,316,548,864,Col620_T,"-37.81887963, 144.95449198"
24520250808,24,2025-08-08,5,91,57,148,Col620_T,"-37.81887963, 144.95449198"
24920250917,24,2025-09-17,9,1300,288,1588,Col620_T,"-37.81887963, 144.95449198"
35520240124,35,2024-01-24,5,80,64,144,SouthB_T,"-37.82018685, 144.96508508"
58220250323,58,2025-03-23,2,27,104,131,Bou688_T,"-37.81686075, 144.95358075"
272020231231,27,2023-12-31,20,117,67,184,Vic_T,"-37.80606888, 144.95644692"
27920240829,27,2024-08-29,9,53,81,134,Vic_T,"-37.80606888, 144.95644692"
581920250712,58,2025-07-12,19,415,369,784,Bou688_T,"-37.81686075, 144.95358075"
532020241201,53,2024-12-01,20,176,213,389,Col254_T,"-37.81564191, 144.965499"
53120240111,53,2024-01-11,1,6,8,14,Col254_T,"-37.81564191, 144.965499"
91520250302,9,2025-03-02,15,58,77,135,Col700_T,"-37.81982992, 144.95102555"
301920240829,30,2024-08-29,19,286,445,731,Lon189_T,"-37.8112185, 144.96656806"
53320250912,53,2025-09-12,3,4,4,8,Col254_T,"-37.81564191, 144.965499"
511320240224,51,2024-02-24,13,197,262,459,Fra118_T,"-37.80841815, 144.95906316"
481520231024,48,2023-10-24,15,209,171,380,QVMQ_T,"-37.80631581, 144.95866697"
251020241009,25,2024-10-09,10,181,508,689,MCEC_T,"-37.82401776, 144.95604426"
462220250922,46,2025-09-22,22,3,0,3,Pel147_T,"-37.80240719, 144.9615673"
20020240721,20,2024-07-21,0,165,304,469,LtB170_T,"-37.81172914, 144.9682466"
25220240623,25,2024-06-23,2,19,31,50,MCEC_T,"-37.82401776, 144.95604426"
461920240905,46,2024-09-05,19,10,27,37,Pel147_T,"-37.80240719, 144.9615673"
141320231122,141,2023-11-22,3,8,10,18,474Fl_T,"-37.81997273, 144.95834911"
1411520240328,141,2024-03-28,15,134,113,247,474Fl_T,"-37.81997273, 144.95834911"
1411420240927,141,2024-09-27,14,164,156,320,474Fl_T,"-37.81997273, 144.95834911"
1411320250108,141,2025-01-08,13,224,145,369,474Fl_T,"-37.81997273, 144.95834911"
1392020240310,139,2024-03-10,20,128,51,179,Signal1647_T,"-37.81959923, 144.9632832"
1172020241031,117,2024-10-31,20,91,88,179,Fli114F_T,"-37.81629332, 144.97090877"
1231520231028,123,2023-10-28,15,28,10,38,BirBridge_T,"-37.81753741, 144.97329734"
1231120240809,123,2024-08-09,11,11,1,12,BirBridge_T,"-37.81753741, 144.97329734"
1092320240118,109,2024-01-18,23,34,54,88,LatWill_T,"-37.81193681, 144.95621105"
19420240909,19,2024-09-09,4,1,5,6,LtB210_T,"-37.81237202, 144.96550671"
1802320250408,180,2025-04-08,23,1,4,5,Mac330_T,"-37.79497059, 144.93530329"
661320250522,66,2025-05-22,13,1215,1269,2484,QVN_T,"-37.81057846, 144.96444294"
69820240426,69,2024-04-26,8,176,45,221,FLDegC_T,"-37.81687226, 144.96559144"
69120250726,69,2025-07-26,1,1,9,10,FLDegC_T,"-37.81687226, 144.96559144"
692320251002,69,2025-10-02,23,2,3,5,FLDegC_T,"-37.81687226, 144.96559144"
4020240129,4,2024-01-29,0,564,83,647,Swa123_T,"-37.81487988, 144.9660878"
661420240702,66,2024-07-02,14,1266,1264,2530,QVN_T,"-37.81057846, 144.96444294"
751520231218,75,2023-12-18,15,48,38,86,SprFli_T,"-37.81515276, 144.97467661"
391820240408,39,2024-04-08,18,79,46,125,AlfPl_T,"-37.81379749, 144.96995745"
41720240209,41,2024-02-09,7,621,211,832,Swa31,"-37.81668634, 144.96689733"
8820240809,8,2024-08-09,8,186,141,327,WebBN_T,"-37.82293543, 144.9471751"
411020240308,41,2024-03-08,10,1340,814,2154,Swa31,"-37.81668634, 144.96689733"
41420251004,41,2025-10-04,4,50,64,114,Swa31,"-37.81668634, 144.96689733"
41520250907,41,2025-09-07,5,86,90,176,Swa31,"-37.81668634, 144.96689733"
71320250106,71,2025-01-06,3,1,3,4,WestWP_T,"-37.81235775, 144.97136962"
651220240430,65,2024-04-30,12,427,682,1109,SwaCs_T,"-37.81569416, 144.9668064"
281720240615,28,2024-06-15,17,419,831,1250,VAC_T,"-37.82129925, 144.96879309"
40820240127,40,2024-01-27,8,34,50,84,Spr201_T,"-37.80999341, 144.97227587"
401020240714,40,2024-07-14,10,127,94,221,Spr201_T,"-37.80999341, 144.97227587"
40220241105,40,2024-11-05,2,0,2,2,Spr201_T,"-37.80999341, 144.97227587"
402320241109,40,2024-11-09,23,64,28,92,Spr201_T,"-37.80999341, 144.97227587"
541720250308,54,2025-03-08,17,76,118,194,Swa607_T,"-37.804024, 144.96308399"
541920250321,54,2025-03-21,19,130,209,339,Swa607_T,"-37.804024, 144.96308399"
372320240827,37,2024-08-27,23,26,28,54,Lyg260_T,"-37.80107122, 144.96704554"
44620240619,44,2024-06-19,6,7,9,16,UM3_T,"-37.79698741, 144.96441306"
44520240819,44,2024-08-19,5,0,1,1,UM3_T,"-37.79698741, 144.96441306"
43520240517,43,2024-05-17,5,7,5,12,UM2_T,"-37.79844526, 144.96411782"
301020240410,30,2024-04-10,10,133,153,286,Lon189_T,"-37.8112185, 144.96656806"
511820250907,51,2025-09-07,18,77,73,150,Fra118_T,"-37.80841815, 144.95906316"
231920250610,23,2025-06-10,19,137,196,333,Col623_T,"-37.81909256, 144.95452748"
512220250309,51,2025-03-09,22,41,64,105,Fra118_T,"-37.80841815, 144.95906316"
46120240106,46,2024-01-06,1,4,6,10,Pel147_T,"-37.80240719, 144.9615673"
180820250720,180,2025-07-20,8,17,12,29,Mac330_T,"-37.79497059, 144.93530329"
1372020231114,137,2023-11-14,20,7,17,24,BouHbr2353_T,"-37.81894815, 144.94612292"
137720240620,137,2024-06-20,7,27,13,40,BouHbr2353_T,"-37.81894815, 144.94612292"
136720250328,136,2025-03-28,7,79,76,155,BirFed1120_T,"-37.8184141, 144.97357915"
1362120240126,136,2024-01-26,21,22,42,64,BirFed1120_T,"-37.8184141, 144.97357915"
1361720240307,136,2024-03-07,17,347,168,515,BirFed1120_T,"-37.8184141, 144.97357915"
130820240404,130,2024-04-04,8,3,6,9,Bou892T,"-37.8204637, 144.94126826"
142720240522,142,2024-05-22,7,191,145,336,Hammer1584_T,"-37.81970749, 144.96795734"
1231820241205,123,2024-12-05,18,7,2,9,BirBridge_T,"-37.81753741, 144.97329734"
49620240728,49,2024-07-28,6,23,19,42,Eli501_T,"-37.80730068, 144.95956055"
66420240208,66,2024-02-08,4,7,18,25,QVN_T,"-37.81057846, 144.96444294"
84420250719,84,2025-07-19,4,20,33,53,ElFi_T,"-37.81798049, 144.96503383"
4420231128,4,2023-11-28,4,13,20,33,Swa123_T,"-37.81487988, 144.9660878"
662120240509,66,2024-05-09,21,625,409,1034,QVN_T,"-37.81057846, 144.96444294"
41520240307,4,2024-03-07,15,1707,1470,3177,Swa123_T,"-37.81487988, 144.9660878"
41720240702,4,2024-07-02,17,1144,697,1841,Swa123_T,"-37.81487988, 144.9660878"
391420241214,39,2024-12-14,14,86,80,166,AlfPl_T,"-37.81379749, 144.96995745"
8120250302,8,2025-03-02,1,8,0,8,WebBN_T,"-37.82293543, 144.9471751"
41320250128,41,2025-01-28,3,19,31,50,Swa31,"-37.81668634, 144.96689733"
781620250307,78,2025-03-07,16,37,97,134,HarEsB_T,"-37.81471642, 144.9446508"
78420250502,78,2025-05-02,4,1,4,5,HarEsB_T,"-37.81471642, 144.9446508"
781220231214,78,2023-12-14,12,32,63,95,HarEsB_T,"-37.81471642, 144.9446508"
65020240901,65,2024-09-01,0,199,186,385,SwaCs_T,"-37.81569416, 144.9668064"
592120250430,59,2025-04-30,21,165,193,358,RMIT_T,"-37.80825648, 144.96304859"
362220250117,36,2025-01-17,22,172,111,283,Que85_T,"-37.81652527, 144.96121062"
37120241107,37,2024-11-07,1,6,9,15,Lyg260_T,"-37.80107122, 144.96704554"
50820250302,50,2025-03-02,8,28,31,59,Lyg309_T,"-37.79808192, 144.96721013"
43420231020,43,2023-10-20,4,2,2,4,UM2_T,"-37.79844526, 144.96411782"
5020250525,5,2025-05-25,0,115,175,290,PriNW_T,"-37.81874249, 144.96787656"
51320240602,5,2024-06-02,13,749,982,1731,PriNW_T,"-37.81874249, 144.96787656"
51620250128,5,2025-01-28,16,1319,812,2131,PriNW_T,"-37.81874249, 144.96787656"
135220241230,135,2024-12-30,2,4,14,18,Spen161_T,"-37.8172861, 144.95319102"
1071820250206,107,2025-02-06,18,136,117,253,280Will_T,"-37.81246271, 144.95690188"
118520240104,118,2024-01-04,5,0,1,1,Fli114C_T,"-37.81632783, 144.97090512"
1082320240316,108,2024-03-16,23,78,85,163,261Will_T,"-37.81295822, 144.95678789"
1791520250708,179,2025-07-08,15,68,47,115,Pow61_T,"-37.82392385, 144.96299677"
1621120240923,162,2024-09-23,11,263,355,618,Eli489_T,"-37.80740397, 144.95987909"
1312220250520,131,2025-05-20,22,41,28,69,King2_T,"-37.82009057, 144.95758725"
132020231212,132,2023-12-12,0,29,16,45,King335_T,"-37.81267639, 144.95386444"
132720241011,132,2024-10-11,7,61,39,100,King335_T,"-37.81267639, 144.95386444"
1091720250414,109,2025-04-14,17,474,171,645,LatWill_T,"-37.81193681, 144.95621105"
191220250817,19,2025-08-17,12,602,513,1115,LtB210_T,"-37.81237202, 144.96550671"
191820241026,19,2024-10-26,18,827,535,1362,LtB210_T,"-37.81237202, 144.96550671"
17520240123,17,2024-01-23,5,57,12,69,Col15_T,"-37.81362543, 144.97323591"
1081320240307,108,2024-03-07,13,663,567,1230,261Will_T,"-37.81295822, 144.95678789"
108820251001,108,2025-10-01,8,183,2287,2470,261Will_T,"-37.81295822, 144.95678789"
681720240724,68,2024-07-24,17,108,27,135,FLDegN_T,"-37.8168479, 144.96559789"
681420241218,68,2024-12-18,14,304,194,498,FLDegN_T,"-37.8168479, 144.96559789"
11020250517,1,2025-05-17,10,572,687,1259,Bou292_T,"-37.81349441, 144.96515323"
631920240206,63,2024-02-06,19,169,292,461,Bou231_T,"-37.81333081, 144.96675571"
682220250421,68,2025-04-21,22,19,21,40,FLDegN_T,"-37.8168479, 144.96559789"
68720240201,68,2024-02-01,7,72,77,149,FLDegN_T,"-37.8168479, 144.96559789"
181220250116,18,2025-01-16,12,268,280,548,Col12_T,"-37.81344862, 144.97305353"
18920250610,18,2025-06-10,9,137,631,768,Col12_T,"-37.81344862, 144.97305353"
122020241016,12,2024-10-16,20,284,247,531,NewQ_T,"-37.81457988, 144.94292398"
101720240630,10,2024-06-30,17,76,96,172,BouHbr_T,"-37.81876474, 144.94710545"
241320250608,24,2025-06-08,13,548,517,1065,Col620_T,"-37.81887963, 144.95449198"
121820250811,12,2025-08-11,18,66,67,133,NewQ_T,"-37.81457988, 144.94292398"
56120250627,56,2025-06-27,1,9,4,13,Lon364_T,"-37.81234775, 144.96153311"
351320240617,35,2024-06-17,13,989,1060,2049,SouthB_T,"-37.82018685, 144.96508508"
761820240404,76,2024-04-04,18,68,59,127,KenMac_T,"-37.79453803, 144.93036194"
761620241212,76,2024-12-12,16,43,63,106,KenMac_T,"-37.79453803, 144.93036194"
92120241116,9,2024-11-16,21,45,38,83,Col700_T,"-37.81982992, 144.95102555"
791620231124,79,2023-11-24,16,590,488,1078,FliSS_T,"-37.81794046, 144.96616678"
91520251007,9,2025-10-07,15,964,149,1113,Col700_T,"-37.81982992, 144.95102555"
53920240203,53,2024-02-03,9,240,211,451,Col254_T,"-37.81564191, 144.965499"
522320240202,52,2024-02-02,23,187,175,362,Eli263_T,"-37.81252157, 144.9619401"
521920250526,52,2025-05-26,19,177,139,316,Eli263_T,"-37.81252157, 144.9619401"
52620240704,52,2024-07-04,6,29,15,44,Eli263_T,"-37.81252157, 144.9619401"
1641920250823,164,2025-08-23,19,120,78,198,Lat526_T,"-37.813005, 144.95160411"
164620250901,164,2025-09-01,6,19,20,39,Lat526_T,"-37.813005, 144.95160411"
1411920250901,141,2025-09-01,19,43,82,125,474Fl_T,"-37.81997273, 144.95834911"
139320241026,139,2024-10-26,3,1,1,2,Signal1647_T,"-37.81959923, 144.9632832"
1362120250120,136,2025-01-20,21,23,48,71,BirFed1120_T,"-37.8184141, 144.97357915"
1361920240819,136,2024-08-19,19,1,0,1,BirFed1120_T,"-37.8184141, 144.97357915"
1231720250226,123,2025-02-26,17,60,83,143,BirBridge_T,"-37.81753741, 144.97329734"
1641520250413,164,2025-04-13,15,88,92,180,Lat526_T,"-37.813005, 144.95160411"
164920250808,164,2025-08-08,9,133,52,185,Lat526_T,"-37.813005, 144.95160411"
1381820240305,138,2024-03-05,18,8,5,13,EntPark1671_T,"-37.81996544, 144.95981454"
6320231129,6,2023-11-29,3,10,16,26,FliS_T,"-37.81911705, 144.96558255"
42320231203,4,2023-12-03,23,419,210,629,Swa123_T,"-37.81487988, 144.9660878"
6720250707,6,2025-07-07,7,369,579,948,FliS_T,"-37.81911705, 144.96558255"
70520240110,70,2024-01-10,5,1,2,3,Errol20_T,"-37.80456984, 144.94946228"
70120240328,70,2024-03-28,1,2,1,3,Errol20_T,"-37.80456984, 144.94946228"
751820241211,75,2024-12-11,18,68,56,124,SprFli_T,"-37.81515276, 144.97467661"
771120250626,77,2025-06-26,11,96,69,165,HarEsP_T,"-37.81441438, 144.94433026"
141620231101,14,2023-11-01,16,576,171,747,SanBri_T,"-37.82011242, 144.96291897"
54520250804,54,2025-08-04,5,7,6,13,Swa607_T,"-37.804024, 144.96308399"
47020241017,47,2024-10-17,0,65,69,134,Eli250_T,"-37.81258467, 144.9625775"
211020240308,21,2024-03-08,10,169,157,326,Bourke155_T,"-37.81267313, 144.96788288"
211420241017,21,2024-10-17,14,274,302,576,Bourke155_T,"-37.81267313, 144.96788288"
37120241224,37,2024-12-24,1,4,18,22,Lyg260_T,"-37.80107122, 144.96704554"
451820250413,45,2025-04-13,18,853,1076,1929,Swa148_T,"-37.81414075, 144.96609379"
45620251015,45,2025-10-15,6,41,59,100,Swa148_T,"-37.81414075, 144.96609379"
362220250911,36,2025-09-11,22,53,84,137,Que85_T,"-37.81652527, 144.96121062"
1392020240824,139,2024-08-24,20,27,43,70,Signal1647_T,"-37.81959923, 144.9632832"
142420250414,142,2025-04-14,4,1,0,1,Hammer1584_T,"-37.81970749, 144.96795734"
1301320250421,130,2025-04-21,13,42,32,74,Bou892T,"-37.8204637, 144.94126826"
130020250903,130,2025-09-03,0,0,1,1,Bou892T,"-37.8204637, 144.94126826"
1301520251011,130,2025-10-11,15,52,107,159,Bou892T,"-37.8204637, 144.94126826"
1381520250625,138,2025-06-25,15,6,6,12,EntPark1671_T,"-37.81996544, 144.95981454"
492120250419,49,2025-04-19,21,172,158,330,Eli501_T,"-37.80730068, 144.95956055"
67220240508,67,2024-05-08,2,1,1,2,FLDegS_T,"-37.81688755, 144.96562569"
681520241221,68,2024-12-21,15,285,242,527,FLDegN_T,"-37.8168479, 144.96559789"
1320231110,1,2023-11-10,3,13,18,31,Bou292_T,"-37.81349441, 144.96515323"
11920240223,1,2024-02-23,19,1065,786,1851,Bou292_T,"-37.81349441, 144.96515323"
182020250123,18,2025-01-23,20,49,19,68,Col12_T,"-37.81344862, 144.97305353"
86120240303,86,2024-03-03,1,0,1,1,574Qub_T,"-37.80309992, 144.94908064"
862020240821,86,2024-08-21,20,31,37,68,574Qub_T,"-37.80309992, 144.94908064"
722220250523,72,2025-05-23,22,63,698,761,ACMI_T,"-37.81726338, 144.96872809"
352320251010,35,2025-10-10,23,449,592,1041,SouthB_T,"-37.82018685, 144.96508508"
58620240214,58,2024-02-14,6,261,68,329,Bou688_T,"-37.81686075, 144.95358075"
27620240226,27,2024-02-26,6,11,13,24,Vic_T,"-37.80606888, 144.95644692"
53020240410,53,2024-04-10,0,12,10,22,Col254_T,"-37.81564191, 144.965499"
91020240504,9,2024-05-04,10,88,104,192,Col700_T,"-37.81982992, 144.95102555"
91220240507,9,2024-05-07,12,820,745,1565,Col700_T,"-37.81982992, 144.95102555"
302320250107,30,2025-01-07,23,113,150,263,Lon189_T,"-37.8112185, 144.96656806"
791020240106,79,2024-01-06,10,479,230,709,FliSS_T,"-37.81794046, 144.96616678"
511120250305,51,2025-03-05,11,101,87,188,Fra118_T,"-37.80841815, 144.95906316"
512120240806,51,2024-08-06,21,55,42,97,Fra118_T,"-37.80841815, 144.95906316"
191720250915,19,2025-09-15,17,536,349,885,LtB210_T,"-37.81237202, 144.96550671"
1401720250206,140,2025-02-06,17,120,141,261,Boyd2837_T,"-37.82590962, 144.96185972"
132620250215,132,2025-02-15,6,26,8,34,King335_T,"-37.81267639, 144.95386444"
134120250217,134,2025-02-17,1,25,45,70,Spen201_T,"-37.81694221, 144.95303935"
1072220240530,107,2024-05-30,22,38,28,66,280Will_T,"-37.81246271, 144.95690188"
87120250127,87,2025-01-27,1,4,0,4,Errol23_T,"-37.80454949, 144.94921863"
87720250131,87,2025-01-31,7,22,28,50,Errol23_T,"-37.80454949, 144.94921863"
166320250228,166,2025-02-28,3,1,2,3,Spen484_T,"-37.80896733, 144.94931703"
1661120250825,166,2025-08-25,11,53,49,102,Spen484_T,"-37.80896733, 144.94931703"
1671120250905,167,2025-09-05,11,38,45,83,Lat526_T,"-37.81304149, 144.95155955"
1622320241121,162,2024-11-21,23,95,54,149,Eli489_T,"-37.80740397, 144.95987909"
1621920241227,162,2024-12-27,19,266,277,543,Eli489_T,"-37.80740397, 144.95987909"
671420241226,67,2024-12-26,14,284,431,715,FLDegS_T,"-37.81688755, 144.96562569"
671620240110,67,2024-01-10,16,424,543,967,FLDegS_T,"-37.81688755, 144.96562569"
67620251002,67,2025-10-02,6,122,73,195,FLDegS_T,"-37.81688755, 144.96562569"
861920240629,86,2024-06-29,19,43,35,78,574Qub_T,"-37.80309992, 144.94908064"
86920241104,86,2024-11-04,9,38,23,61,574Qub_T,"-37.80309992, 144.94908064"
621620241223,62,2024-12-23,16,200,113,313,Lat224_T,"-37.80996494, 144.96216521"
612120250809,61,2025-08-09,21,248,171,419,RMIT14_T,"-37.80767455, 144.96309114"
441020250320,44,2025-03-20,10,88,117,205,UM3_T,"-37.79698741, 144.96441306"
431320240127,43,2024-01-27,13,58,43,101,UM2_T,"-37.79844526, 144.96411782"
185520250811,185,2025-08-11,5,12,58,70,Eli197_T,"-37.81374643, 144.96276183"
1621120240807,162,2024-08-07,11,376,403,779,Eli489_T,"-37.80740397, 144.95987909"
1402120241231,140,2024-12-31,21,2,0,2,Boyd2837_T,"-37.82590962, 144.96185972"
132720240130,132,2024-01-30,7,78,55,133,King335_T,"-37.81267639, 144.95386444"
132520241231,132,2024-12-31,5,12,1,13,King335_T,"-37.81267639, 144.95386444"
1351720231121,135,2023-11-21,17,638,518,1156,Spen161_T,"-37.8172861, 144.95319102"
1071820250828,107,2025-08-28,18,168,130,298,280Will_T,"-37.81246271, 144.95690188"
124820231020,124,2023-10-20,8,2,3,5,BirBridge_T,"-37.81757416, 144.97329934"
108320241007,108,2024-10-07,3,7,15,22,261Will_T,"-37.81295822, 144.95678789"
85420240803,85,2024-08-03,4,0,2,2,488Mac_T,"-37.79432415, 144.92973378"
11220241101,1,2024-11-01,12,1397,1141,2538,Bou292_T,"-37.81349441, 144.96515323"
63120240220,63,2024-02-20,1,12,24,36,Bou231_T,"-37.81333081, 144.96675571"
121120231221,12,2023-12-21,11,136,218,354,NewQ_T,"-37.81457988, 144.94292398"
121620240830,12,2024-08-30,16,138,174,312,NewQ_T,"-37.81457988, 144.94292398"
561720231204,56,2023-12-04,17,363,296,659,Lon364_T,"-37.81234775, 144.96153311"
622020241202,62,2024-12-02,20,130,151,281,Lat224_T,"-37.80996494, 144.96216521"
101720231101,10,2023-11-01,17,218,56,274,BouHbr_T,"-37.81876474, 144.94710545"
35520231221,35,2023-12-21,5,84,63,147,SouthB_T,"-37.82018685, 144.96508508"
721720250414,72,2025-04-14,17,196,807,1003,ACMI_T,"-37.81726338, 144.96872809"
351920241108,35,2024-11-08,19,1480,1379,2859,SouthB_T,"-37.82018685, 144.96508508"
58120241221,58,2024-12-21,1,72,106,178,Bou688_T,"-37.81686075, 144.95358075"
581120240525,58,2024-05-25,11,977,408,1385,Bou688_T,"-37.81686075, 144.95358075"
58620241108,58,2024-11-08,6,166,62,228,Bou688_T,"-37.81686075, 144.95358075"
92120250123,9,2025-01-23,21,50,41,91,Col700_T,"-37.81982992, 144.95102555"
79420251010,79,2025-10-10,4,18,13,31,FliSS_T,"-37.81794046, 144.96616678"
30820241208,30,2024-12-08,8,22,76,98,Lon189_T,"-37.8112185, 144.96656806"
231720250707,23,2025-07-07,17,319,721,1040,Col623_T,"-37.81909256, 144.95452748"
521620251002,52,2025-10-02,16,376,265,641,Eli263_T,"-37.81252157, 144.9619401"
461520240909,46,2024-09-09,15,121,140,261,Pel147_T,"-37.80240719, 144.9615673"
512320241113,51,2024-11-13,23,29,34,63,Fra118_T,"-37.80841815, 144.95906316"
511520240414,51,2024-04-14,15,179,133,312,Fra118_T,"-37.80841815, 144.95906316"
191020240529,19,2024-05-29,10,182,120,302,LtB210_T,"-37.81237202, 144.96550671"
30920250709,30,2025-07-09,9,108,142,250,Lon189_T,"-37.8112185, 144.96656806"
1801820251009,180,2025-10-09,18,36,68,104,Mac330_T,"-37.79497059, 144.93530329"
1411020241107,141,2024-11-07,10,135,95,230,474Fl_T,"-37.81997273, 144.95834911"
1361620251002,136,2025-10-02,16,102,32,134,BirFed1120_T,"-37.8184141, 144.97357915"
1421020240702,142,2024-07-02,10,243,120,363,Hammer1584_T,"-37.81970749, 144.96795734"
1421020241102,142,2024-11-02,10,406,316,722,Hammer1584_T,"-37.81970749, 144.96795734"
142020250217,142,2025-02-17,0,0,3,3,Hammer1584_T,"-37.81970749, 144.96795734"
130920240727,130,2024-07-27,9,36,4,40,Bou892T,"-37.8204637, 144.94126826"
1611120241213,161,2024-12-13,11,58,88,146,BirArt1109_T,"-37.81851276, 144.97131336"
62320240601,6,2024-06-01,23,468,268,736,FliS_T,"-37.81911705, 144.96558255"
84120250330,84,2025-03-30,1,153,205,358,ElFi_T,"-37.81798049, 144.96503383"
3220240730,3,2024-07-30,2,35,17,52,Swa295_T,"-37.81101524, 144.96429485"
66220240223,66,2024-02-23,2,45,18,63,QVN_T,"-37.81057846, 144.96444294"
4020240817,4,2024-08-17,0,124,130,254,Swa123_T,"-37.81487988, 144.9660878"
3020240417,3,2024-04-17,0,146,137,283,Swa295_T,"-37.81101524, 144.96429485"
391620240628,39,2024-06-28,16,99,91,190,AlfPl_T,"-37.81379749, 144.96995745"
63420240717,63,2024-07-17,4,2,5,7,Bou231_T,"-37.81333081, 144.96675571"
67520250716,67,2025-07-16,5,8,7,15,FLDegS_T,"-37.81688755, 144.96562569"
182120241115,18,2024-11-15,21,5,6,11,Col12_T,"-37.81344862, 144.97305353"
111720240807,11,2024-08-07,17,125,108,233,WatCit_T,"-37.81564989, 144.93970694"
622320250620,62,2025-06-20,23,107,132,239,Lat224_T,"-37.80996494, 144.96216521"
56420240629,56,2024-06-29,4,27,11,38,Lon364_T,"-37.81234775, 144.96153311"
121720240401,12,2024-04-01,17,51,72,123,NewQ_T,"-37.81457988, 144.94292398"
21720241013,2,2024-10-13,17,471,396,867,Bou283_T,"-37.81380668, 144.96516718"
352320240207,35,2024-02-07,23,221,315,536,SouthB_T,"-37.82018685, 144.96508508"
352220240224,35,2024-02-24,22,888,1818,2706,SouthB_T,"-37.82018685, 144.96508508"
79920250609,79,2025-06-09,9,153,116,269,FliSS_T,"-37.81794046, 144.96616678"
301320250327,30,2025-03-27,13,321,451,772,Lon189_T,"-37.8112185, 144.96656806"
30320241017,30,2024-10-17,3,9,27,36,Lon189_T,"-37.8112185, 144.96656806"
53220250212,53,2025-02-12,2,1,6,7,Col254_T,"-37.81564191, 144.965499"
531020250531,53,2025-05-31,10,462,271,733,Col254_T,"-37.81564191, 144.965499"
19120231110,19,2023-11-10,1,75,63,138,LtB210_T,"-37.81237202, 144.96550671"
48720241009,48,2024-10-09,7,45,43,88,QVMQ_T,"-37.80631581, 144.95866697"
251720250411,25,2025-04-11,17,1020,871,1891,MCEC_T,"-37.82401776, 144.95604426"
201820240620,20,2024-06-20,18,467,283,750,LtB170_T,"-37.81172914, 144.9682466"
46220241115,46,2024-11-15,2,2,0,2,Pel147_T,"-37.80240719, 144.9615673"
462120250928,46,2025-09-28,21,2,0,2,Pel147_T,"-37.80240719, 144.9615673"
46520241215,46,2024-12-15,5,0,1,1,Pel147_T,"-37.80240719, 144.9615673"
141720240513,141,2024-05-13,7,67,40,107,474Fl_T,"-37.81997273, 144.95834911"
164520250319,164,2025-03-19,5,3,2,5,Lat526_T,"-37.813005, 144.95160411"
1171420250816,117,2025-08-16,14,320,229,549,Fli114F_T,"-37.81629332, 144.97090877"
69920240712,69,2024-07-12,9,179,69,248,FLDegC_T,"-37.81687226, 144.96559144"
69620241112,69,2024-11-12,6,22,19,41,FLDegC_T,"-37.81687226, 144.96559144"
841320240121,84,2024-01-21,13,924,1482,2406,ElFi_T,"-37.81798049, 144.96503383"
84420250925,84,2025-09-25,4,18,23,41,ElFi_T,"-37.81798049, 144.96503383"
702220240312,70,2024-03-12,22,187,53,240,Errol20_T,"-37.80456984, 144.94946228"
70720250310,70,2025-03-10,7,12,11,23,Errol20_T,"-37.80456984, 144.94946228"
392220250403,39,2025-04-03,22,33,19,52,AlfPl_T,"-37.81379749, 144.96995745"
752020250505,75,2025-05-05,20,11,4,15,SprFli_T,"-37.81515276, 144.97467661"
42820250325,42,2025-03-25,8,404,141,545,UM1_T,"-37.80008566, 144.96386412"
421620240603,42,2024-06-03,16,131,234,365,UM1_T,"-37.80008566, 144.96386412"
712020250628,71,2025-06-28,20,12,9,21,WestWP_T,"-37.81235775, 144.97136962"
71920231030,71,2023-10-30,9,26,25,51,WestWP_T,"-37.81235775, 144.97136962"
471920231214,47,2023-12-14,19,813,661,1474,Eli250_T,"-37.81258467, 144.9625775"
472320240114,47,2024-01-14,23,184,103,287,Eli250_T,"-37.81258467, 144.9625775"
36720240809,36,2024-08-09,7,79,46,125,Que85_T,"-37.81652527, 144.96121062"
37220240114,37,2024-01-14,2,8,8,16,Lyg260_T,"-37.80107122, 144.96704554"
451920240826,45,2024-08-26,19,346,541,887,Swa148_T,"-37.81414075, 144.96609379"
1181320250723,118,2025-07-23,13,30,21,51,Fli114C_T,"-37.81632783, 144.97090512"
124920250926,124,2025-09-26,9,28,99,127,BirBridge_T,"-37.81757416, 144.97329934"
108220250110,108,2025-01-10,2,16,10,26,261Will_T,"-37.81295822, 144.95678789"
165820250930,165,2025-09-30,8,18,41,59,Spen475_T,"-37.80953359, 144.94939004"
1652020241203,165,2024-12-03,20,47,29,76,Spen475_T,"-37.80953359, 144.94939004"
1622320251007,162,2025-10-07,23,119,84,203,Eli489_T,"-37.80740397, 144.95987909"
1401520250104,140,2025-01-04,15,62,59,121,Boyd2837_T,"-37.82590962, 144.96185972"
143120250412,143,2025-04-12,1,85,35,120,Spencer_T,"-37.821728, 144.95557015"
111620240825,11,2024-08-25,16,69,50,119,WatCit_T,"-37.81564989, 144.93970694"
101420231115,10,2023-11-15,14,97,37,134,BouHbr_T,"-37.81876474, 144.94710545"
241120231023,24,2023-10-23,11,553,371,924,Col620_T,"-37.81887963, 144.95449198"
122320240530,12,2024-05-30,23,21,32,53,NewQ_T,"-37.81457988, 144.94292398"
121020250810,12,2025-08-10,10,174,186,360,NewQ_T,"-37.81457988, 144.94292398"
56120250918,56,2025-09-18,1,8,11,19,Lon364_T,"-37.81234775, 144.96153311"
76920250326,76,2025-03-26,9,49,40,89,KenMac_T,"-37.79453803, 144.93036194"
721320250726,72,2025-07-26,13,302,440,742,ACMI_T,"-37.81726338, 144.96872809"
35420250731,35,2025-07-31,4,3,6,9,SouthB_T,"-37.82018685, 144.96508508"
53320250203,53,2025-02-03,3,3,7,10,Col254_T,"-37.81564191, 144.965499"
92320241108,9,2024-11-08,23,27,25,52,Col700_T,"-37.81982992, 144.95102555"
791820250627,79,2025-06-27,18,539,440,979,FliSS_T,"-37.81794046, 144.96616678"
79720250810,79,2025-08-10,7,60,63,123,FliSS_T,"-37.81794046, 144.96616678"
79820250112,79,2025-01-12,8,150,101,251,FliSS_T,"-37.81794046, 144.96616678"
302220231231,30,2023-12-31,22,373,633,1006,Lon189_T,"-37.8112185, 144.96656806"
191120240129,19,2024-01-29,11,246,194,440,LtB210_T,"-37.81237202, 144.96550671"
481420240715,48,2024-07-15,14,122,94,216,QVMQ_T,"-37.80631581, 144.95866697"
251720250425,25,2025-04-25,17,508,303,811,MCEC_T,"-37.82401776, 144.95604426"
461120241116,46,2024-11-16,11,28,39,67,Pel147_T,"-37.80240719, 144.9615673"
20920250402,20,2025-04-02,9,69,63,132,LtB170_T,"-37.81172914, 144.9682466"
521020240912,52,2024-09-12,10,160,133,293,Eli263_T,"-37.81252157, 144.9619401"
1361320250709,136,2025-07-09,13,86,102,188,BirFed1120_T,"-37.8184141, 144.97357915"
136920231107,136,2023-11-07,9,67,66,133,BirFed1120_T,"-37.8184141, 144.97357915"
1301520241210,130,2024-12-10,15,46,56,102,Bou892T,"-37.8204637, 144.94126826"
1612020250404,161,2025-04-04,20,1,0,1,BirArt1109_T,"-37.81851276, 144.97131336"
164420250122,164,2025-01-22,4,1,0,1,Lat526_T,"-37.813005, 144.95160411"
1641920250425,164,2025-04-25,19,49,48,97,Lat526_T,"-37.813005, 144.95160411"
138920250828,138,2025-08-28,9,7,6,13,EntPark1671_T,"-37.81996544, 144.95981454"
492020240101,49,2024-01-01,20,159,114,273,Eli501_T,"-37.80730068, 144.95956055"
1092220240926,109,2024-09-26,22,65,78,143,LatWill_T,"-37.81193681, 144.95621105"
109320231027,109,2023-10-27,3,0,3,3,LatWill_T,"-37.81193681, 144.95621105"
66020240911,66,2024-09-11,0,92,42,134,QVN_T,"-37.81057846, 144.96444294"
69120250209,69,2025-02-09,1,14,18,32,FLDegC_T,"-37.81687226, 144.96559144"
6320250822,6,2025-08-22,3,14,15,29,FliS_T,"-37.81911705, 144.96558255"
842120250225,84,2025-02-25,21,574,733,1307,ElFi_T,"-37.81798049, 144.96503383"
661320240512,66,2024-05-12,13,1228,1579,2807,QVN_T,"-37.81057846, 144.96444294"
39420240515,39,2024-05-15,4,4,4,8,AlfPl_T,"-37.81379749, 144.96995745"
8320241209,8,2024-12-09,3,1,0,1,WebBN_T,"-37.82293543, 144.9471751"
782120240916,78,2024-09-16,21,2,3,5,HarEsB_T,"-37.81471642, 144.9446508"
77120250116,77,2025-01-16,1,7,3,10,HarEsP_T,"-37.81441438, 144.94433026"
141020241127,14,2024-11-27,10,175,114,289,SanBri_T,"-37.82011242, 144.96291897"
711220250519,71,2025-05-19,12,36,41,77,WestWP_T,"-37.81235775, 144.97136962"
711320231112,71,2023-11-12,13,5,5,10,WestWP_T,"-37.81235775, 144.97136962"
311120240330,31,2024-03-30,11,169,126,295,Lyg161_T,"-37.80169681, 144.96658911"
541220250125,54,2025-01-25,12,57,68,125,Swa607_T,"-37.804024, 144.96308399"
541020240114,54,2024-01-14,10,50,42,92,Swa607_T,"-37.804024, 144.96308399"
37420250126,37,2025-01-26,4,2,5,7,Lyg260_T,"-37.80107122, 144.96704554"
501820240220,50,2024-02-20,18,199,234,433,Lyg309_T,"-37.79808192, 144.96721013"
5520250728,5,2025-07-28,5,34,51,85,PriNW_T,"-37.81874249, 144.96787656"
51520250425,5,2025-04-25,15,611,570,1181,PriNW_T,"-37.81874249, 144.96787656"
52220240609,5,2024-06-09,22,1111,1163,2274,PriNW_T,"-37.81874249, 144.96787656"
211120241110,21,2024-11-10,11,212,180,392,Bourke155_T,"-37.81267313, 144.96788288"
361120241231,36,2024-12-31,11,126,104,230,Que85_T,"-37.81652527, 144.96121062"
36420250325,36,2025-03-25,4,3,0,3,Que85_T,"-37.81652527, 144.96121062"
134520241110,134,2024-11-10,5,64,38,102,Spen201_T,"-37.81694221, 144.95303935"
87920250723,87,2025-07-23,9,47,61,108,Errol23_T,"-37.80454949, 144.94921863"
1081520231116,108,2023-11-16,15,461,189,650,261Will_T,"-37.81295822, 144.95678789"
165620250114,165,2025-01-14,6,8,14,22,Spen475_T,"-37.80953359, 144.94939004"
631020250108,63,2025-01-08,10,172,269,441,Bou231_T,"-37.81333081, 144.96675571"
681520240721,68,2024-07-21,15,230,153,383,FLDegN_T,"-37.8168479, 144.96559789"
62420250910,62,2025-09-10,4,8,7,15,Lat224_T,"-37.80996494, 144.96216521"
672120250613,67,2025-06-13,21,244,360,604,FLDegS_T,"-37.81688755, 144.96562569"
562320231107,56,2023-11-07,23,36,41,77,Lon364_T,"-37.81234775, 144.96153311"
111920240110,11,2024-01-10,19,223,186,409,WatCit_T,"-37.81564989, 144.93970694"
101320231204,10,2023-12-04,13,103,78,181,BouHbr_T,"-37.81876474, 144.94710545"
241220240418,24,2024-04-18,12,904,947,1851,Col620_T,"-37.81887963, 144.95449198"
101720250430,10,2025-04-30,17,219,50,269,BouHbr_T,"-37.81876474, 144.94710545"
10420240423,10,2024-04-23,4,1,0,1,BouHbr_T,"-37.81876474, 144.94710545"
761620240902,76,2024-09-02,16,30,58,88,KenMac_T,"-37.79453803, 144.93036194"
721920250307,72,2025-03-07,19,255,461,716,ACMI_T,"-37.81726338, 144.96872809"
581020241130,58,2024-11-30,10,664,186,850,Bou688_T,"-37.81686075, 144.95358075"
531820231218,53,2023-12-18,18,481,336,817,Col254_T,"-37.81564191, 144.965499"
482120250825,48,2025-08-25,21,32,48,80,QVMQ_T,"-37.80631581, 144.95866697"
201720251010,20,2025-10-10,17,441,344,785,LtB170_T,"-37.81172914, 144.9682466"
20220241015,20,2024-10-15,2,12,0,12,LtB170_T,"-37.81172914, 144.9682466"
52120250110,52,2025-01-10,1,13,48,61,Eli263_T,"-37.81252157, 144.9619401"
130820241127,130,2024-11-27,8,15,7,22,Bou892T,"-37.8204637, 144.94126826"
1611520241211,161,2024-12-11,15,67,85,152,BirArt1109_T,"-37.81851276, 144.97131336"
1641620250220,164,2025-02-20,16,134,123,257,Lat526_T,"-37.813005, 144.95160411"
1231020250925,123,2025-09-25,10,26,19,45,BirBridge_T,"-37.81753741, 144.97329734"
191120250502,19,2025-05-02,11,332,191,523,LtB210_T,"-37.81237202, 144.96550671"
841220240302,84,2024-03-02,12,1045,1027,2072,ElFi_T,"-37.81798049, 144.96503383"
751520250320,75,2025-03-20,15,47,30,77,SprFli_T,"-37.81515276, 144.97467661"
412120250513,41,2025-05-13,21,83,59,142,Swa31,"-37.81668634, 144.96689733"
41920231207,41,2023-12-07,9,1531,575,2106,Swa31,"-37.81668634, 144.96689733"
41820241222,41,2024-12-22,8,334,189,523,Swa31,"-37.81668634, 144.96689733"
782220250518,78,2025-05-18,22,4,7,11,HarEsB_T,"-37.81471642, 144.9446508"
771420240612,77,2024-06-12,14,98,52,150,HarEsP_T,"-37.81441438, 144.94433026"
771620240912,77,2024-09-12,16,181,124,305,HarEsP_T,"-37.81441438, 144.94433026"
59720250203,59,2025-02-03,7,124,56,180,RMIT_T,"-37.80825648, 144.96304859"
591920250722,59,2025-07-22,19,526,599,1125,RMIT_T,"-37.80825648, 144.96304859"
141020231104,14,2023-11-04,10,428,111,539,SanBri_T,"-37.82011242, 144.96291897"
65420240822,65,2024-08-22,4,182,94,276,SwaCs_T,"-37.81569416, 144.9668064"
281320240921,28,2024-09-21,13,1912,1035,2947,VAC_T,"-37.82129925, 144.96879309"
281920241003,28,2024-10-03,19,202,590,792,VAC_T,"-37.82129925, 144.96879309"
291420240217,29,2024-02-17,14,400,815,1215,AG_T,"-37.8199817, 144.96872865"
541220241103,54,2024-11-03,12,150,107,257,Swa607_T,"-37.804024, 144.96308399"
471020241011,47,2024-10-11,10,432,575,1007,Eli250_T,"-37.81258467, 144.9625775"
752120240910,75,2024-09-10,21,12,14,26,SprFli_T,"-37.81515276, 144.97467661"
28820240313,28,2024-03-13,8,432,183,615,VAC_T,"-37.82129925, 144.96879309"
291320250111,29,2025-01-11,13,383,428,811,AG_T,"-37.8199817, 144.96872865"
29120231119,29,2023-11-19,1,20,54,74,AG_T,"-37.8199817, 144.96872865"
14920240519,14,2024-05-19,9,171,71,242,SanBri_T,"-37.82011242, 144.96291897"
29820241023,29,2024-10-23,8,107,82,189,AG_T,"-37.8199817, 144.96872865"
141720240313,14,2024-03-13,17,961,208,1169,SanBri_T,"-37.82011242, 144.96291897"
541720250519,54,2025-05-19,17,148,415,563,Swa607_T,"-37.804024, 144.96308399"
541420240608,54,2024-06-08,14,183,131,314,Swa607_T,"-37.804024, 144.96308399"
471620240829,47,2024-08-29,16,1026,992,2018,Eli250_T,"-37.81258467, 144.9625775"
40320240404,40,2024-04-04,3,5,0,5,Spr201_T,"-37.80999341, 144.97227587"
871720240610,87,2024-06-10,17,62,38,100,Errol23_T,"-37.80454949, 144.94921863"
441620250917,44,2025-09-17,16,132,82,214,UM3_T,"-37.79698741, 144.96441306"
1091320231031,109,2023-10-31,13,285,234,519,LatWill_T,"-37.81193681, 144.95621105"
851420240208,85,2024-02-08,14,53,71,124,488Mac_T,"-37.79432415, 144.92973378"
1820231123,1,2023-11-23,8,259,327,586,Bou292_T,"-37.81349441, 144.96515323"
12020240916,1,2024-09-16,20,222,234,456,Bou292_T,"-37.81349441, 144.96515323"
63720250719,63,2025-07-19,7,10,19,29,Bou231_T,"-37.81333081, 144.96675571"
12220250809,1,2025-08-09,22,307,232,539,Bou292_T,"-37.81349441, 144.96515323"
241420250202,24,2025-02-02,14,336,566,902,Col620_T,"-37.81887963, 144.95449198"
56020250803,56,2025-08-03,0,86,132,218,Lon364_T,"-37.81234775, 144.96153311"
721820250829,72,2025-08-29,18,188,284,472,ACMI_T,"-37.81726338, 144.96872809"
21220250406,2,2025-04-06,12,619,729,1348,Bou283_T,"-37.81380668, 144.96516718"
2920240130,2,2024-01-30,9,151,171,322,Bou283_T,"-37.81380668, 144.96516718"
512320240713,51,2024-07-13,23,27,13,40,Fra118_T,"-37.80841815, 144.95906316"
49520240113,49,2024-01-13,5,24,23,47,Eli501_T,"-37.80730068, 144.95956055"
191220250111,19,2025-01-11,12,543,548,1091,LtB210_T,"-37.81237202, 144.96550671"
201120240208,20,2024-02-08,11,173,127,300,LtB170_T,"-37.81172914, 144.9682466"
521720251016,52,2025-10-16,17,408,335,743,Eli263_T,"-37.81252157, 144.9619401"
46520240210,46,2024-02-10,5,1,0,1,Pel147_T,"-37.80240719, 144.9615673"
492020250712,49,2025-07-12,20,224,205,429,Eli501_T,"-37.80730068, 144.95956055"
49220250922,49,2025-09-22,2,22,20,42,Eli501_T,"-37.80730068, 144.95956055"
1412320240613,141,2024-06-13,23,25,24,49,474Fl_T,"-37.81997273, 144.95834911"
1411120241017,141,2024-10-17,11,147,121,268,474Fl_T,"-37.81997273, 144.95834911"
1391820250808,139,2025-08-08,18,57,27,84,Signal1647_T,"-37.81959923, 144.9632832"
136720240318,136,2024-03-18,7,65,83,148,BirFed1120_T,"-37.8184141, 144.97357915"
123820250907,123,2025-09-07,8,16,13,29,BirBridge_T,"-37.81753741, 144.97329734"
1231420250619,123,2025-06-19,14,35,15,50,BirBridge_T,"-37.81753741, 144.97329734"
1301720250301,130,2025-03-01,17,54,42,96,Bou892T,"-37.8204637, 144.94126826"
164120250419,164,2025-04-19,1,9,6,15,Lat526_T,"-37.813005, 144.95160411"
5220231117,5,2023-11-17,2,21,34,55,PriNW_T,"-37.81874249, 144.96787656"
402220240917,40,2024-09-17,22,35,27,62,Spr201_T,"-37.80999341, 144.97227587"
50720250204,50,2025-02-04,7,28,40,68,Lyg309_T,"-37.79808192, 144.96721013"
45620240714,45,2024-07-14,6,53,45,98,Swa148_T,"-37.81414075, 144.96609379"
132820240316,132,2024-03-16,8,76,44,120,King335_T,"-37.81267639, 144.95386444"
132020250523,132,2025-05-23,0,27,25,52,King335_T,"-37.81267639, 144.95386444"
1321520250921,132,2025-09-21,15,101,154,255,King335_T,"-37.81267639, 144.95386444"
1351620250618,135,2025-06-18,16,414,419,833,Spen161_T,"-37.8172861, 144.95319102"
1311120240131,131,2024-01-31,11,60,77,137,King2_T,"-37.82009057, 144.95758725"
1311220240601,131,2024-06-01,12,135,134,269,King2_T,"-37.82009057, 144.95758725"
131820240722,131,2024-07-22,8,115,43,158,King2_T,"-37.82009057, 144.95758725"
1332220250207,133,2025-02-07,22,658,607,1265,Spen229_T,"-37.81531435, 144.95227769"
1181120250501,118,2025-05-01,11,4,13,17,Fli114C_T,"-37.81632783, 144.97090512"
1081520250718,108,2025-07-18,15,403,216,619,261Will_T,"-37.81295822, 144.95678789"
871620251016,87,2025-10-16,16,102,108,210,Errol23_T,"-37.80454949, 144.94921863"
1081120240314,108,2024-03-14,11,326,334,660,261Will_T,"-37.81295822, 144.95678789"
851820250914,85,2025-09-14,18,39,30,69,488Mac_T,"-37.79432415, 144.92973378"
171620231020,17,2023-10-20,16,230,322,552,Col15_T,"-37.81362543, 144.97323591"
68520250824,68,2025-08-24,5,2,0,2,FLDegN_T,"-37.8168479, 144.96559789"
861020240626,86,2024-06-26,10,43,24,67,574Qub_T,"-37.80309992, 144.94908064"
621420240101,62,2024-01-01,14,107,49,156,Lat224_T,"-37.80996494, 144.96216521"
241120240823,24,2024-08-23,11,777,537,1314,Col620_T,"-37.81887963, 144.95449198"
562220250503,56,2025-05-03,22,196,301,497,Lon364_T,"-37.81234775, 144.96153311"
101920231216,10,2023-12-16,19,75,45,120,BouHbr_T,"-37.81876474, 144.94710545"
242220240328,24,2024-03-28,22,310,489,799,Col620_T,"-37.81887963, 144.95449198"
76720250514,76,2025-05-14,7,44,20,64,KenMac_T,"-37.79453803, 144.93036194"
581720241022,58,2024-10-22,17,869,1499,2368,Bou688_T,"-37.81686075, 144.95358075"
76520250924,76,2025-09-24,5,2,0,2,KenMac_T,"-37.79453803, 144.93036194"
581920240410,58,2024-04-10,19,331,396,727,Bou688_T,"-37.81686075, 144.95358075"
351220250408,35,2025-04-08,12,1348,1320,2668,SouthB_T,"-37.82018685, 144.96508508"
351220241106,35,2024-11-06,12,1197,1496,2693,SouthB_T,"-37.82018685, 144.96508508"
9620250820,9,2025-08-20,6,39,296,335,Col700_T,"-37.81982992, 144.95102555"
53320231020,53,2023-10-20,3,6,12,18,Col254_T,"-37.81564191, 144.965499"
301520241115,30,2024-11-15,15,170,333,503,Lon189_T,"-37.8112185, 144.96656806"
301320250118,30,2025-01-18,13,294,417,711,Lon189_T,"-37.8112185, 144.96656806"
512220250809,51,2025-08-09,22,64,56,120,Fra118_T,"-37.80841815, 144.95906316"
511020231018,51,2023-10-18,10,117,74,191,Fra118_T,"-37.80841815, 144.95906316"
231120241229,23,2024-12-29,11,162,168,330,Col623_T,"-37.81909256, 144.95452748"
231820240402,23,2024-04-02,18,149,301,450,Col623_T,"-37.81909256, 144.95452748"
232320250520,23,2025-05-20,23,21,37,58,Col623_T,"-37.81909256, 144.95452748"
201620250627,20,2025-06-27,16,208,222,430,LtB170_T,"-37.81172914, 144.9682466"
46020250621,46,2025-06-21,0,0,1,1,Pel147_T,"-37.80240719, 144.9615673"
1301020251014,130,2025-10-14,10,105,96,201,Bou892T,"-37.8204637, 144.94126826"
164820250920,164,2025-09-20,8,37,28,65,Lat526_T,"-37.813005, 144.95160411"
1231420240525,123,2024-05-25,14,31,11,42,BirBridge_T,"-37.81753741, 144.97329734"
109520240827,109,2024-08-27,5,15,9,24,LatWill_T,"-37.81193681, 144.95621105"
6220240822,6,2024-08-22,2,14,8,22,FliS_T,"-37.81911705, 144.96558255"
841520240505,84,2024-05-05,15,988,1505,2493,ElFi_T,"-37.81798049, 144.96503383"
66120240419,66,2024-04-19,1,68,14,82,QVN_T,"-37.81057846, 144.96444294"
661220240608,66,2024-06-08,12,905,1119,2024,QVN_T,"-37.81057846, 144.96444294"
752220250514,75,2025-05-14,22,5,6,11,SprFli_T,"-37.81515276, 144.97467661"
8520240430,8,2024-04-30,5,12,14,26,WebBN_T,"-37.82293543, 144.9471751"
8120240222,8,2024-02-22,1,6,2,8,WebBN_T,"-37.82293543, 144.9471751"
81820250708,8,2025-07-08,18,23,24,47,WebBN_T,"-37.82293543, 144.9471751"
78320241117,78,2024-11-17,3,0,3,3,HarEsB_T,"-37.81471642, 144.9446508"
14220250307,14,2025-03-07,2,19,4,23,SanBri_T,"-37.82011242, 144.96291897"
59220250124,59,2025-01-24,2,15,8,23,RMIT_T,"-37.80825648, 144.96304859"
28620241030,28,2024-10-30,6,231,105,336,VAC_T,"-37.82129925, 144.96879309"
28420231108,28,2023-11-08,4,2,28,30,VAC_T,"-37.82129925, 144.96879309"
28520240104,28,2024-01-04,5,27,65,92,VAC_T,"-37.82129925, 144.96879309"
28220250430,28,2025-04-30,2,9,5,14,VAC_T,"-37.82129925, 144.96879309"
291320250526,29,2025-05-26,13,674,662,1336,AG_T,"-37.8199817, 144.96872865"
28320240605,28,2024-06-05,3,0,17,17,VAC_T,"-37.82129925, 144.96879309"
311120250701,31,2025-07-01,11,76,60,136,Lyg161_T,"-37.80169681, 144.96658911"
541020250416,54,2025-04-16,10,186,139,325,Swa607_T,"-37.804024, 144.96308399"
541520240528,54,2024-05-28,15,195,208,403,Swa607_T,"-37.804024, 144.96308399"
401020241005,40,2024-10-05,10,72,89,161,Spr201_T,"-37.80999341, 144.97227587"
611420250324,61,2025-03-24,14,807,956,1763,RMIT14_T,"-37.80767455, 144.96309114"
611720250813,61,2025-08-13,17,697,816,1513,RMIT14_T,"-37.80767455, 144.96309114"
61420231021,61,2023-10-21,4,22,5,27,RMIT14_T,"-37.80767455, 144.96309114"
611320240320,61,2024-03-20,13,723,812,1535,RMIT14_T,"-37.80767455, 144.96309114"
51820231115,5,2023-11-15,18,1008,1144,2152,PriNW_T,"-37.81874249, 144.96787656"
361520240125,36,2024-01-25,15,165,183,348,Que85_T,"-37.81652527, 144.96121062"
1432220240918,143,2024-09-18,22,92,62,154,Spencer_T,"-37.821728, 144.95557015"
1431420250625,143,2025-06-25,14,81,117,198,Spencer_T,"-37.821728, 144.95557015"
1432020250711,143,2025-07-11,20,174,170,344,Spencer_T,"-37.821728, 144.95557015"
1341620241014,134,2024-10-14,16,614,651,1265,Spen201_T,"-37.81694221, 144.95303935"
131420250726,131,2025-07-26,4,16,43,59,King2_T,"-37.82009057, 144.95758725"
1352320231210,135,2023-12-10,23,42,62,104,Spen161_T,"-37.8172861, 144.95319102"
133420250622,133,2025-06-22,4,21,25,46,Spen229_T,"-37.81531435, 144.95227769"
133520231216,133,2023-12-16,5,48,82,130,Spen229_T,"-37.81531435, 144.95227769"
118720231018,118,2023-10-18,7,11,10,21,Fli114C_T,"-37.81632783, 144.97090512"
67020240505,67,2024-05-05,0,58,65,123,FLDegS_T,"-37.81688755, 144.96562569"
68220240101,68,2024-01-01,2,27,5,32,FLDegN_T,"-37.8168479, 144.96559789"
85520240415,85,2024-04-15,5,9,1,10,488Mac_T,"-37.79432415, 144.92973378"
851320240801,85,2024-08-01,13,87,75,162,488Mac_T,"-37.79432415, 144.92973378"
85720251014,85,2025-10-14,7,80,22,102,488Mac_T,"-37.79432415, 144.92973378"
85120251010,85,2025-10-10,1,1,0,1,488Mac_T,"-37.79432415, 144.92973378"
171520240614,17,2024-06-14,15,239,297,536,Col15_T,"-37.81362543, 144.97323591"
11420241208,1,2024-12-08,14,1638,1813,3451,Bou292_T,"-37.81349441, 144.96515323"
182220240123,18,2024-01-23,22,6,11,17,Col12_T,"-37.81344862, 144.97305353"
18720250122,18,2025-01-22,7,43,369,412,Col12_T,"-37.81344862, 144.97305353"
63320250923,63,2025-09-23,3,0,4,4,Bou231_T,"-37.81333081, 144.96675571"
11620240915,11,2024-09-15,6,8,12,20,WatCit_T,"-37.81564989, 144.93970694"
86020250817,86,2025-08-17,0,0,2,2,574Qub_T,"-37.80309992, 144.94908064"
121220231127,12,2023-11-27,12,139,181,320,NewQ_T,"-37.81457988, 144.94292398"
101320250306,10,2025-03-06,13,113,110,223,BouHbr_T,"-37.81876474, 144.94710545"
582020250612,58,2025-06-12,20,240,227,467,Bou688_T,"-37.81686075, 144.95358075"
351520241017,35,2024-10-17,15,977,831,1808,SouthB_T,"-37.82018685, 144.96508508"
35820250305,35,2025-03-05,8,638,2081,2719,SouthB_T,"-37.82018685, 144.96508508"
91420240613,9,2024-06-13,14,410,191,601,Col700_T,"-37.81982992, 144.95102555"
91220241215,9,2024-12-15,12,61,78,139,Col700_T,"-37.81982992, 144.95102555"
162720241026,162,2024-10-26,7,105,100,205,Eli489_T,"-37.80740397, 144.95987909"
131020231225,131,2023-12-25,0,31,25,56,King2_T,"-37.82009057, 144.95758725"
1311720241024,131,2024-10-24,17,160,175,335,King2_T,"-37.82009057, 144.95758725"
1401520250604,140,2025-06-04,15,74,69,143,Boyd2837_T,"-37.82590962, 144.96185972"
134920250814,134,2025-08-14,9,292,453,745,Spen201_T,"-37.81694221, 144.95303935"
1120240321,1,2024-03-21,1,9,28,37,Bou292_T,"-37.81349441, 144.96515323"
1520250422,1,2025-04-22,5,7,9,16,Bou292_T,"-37.81349441, 144.96515323"
682020240322,68,2024-03-22,20,167,20,187,FLDegN_T,"-37.8168479, 144.96559789"
11320250617,1,2025-06-17,13,1265,1145,2410,Bou292_T,"-37.81349441, 144.96515323"
121720241215,12,2024-12-15,17,128,104,232,NewQ_T,"-37.81457988, 144.94292398"
621120250720,62,2025-07-20,11,171,163,334,Lat224_T,"-37.80996494, 144.96216521"
11220240930,11,2024-09-30,2,0,4,4,WatCit_T,"-37.81564989, 144.93970694"
24720240822,24,2024-08-22,7,1066,253,1319,Col620_T,"-37.81887963, 144.95449198"
10620240529,10,2024-05-29,6,3,16,19,BouHbr_T,"-37.81876474, 144.94710545"
101420241228,10,2024-12-28,14,46,38,84,BouHbr_T,"-37.81876474, 144.94710545"
76920250427,76,2025-04-27,9,48,48,96,KenMac_T,"-37.79453803, 144.93036194"
722220241220,72,2024-12-20,22,386,425,811,ACMI_T,"-37.81726338, 144.96872809"
2920241101,2,2024-11-01,9,216,302,518,Bou283_T,"-37.81380668, 144.96516718"
91520240429,9,2024-04-29,15,972,205,1177,Col700_T,"-37.81982992, 144.95102555"
53720250524,53,2025-05-24,7,26,23,49,Col254_T,"-37.81564191, 144.965499"
531120240429,53,2024-04-29,11,508,443,951,Col254_T,"-37.81564191, 144.965499"
23220240209,23,2024-02-09,2,3,7,10,Col623_T,"-37.81909256, 144.95452748"
792020250723,79,2025-07-23,20,219,247,466,FliSS_T,"-37.81794046, 144.96616678"
46020231230,46,2023-12-30,0,11,6,17,Pel147_T,"-37.80240719, 144.9615673"
511420250207,51,2025-02-07,14,71,80,151,Fra118_T,"-37.80841815, 144.95906316"
48820231221,48,2023-12-21,8,151,101,252,QVMQ_T,"-37.80631581, 144.95866697"
20220250227,20,2025-02-27,2,32,35,67,LtB170_T,"-37.81172914, 144.9682466"
180620250717,180,2025-07-17,6,6,8,14,Mac330_T,"-37.79497059, 144.93530329"
141020240621,141,2024-06-21,0,19,26,45,474Fl_T,"-37.81997273, 144.95834911"
1411120240913,141,2024-09-13,11,141,102,243,474Fl_T,"-37.81997273, 144.95834911"
141920250610,141,2025-06-10,9,138,85,223,474Fl_T,"-37.81997273, 144.95834911"
136720250826,136,2025-08-26,7,48,49,97,BirFed1120_T,"-37.8184141, 144.97357915"
1421220240121,142,2024-01-21,12,884,716,1600,Hammer1584_T,"-37.81970749, 144.96795734"
1301520250319,130,2025-03-19,15,52,42,94,Bou892T,"-37.8204637, 144.94126826"
138720241213,138,2024-12-13,7,5,2,7,EntPark1671_T,"-37.81996544, 144.95981454"
1381120251002,138,2025-10-02,11,4,6,10,EntPark1671_T,"-37.81996544, 144.95981454"
117620240623,117,2024-06-23,6,5,4,9,Fli114F_T,"-37.81629332, 144.97090877"
109020250310,109,2025-03-10,0,32,37,69,LatWill_T,"-37.81193681, 144.95621105"
109220231123,109,2023-11-23,2,10,6,16,LatWill_T,"-37.81193681, 144.95621105"
692220240627,69,2024-06-27,22,9,14,23,FLDegC_T,"-37.81687226, 144.96559144"
692320250205,69,2025-02-05,23,17,10,27,FLDegC_T,"-37.81687226, 144.96559144"
61520250518,6,2025-05-18,15,873,891,1764,FliS_T,"-37.81911705, 144.96558255"
842220231225,84,2023-12-25,22,1046,884,1930,ElFi_T,"-37.81798049, 144.96503383"
4020250520,4,2025-05-20,0,27,41,68,Swa123_T,"-37.81487988, 144.9660878"
32220250415,3,2025-04-15,22,447,393,840,Swa295_T,"-37.81101524, 144.96429485"
8020231225,8,2023-12-25,0,2,3,5,WebBN_T,"-37.82293543, 144.9471751"
752220250407,75,2025-04-07,22,6,2,8,SprFli_T,"-37.81515276, 144.97467661"
41720240301,41,2024-03-01,7,653,278,931,Swa31,"-37.81668634, 144.96689733"
172320250525,17,2025-05-25,23,7,5,12,Col15_T,"-37.81362543, 144.97323591"
1920231205,1,2023-12-05,9,371,643,1014,Bou292_T,"-37.81349441, 144.96515323"
681420231227,68,2023-12-27,14,339,208,547,FLDegN_T,"-37.8168479, 144.96559789"
681420240111,68,2024-01-11,14,262,129,391,FLDegN_T,"-37.8168479, 144.96559789"
722220251008,72,2025-10-08,22,61,121,182,ACMI_T,"-37.81726338, 144.96872809"
72820251011,72,2025-10-11,8,78,92,170,ACMI_T,"-37.81726338, 144.96872809"
721120240216,72,2024-02-16,11,286,348,634,ACMI_T,"-37.81726338, 144.96872809"
722120241214,72,2024-12-14,21,468,586,1054,ACMI_T,"-37.81726338, 144.96872809"
10820251007,10,2025-10-07,8,55,188,243,BouHbr_T,"-37.81876474, 144.94710545"
2420240810,2,2024-08-10,4,15,5,20,Bou283_T,"-37.81380668, 144.96516718"
76720240505,76,2024-05-05,7,7,6,13,KenMac_T,"-37.79453803, 144.93036194"
76820250608,76,2025-06-08,8,26,9,35,KenMac_T,"-37.79453803, 144.93036194"
792120231209,79,2023-12-09,21,385,407,792,FliSS_T,"-37.81794046, 144.96616678"
53220250211,53,2025-02-11,2,5,3,8,Col254_T,"-37.81564191, 144.965499"
231220250625,23,2025-06-25,12,338,438,776,Col623_T,"-37.81909256, 144.95452748"
482020250309,48,2025-03-09,20,157,93,250,QVMQ_T,"-37.80631581, 144.95866697"
20720250506,20,2025-05-06,7,28,27,55,LtB170_T,"-37.81172914, 144.9682466"
141220240503,141,2024-05-03,2,3,17,20,474Fl_T,"-37.81997273, 144.95834911"
139220250114,139,2025-01-14,2,0,1,1,Signal1647_T,"-37.81959923, 144.9632832"
1371320240711,137,2024-07-11,13,36,56,92,BouHbr2353_T,"-37.81894815, 144.94612292"
1371720250131,137,2025-01-31,17,23,104,127,BouHbr2353_T,"-37.81894815, 144.94612292"
1422220240617,142,2024-06-17,22,38,14,52,Hammer1584_T,"-37.81970749, 144.96795734"
142920240904,142,2024-09-04,9,129,116,245,Hammer1584_T,"-37.81970749, 144.96795734"
138720251016,138,2025-10-16,7,5,3,8,EntPark1671_T,"-37.81996544, 144.95981454"
138720240509,138,2024-05-09,7,1,2,3,EntPark1671_T,"-37.81996544, 144.95981454"
491820231119,49,2023-11-19,18,162,114,276,Eli501_T,"-37.80730068, 144.95956055"
109920250724,109,2025-07-24,9,86,364,450,LatWill_T,"-37.81193681, 144.95621105"
19720250911,19,2025-09-11,7,28,24,52,LtB210_T,"-37.81237202, 144.96550671"
661020250113,66,2025-01-13,10,424,422,846,QVN_T,"-37.81057846, 144.96444294"
661820240602,66,2024-06-02,18,744,798,1542,QVN_T,"-37.81057846, 144.96444294"
6820250714,6,2025-07-14,8,804,1721,2525,FliS_T,"-37.81911705, 144.96558255"
841320250228,84,2025-02-28,13,1053,1269,2322,ElFi_T,"-37.81798049, 144.96503383"
701620250207,70,2025-02-07,16,146,131,277,Errol20_T,"-37.80456984, 144.94946228"
41520250406,41,2025-04-06,5,121,105,226,Swa31,"-37.81668634, 144.96689733"
771220240420,77,2024-04-20,12,215,130,345,HarEsP_T,"-37.81441438, 144.94433026"
42720250814,42,2025-08-14,7,50,53,103,UM1_T,"-37.80008566, 144.96386412"
771920250708,77,2025-07-08,19,108,94,202,HarEsP_T,"-37.81441438, 144.94433026"
29220240710,29,2024-07-10,2,2,7,9,AG_T,"-37.8199817, 144.96872865"
711020251016,71,2025-10-16,10,14,18,32,WestWP_T,"-37.81235775, 144.97136962"
71220240814,71,2024-08-14,2,0,1,1,WestWP_T,"-37.81235775, 144.97136962"
28020250412,28,2025-04-12,0,48,22,70,VAC_T,"-37.82129925, 144.96879309"
47420250204,47,2025-02-04,4,23,17,40,Eli250_T,"-37.81258467, 144.9625775"
402120250209,40,2025-02-09,21,53,34,87,Spr201_T,"-37.80999341, 144.97227587"
361820250704,36,2025-07-04,18,222,232,454,Que85_T,"-37.81652527, 144.96121062"
781320250321,78,2025-03-21,13,24,46,70,HarEsB_T,"-37.81471642, 144.9446508"
422120250901,42,2025-09-01,21,46,73,119,UM1_T,"-37.80008566, 144.96386412"
77920240103,77,2024-01-03,9,63,56,119,HarEsP_T,"-37.81441438, 144.94433026"
292120240701,29,2024-07-01,21,30,67,97,AG_T,"-37.8199817, 144.96872865"
711220251004,71,2025-10-04,12,9,11,20,WestWP_T,"-37.81235775, 144.97136962"
711020231123,71,2023-11-23,10,13,28,41,WestWP_T,"-37.81235775, 144.97136962"
47520250126,47,2025-01-26,5,17,40,57,Eli250_T,"-37.81258467, 144.9625775"
47520250628,47,2025-06-28,5,18,37,55,Eli250_T,"-37.81258467, 144.9625775"
401020231221,40,2023-12-21,10,169,180,349,Spr201_T,"-37.80999341, 144.97227587"
21720250910,21,2025-09-10,7,33,34,67,Bourke155_T,"-37.81267313, 144.96788288"
212220240531,21,2024-05-31,22,343,485,828,Bourke155_T,"-37.81267313, 144.96788288"
211020241113,21,2024-11-13,10,129,150,279,Bourke155_T,"-37.81267313, 144.96788288"
36020240917,36,2024-09-17,0,8,3,11,Que85_T,"-37.81652527, 144.96121062"
501720231230,50,2023-12-30,17,215,280,495,Lyg309_T,"-37.79808192, 144.96721013"
44120240611,44,2024-06-11,1,3,0,3,UM3_T,"-37.79698741, 144.96441306"
452220231212,45,2023-12-12,22,240,500,740,Swa148_T,"-37.81414075, 144.96609379"
52220240802,5,2024-08-02,22,1154,382,1536,PriNW_T,"-37.81874249, 144.96787656"
1821820250421,182,2025-04-21,18,321,211,532,King163_T,"-37.81627451, 144.95550503"
1621120250414,162,2025-04-14,11,333,376,709,Eli489_T,"-37.80740397, 144.95987909"
1311520241111,131,2024-11-11,15,102,102,204,King2_T,"-37.82009057, 144.95758725"
143720250829,143,2025-08-29,7,61,115,176,Spencer_T,"-37.821728, 144.95557015"
1432020241010,143,2024-10-10,20,158,138,296,Spencer_T,"-37.821728, 144.95557015"
1321520240706,132,2024-07-06,15,163,147,310,King335_T,"-37.81267639, 144.95386444"
1341920250411,134,2025-04-11,19,444,361,805,Spen201_T,"-37.81694221, 144.95303935"
134720231105,134,2023-11-05,7,115,79,194,Spen201_T,"-37.81694221, 144.95303935"
1071920250427,107,2025-04-27,19,42,73,115,280Will_T,"-37.81246271, 144.95690188"
1331420250409,133,2025-04-09,14,424,470,894,Spen229_T,"-37.81531435, 144.95227769"
1331520240229,133,2024-02-29,15,525,759,1284,Spen229_T,"-37.81531435, 144.95227769"
1181520240427,118,2024-04-27,15,26,87,113,Fli114C_T,"-37.81632783, 144.97090512"
171720240823,17,2024-08-23,17,228,442,670,Col15_T,"-37.81362543, 144.97323591"
631620240109,63,2024-01-09,16,327,433,760,Bou231_T,"-37.81333081, 144.96675571"
182220231207,18,2023-12-07,22,4,19,23,Col12_T,"-37.81344862, 144.97305353"
18420231222,18,2023-12-22,4,2,1,3,Col12_T,"-37.81344862, 144.97305353"
18020250315,18,2025-03-15,0,8,11,19,Col12_T,"-37.81344862, 144.97305353"
671820241010,67,2024-10-10,18,373,601,974,FLDegS_T,"-37.81688755, 144.96562569"
56220241124,56,2024-11-24,2,84,83,167,Lon364_T,"-37.81234775, 144.96153311"
111720240223,11,2024-02-23,17,235,132,367,WatCit_T,"-37.81564989, 144.93970694"
111820250717,11,2025-07-17,18,89,44,133,WatCit_T,"-37.81564989, 144.93970694"
101420241124,10,2024-11-24,14,24,23,47,BouHbr_T,"-37.81876474, 144.94710545"
102220241216,10,2024-12-16,22,11,7,18,BouHbr_T,"-37.81876474, 144.94710545"
121820250311,12,2025-03-11,18,162,315,477,NewQ_T,"-37.81457988, 144.94292398"
12220250512,12,2025-05-12,2,2,6,8,NewQ_T,"-37.81457988, 144.94292398"
582120231024,58,2023-10-24,21,196,194,390,Bou688_T,"-37.81686075, 144.95358075"
30420240905,30,2024-09-05,4,18,33,51,Lon189_T,"-37.8112185, 144.96656806"
79320250719,79,2025-07-19,3,36,29,65,FliSS_T,"-37.81794046, 144.96616678"
52920240610,52,2024-06-10,9,79,42,121,Eli263_T,"-37.81252157, 144.9619401"
522220250920,52,2025-09-20,22,182,274,456,Eli263_T,"-37.81252157, 144.9619401"
52420251005,52,2025-10-05,4,85,57,142,Eli263_T,"-37.81252157, 144.9619401"
191720231211,19,2023-12-11,17,605,420,1025,LtB210_T,"-37.81237202, 144.96550671"
481020240313,48,2024-03-13,10,168,110,278,QVMQ_T,"-37.80631581, 144.95866697"
202220240730,20,2024-07-30,22,62,110,172,LtB170_T,"-37.81172914, 144.9682466"
302120250408,30,2025-04-08,21,232,373,605,Lon189_T,"-37.8112185, 144.96656806"
23920250309,23,2025-03-09,9,135,120,255,Col623_T,"-37.81909256, 144.95452748"
231620240107,23,2024-01-07,16,56,169,225,Col623_T,"-37.81909256, 144.95452748"
512320240507,51,2024-05-07,23,22,15,37,Fra118_T,"-37.80841815, 144.95906316"
25720250921,25,2025-09-21,7,159,230,389,MCEC_T,"-37.82401776, 144.95604426"
462220250701,46,2025-07-01,22,1,0,1,Pel147_T,"-37.80240719, 144.9615673"
251820240507,25,2024-05-07,18,739,339,1078,MCEC_T,"-37.82401776, 144.95604426"
521120241028,52,2024-10-28,11,220,178,398,Eli263_T,"-37.81252157, 144.9619401"
462320241022,46,2024-10-22,23,2,3,5,Pel147_T,"-37.80240719, 144.9615673"
1412020231212,141,2023-12-12,20,96,98,194,474Fl_T,"-37.81997273, 144.95834911"
141920240518,141,2024-05-18,9,115,112,227,474Fl_T,"-37.81997273, 144.95834911"
1411120241004,141,2024-10-04,11,180,155,335,474Fl_T,"-37.81997273, 144.95834911"
139320250814,139,2025-08-14,3,0,1,1,Signal1647_T,"-37.81959923, 144.9632832"
1361520241205,136,2024-12-05,15,72,44,116,BirFed1120_T,"-37.8184141, 144.97357915"
138920250606,138,2025-06-06,9,7,3,10,EntPark1671_T,"-37.81996544, 144.95981454"
1381020240605,138,2024-06-05,10,2,0,2,EntPark1671_T,"-37.81996544, 144.95981454"
117520240926,117,2024-09-26,5,5,6,11,Fli114F_T,"-37.81629332, 144.97090877"
661420251003,66,2025-10-03,14,1344,1346,2690,QVN_T,"-37.81057846, 144.96444294"
66020251004,66,2025-10-04,0,184,182,366,QVN_T,"-37.81057846, 144.96444294"
66320240904,66,2024-09-04,3,3,0,3,QVN_T,"-37.81057846, 144.96444294"
691220250622,69,2025-06-22,12,280,212,492,FLDegC_T,"-37.81687226, 144.96559144"
62120250426,6,2025-04-26,21,727,657,1384,FliS_T,"-37.81911705, 144.96558255"
702320250527,70,2025-05-27,23,7,5,12,Errol20_T,"-37.80456984, 144.94946228"
3420250427,3,2025-04-27,4,77,46,123,Swa295_T,"-37.81101524, 144.96429485"
391620250914,39,2025-09-14,16,22,17,39,AlfPl_T,"-37.81379749, 144.96995745"
412120240210,41,2024-02-10,21,1184,1125,2309,Swa31,"-37.81668634, 144.96689733"
59320240815,59,2024-08-15,3,8,9,17,RMIT_T,"-37.80825648, 144.96304859"
282120240918,28,2024-09-18,21,630,217,847,VAC_T,"-37.82129925, 144.96879309"
54620240129,54,2024-01-29,6,14,8,22,Swa607_T,"-37.804024, 144.96308399"
372320240105,37,2024-01-05,23,164,136,300,Lyg260_T,"-37.80107122, 144.96704554"
612020240524,61,2024-05-24,20,242,230,472,RMIT14_T,"-37.80767455, 144.96309114"
442320250705,44,2025-07-05,23,5,1,6,UM3_T,"-37.79698741, 144.96441306"
431520251016,43,2025-10-16,15,228,494,722,UM2_T,"-37.79844526, 144.96411782"
451420241224,45,2024-12-24,14,791,925,1716,Swa148_T,"-37.81414075, 144.96609379"
451520250202,45,2025-02-02,15,218,740,958,Swa148_T,"-37.81414075, 144.96609379"
212120240120,21,2024-01-20,21,539,554,1093,Bourke155_T,"-37.81267313, 144.96788288"
140920240923,140,2024-09-23,9,94,37,131,Boyd2837_T,"-37.82590962, 144.96185972"
1401320250222,140,2025-02-22,13,123,79,202,Boyd2837_T,"-37.82590962, 144.96185972"
107620250224,107,2025-02-24,6,19,32,51,280Will_T,"-37.81246271, 144.95690188"
1331220240219,133,2024-02-19,12,576,619,1195,Spen229_T,"-37.81531435, 144.95227769"
1081020240628,108,2024-06-28,10,95,315,410,261Will_T,"-37.81295822, 144.95678789"
872220240924,87,2024-09-24,22,11,12,23,Errol23_T,"-37.80454949, 144.94921863"
1791420250528,179,2025-05-28,14,38,55,93,Pow61_T,"-37.82392385, 144.96299677"
1822220250904,182,2025-09-04,22,111,103,214,King163_T,"-37.81627451, 144.95550503"
51020251009,51,2025-10-09,0,15,14,29,Fra118_T,"-37.80841815, 144.95906316"
231020250622,23,2025-06-22,10,87,148,235,Col623_T,"-37.81909256, 144.95452748"
48020240425,48,2024-04-25,0,15,32,47,QVMQ_T,"-37.80631581, 144.95866697"
522020240106,52,2024-01-06,20,253,277,530,Eli263_T,"-37.81252157, 144.9619401"
19420251002,19,2025-10-02,4,7,7,14,LtB210_T,"-37.81237202, 144.96550671"
1411020240901,141,2024-09-01,10,83,143,226,474Fl_T,"-37.81997273, 144.95834911"
139020241019,139,2024-10-19,0,6,4,10,Signal1647_T,"-37.81959923, 144.9632832"
1361820240204,136,2024-02-04,18,206,23,229,BirFed1120_T,"-37.8184141, 144.97357915"
501020250317,50,2025-03-17,10,113,155,268,Lyg309_T,"-37.79808192, 144.96721013"
44820240713,44,2024-07-13,8,7,8,15,UM3_T,"-37.79698741, 144.96441306"
51620231028,5,2023-10-28,16,1706,1338,3044,PriNW_T,"-37.81874249, 144.96787656"
1341420250502,134,2025-05-02,14,428,420,848,Spen201_T,"-37.81694221, 144.95303935"
107920231018,107,2023-10-18,9,85,197,282,280Will_T,"-37.81246271, 144.95690188"
133720250113,133,2025-01-13,7,649,353,1002,Spen229_T,"-37.81531435, 144.95227769"
1181720250331,118,2025-03-31,17,22,50,72,Fli114C_T,"-37.81632783, 144.97090512"
61120250821,61,2025-08-21,1,26,8,34,RMIT14_T,"-37.80767455, 144.96309114"
1661620250912,166,2025-09-12,16,77,42,119,Spen484_T,"-37.80896733, 144.94931703"
1791220250226,179,2025-02-26,12,42,50,92,Pow61_T,"-37.82392385, 144.96299677"
1431720240605,143,2024-06-05,17,252,238,490,Spencer_T,"-37.821728, 144.95557015"
143120250218,143,2025-02-18,1,23,12,35,Spencer_T,"-37.821728, 144.95557015"
68220250208,68,2025-02-08,2,9,3,12,FLDegN_T,"-37.8168479, 144.96559789"
851920240312,85,2024-03-12,19,41,48,89,488Mac_T,"-37.79432415, 144.92973378"
172020231206,17,2023-12-06,20,118,183,301,Col15_T,"-37.81362543, 144.97323591"
171820240531,17,2024-05-31,18,181,238,419,Col15_T,"-37.81362543, 144.97323591"
17820250820,17,2025-08-20,8,1455,215,1670,Col15_T,"-37.81362543, 144.97323591"
631620250102,63,2025-01-02,16,363,461,824,Bou231_T,"-37.81333081, 144.96675571"
181020231204,18,2023-12-04,10,125,204,329,Col12_T,"-37.81344862, 144.97305353"
11720240512,11,2024-05-12,7,20,19,39,WatCit_T,"-37.81564989, 144.93970694"
112020240719,11,2024-07-19,20,43,31,74,WatCit_T,"-37.81564989, 144.93970694"
111220241110,11,2024-11-10,12,177,149,326,WatCit_T,"-37.81564989, 144.93970694"
621520250720,62,2025-07-20,15,323,254,577,Lat224_T,"-37.80996494, 144.96216521"
561120240127,56,2024-01-27,11,353,237,590,Lon364_T,"-37.81234775, 144.96153311"
12520240723,12,2024-07-23,5,14,5,19,NewQ_T,"-37.81457988, 144.94292398"
121120240902,12,2024-09-02,11,21,48,69,NewQ_T,"-37.81457988, 144.94292398"
1920250808,1,2025-08-08,9,982,842,1824,Bou292_T,"-37.81349441, 144.96515323"
111320250316,11,2025-03-16,13,5,2,7,WatCit_T,"-37.81564989, 144.93970694"
761520240820,76,2024-08-20,15,51,89,140,KenMac_T,"-37.79453803, 144.93036194"
761920241020,76,2024-10-20,19,38,41,79,KenMac_T,"-37.79453803, 144.93036194"
91820240207,9,2024-02-07,18,1066,133,1199,Col700_T,"-37.81982992, 144.95102555"
51520240423,51,2024-04-23,5,8,6,14,Fra118_T,"-37.80841815, 144.95906316"
25320231023,25,2023-10-23,3,2,5,7,MCEC_T,"-37.82401776, 144.95604426"
201120240809,20,2024-08-09,11,209,152,361,LtB170_T,"-37.81172914, 144.9682466"
52720241022,52,2024-10-22,7,82,109,191,Eli263_T,"-37.81252157, 144.9619401"
192320250921,19,2025-09-21,23,87,139,226,LtB210_T,"-37.81237202, 144.96550671"
1301220251016,130,2025-10-16,12,128,104,232,Bou892T,"-37.8204637, 144.94126826"
117720241031,117,2024-10-31,7,117,49,166,Fli114F_T,"-37.81629332, 144.97090877"
109420231108,109,2023-11-08,4,4,6,10,LatWill_T,"-37.81193681, 144.95621105"
109320240328,109,2024-03-28,3,4,3,7,LatWill_T,"-37.81193681, 144.95621105"
1091320240712,109,2024-07-12,13,234,181,415,LatWill_T,"-37.81193681, 144.95621105"
751120240501,75,2024-05-01,11,47,36,83,SprFli_T,"-37.81515276, 144.97467661"
81920240120,8,2024-01-20,19,92,125,217,WebBN_T,"-37.82293543, 144.9471751"
411320250808,41,2025-08-08,13,1586,1770,3356,Swa31,"-37.81668634, 144.96689733"
411420231116,41,2023-11-16,14,1547,1514,3061,Swa31,"-37.81668634, 144.96689733"
411820231212,41,2023-12-12,18,1360,1575,2935,Swa31,"-37.81668634, 144.96689733"
772220240330,77,2024-03-30,22,9,5,14,HarEsP_T,"-37.81441438, 144.94433026"
1381220240330,138,2024-03-30,12,10,14,24,EntPark1671_T,"-37.81996544, 144.95981454"
1381620241113,138,2024-11-13,16,13,4,17,EntPark1671_T,"-37.81996544, 144.95981454"
117420250324,117,2025-03-24,4,2,4,6,Fli114F_T,"-37.81629332, 144.97090877"
109820250227,109,2025-02-27,8,116,684,800,LatWill_T,"-37.81193681, 144.95621105"
492120240409,49,2024-04-09,21,146,113,259,Eli501_T,"-37.80730068, 144.95956055"
49820231021,49,2023-10-21,8,83,103,186,Eli501_T,"-37.80730068, 144.95956055"
49020231219,49,2023-12-19,0,50,33,83,Eli501_T,"-37.80730068, 144.95956055"
492320231226,49,2023-12-26,23,78,63,141,Eli501_T,"-37.80730068, 144.95956055"
11320231218,1,2023-12-18,13,1667,1687,3354,Bou292_T,"-37.81349441, 144.96515323"
1120250225,1,2025-02-25,1,10,14,24,Bou292_T,"-37.81349441, 144.96515323"
63020241212,63,2024-12-12,0,6,22,28,Bou231_T,"-37.81333081, 144.96675571"
181620241207,18,2024-12-07,16,156,64,220,Col12_T,"-37.81344862, 144.97305353"
861220250930,86,2025-09-30,12,67,85,152,574Qub_T,"-37.80309992, 144.94908064"
862120240614,86,2024-06-14,21,27,47,74,574Qub_T,"-37.80309992, 144.94908064"
561120250218,56,2025-02-18,11,270,228,498,Lon364_T,"-37.81234775, 144.96153311"
121220240218,12,2024-02-18,12,219,210,429,NewQ_T,"-37.81457988, 144.94292398"
721220240312,72,2024-03-12,12,142,242,384,ACMI_T,"-37.81726338, 144.96872809"
2620240929,2,2024-09-29,6,12,17,29,Bou283_T,"-37.81380668, 144.96516718"
92020250915,9,2025-09-15,20,97,39,136,Col700_T,"-37.81982992, 144.95102555"
792220250321,79,2025-03-21,22,304,1001,1305,FliSS_T,"-37.81794046, 144.96616678"
792320250513,79,2025-05-13,23,75,95,170,FliSS_T,"-37.81794046, 144.96616678"
302320240308,30,2024-03-08,23,327,381,708,Lon189_T,"-37.8112185, 144.96656806"
53620250323,53,2025-03-23,6,16,16,32,Col254_T,"-37.81564191, 144.965499"
531920250518,53,2025-05-18,19,136,100,236,Col254_T,"-37.81564191, 144.965499"
77220240101,77,2024-01-01,2,73,109,182,HarEsP_T,"-37.81441438, 144.94433026"
77020240308,77,2024-03-08,0,3,4,7,HarEsP_T,"-37.81441438, 144.94433026"
77520250519,77,2025-05-19,5,3,11,14,HarEsP_T,"-37.81441438, 144.94433026"
78120240201,78,2024-02-01,1,1,1,2,HarEsB_T,"-37.81471642, 144.9446508"
711320250130,71,2025-01-30,13,18,17,35,WestWP_T,"-37.81235775, 144.97136962"
592320240606,59,2024-06-06,23,148,94,242,RMIT_T,"-37.80825648, 144.96304859"
281020250316,28,2025-03-16,10,570,248,818,VAC_T,"-37.82129925, 144.96879309"
292320240714,29,2024-07-14,23,51,66,117,AG_T,"-37.8199817, 144.96872865"
402220250427,40,2025-04-27,22,26,17,43,Spr201_T,"-37.80999341, 144.97227587"
40320231018,40,2023-10-18,3,2,0,2,Spr201_T,"-37.80999341, 144.97227587"
311920250517,31,2025-05-17,19,228,244,472,Lyg161_T,"-37.80169681, 144.96658911"
312320231101,31,2023-11-01,23,15,52,67,Lyg161_T,"-37.80169681, 144.96658911"
501420231102,50,2023-11-02,14,187,128,315,Lyg309_T,"-37.79808192, 144.96721013"
441620240222,44,2024-02-22,16,12,6,18,UM3_T,"-37.79698741, 144.96441306"
51020250414,5,2025-04-14,10,605,994,1599,PriNW_T,"-37.81874249, 144.96787656"
21120241031,21,2024-10-31,1,24,33,57,Bourke155_T,"-37.81267313, 144.96788288"
36420240815,36,2024-08-15,4,2,6,8,Que85_T,"-37.81652527, 144.96121062"
1431020250322,143,2025-03-22,10,116,360,476,Spencer_T,"-37.821728, 144.95557015"
1342320231102,134,2023-11-02,23,85,94,179,Spen201_T,"-37.81694221, 144.95303935"
1071520250122,107,2025-01-22,15,98,76,174,280Will_T,"-37.81246271, 144.95690188"
1081920250207,108,2025-02-07,19,233,172,405,261Will_T,"-37.81295822, 144.95678789"
1081520240708,108,2024-07-08,15,156,172,328,261Will_T,"-37.81295822, 144.95678789"
61320250819,61,2025-08-19,3,0,4,4,RMIT14_T,"-37.80767455, 144.96309114"
1621420250217,162,2025-02-17,14,264,327,591,Eli489_T,"-37.80740397, 144.95987909"
184220250726,184,2025-07-26,2,29,76,105,Eli124_T,"-37.81512416, 144.96371988"
66220240927,66,2024-09-27,2,67,34,101,QVN_T,"-37.81057846, 144.96444294"
691220250331,69,2025-03-31,12,306,266,572,FLDegC_T,"-37.81687226, 144.96559144"
61120241129,6,2024-11-29,11,736,732,1468,FliS_T,"-37.81911705, 144.96558255"
6720250619,6,2025-06-19,7,464,809,1273,FliS_T,"-37.81911705, 144.96558255"
84720240827,84,2024-08-27,7,781,281,1062,ElFi_T,"-37.81798049, 144.96503383"
139720241208,139,2024-12-08,7,8,5,13,Signal1647_T,"-37.81959923, 144.9632832"
1361420250601,136,2025-06-01,14,68,84,152,BirFed1120_T,"-37.8184141, 144.97357915"
142520240711,142,2024-07-11,5,7,1,8,Hammer1584_T,"-37.81970749, 144.96795734"
1301920240202,130,2024-02-02,19,10,8,18,Bou892T,"-37.8204637, 144.94126826"
491520250601,49,2025-06-01,15,272,757,1029,Eli501_T,"-37.80730068, 144.95956055"
117320240802,117,2024-08-02,3,3,2,5,Fli114F_T,"-37.81629332, 144.97090877"
109520250702,109,2025-07-02,5,11,14,25,LatWill_T,"-37.81193681, 144.95621105"
691820240526,69,2024-05-26,18,69,25,94,FLDegC_T,"-37.81687226, 144.96559144"
84420250618,84,2025-06-18,4,3,17,20,ElFi_T,"-37.81798049, 144.96503383"
701320240111,70,2024-01-11,13,186,155,341,Errol20_T,"-37.80456984, 144.94946228"
391820231020,39,2023-10-20,18,161,99,260,AlfPl_T,"-37.81379749, 144.96995745"
411920240227,41,2024-02-27,19,742,1024,1766,Swa31,"-37.81668634, 144.96689733"
41820250128,41,2025-01-28,8,1667,295,1962,Swa31,"-37.81668634, 144.96689733"
41720250809,41,2025-08-09,7,208,191,399,Swa31,"-37.81668634, 144.96689733"
77220250625,77,2025-06-25,2,7,2,9,HarEsP_T,"-37.81441438, 144.94433026"
541020250829,54,2025-08-29,10,191,113,304,Swa607_T,"-37.804024, 144.96308399"
28220241025,28,2024-10-25,2,6,4,10,VAC_T,"-37.82129925, 144.96879309"
36320250829,36,2025-08-29,3,10,3,13,Que85_T,"-37.81652527, 144.96121062"
371820240702,37,2024-07-02,18,109,74,183,Lyg260_T,"-37.80107122, 144.96704554"
87620240128,87,2024-01-28,6,3,2,5,Errol23_T,"-37.80454949, 144.94921863"
50620250317,50,2025-03-17,6,13,21,34,Lyg309_T,"-37.79808192, 144.96721013"
501320240804,50,2024-08-04,13,266,260,526,Lyg309_T,"-37.79808192, 144.96721013"
5820241127,5,2024-11-27,8,161,465,626,PriNW_T,"-37.81874249, 144.96787656"
51420231022,5,2023-10-22,14,890,1805,2695,PriNW_T,"-37.81874249, 144.96787656"
162820250920,162,2025-09-20,8,170,157,327,Eli489_T,"-37.80740397, 144.95987909"
1671820241101,167,2024-11-01,18,41,69,110,Lat526_T,"-37.81304149, 144.95155955"
131320250211,131,2025-02-11,3,3,13,16,King2_T,"-37.82009057, 144.95758725"
1312220240928,131,2024-09-28,22,162,109,271,King2_T,"-37.82009057, 144.95758725"
67820250507,67,2025-05-07,8,338,315,653,FLDegS_T,"-37.81688755, 144.96562569"
68920240723,68,2024-07-23,9,144,121,265,FLDegN_T,"-37.8168479, 144.96559789"
852020231030,85,2023-10-30,20,19,20,39,488Mac_T,"-37.79432415, 144.92973378"
12620240523,12,2024-05-23,6,34,35,69,NewQ_T,"-37.81457988, 144.94292398"
67020240902,67,2024-09-02,0,4,17,21,FLDegS_T,"-37.81688755, 144.96562569"
241520240913,24,2024-09-13,15,525,843,1368,Col620_T,"-37.81887963, 144.95449198"
24820250214,24,2025-02-14,8,1593,199,1792,Col620_T,"-37.81887963, 144.95449198"
241120240222,24,2024-02-22,11,604,469,1073,Col620_T,"-37.81887963, 144.95449198"
2120241121,2,2024-11-21,1,11,17,28,Bou283_T,"-37.81380668, 144.96516718"
58120241117,58,2024-11-17,1,126,214,340,Bou688_T,"-37.81686075, 144.95358075"
532320240629,53,2024-06-29,23,81,131,212,Col254_T,"-37.81564191, 144.965499"
421620250904,42,2025-09-04,16,203,458,661,UM1_T,"-37.80008566, 144.96386412"
29920241016,29,2024-10-16,9,122,239,361,AG_T,"-37.8199817, 144.96872865"
14020241226,14,2024-12-26,0,577,147,724,SanBri_T,"-37.82011242, 144.96291897"
592320240330,59,2024-03-30,23,272,183,455,RMIT_T,"-37.80825648, 144.96304859"
71620240301,71,2024-03-01,6,19,6,25,WestWP_T,"-37.81235775, 144.97136962"
541820241028,54,2024-10-28,18,105,162,267,Swa607_T,"-37.804024, 144.96308399"
28820240429,28,2024-04-29,8,641,200,841,VAC_T,"-37.82129925, 144.96879309"
47020240330,47,2024-03-30,0,173,202,375,Eli250_T,"-37.81258467, 144.9625775"
211120250705,21,2025-07-05,11,263,240,503,Bourke155_T,"-37.81267313, 144.96788288"
37620250108,37,2025-01-08,6,5,5,10,Lyg260_T,"-37.80107122, 144.96704554"
50720250705,50,2025-07-05,7,3,8,11,Lyg309_T,"-37.79808192, 144.96721013"
43920240611,43,2024-06-11,9,148,71,219,UM2_T,"-37.79844526, 144.96411782"
451320240314,45,2024-03-14,13,592,1029,1621,Swa148_T,"-37.81414075, 144.96609379"
51620231030,5,2023-10-30,16,855,576,1431,PriNW_T,"-37.81874249, 144.96787656"
1341520240601,134,2024-06-01,15,344,319,663,Spen201_T,"-37.81694221, 144.95303935"
134020241202,134,2024-12-02,0,73,71,144,Spen201_T,"-37.81694221, 144.95303935"
1351720240715,135,2024-07-15,17,128,165,293,Spen161_T,"-37.8172861, 144.95319102"
132320250517,132,2025-05-17,3,18,16,34,King335_T,"-37.81267639, 144.95386444"
501320231123,50,2023-11-23,13,170,180,350,Lyg309_T,"-37.79808192, 144.96721013"
1401120251003,140,2025-10-03,11,107,73,180,Boyd2837_T,"-37.82590962, 144.96185972"
1431420250418,143,2025-04-18,14,433,205,638,Spencer_T,"-37.821728, 144.95557015"
1432020250917,143,2025-09-17,20,125,133,258,Spencer_T,"-37.821728, 144.95557015"
69220231118,69,2023-11-18,2,1,1,2,FLDegC_T,"-37.81687226, 144.96559144"
69120250503,69,2025-05-03,1,1,0,1,FLDegC_T,"-37.81687226, 144.96559144"
61220241017,6,2024-10-17,12,911,782,1693,FliS_T,"-37.81911705, 144.96558255"
6920250207,6,2025-02-07,9,595,752,1347,FliS_T,"-37.81911705, 144.96558255"
851620250829,85,2025-08-29,16,84,87,171,488Mac_T,"-37.79432415, 144.92973378"
681120250712,68,2025-07-12,11,457,407,864,FLDegN_T,"-37.8168479, 144.96559789"
63220240422,63,2024-04-22,2,13,45,58,Bou231_T,"-37.81333081, 144.96675571"
86920240326,86,2024-03-26,9,46,38,84,574Qub_T,"-37.80309992, 144.94908064"
621220250326,62,2025-03-26,12,250,235,485,Lat224_T,"-37.80996494, 144.96216521"
1320250714,1,2025-07-14,3,7,7,14,Bou292_T,"-37.81349441, 144.96515323"
122220231121,12,2023-11-21,22,79,93,172,NewQ_T,"-37.81457988, 144.94292398"
241420241010,24,2024-10-10,14,572,961,1533,Col620_T,"-37.81887963, 144.95449198"
10120240911,10,2024-09-11,1,0,1,1,BouHbr_T,"-37.81876474, 144.94710545"
351920241230,35,2024-12-30,19,1316,2018,3334,SouthB_T,"-37.82018685, 144.96508508"
351620250608,35,2025-06-08,16,987,1292,2279,SouthB_T,"-37.82018685, 144.96508508"
76620240923,76,2024-09-23,6,17,24,41,KenMac_T,"-37.79453803, 144.93036194"
21020250924,2,2025-09-24,10,353,449,802,Bou283_T,"-37.81380668, 144.96516718"
27020240810,27,2024-08-10,0,58,23,81,Vic_T,"-37.80606888, 144.95644692"
582320250829,58,2025-08-29,23,170,159,329,Bou688_T,"-37.81686075, 144.95358075"
271020250221,27,2025-02-21,10,110,116,226,Vic_T,"-37.80606888, 144.95644692"
271220251003,27,2025-10-03,12,177,151,328,Vic_T,"-37.80606888, 144.95644692"
41820250623,4,2025-06-23,18,1067,855,1922,Swa123_T,"-37.81487988, 144.9660878"
41020240127,41,2024-01-27,0,688,374,1062,Swa31,"-37.81668634, 144.96689733"
8620231124,8,2023-11-24,6,56,75,131,WebBN_T,"-37.82293543, 144.9471751"
81820240128,8,2024-01-28,18,162,122,284,WebBN_T,"-37.82293543, 144.9471751"
41120240413,41,2024-04-13,1,191,333,524,Swa31,"-37.81668634, 144.96689733"
672220240612,67,2024-06-12,22,35,80,115,FLDegS_T,"-37.81688755, 144.96562569"
18020250402,18,2025-04-02,0,3,0,3,Col12_T,"-37.81344862, 144.97305353"
68720250414,68,2025-04-14,7,87,61,148,FLDegN_T,"-37.8168479, 144.96559789"
112220240813,11,2024-08-13,22,33,31,64,WatCit_T,"-37.81564989, 144.93970694"
101520240317,10,2024-03-17,15,55,27,82,BouHbr_T,"-37.81876474, 144.94710545"
241320250915,24,2025-09-15,13,572,682,1254,Col620_T,"-37.81887963, 144.95449198"
761720250518,76,2025-05-18,17,38,31,69,KenMac_T,"-37.79453803, 144.93036194"
35820231203,35,2023-12-03,8,376,255,631,SouthB_T,"-37.82018685, 144.96508508"
351020240604,35,2024-06-04,10,404,436,840,SouthB_T,"-37.82018685, 144.96508508"
58720241018,58,2024-10-18,7,511,75,586,Bou688_T,"-37.81686075, 144.95358075"
271220240701,27,2024-07-01,12,132,124,256,Vic_T,"-37.80606888, 144.95644692"
91320250712,9,2025-07-12,13,70,186,256,Col700_T,"-37.81982992, 144.95102555"
91420240112,9,2024-01-12,14,285,166,451,Col700_T,"-37.81982992, 144.95102555"
79220250731,79,2025-07-31,2,11,5,16,FliSS_T,"-37.81794046, 144.96616678"
30520250511,30,2025-05-11,5,67,106,173,Lon189_T,"-37.8112185, 144.96656806"
792020240801,79,2024-08-01,20,226,211,437,FliSS_T,"-37.81794046, 144.96616678"
51720250522,51,2025-05-22,7,33,35,68,Fra118_T,"-37.80841815, 144.95906316"
512120250607,51,2025-06-07,21,63,59,122,Fra118_T,"-37.80841815, 144.95906316"
231320240812,23,2024-08-12,13,254,551,805,Col623_T,"-37.81909256, 144.95452748"
23120251006,23,2025-10-06,1,4,3,7,Col623_T,"-37.81909256, 144.95452748"
192020231102,19,2023-11-02,20,622,481,1103,LtB210_T,"-37.81237202, 144.96550671"
48420240221,48,2024-02-21,4,3,6,9,QVMQ_T,"-37.80631581, 144.95866697"
25020241121,25,2024-11-21,0,39,33,72,MCEC_T,"-37.82401776, 144.95604426"
251420240411,25,2024-04-11,14,731,703,1434,MCEC_T,"-37.82401776, 144.95604426"
52720250114,52,2025-01-14,7,58,44,102,Eli263_T,"-37.81252157, 144.9619401"
1372020250507,137,2025-05-07,20,1,11,12,BouHbr2353_T,"-37.81894815, 144.94612292"
1301620240206,130,2024-02-06,16,12,23,35,Bou892T,"-37.8204637, 144.94126826"
1301820240209,130,2024-02-09,18,6,11,17,Bou892T,"-37.8204637, 144.94126826"
164220241028,164,2024-10-28,2,2,2,4,Lat526_T,"-37.813005, 144.95160411"
123720250313,123,2025-03-13,7,49,21,70,BirBridge_T,"-37.81753741, 144.97329734"
491320231028,49,2023-10-28,13,367,470,837,Eli501_T,"-37.80730068, 144.95956055"
109920240714,109,2024-07-14,9,98,64,162,LatWill_T,"-37.81193681, 144.95621105"
109020240403,109,2024-04-03,0,13,16,29,LatWill_T,"-37.81193681, 144.95621105"
4320240123,4,2024-01-23,3,8,7,15,Swa123_T,"-37.81487988, 144.9660878"
701720240928,70,2024-09-28,17,97,114,211,Errol20_T,"-37.80456984, 144.94946228"
702020250311,70,2025-03-11,20,90,107,197,Errol20_T,"-37.80456984, 144.94946228"
78020250425,78,2025-04-25,0,5,18,23,HarEsB_T,"-37.81471642, 144.9446508"
14520240704,14,2024-07-04,5,39,29,68,SanBri_T,"-37.82011242, 144.96291897"
712120240411,71,2024-04-11,21,7,10,17,WestWP_T,"-37.81235775, 144.97136962"
421320250108,42,2025-01-08,13,120,117,237,UM1_T,"-37.80008566, 144.96386412"
421020250201,42,2025-02-01,10,33,51,84,UM1_T,"-37.80008566, 144.96386412"
311920250503,31,2025-05-03,19,415,368,783,Lyg161_T,"-37.80169681, 144.96658911"
54120240219,54,2024-02-19,1,14,9,23,Swa607_T,"-37.804024, 144.96308399"
37520250823,37,2025-08-23,5,0,7,7,Lyg260_T,"-37.80107122, 144.96704554"
47120250502,47,2025-05-02,1,74,37,111,Eli250_T,"-37.81258467, 144.9625775"
47420240628,47,2024-06-28,4,23,24,47,Eli250_T,"-37.81258467, 144.9625775"
52120241031,5,2024-10-31,21,368,407,775,PriNW_T,"-37.81874249, 144.96787656"
51920241115,5,2024-11-15,19,988,1337,2325,PriNW_T,"-37.81874249, 144.96787656"
212220250625,21,2025-06-25,22,62,98,160,Bourke155_T,"-37.81267313, 144.96788288"
211320240123,21,2024-01-23,13,451,555,1006,Bourke155_T,"-37.81267313, 144.96788288"
212320240516,21,2024-05-16,23,113,134,247,Bourke155_T,"-37.81267313, 144.96788288"
361520250926,36,2025-09-26,15,91,107,198,Que85_T,"-37.81652527, 144.96121062"
1431420240630,143,2024-06-30,14,264,317,581,Spencer_T,"-37.821728, 144.95557015"
1431120240706,143,2024-07-06,11,298,648,946,Spencer_T,"-37.821728, 144.95557015"
1321820240829,132,2024-08-29,18,103,131,234,King335_T,"-37.81267639, 144.95386444"
1341620240723,134,2024-07-23,16,513,495,1008,Spen201_T,"-37.81694221, 144.95303935"
131320240412,131,2024-04-12,3,5,11,16,King2_T,"-37.82009057, 144.95758725"
135520250212,135,2025-02-12,5,30,31,61,Spen161_T,"-37.8172861, 144.95319102"
1331820240423,133,2024-04-23,18,709,488,1197,Spen229_T,"-37.81531435, 144.95227769"
1182220251005,118,2025-10-05,22,4,4,8,Fli114C_T,"-37.81632783, 144.97090512"
107120231215,107,2023-12-15,1,23,11,34,280Will_T,"-37.81246271, 144.95690188"
25520240507,25,2024-05-07,5,17,24,41,MCEC_T,"-37.82401776, 144.95604426"
251720240308,25,2024-03-08,17,0,0,0,MCEC_T,"-37.82401776, 144.95604426"
1371820241220,137,2024-12-20,18,11,38,49,BouHbr2353_T,"-37.81894815, 144.94612292"
136620241109,136,2024-11-09,6,44,17,61,BirFed1120_T,"-37.8184141, 144.97357915"
136620231226,136,2023-12-26,6,40,11,51,BirFed1120_T,"-37.8184141, 144.97357915"
1421820250922,142,2025-09-22,18,180,143,323,Hammer1584_T,"-37.81970749, 144.96795734"
142220240516,142,2024-05-16,2,1,2,3,Hammer1584_T,"-37.81970749, 144.96795734"
1301320240401,130,2024-04-01,13,8,6,14,Bou892T,"-37.8204637, 144.94126826"
1231420240619,123,2024-06-19,14,10,1,11,BirBridge_T,"-37.81753741, 144.97329734"
1231020250707,123,2025-07-07,10,37,7,44,BirBridge_T,"-37.81753741, 144.97329734"
1092320250826,109,2025-08-26,23,14,13,27,LatWill_T,"-37.81193681, 144.95621105"
66520240428,66,2024-04-28,5,34,10,44,QVN_T,"-37.81057846, 144.96444294"
66020250619,66,2025-06-19,0,55,38,93,QVN_T,"-37.81057846, 144.96444294"
69620231231,69,2023-12-31,6,13,6,19,FLDegC_T,"-37.81687226, 144.96559144"
84120240812,84,2024-08-12,1,23,21,44,ElFi_T,"-37.81798049, 144.96503383"
701920250127,70,2025-01-27,19,90,96,186,Errol20_T,"-37.80456984, 144.94946228"
752120240811,75,2024-08-11,21,8,14,22,SprFli_T,"-37.81515276, 144.97467661"
39720240824,39,2024-08-24,7,19,32,51,AlfPl_T,"-37.81379749, 144.96995745"
77320240909,77,2024-09-09,3,5,1,6,HarEsP_T,"-37.81441438, 144.94433026"
771320241024,77,2024-10-24,13,107,136,243,HarEsP_T,"-37.81441438, 144.94433026"
771320241127,77,2024-11-27,13,162,72,234,HarEsP_T,"-37.81441438, 144.94433026"
141820231125,14,2023-11-25,18,594,162,756,SanBri_T,"-37.82011242, 144.96291897"
141820231022,14,2023-10-22,18,244,110,354,SanBri_T,"-37.82011242, 144.96291897"
711520241201,71,2024-12-01,15,4,1,5,WestWP_T,"-37.81235775, 144.97136962"
651620231028,65,2023-10-28,16,435,986,1421,SwaCs_T,"-37.81569416, 144.9668064"
28520240803,28,2024-08-03,5,8,13,21,VAC_T,"-37.82129925, 144.96879309"
29420250829,29,2025-08-29,4,3,4,7,AG_T,"-37.8199817, 144.96872865"
291920240120,29,2024-01-20,19,351,484,835,AG_T,"-37.8199817, 144.96872865"
292020240229,29,2024-02-29,20,3,2,5,AG_T,"-37.8199817, 144.96872865"
47820250717,47,2025-07-17,8,210,662,872,Eli250_T,"-37.81258467, 144.9625775"
471620250414,47,2025-04-14,16,1022,993,2015,Eli250_T,"-37.81258467, 144.9625775"
45720250918,45,2025-09-18,7,132,162,294,Swa148_T,"-37.81414075, 144.96609379"
51220250114,5,2025-01-14,12,1072,1341,2413,PriNW_T,"-37.81874249, 144.96787656"
362320250926,36,2025-09-26,23,145,157,302,Que85_T,"-37.81652527, 144.96121062"
1071620250715,107,2025-07-15,16,125,121,246,280Will_T,"-37.81246271, 144.95690188"
118620241019,118,2024-10-19,6,2,1,3,Fli114C_T,"-37.81632783, 144.97090512"
871420250913,87,2025-09-13,14,140,133,273,Errol23_T,"-37.80454949, 144.94921863"
611320250610,61,2025-06-10,13,401,514,915,RMIT14_T,"-37.80767455, 144.96309114"
61820240511,61,2024-05-11,8,68,106,174,RMIT14_T,"-37.80767455, 144.96309114"
61820240614,61,2024-06-14,8,122,269,391,RMIT14_T,"-37.80767455, 144.96309114"
501220250413,50,2025-04-13,12,209,261,470,Lyg309_T,"-37.79808192, 144.96721013"
502020240811,50,2024-08-11,20,234,102,336,Lyg309_T,"-37.79808192, 144.96721013"
43520241007,43,2024-10-07,5,3,2,5,UM2_T,"-37.79844526, 144.96411782"
1791520250613,179,2025-06-13,15,58,57,115,Pow61_T,"-37.82392385, 144.96299677"
167720250320,167,2025-03-20,7,16,64,80,Lat526_T,"-37.81304149, 144.95155955"
131120241125,131,2024-11-25,1,5,18,23,King2_T,"-37.82009057, 144.95758725"
1331120250701,133,2025-07-01,11,320,334,654,Spen229_T,"-37.81531435, 144.95227769"
133120250517,133,2025-05-17,1,35,35,70,Spen229_T,"-37.81531435, 144.95227769"
1241420250313,124,2025-03-13,14,4,6,10,BirBridge_T,"-37.81757416, 144.97329934"
68020241006,68,2024-10-06,0,6,1,7,FLDegN_T,"-37.8168479, 144.96559789"
85620250617,85,2025-06-17,6,20,11,31,488Mac_T,"-37.79432415, 144.92973378"
17320240512,17,2024-05-12,3,2,3,5,Col15_T,"-37.81362543, 144.97323591"
11220240207,1,2024-02-07,12,1282,1014,2296,Bou292_T,"-37.81349441, 144.96515323"
671420240409,67,2024-04-09,14,384,575,959,FLDegS_T,"-37.81688755, 144.96562569"
1320250529,1,2025-05-29,3,2,6,8,Bou292_T,"-37.81349441, 144.96515323"
631320240927,63,2024-09-27,13,383,439,822,Bou231_T,"-37.81333081, 144.96675571"
68120250329,68,2025-03-29,1,4,5,9,FLDegN_T,"-37.8168479, 144.96559789"
181520250729,18,2025-07-29,15,334,125,459,Col12_T,"-37.81344862, 144.97305353"
63020240201,63,2024-02-01,0,25,57,82,Bou231_T,"-37.81333081, 144.96675571"
111820241213,11,2024-12-13,18,197,146,343,WatCit_T,"-37.81564989, 144.93970694"
10920250225,10,2025-02-25,9,56,129,185,BouHbr_T,"-37.81876474, 144.94710545"
72620240731,72,2024-07-31,6,58,27,85,ACMI_T,"-37.81726338, 144.96872809"
761320250814,76,2025-08-14,13,74,59,133,KenMac_T,"-37.79453803, 144.93036194"
272020241111,27,2024-11-11,20,81,41,122,Vic_T,"-37.80606888, 144.95644692"
271920240301,27,2024-03-01,19,134,72,206,Vic_T,"-37.80606888, 144.95644692"
53020240802,53,2024-08-02,0,8,17,25,Col254_T,"-37.81564191, 144.965499"
791320240316,79,2024-03-16,13,899,482,1381,FliSS_T,"-37.81794046, 144.96616678"
302120240116,30,2024-01-16,21,209,282,491,Lon189_T,"-37.8112185, 144.96656806"
531820250912,53,2025-09-12,18,425,314,739,Col254_T,"-37.81564191, 144.965499"
51820251010,51,2025-10-10,8,62,71,133,Fra118_T,"-37.80841815, 144.95906316"
512120241226,51,2024-12-26,21,46,69,115,Fra118_T,"-37.80841815, 144.95906316"
511020250401,51,2025-04-01,10,96,84,180,Fra118_T,"-37.80841815, 144.95906316"
19020240115,19,2024-01-15,0,54,83,137,LtB210_T,"-37.81237202, 144.96550671"
481920240930,48,2024-09-30,19,94,121,215,QVMQ_T,"-37.80631581, 144.95866697"
201520231211,20,2023-12-11,15,143,209,352,LtB170_T,"-37.81172914, 144.9682466"
46920241003,46,2024-10-03,9,139,44,183,Pel147_T,"-37.80240719, 144.9615673"
1371220241017,137,2024-10-17,12,48,83,131,BouHbr2353_T,"-37.81894815, 144.94612292"
142920240101,142,2024-01-01,9,194,120,314,Hammer1584_T,"-37.81970749, 144.96795734"
1302020250706,130,2025-07-06,20,378,563,941,Bou892T,"-37.8204637, 144.94126826"
1171420250221,117,2025-02-21,14,145,158,303,Fli114F_T,"-37.81629332, 144.97090877"
123020240503,123,2024-05-03,0,1,0,1,BirBridge_T,"-37.81753741, 144.97329734"
1231620250513,123,2025-05-13,16,36,29,65,BirBridge_T,"-37.81753741, 144.97329734"
1381520240611,138,2024-06-11,15,2,3,5,EntPark1671_T,"-37.81996544, 144.95981454"
1092020250507,109,2025-05-07,20,70,71,141,LatWill_T,"-37.81193681, 144.95621105"
1091620241101,109,2024-11-01,16,278,136,414,LatWill_T,"-37.81193681, 144.95621105"
62020231021,6,2023-10-21,20,963,773,1736,FliS_T,"-37.81911705, 144.96558255"
62320231105,6,2023-11-05,23,312,171,483,FliS_T,"-37.81911705, 144.96558255"
841420250305,84,2025-03-05,14,872,1186,2058,ElFi_T,"-37.81798049, 144.96503383"
37120240917,37,2024-09-17,1,9,4,13,Lyg260_T,"-37.80107122, 144.96704554"
871020231121,87,2023-11-21,10,86,69,155,Errol23_T,"-37.80454949, 144.94921863"
612320240829,61,2024-08-29,23,216,108,324,RMIT14_T,"-37.80767455, 144.96309114"
442220250811,44,2025-08-11,22,16,17,33,UM3_T,"-37.79698741, 144.96441306"
451120240723,45,2024-07-23,11,522,424,946,Swa148_T,"-37.81414075, 144.96609379"
451420240314,45,2024-03-14,14,671,1079,1750,Swa148_T,"-37.81414075, 144.96609379"
51620241030,5,2024-10-30,16,1050,760,1810,PriNW_T,"-37.81874249, 144.96787656"
5320241212,5,2024-12-12,3,17,13,30,PriNW_T,"-37.81874249, 144.96787656"
211320250123,21,2025-01-23,13,381,555,936,Bourke155_T,"-37.81267313, 144.96788288"
1431320250304,143,2025-03-04,13,141,211,352,Spencer_T,"-37.821728, 144.95557015"
1401020240508,140,2024-05-08,10,85,46,131,Boyd2837_T,"-37.82590962, 144.96185972"
1351520240909,135,2024-09-09,15,376,344,720,Spen161_T,"-37.8172861, 144.95319102"
1181220250130,118,2025-01-30,12,22,16,38,Fli114C_T,"-37.81632783, 144.97090512"
108620250716,108,2025-07-16,6,26,236,262,261Will_T,"-37.81295822, 144.95678789"
671520240815,67,2024-08-15,15,369,602,971,FLDegS_T,"-37.81688755, 144.96562569"
681520240409,68,2024-04-09,15,179,143,322,FLDegN_T,"-37.8168479, 144.96559789"
85920240225,85,2024-02-25,9,93,78,171,488Mac_T,"-37.79432415, 144.92973378"
171620250921,17,2025-09-21,16,126,78,204,Col15_T,"-37.81362543, 144.97323591"
671620240214,67,2024-02-14,16,398,585,983,FLDegS_T,"-37.81688755, 144.96562569"
18020231031,18,2023-10-31,0,2,2,4,Col12_T,"-37.81344862, 144.97305353"
631620250710,63,2025-07-10,16,373,481,854,Bou231_T,"-37.81333081, 144.96675571"
63020251006,63,2025-10-06,0,12,27,39,Bou231_T,"-37.81333081, 144.96675571"
12320250816,1,2025-08-16,23,120,109,229,Bou292_T,"-37.81349441, 144.96515323"
862320231117,86,2023-11-17,23,1,25,26,574Qub_T,"-37.80309992, 144.94908064"
861420240424,86,2024-04-24,14,64,75,139,574Qub_T,"-37.80309992, 144.94908064"
671320250610,67,2025-06-10,13,442,631,1073,FLDegS_T,"-37.81688755, 144.96562569"
621520240925,62,2024-09-25,15,254,162,416,Lat224_T,"-37.80996494, 144.96216521"
56820231102,56,2023-11-02,8,90,117,207,Lon364_T,"-37.81234775, 144.96153311"
56320250213,56,2025-02-13,3,7,12,19,Lon364_T,"-37.81234775, 144.96153311"
861520250807,86,2025-08-07,15,41,50,91,574Qub_T,"-37.80309992, 144.94908064"
101920240913,10,2024-09-13,19,67,38,105,BouHbr_T,"-37.81876474, 144.94710545"
101820241005,10,2024-10-05,18,136,83,219,BouHbr_T,"-37.81876474, 144.94710545"
242120240702,24,2024-07-02,21,276,406,682,Col620_T,"-37.81887963, 144.95449198"
721220240914,72,2024-09-14,12,159,270,429,ACMI_T,"-37.81726338, 144.96872809"
58720240526,58,2024-05-26,7,90,59,149,Bou688_T,"-37.81686075, 144.95358075"
76020240428,76,2024-04-28,0,0,3,3,KenMac_T,"-37.79453803, 144.93036194"
531320240309,53,2024-03-09,13,687,482,1169,Col254_T,"-37.81564191, 144.965499"
232120250728,23,2025-07-28,21,69,143,212,Col623_T,"-37.81909256, 144.95452748"
461220250225,46,2025-02-25,12,113,121,234,Pel147_T,"-37.80240719, 144.9615673"
461920240316,46,2024-03-16,19,63,51,114,Pel147_T,"-37.80240719, 144.9615673"
46820240617,46,2024-06-17,8,41,78,119,Pel147_T,"-37.80240719, 144.9615673"
191320240913,19,2024-09-13,13,438,468,906,LtB210_T,"-37.81237202, 144.96550671"
1371520250606,137,2025-06-06,15,14,68,82,BouHbr2353_T,"-37.81894815, 144.94612292"
139520250320,139,2025-03-20,5,1,1,2,Signal1647_T,"-37.81959923, 144.9632832"
1391520250907,139,2025-09-07,15,44,42,86,Signal1647_T,"-37.81959923, 144.9632832"
1371220240520,137,2024-05-20,12,29,70,99,BouHbr2353_T,"-37.81894815, 144.94612292"
139220240111,139,2024-01-11,2,2,0,2,Signal1647_T,"-37.81959923, 144.9632832"
1361720250713,136,2025-07-13,17,15,46,61,BirFed1120_T,"-37.8184141, 144.97357915"
1301520240131,130,2024-01-31,15,20,18,38,Bou892T,"-37.8204637, 144.94126826"
662120240406,66,2024-04-06,21,1042,791,1833,QVN_T,"-37.81057846, 144.96444294"
691220251003,69,2025-10-03,12,402,444,846,FLDegC_T,"-37.81687226, 144.96559144"
842320240730,84,2024-07-30,23,91,151,242,ElFi_T,"-37.81798049, 144.96503383"
31820250313,3,2025-03-13,18,1154,1332,2486,Swa295_T,"-37.81101524, 144.96429485"
39920251003,39,2025-10-03,9,95,104,199,AlfPl_T,"-37.81379749, 144.96995745"
78620240826,78,2024-08-26,6,2,4,6,HarEsB_T,"-37.81471642, 144.9446508"
591020240426,59,2024-04-26,10,857,675,1532,RMIT_T,"-37.80825648, 144.96304859"
31220250304,31,2025-03-04,2,0,2,2,Lyg161_T,"-37.80169681, 144.96658911"
36820250809,36,2025-08-09,8,70,37,107,Que85_T,"-37.81652527, 144.96121062"
361420231124,36,2023-11-24,14,187,264,451,Que85_T,"-37.81652527, 144.96121062"
44320251005,44,2025-10-05,3,8,6,14,UM3_T,"-37.79698741, 144.96441306"
45420240210,45,2024-02-10,4,8,27,35,Swa148_T,"-37.81414075, 144.96609379"
452120240513,45,2024-05-13,21,90,284,374,Swa148_T,"-37.81414075, 144.96609379"
51620250304,5,2025-03-04,16,1150,829,1979,PriNW_T,"-37.81874249, 144.96787656"
1811020250711,181,2025-07-11,10,348,641,989,Eli368_T,"-37.81009465, 144.96143149"
1621320240916,162,2024-09-16,13,438,534,972,Eli489_T,"-37.80740397, 144.95987909"
1621220250801,162,2025-08-01,12,608,841,1449,Eli489_T,"-37.80740397, 144.95987909"
1352120240428,135,2024-04-28,21,79,117,196,Spen161_T,"-37.8172861, 144.95319102"
1331620240706,133,2024-07-06,16,637,492,1129,Spen229_T,"-37.81531435, 144.95227769"
1182020240130,118,2024-01-30,20,4,4,8,Fli114C_T,"-37.81632783, 144.97090512"
118620240524,118,2024-05-24,6,3,2,5,Fli114C_T,"-37.81632783, 144.97090512"
1661120250120,166,2025-01-20,11,33,35,68,Spen484_T,"-37.80896733, 144.94931703"
85620240723,85,2024-07-23,6,7,3,10,488Mac_T,"-37.79432415, 144.92973378"
17420250808,17,2025-08-08,4,11,8,19,Col15_T,"-37.81362543, 144.97323591"
12120250504,1,2025-05-04,21,136,169,305,Bou292_T,"-37.81349441, 144.96515323"
11920250617,1,2025-06-17,19,461,307,768,Bou292_T,"-37.81349441, 144.96515323"
112220240917,11,2024-09-17,22,25,25,50,WatCit_T,"-37.81564989, 144.93970694"
56520240624,56,2024-06-24,5,12,8,20,Lon364_T,"-37.81234775, 144.96153311"
10720231124,10,2023-11-24,7,53,114,167,BouHbr_T,"-37.81876474, 144.94710545"
121620250129,12,2025-01-29,16,160,153,313,NewQ_T,"-37.81457988, 144.94292398"
561120250617,56,2025-06-17,11,307,235,542,Lon364_T,"-37.81234775, 144.96153311"
72220240915,72,2024-09-15,2,7,12,19,ACMI_T,"-37.81726338, 144.96872809"
35920251002,35,2025-10-02,9,565,838,1403,SouthB_T,"-37.82018685, 144.96508508"
762020250731,76,2025-07-31,20,15,18,33,KenMac_T,"-37.79453803, 144.93036194"
35820240707,35,2024-07-07,8,335,291,626,SouthB_T,"-37.82018685, 144.96508508"
271720240818,27,2024-08-18,17,149,94,243,Vic_T,"-37.80606888, 144.95644692"
21020241130,2,2024-11-30,10,284,492,776,Bou283_T,"-37.81380668, 144.96516718"
661620231226,66,2023-12-26,16,1828,1800,3628,QVN_T,"-37.81057846, 144.96444294"
3820240815,3,2024-08-15,8,270,391,661,Swa295_T,"-37.81101524, 144.96429485"
32320241123,3,2024-11-23,23,627,610,1237,Swa295_T,"-37.81101524, 144.96429485"
3720250605,3,2025-06-05,7,50,110,160,Swa295_T,"-37.81101524, 144.96429485"
391820240828,39,2024-08-28,18,109,53,162,AlfPl_T,"-37.81379749, 144.96995745"
81620240428,8,2024-04-28,16,177,244,421,WebBN_T,"-37.82293543, 144.9471751"
411020240319,41,2024-03-19,10,1293,749,2042,Swa31,"-37.81668634, 144.96689733"
772320250904,77,2025-09-04,23,14,9,23,HarEsP_T,"-37.81441438, 144.94433026"
711120231020,71,2023-10-20,11,20,11,31,WestWP_T,"-37.81235775, 144.97136962"
401520251001,40,2025-10-01,15,370,151,521,Spr201_T,"-37.80999341, 144.97227587"
36220240510,36,2024-05-10,2,9,5,14,Que85_T,"-37.81652527, 144.96121062"
51120240601,5,2024-06-01,11,799,952,1751,PriNW_T,"-37.81874249, 144.96787656"
5620250126,5,2025-01-26,6,62,75,137,PriNW_T,"-37.81874249, 144.96787656"
1072320250312,107,2025-03-12,23,27,33,60,280Will_T,"-37.81246271, 144.95690188"
1071520250926,107,2025-09-26,15,116,92,208,280Will_T,"-37.81246271, 144.95690188"
1181220240610,118,2024-06-10,12,33,56,89,Fli114C_T,"-37.81632783, 144.97090512"
611920250330,61,2025-03-30,19,496,331,827,RMIT14_T,"-37.80767455, 144.96309114"
612020250509,61,2025-05-09,20,437,275,712,RMIT14_T,"-37.80767455, 144.96309114"
612220241009,61,2024-10-09,22,275,108,383,RMIT14_T,"-37.80767455, 144.96309114"
1651020251007,165,2025-10-07,10,22,25,47,Spen475_T,"-37.80953359, 144.94939004"
1672120250322,167,2025-03-22,21,20,31,51,Lat526_T,"-37.81304149, 144.95155955"
1402120240826,140,2024-08-26,21,0,1,1,Boyd2837_T,"-37.82590962, 144.96185972"
1312020240428,131,2024-04-28,20,118,34,152,King2_T,"-37.82009057, 144.95758725"
1431320240819,143,2024-08-19,13,148,154,302,Spencer_T,"-37.821728, 144.95557015"
1431320250216,143,2025-02-16,13,146,224,370,Spencer_T,"-37.821728, 144.95557015"
132620241219,132,2024-12-19,6,39,25,64,King335_T,"-37.81267639, 144.95386444"
1322020231118,132,2023-11-18,20,124,142,266,King335_T,"-37.81267639, 144.95386444"
1321120250503,132,2025-05-03,11,170,111,281,King335_T,"-37.81267639, 144.95386444"
134320250226,134,2025-02-26,3,19,14,33,Spen201_T,"-37.81694221, 144.95303935"
1341220231025,134,2023-10-25,12,297,282,579,Spen201_T,"-37.81694221, 144.95303935"
133920240914,133,2024-09-14,9,272,292,564,Spen229_T,"-37.81531435, 144.95227769"
1182320240407,118,2024-04-07,23,1,0,1,Fli114C_T,"-37.81632783, 144.97090512"
681120241107,68,2024-11-07,11,153,107,260,FLDegN_T,"-37.8168479, 144.96559789"
851720240809,85,2024-08-09,17,96,117,213,488Mac_T,"-37.79432415, 144.92973378"
171520250704,17,2025-07-04,15,224,262,486,Col15_T,"-37.81362543, 144.97323591"
11720231130,1,2023-11-30,17,1797,1325,3122,Bou292_T,"-37.81349441, 144.96515323"
682220250504,68,2025-05-04,22,18,16,34,FLDegN_T,"-37.8168479, 144.96559789"
861820240301,86,2024-03-01,18,68,60,128,574Qub_T,"-37.80309992, 144.94908064"
621720250221,62,2025-02-21,17,330,209,539,Lat224_T,"-37.80996494, 144.96216521"
121720250629,12,2025-06-29,17,91,93,184,NewQ_T,"-37.81457988, 144.94292398"
722220231209,72,2023-12-09,22,273,233,506,ACMI_T,"-37.81726338, 144.96872809"
762020250210,76,2025-02-10,20,16,25,41,KenMac_T,"-37.79453803, 144.93036194"
27920240721,27,2024-07-21,9,101,129,230,Vic_T,"-37.80606888, 144.95644692"
531020250122,53,2025-01-22,10,630,420,1050,Col254_T,"-37.81564191, 144.965499"
531120250203,53,2025-02-03,11,538,390,928,Col254_T,"-37.81564191, 144.965499"
30720250812,30,2025-08-12,7,40,49,89,Lon189_T,"-37.8112185, 144.96656806"
791220250121,79,2025-01-21,12,565,394,959,FliSS_T,"-37.81794046, 144.96616678"
252220240606,25,2024-06-06,22,110,108,218,MCEC_T,"-37.82401776, 144.95604426"
202020240403,20,2024-04-03,20,290,548,838,LtB170_T,"-37.81172914, 144.9682466"
521020250530,52,2025-05-30,10,179,185,364,Eli263_T,"-37.81252157, 144.9619401"
53820240705,53,2024-07-05,8,289,206,495,Col254_T,"-37.81564191, 144.965499"
9720240803,9,2024-08-03,7,20,17,37,Col700_T,"-37.81982992, 144.95102555"
9020231127,9,2023-11-27,0,4,13,17,Col700_T,"-37.81982992, 144.95102555"
792120250429,79,2025-04-29,21,140,165,305,FliSS_T,"-37.81794046, 144.96616678"
51520241207,51,2024-12-07,5,3,5,8,Fra118_T,"-37.80841815, 144.95906316"
232320241017,23,2024-10-17,23,32,59,91,Col623_T,"-37.81909256, 144.95452748"
23120250205,23,2025-02-05,1,2,6,8,Col623_T,"-37.81909256, 144.95452748"
1091920231222,109,2023-12-22,19,99,139,238,LatWill_T,"-37.81193681, 144.95621105"
492320250611,49,2025-06-11,23,73,93,166,Eli501_T,"-37.80730068, 144.95956055"
19720241119,19,2024-11-19,7,36,23,59,LtB210_T,"-37.81237202, 144.96550671"
191320231212,19,2023-12-12,13,515,522,1037,LtB210_T,"-37.81237202, 144.96550671"
1391320250706,139,2025-07-06,13,59,37,96,Signal1647_T,"-37.81959923, 144.9632832"
1302220241201,130,2024-12-01,22,5,8,13,Bou892T,"-37.8204637, 144.94126826"
130920231204,130,2023-12-04,9,11,20,31,Bou892T,"-37.8204637, 144.94126826"
161820250115,161,2025-01-15,8,329,249,578,BirArt1109_T,"-37.81851276, 144.97131336"
1231120250227,123,2025-02-27,11,65,30,95,BirBridge_T,"-37.81753741, 144.97329734"
4920250320,4,2025-03-20,9,770,547,1317,Swa123_T,"-37.81487988, 144.9660878"
4320250419,4,2025-04-19,3,46,86,132,Swa123_T,"-37.81487988, 144.9660878"
8020240819,8,2024-08-19,0,2,1,3,WebBN_T,"-37.82293543, 144.9471751"
81620240912,8,2024-09-12,16,154,291,445,WebBN_T,"-37.82293543, 144.9471751"
411320250411,41,2025-04-11,13,1812,1911,3723,Swa31,"-37.81668634, 144.96689733"
421120241204,42,2024-12-04,11,134,235,369,UM1_T,"-37.80008566, 144.96386412"
771620240601,77,2024-06-01,16,171,113,284,HarEsP_T,"-37.81441438, 144.94433026"
771320250524,77,2025-05-24,13,182,92,274,HarEsP_T,"-37.81441438, 144.94433026"
771720251007,77,2025-10-07,17,314,169,483,HarEsP_T,"-37.81441438, 144.94433026"
42720241020,42,2024-10-20,7,4,8,12,UM1_T,"-37.80008566, 144.96386412"
78420250521,78,2025-05-21,4,0,1,1,HarEsB_T,"-37.81471642, 144.9446508"
711720241015,71,2024-10-15,17,18,11,29,WestWP_T,"-37.81235775, 144.97136962"
541020240120,54,2024-01-20,10,38,48,86,Swa607_T,"-37.804024, 144.96308399"
29620250711,29,2025-07-11,6,41,35,76,AG_T,"-37.8199817, 144.96872865"
401220231019,40,2023-10-19,12,357,543,900,Spr201_T,"-37.80999341, 144.97227587"
311220250303,31,2025-03-03,12,140,153,293,Lyg161_T,"-37.80169681, 144.96658911"
361520250711,36,2025-07-11,15,159,166,325,Que85_T,"-37.81652527, 144.96121062"
36320241006,36,2024-10-06,3,175,90,265,Que85_T,"-37.81652527, 144.96121062"
361020241011,36,2024-10-11,10,147,148,295,Que85_T,"-37.81652527, 144.96121062"
37520231201,37,2023-12-01,5,1,1,2,Lyg260_T,"-37.80107122, 144.96704554"
37920240205,37,2024-02-05,9,68,62,130,Lyg260_T,"-37.80107122, 144.96704554"
61420250115,61,2025-01-15,4,5,6,11,RMIT14_T,"-37.80767455, 144.96309114"
451420250226,45,2025-02-26,14,333,696,1029,Swa148_T,"-37.81414075, 144.96609379"
451620240312,45,2024-03-12,16,473,799,1272,Swa148_T,"-37.81414075, 144.96609379"
131420250608,131,2025-06-08,4,10,32,42,King2_T,"-37.82009057, 144.95758725"
140620240414,140,2024-04-14,6,4,0,4,Boyd2837_T,"-37.82590962, 144.96185972"
1321020240115,132,2024-01-15,10,130,73,203,King335_T,"-37.81267639, 144.95386444"
132320240929,132,2024-09-29,3,20,10,30,King335_T,"-37.81267639, 144.95386444"
134820250618,134,2025-06-18,8,296,370,666,Spen201_T,"-37.81694221, 144.95303935"
107220241126,107,2024-11-26,2,7,5,12,280Will_T,"-37.81246271, 144.95690188"
1322320240827,132,2024-08-27,23,18,19,37,King335_T,"-37.81267639, 144.95386444"
1341220241219,134,2024-12-19,12,327,336,663,Spen201_T,"-37.81694221, 144.95303935"
134220231221,134,2023-12-21,2,20,13,33,Spen201_T,"-37.81694221, 144.95303935"
107820250605,107,2025-06-05,8,62,217,279,280Will_T,"-37.81246271, 144.95690188"
1331120240915,133,2024-09-15,11,338,371,709,Spen229_T,"-37.81531435, 144.95227769"
851020240319,85,2024-03-19,10,69,63,132,488Mac_T,"-37.79432415, 144.92973378"
172320240212,17,2024-02-12,23,40,55,95,Col15_T,"-37.81362543, 144.97323591"
18020241009,18,2024-10-09,0,0,1,1,Col12_T,"-37.81344862, 144.97305353"
621220250920,62,2025-09-20,12,300,252,552,Lat224_T,"-37.80996494, 144.96216521"
11520250922,1,2025-09-22,15,1100,1055,2155,Bou292_T,"-37.81349441, 144.96515323"
111720240315,11,2024-03-15,17,139,135,274,WatCit_T,"-37.81564989, 144.93970694"
56220240620,56,2024-06-20,2,7,6,13,Lon364_T,"-37.81234775, 144.96153311"
35320240326,35,2024-03-26,3,9,14,23,SouthB_T,"-37.82018685, 144.96508508"
72620250516,72,2025-05-16,6,64,31,95,ACMI_T,"-37.81726338, 144.96872809"
581520240306,58,2024-03-06,15,546,642,1188,Bou688_T,"-37.81686075, 144.95358075"
21720241123,2,2024-11-23,17,647,570,1217,Bou283_T,"-37.81380668, 144.96516718"
92020240523,9,2024-05-23,20,134,59,193,Col700_T,"-37.81982992, 144.95102555"
53520240314,53,2024-03-14,5,7,7,14,Col254_T,"-37.81564191, 144.965499"
231920240613,23,2024-06-13,19,133,262,395,Col623_T,"-37.81909256, 144.95452748"
231120240616,23,2024-06-16,11,186,223,409,Col623_T,"-37.81909256, 144.95452748"
301520250212,30,2025-02-12,15,162,365,527,Lon189_T,"-37.8112185, 144.96656806"
481320231026,48,2023-10-26,13,328,251,579,QVMQ_T,"-37.80631581, 144.95866697"
482020240312,48,2024-03-12,20,79,152,231,QVMQ_T,"-37.80631581, 144.95866697"
251820251008,25,2025-10-08,18,1151,708,1859,MCEC_T,"-37.82401776, 144.95604426"
20620240720,20,2024-07-20,6,11,10,21,LtB170_T,"-37.81172914, 144.9682466"
20720241109,20,2024-11-09,7,19,22,41,LtB170_T,"-37.81172914, 144.9682466"
1412220231112,141,2023-11-12,22,47,64,111,474Fl_T,"-37.81997273, 144.95834911"
136620240906,136,2024-09-06,6,29,13,42,BirFed1120_T,"-37.8184141, 144.97357915"
1232120240623,123,2024-06-23,21,6,0,6,BirBridge_T,"-37.81753741, 144.97329734"
1091020240318,109,2024-03-18,10,138,224,362,LatWill_T,"-37.81193681, 144.95621105"
31320240214,3,2024-02-14,13,1252,1324,2576,Swa295_T,"-37.81101524, 144.96429485"
61620250529,6,2025-05-29,16,1588,778,2366,FliS_T,"-37.81911705, 144.96558255"
66520240224,66,2024-02-24,5,9,15,24,QVN_T,"-37.81057846, 144.96444294"
391620231116,39,2023-11-16,16,122,139,261,AlfPl_T,"-37.81379749, 144.96995745"
391820231119,39,2023-11-19,18,51,35,86,AlfPl_T,"-37.81379749, 144.96995745"
75620240129,75,2024-01-29,6,26,16,42,SprFli_T,"-37.81515276, 144.97467661"
391320241118,39,2024-11-18,13,159,173,332,AlfPl_T,"-37.81379749, 144.96995745"
139920240909,139,2024-09-09,9,32,98,130,Signal1647_T,"-37.81959923, 144.9632832"
1422120231214,142,2023-12-14,21,906,650,1556,Hammer1584_T,"-37.81970749, 144.96795734"
142420240707,142,2024-07-07,4,3,0,3,Hammer1584_T,"-37.81970749, 144.96795734"
1302120241023,130,2024-10-23,21,9,14,23,Bou892T,"-37.8204637, 144.94126826"
138620241123,138,2024-11-23,6,1,1,2,EntPark1671_T,"-37.81996544, 144.95981454"
1231320240812,123,2024-08-12,13,42,7,49,BirBridge_T,"-37.81753741, 144.97329734"
1231920250403,123,2025-04-03,19,54,19,73,BirBridge_T,"-37.81753741, 144.97329734"
117120240105,117,2024-01-05,1,19,5,24,Fli114F_T,"-37.81629332, 144.97090877"
192120250501,19,2025-05-01,21,352,472,824,LtB210_T,"-37.81237202, 144.96550671"
69820250510,69,2025-05-10,8,87,55,142,FLDegC_T,"-37.81687226, 144.96559144"
3520241214,3,2024-12-14,5,38,21,59,Swa295_T,"-37.81101524, 144.96429485"
32120240402,3,2024-04-02,21,828,676,1504,Swa295_T,"-37.81101524, 144.96429485"
391220251003,39,2025-10-03,12,285,123,408,AlfPl_T,"-37.81379749, 144.96995745"
42920250927,42,2025-09-27,9,16,28,44,UM1_T,"-37.80008566, 144.96386412"
782120250624,78,2025-06-24,21,3,6,9,HarEsB_T,"-37.81471642, 144.9446508"
652320231208,65,2023-12-08,23,231,338,569,SwaCs_T,"-37.81569416, 144.9668064"
401820241026,40,2024-10-26,18,153,225,378,Spr201_T,"-37.80999341, 144.97227587"
48920250909,48,2025-09-09,9,175,144,319,QVMQ_T,"-37.80631581, 144.95866697"
141420240515,141,2024-05-15,4,10,4,14,474Fl_T,"-37.81997273, 144.95834911"
1412120240524,141,2024-05-24,21,102,106,208,474Fl_T,"-37.81997273, 144.95834911"
681120250909,68,2025-09-09,11,341,243,584,FLDegN_T,"-37.8168479, 144.96559789"
852220241004,85,2024-10-04,22,12,28,40,488Mac_T,"-37.79432415, 144.92973378"
85920250801,85,2025-08-01,9,89,60,149,488Mac_T,"-37.79432415, 144.92973378"
17020240927,17,2024-09-27,0,19,33,52,Col15_T,"-37.81362543, 144.97323591"
632020250301,63,2025-03-01,20,178,380,558,Bou231_T,"-37.81333081, 144.96675571"
671520250716,67,2025-07-16,15,406,598,1004,FLDegS_T,"-37.81688755, 144.96562569"
62520250922,62,2025-09-22,5,14,6,20,Lat224_T,"-37.80996494, 144.96216521"
62420250414,62,2025-04-14,4,13,10,23,Lat224_T,"-37.80996494, 144.96216521"
561720231022,56,2023-10-22,17,247,141,388,Lon364_T,"-37.81234775, 144.96153311"
561820240122,56,2024-01-22,18,257,259,516,Lon364_T,"-37.81234775, 144.96153311"
121620240701,12,2024-07-01,16,143,164,307,NewQ_T,"-37.81457988, 144.94292398"
121620241201,12,2024-12-01,16,187,202,389,NewQ_T,"-37.81457988, 144.94292398"
121920231227,12,2023-12-27,19,320,346,666,NewQ_T,"-37.81457988, 144.94292398"
241320250613,24,2025-06-13,13,664,558,1222,Col620_T,"-37.81887963, 144.95449198"
721120240415,72,2024-04-15,11,165,181,346,ACMI_T,"-37.81726338, 144.96872809"
24720250817,24,2025-08-17,7,117,164,281,Col620_T,"-37.81887963, 144.95449198"
351520240227,35,2024-02-27,15,1068,916,1984,SouthB_T,"-37.82018685, 144.96508508"
2820240721,2,2024-07-21,8,33,38,71,Bou283_T,"-37.81380668, 144.96516718"
581820240513,58,2024-05-13,18,458,412,870,Bou688_T,"-37.81686075, 144.95358075"
762320240904,76,2024-09-04,23,5,1,6,KenMac_T,"-37.79453803, 144.93036194"
35420241009,35,2024-10-09,4,18,7,25,SouthB_T,"-37.82018685, 144.96508508"
35320250611,35,2025-06-11,3,1,6,7,SouthB_T,"-37.82018685, 144.96508508"
21620250803,2,2025-08-03,16,814,690,1504,Bou283_T,"-37.81380668, 144.96516718"
53320240830,53,2024-08-30,3,8,4,12,Col254_T,"-37.81564191, 144.965499"
79220250810,79,2025-08-10,2,73,100,173,FliSS_T,"-37.81794046, 144.96616678"
79820240511,79,2024-05-11,8,158,128,286,FliSS_T,"-37.81794046, 144.96616678"
511520250917,51,2025-09-17,15,100,80,180,Fra118_T,"-37.80841815, 144.95906316"
191620240122,19,2024-01-22,16,421,456,877,LtB210_T,"-37.81237202, 144.96550671"
251420250515,25,2025-05-15,14,436,422,858,MCEC_T,"-37.82401776, 144.95604426"
46420240419,46,2024-04-19,4,1,1,2,Pel147_T,"-37.80240719, 144.9615673"
46920240503,46,2024-05-03,9,53,176,229,Pel147_T,"-37.80240719, 144.9615673"
251820240309,25,2024-03-09,18,0,0,0,MCEC_T,"-37.82401776, 144.95604426"
52920240415,52,2024-04-15,9,138,211,349,Eli263_T,"-37.81252157, 144.9619401"
1421220241023,142,2024-10-23,12,525,410,935,Hammer1584_T,"-37.81970749, 144.96795734"
54720250125,54,2025-01-25,7,18,16,34,Swa607_T,"-37.804024, 144.96308399"
54320250324,54,2025-03-24,3,7,2,9,Swa607_T,"-37.804024, 144.96308399"
45920240908,45,2024-09-08,9,232,161,393,Swa148_T,"-37.81414075, 144.96609379"
21120251016,21,2025-10-16,1,4,10,14,Bourke155_T,"-37.81267313, 144.96788288"
1071320240604,107,2024-06-04,13,212,258,470,280Will_T,"-37.81246271, 144.95690188"
1082320250316,108,2025-03-16,23,53,43,96,261Will_T,"-37.81295822, 144.95678789"
1081320250514,108,2025-05-14,13,731,608,1339,261Will_T,"-37.81295822, 144.95678789"
118920241211,118,2024-12-11,9,19,15,34,Fli114C_T,"-37.81632783, 144.97090512"
87620240504,87,2024-05-04,6,7,2,9,Errol23_T,"-37.80454949, 144.94921863"
50420250528,50,2025-05-28,4,5,2,7,Lyg309_T,"-37.79808192, 144.96721013"
44920250114,44,2025-01-14,9,25,60,85,UM3_T,"-37.79698741, 144.96441306"
1651320250414,165,2025-04-14,13,41,31,72,Spen475_T,"-37.80953359, 144.94939004"
167620250711,167,2025-07-11,6,3,11,14,Lat526_T,"-37.81304149, 144.95155955"
1671320250804,167,2025-08-04,13,74,77,151,Lat526_T,"-37.81304149, 144.95155955"
162920241207,162,2024-12-07,9,412,307,719,Eli489_T,"-37.80740397, 144.95987909"
131720240706,131,2024-07-06,7,13,18,31,King2_T,"-37.82009057, 144.95758725"
1321320240123,132,2024-01-23,13,133,127,260,King335_T,"-37.81267639, 144.95386444"
1341420240814,134,2024-08-14,14,368,334,702,Spen201_T,"-37.81694221, 144.95303935"
135720250314,135,2025-03-14,7,257,330,587,Spen161_T,"-37.8172861, 144.95319102"
1351620251003,135,2025-10-03,16,435,612,1047,Spen161_T,"-37.8172861, 144.95319102"
1351820251006,135,2025-10-06,18,312,385,697,Spen161_T,"-37.8172861, 144.95319102"
1351420240408,135,2024-04-08,14,357,382,739,Spen161_T,"-37.8172861, 144.95319102"
133720231024,133,2023-10-24,7,835,378,1213,Spen229_T,"-37.81531435, 144.95227769"
171320231110,17,2023-11-10,13,540,505,1045,Col15_T,"-37.81362543, 144.97323591"
17620240519,17,2024-05-19,6,23,16,39,Col15_T,"-37.81362543, 144.97323591"
171920241026,17,2024-10-26,19,186,171,357,Col15_T,"-37.81362543, 144.97323591"
1320240122,1,2024-01-22,3,12,9,21,Bou292_T,"-37.81349441, 144.96515323"
1020240720,1,2024-07-20,0,54,51,105,Bou292_T,"-37.81349441, 144.96515323"
631920240717,63,2024-07-17,19,211,264,475,Bou231_T,"-37.81333081, 144.96675571"
632020240826,63,2024-08-26,20,115,193,308,Bou231_T,"-37.81333081, 144.96675571"
67820241006,67,2024-10-06,8,127,112,239,FLDegS_T,"-37.81688755, 144.96562569"
182020250112,18,2025-01-12,20,41,11,52,Col12_T,"-37.81344862, 144.97305353"
182120240606,18,2024-06-06,21,0,1,1,Col12_T,"-37.81344862, 144.97305353"
682220250913,68,2025-09-13,22,106,92,198,FLDegN_T,"-37.8168479, 144.96559789"
11720250802,11,2025-08-02,7,22,21,43,WatCit_T,"-37.81564989, 144.93970694"
242220250411,24,2025-04-11,22,298,512,810,Col620_T,"-37.81887963, 144.95449198"
721820250424,72,2025-04-24,18,200,302,502,ACMI_T,"-37.81726338, 144.96872809"
21120240213,2,2024-02-13,11,386,404,790,Bou283_T,"-37.81380668, 144.96516718"
91420250111,9,2025-01-11,14,48,57,105,Col700_T,"-37.81982992, 144.95102555"
92020250905,9,2025-09-05,20,51,50,101,Col700_T,"-37.81982992, 144.95102555"
53020240905,53,2024-09-05,0,7,23,30,Col254_T,"-37.81564191, 144.965499"
531520240214,53,2024-02-14,15,850,678,1528,Col254_T,"-37.81564191, 144.965499"
92220240808,9,2024-08-08,22,71,52,123,Col700_T,"-37.81982992, 144.95102555"
301020250221,30,2025-02-21,10,86,197,283,Lon189_T,"-37.8112185, 144.96656806"
232220250817,23,2025-08-17,22,23,84,107,Col623_T,"-37.81909256, 144.95452748"
23420240428,23,2024-04-28,4,5,16,21,Col623_T,"-37.81909256, 144.95452748"
231120240913,23,2024-09-13,11,171,294,465,Col623_T,"-37.81909256, 144.95452748"
231120231112,23,2023-11-12,11,155,210,365,Col623_T,"-37.81909256, 144.95452748"
51420240820,51,2024-08-20,4,5,4,9,Fra118_T,"-37.80841815, 144.95906316"
51920250203,51,2025-02-03,9,64,55,119,Fra118_T,"-37.80841815, 144.95906316"
482320241116,48,2024-11-16,23,51,77,128,QVMQ_T,"-37.80631581, 144.95866697"
481820240105,48,2024-01-05,18,129,152,281,QVMQ_T,"-37.80631581, 144.95866697"
46620240401,46,2024-04-01,6,2,0,2,Pel147_T,"-37.80240719, 144.9615673"
20720240228,20,2024-02-28,7,22,33,55,LtB170_T,"-37.81172914, 144.9682466"
25320240104,25,2024-01-04,3,8,4,12,MCEC_T,"-37.82401776, 144.95604426"
251720240411,25,2024-04-11,17,1444,545,1989,MCEC_T,"-37.82401776, 144.95604426"
1371620240717,137,2024-07-17,16,14,143,157,BouHbr2353_T,"-37.81894815, 144.94612292"
139620250610,139,2025-06-10,6,2,6,8,Signal1647_T,"-37.81959923, 144.9632832"
1361120240509,136,2024-05-09,11,60,54,114,BirFed1120_T,"-37.8184141, 144.97357915"
136720250318,136,2025-03-18,7,79,109,188,BirFed1120_T,"-37.8184141, 144.97357915"
141520250616,141,2025-06-16,5,11,4,15,474Fl_T,"-37.81997273, 144.95834911"
491720240324,49,2024-03-24,17,245,245,490,Eli501_T,"-37.80730068, 144.95956055"
66620250208,66,2025-02-08,6,16,34,50,QVN_T,"-37.81057846, 144.96444294"
69620240121,69,2024-01-21,6,5,1,6,FLDegC_T,"-37.81687226, 144.96559144"
6620250923,6,2025-09-23,6,176,291,467,FliS_T,"-37.81911705, 144.96558255"
662320240304,66,2024-03-04,23,127,104,231,QVN_T,"-37.81057846, 144.96444294"
701720240523,70,2024-05-23,17,175,183,358,Errol20_T,"-37.80456984, 144.94946228"
70820250205,70,2025-02-05,8,89,78,167,Errol20_T,"-37.80456984, 144.94946228"
31220241125,3,2024-11-25,12,532,486,1018,Swa295_T,"-37.81101524, 144.96429485"
41320250606,41,2025-06-06,3,52,64,116,Swa31,"-37.81668634, 144.96689733"
42620250123,42,2025-01-23,6,13,24,37,UM1_T,"-37.80008566, 144.96386412"
71820240930,71,2024-09-30,8,24,20,44,WestWP_T,"-37.81235775, 144.97136962"
711820231026,71,2023-10-26,18,33,41,74,WestWP_T,"-37.81235775, 144.97136962"
361220240316,36,2024-03-16,12,145,161,306,Que85_T,"-37.81652527, 144.96121062"
37620241123,37,2024-11-23,6,4,7,11,Lyg260_T,"-37.80107122, 144.96704554"
37620240422,37,2024-04-22,6,3,4,7,Lyg260_T,"-37.80107122, 144.96704554"
451820250123,45,2025-01-23,18,487,703,1190,Swa148_T,"-37.81414075, 144.96609379"
21620250627,21,2025-06-27,6,8,10,18,Bourke155_T,"-37.81267313, 144.96788288"
1071320240514,107,2024-05-14,13,212,268,480,280Will_T,"-37.81246271, 144.95690188"
1072220240831,107,2024-08-31,22,66,36,102,280Will_T,"-37.81246271, 144.95690188"
1182320240817,118,2024-08-17,23,13,7,20,Fli114C_T,"-37.81632783, 144.97090512"
118620250424,118,2025-04-24,6,3,1,4,Fli114C_T,"-37.81632783, 144.97090512"
871320240930,87,2024-09-30,13,122,127,249,Errol23_T,"-37.80454949, 144.94921863"
431320240913,43,2024-09-13,13,142,174,316,UM2_T,"-37.79844526, 144.96411782"
182220250617,182,2025-06-17,2,16,17,33,King163_T,"-37.81627451, 144.95550503"
131420250423,131,2025-04-23,4,4,7,11,King2_T,"-37.82009057, 144.95758725"
131320250911,131,2025-09-11,3,4,11,15,King2_T,"-37.82009057, 144.95758725"
1431420240626,143,2024-06-26,14,279,311,590,Spencer_T,"-37.821728, 144.95557015"
143720240523,143,2024-05-23,7,143,253,396,Spencer_T,"-37.821728, 144.95557015"
1342220250314,134,2025-03-14,22,337,271,608,Spen201_T,"-37.81694221, 144.95303935"
1341120250120,134,2025-01-20,11,363,387,750,Spen201_T,"-37.81694221, 144.95303935"
133420240810,133,2024-08-10,4,17,32,49,Spen229_T,"-37.81531435, 144.95227769"
852320240613,85,2024-06-13,23,2,4,6,488Mac_T,"-37.79432415, 144.92973378"
1020240616,1,2024-06-16,0,73,84,157,Bou292_T,"-37.81349441, 144.96515323"
68720250903,68,2025-09-03,7,97,60,157,FLDegN_T,"-37.8168479, 144.96559789"
631520240504,63,2024-05-04,15,360,458,818,Bou231_T,"-37.81333081, 144.96675571"
56820240109,56,2024-01-09,8,81,129,210,Lon364_T,"-37.81234775, 144.96153311"
56620241002,56,2024-10-02,6,29,16,45,Lon364_T,"-37.81234775, 144.96153311"
11320250726,1,2025-07-26,13,1519,1458,2977,Bou292_T,"-37.81349441, 144.96515323"
122020240317,12,2024-03-17,20,321,256,577,NewQ_T,"-37.81457988, 144.94292398"
2320240821,2,2024-08-21,3,4,6,10,Bou283_T,"-37.81380668, 144.96516718"
27120250114,27,2025-01-14,1,10,6,16,Vic_T,"-37.80606888, 144.95644692"
27920250208,27,2025-02-08,9,141,174,315,Vic_T,"-37.80606888, 144.95644692"
582020250726,58,2025-07-26,20,252,191,443,Bou688_T,"-37.81686075, 144.95358075"
531920240102,53,2024-01-02,19,124,126,250,Col254_T,"-37.81564191, 144.965499"
302120241130,30,2024-11-30,21,412,603,1015,Lon189_T,"-37.8112185, 144.96656806"
791920241203,79,2024-12-03,19,363,320,683,FliSS_T,"-37.81794046, 144.96616678"
30620231101,30,2023-11-01,6,17,34,51,Lon189_T,"-37.8112185, 144.96656806"
30120231227,30,2023-12-27,1,51,60,111,Lon189_T,"-37.8112185, 144.96656806"
30920240121,30,2024-01-21,9,66,128,194,Lon189_T,"-37.8112185, 144.96656806"
301720240327,30,2024-03-27,17,330,448,778,Lon189_T,"-37.8112185, 144.96656806"
531520250516,53,2025-05-16,15,662,495,1157,Col254_T,"-37.81564191, 144.965499"
231320241204,23,2024-12-04,13,378,589,967,Col623_T,"-37.81909256, 144.95452748"
231420240420,23,2024-04-20,14,177,240,417,Col623_T,"-37.81909256, 144.95452748"
301120250908,30,2025-09-08,11,121,220,341,Lon189_T,"-37.8112185, 144.96656806"
251020231129,25,2023-11-29,10,77,383,460,MCEC_T,"-37.82401776, 144.95604426"
252120240125,25,2024-01-25,21,188,154,342,MCEC_T,"-37.82401776, 144.95604426"
521520250408,52,2025-04-08,15,414,271,685,Eli263_T,"-37.81252157, 144.9619401"
521020241124,52,2024-11-24,10,79,64,143,Eli263_T,"-37.81252157, 144.9619401"
1411320240402,141,2024-04-02,13,182,201,383,474Fl_T,"-37.81997273, 144.95834911"
1391320240714,139,2024-07-14,13,28,28,56,Signal1647_T,"-37.81959923, 144.9632832"
1421820240620,142,2024-06-20,18,261,105,366,Hammer1584_T,"-37.81970749, 144.96795734"
1611020250701,161,2025-07-01,10,156,64,220,BirArt1109_T,"-37.81851276, 144.97131336"
491920250528,49,2025-05-28,19,216,263,479,Eli501_T,"-37.80730068, 144.95956055"
1231120250725,123,2025-07-25,11,51,25,76,BirBridge_T,"-37.81753741, 144.97329734"
117920240526,117,2024-05-26,9,37,91,128,Fli114F_T,"-37.81629332, 144.97090877"
691820250711,69,2025-07-11,18,135,162,297,FLDegC_T,"-37.81687226, 144.96559144"
6720231229,6,2023-12-29,7,149,163,312,FliS_T,"-37.81911705, 144.96558255"
661220240327,66,2024-03-27,12,949,1236,2185,QVN_T,"-37.81057846, 144.96444294"
61020250721,6,2025-07-21,10,435,351,786,FliS_T,"-37.81911705, 144.96558255"
6820250829,6,2025-08-29,8,640,1487,2127,FliS_T,"-37.81911705, 144.96558255"
391320250817,39,2025-08-17,13,28,39,67,AlfPl_T,"-37.81379749, 144.96995745"
391920250524,39,2025-05-24,19,38,26,64,AlfPl_T,"-37.81379749, 144.96995745"
81020240127,8,2024-01-27,10,128,286,414,WebBN_T,"-37.82293543, 144.9471751"
41920240330,41,2024-03-30,9,606,325,931,Swa31,"-37.81668634, 144.96689733"
781320240618,78,2024-06-18,13,26,36,62,HarEsB_T,"-37.81471642, 144.9446508"
711120240411,71,2024-04-11,11,35,24,59,WestWP_T,"-37.81235775, 144.97136962"
59620250119,59,2025-01-19,6,11,9,20,RMIT_T,"-37.80825648, 144.96304859"
591920231228,59,2023-12-28,19,435,370,805,RMIT_T,"-37.80825648, 144.96304859"
291420231220,29,2023-12-20,14,294,417,711,AG_T,"-37.8199817, 144.96872865"
291720240218,29,2024-02-18,17,774,527,1301,AG_T,"-37.8199817, 144.96872865"
541120241019,54,2024-10-19,11,95,94,189,Swa607_T,"-37.804024, 144.96308399"
37520231211,37,2023-12-11,5,3,7,10,Lyg260_T,"-37.80107122, 144.96704554"
36420250918,36,2025-09-18,4,3,0,3,Que85_T,"-37.81652527, 144.96121062"
1072020250818,107,2025-08-18,20,101,56,157,280Will_T,"-37.81246271, 144.95690188"
1081620250309,108,2025-03-09,16,127,115,242,261Will_T,"-37.81295822, 144.95678789"
871720231024,87,2023-10-24,17,103,118,221,Errol23_T,"-37.80454949, 144.94921863"
87720231215,87,2023-12-15,7,41,35,76,Errol23_T,"-37.80454949, 144.94921863"
50620250912,50,2025-09-12,6,4,12,16,Lyg309_T,"-37.79808192, 144.96721013"
502220240215,50,2024-02-15,22,129,61,190,Lyg309_T,"-37.79808192, 144.96721013"
44220240715,44,2024-07-15,2,0,1,1,UM3_T,"-37.79698741, 144.96441306"
1852220250802,185,2025-08-02,22,439,431,870,Eli197_T,"-37.81374643, 144.96276183"
1792320250429,179,2025-04-29,23,14,8,22,Pow61_T,"-37.82392385, 144.96299677"
165220250621,165,2025-06-21,2,1,1,2,Spen475_T,"-37.80953359, 144.94939004"
1401820250303,140,2025-03-03,18,142,134,276,Boyd2837_T,"-37.82590962, 144.96185972"
1401220251003,140,2025-10-03,12,97,71,168,Boyd2837_T,"-37.82590962, 144.96185972"
132720240710,132,2024-07-10,7,50,39,89,King335_T,"-37.81267639, 144.95386444"
1341620240107,134,2024-01-07,16,171,167,338,Spen201_T,"-37.81694221, 144.95303935"
135420250214,135,2025-02-14,4,15,17,32,Spen161_T,"-37.8172861, 144.95319102"
1352320250531,135,2025-05-31,23,50,90,140,Spen161_T,"-37.8172861, 144.95319102"
681520240419,68,2024-04-19,15,239,146,385,FLDegN_T,"-37.8168479, 144.96559789"
1020241220,1,2024-12-20,0,66,63,129,Bou292_T,"-37.81349441, 144.96515323"
63420241109,63,2024-11-09,4,2,18,20,Bou231_T,"-37.81333081, 144.96675571"
63920241123,63,2024-11-23,9,9,8,17,Bou231_T,"-37.81333081, 144.96675571"
18720241110,18,2024-11-10,7,17,9,26,Col12_T,"-37.81344862, 144.97305353"
182320241209,18,2024-12-09,23,14,5,19,Col12_T,"-37.81344862, 144.97305353"
861420240622,86,2024-06-22,14,25,22,47,574Qub_T,"-37.80309992, 144.94908064"
11020241002,11,2024-10-02,0,4,6,10,WatCit_T,"-37.81564989, 144.93970694"
35920240106,35,2024-01-06,9,592,417,1009,SouthB_T,"-37.82018685, 144.96508508"
79120241028,79,2024-10-28,1,13,22,35,FliSS_T,"-37.81794046, 144.96616678"
302320231018,30,2023-10-18,23,173,130,303,Lon189_T,"-37.8112185, 144.96656806"
531020251006,53,2025-10-06,10,483,343,826,Col254_T,"-37.81564191, 144.965499"
232220250720,23,2025-07-20,22,17,53,70,Col623_T,"-37.81909256, 144.95452748"
252020250104,25,2025-01-04,20,389,479,868,MCEC_T,"-37.82401776, 144.95604426"
1392320240606,139,2024-06-06,23,7,6,13,Signal1647_T,"-37.81959923, 144.9632832"
1392020240612,139,2024-06-12,20,15,8,23,Signal1647_T,"-37.81959923, 144.9632832"
1641520250922,164,2025-09-22,15,114,50,164,Lat526_T,"-37.813005, 144.95160411"
164420241228,164,2024-12-28,4,0,5,5,Lat526_T,"-37.813005, 144.95160411"
1641120250131,164,2025-01-31,11,73,43,116,Lat526_T,"-37.813005, 144.95160411"
1641820250306,164,2025-03-06,18,129,133,262,Lat526_T,"-37.813005, 144.95160411"
1612020250115,161,2025-01-15,20,180,342,522,BirArt1109_T,"-37.81851276, 144.97131336"
492320250714,49,2025-07-14,23,49,49,98,Eli501_T,"-37.80730068, 144.95956055"
1091920250813,109,2025-08-13,19,106,140,246,LatWill_T,"-37.81193681, 144.95621105"
1091220250531,109,2025-05-31,12,80,65,145,LatWill_T,"-37.81193681, 144.95621105"
191220250308,19,2025-03-08,12,774,512,1286,LtB210_T,"-37.81237202, 144.96550671"
191420240614,19,2024-06-14,14,369,443,812,LtB210_T,"-37.81237202, 144.96550671"
842220240930,84,2024-09-30,22,254,381,635,ElFi_T,"-37.81798049, 144.96503383"
42120231230,4,2023-12-30,21,816,579,1395,Swa123_T,"-37.81487988, 144.9660878"
3420240809,3,2024-08-09,4,25,31,56,Swa295_T,"-37.81101524, 144.96429485"
39020250124,39,2025-01-24,0,2,1,3,AlfPl_T,"-37.81379749, 144.96995745"
8920240808,8,2024-08-08,9,231,130,361,WebBN_T,"-37.82293543, 144.9471751"
14220240215,14,2024-02-15,2,9,4,13,SanBri_T,"-37.82011242, 144.96291897"
712320241107,71,2024-11-07,23,6,13,19,WestWP_T,"-37.81235775, 144.97136962"
71420240724,71,2024-07-24,4,16,11,27,WestWP_T,"-37.81235775, 144.97136962"
541120231218,54,2023-12-18,11,43,47,90,Swa607_T,"-37.804024, 144.96308399"
281720240604,28,2024-06-04,17,352,730,1082,VAC_T,"-37.82129925, 144.96879309"
311320250131,31,2025-01-31,13,127,144,271,Lyg161_T,"-37.80169681, 144.96658911"
311120250412,31,2025-04-12,11,191,126,317,Lyg161_T,"-37.80169681, 144.96658911"
312020241230,31,2024-12-30,20,336,332,668,Lyg161_T,"-37.80169681, 144.96658911"
541120250228,54,2025-02-28,11,136,93,229,Swa607_T,"-37.804024, 144.96308399"
54120250310,54,2025-03-10,1,20,34,54,Swa607_T,"-37.804024, 144.96308399"
362320240327,36,2024-03-27,23,17,32,49,Que85_T,"-37.81652527, 144.96121062"
36620250128,36,2025-01-28,6,29,19,48,Que85_T,"-37.81652527, 144.96121062"
471820240414,47,2024-04-14,18,681,625,1306,Eli250_T,"-37.81258467, 144.9625775"
30820250927,30,2025-09-27,8,34,89,123,Lon189_T,"-37.8112185, 144.96656806"
25820241121,25,2024-11-21,8,276,947,1223,MCEC_T,"-37.82401776, 144.95604426"
20220240304,20,2024-03-04,2,10,14,24,LtB170_T,"-37.81172914, 144.9682466"
52720250508,52,2025-05-08,7,61,74,135,Eli263_T,"-37.81252157, 144.9619401"
46220240416,46,2024-04-16,2,0,3,3,Pel147_T,"-37.80240719, 144.9615673"
130620250414,130,2025-04-14,6,7,2,9,Bou892T,"-37.8204637, 144.94126826"
164120250219,164,2025-02-19,1,4,4,8,Lat526_T,"-37.813005, 144.95160411"
1172120250310,117,2025-03-10,21,238,77,315,Fli114F_T,"-37.81629332, 144.97090877"
117620240528,117,2024-05-28,6,34,21,55,Fli114F_T,"-37.81629332, 144.97090877"
66520250228,66,2025-02-28,5,10,25,35,QVN_T,"-37.81057846, 144.96444294"
32120231205,3,2023-12-05,21,990,780,1770,Swa295_T,"-37.81101524, 144.96429485"
4020250212,4,2025-02-12,0,96,100,196,Swa123_T,"-37.81487988, 144.9660878"
412120240825,41,2024-08-25,21,65,66,131,Swa31,"-37.81668634, 144.96689733"
711020240225,71,2024-02-25,10,4,3,7,WestWP_T,"-37.81235775, 144.97136962"
28820231207,28,2023-12-07,8,533,307,840,VAC_T,"-37.82129925, 144.96879309"
292020240313,29,2024-03-13,20,88,146,234,AG_T,"-37.8199817, 144.96872865"
142020240108,14,2024-01-08,20,175,52,227,SanBri_T,"-37.82011242, 144.96291897"
311820240115,31,2024-01-15,18,240,134,374,Lyg161_T,"-37.80169681, 144.96658911"
312120250324,31,2025-03-24,21,110,126,236,Lyg161_T,"-37.80169681, 144.96658911"
21720250605,21,2025-06-05,7,32,30,62,Bourke155_T,"-37.81267313, 144.96788288"
36220231215,36,2023-12-15,2,24,5,29,Que85_T,"-37.81652527, 144.96121062"
37520241012,37,2024-10-12,5,3,14,17,Lyg260_T,"-37.80107122, 144.96704554"
50920240210,50,2024-02-10,9,85,116,201,Lyg309_T,"-37.79808192, 144.96721013"
442020240913,44,2024-09-13,20,12,27,39,UM3_T,"-37.79698741, 144.96441306"
1341220240221,134,2024-02-21,12,329,317,646,Spen201_T,"-37.81694221, 144.95303935"
1332320240611,133,2024-06-11,23,81,50,131,Spen229_T,"-37.81531435, 144.95227769"
133520250103,133,2025-01-03,5,83,84,167,Spen229_T,"-37.81531435, 144.95227769"
61820250929,61,2025-09-29,8,250,384,634,RMIT14_T,"-37.80767455, 144.96309114"
1622020250209,162,2025-02-09,20,183,136,319,Eli489_T,"-37.80740397, 144.95987909"
1651220250613,165,2025-06-13,12,61,51,112,Spen475_T,"-37.80953359, 144.94939004"
1812220250424,181,2025-04-24,22,726,606,1332,Eli368_T,"-37.81009465, 144.96143149"
851220250103,85,2025-01-03,12,114,101,215,488Mac_T,"-37.79432415, 144.92973378"
85520231209,85,2023-12-09,5,3,0,3,488Mac_T,"-37.79432415, 144.92973378"
171220231102,17,2023-11-02,12,774,676,1450,Col15_T,"-37.81362543, 144.97323591"
1820231028,1,2023-10-28,8,124,188,312,Bou292_T,"-37.81349441, 144.96515323"
561620240201,56,2024-02-01,16,257,290,547,Lon364_T,"-37.81234775, 144.96153311"
121020240504,12,2024-05-04,10,151,128,279,NewQ_T,"-37.81457988, 144.94292398"
111720240128,11,2024-01-28,17,143,115,258,WatCit_T,"-37.81564989, 144.93970694"
111820250911,11,2025-09-11,18,82,98,180,WatCit_T,"-37.81564989, 144.93970694"
102020250603,10,2025-06-03,20,31,30,61,BouHbr_T,"-37.81876474, 144.94710545"
762320240404,76,2024-04-04,23,0,4,4,KenMac_T,"-37.79453803, 144.93036194"
2920240313,2,2024-03-13,9,151,223,374,Bou283_T,"-37.81380668, 144.96516718"
21720240524,2,2024-05-24,17,581,451,1032,Bou283_T,"-37.81380668, 144.96516718"
582320241120,58,2024-11-20,23,87,140,227,Bou688_T,"-37.81686075, 144.95358075"
791620231220,79,2023-12-20,16,663,545,1208,FliSS_T,"-37.81794046, 144.96616678"
79820250313,79,2025-03-13,8,901,395,1296,FliSS_T,"-37.81794046, 144.96616678"
791320250116,79,2025-01-16,13,767,506,1273,FliSS_T,"-37.81794046, 144.96616678"
23820250907,23,2025-09-07,8,67,79,146,Col623_T,"-37.81909256, 144.95452748"
481020250116,48,2025-01-16,10,237,194,431,QVMQ_T,"-37.80631581, 144.95866697"
481920240513,48,2024-05-13,19,63,106,169,QVMQ_T,"-37.80631581, 144.95866697"
25220250317,25,2025-03-17,2,4,6,10,MCEC_T,"-37.82401776, 144.95604426"
20020240711,20,2024-07-11,0,18,28,46,LtB170_T,"-37.81172914, 144.9682466"
20120240307,20,2024-03-07,1,11,22,33,LtB170_T,"-37.81172914, 144.9682466"
25720240110,25,2024-01-10,7,167,207,374,MCEC_T,"-37.82401776, 144.95604426"
46120250124,46,2025-01-24,1,1,0,1,Pel147_T,"-37.80240719, 144.9615673"
1392120240404,139,2024-04-04,21,16,21,37,Signal1647_T,"-37.81959923, 144.9632832"
1362120250423,136,2025-04-23,21,3,1,4,BirFed1120_T,"-37.8184141, 144.97357915"
130920240109,130,2024-01-09,9,9,9,18,Bou892T,"-37.8204637, 144.94126826"
1801020250314,180,2025-03-14,10,36,15,51,Mac330_T,"-37.79497059, 144.93530329"
1381520231220,138,2023-12-20,15,10,2,12,EntPark1671_T,"-37.81996544, 144.95981454"
1612320250715,161,2025-07-15,23,1,22,23,BirArt1109_T,"-37.81851276, 144.97131336"
117420250329,117,2025-03-29,4,4,0,4,Fli114F_T,"-37.81629332, 144.97090877"
1231920241101,123,2024-11-01,19,4,1,5,BirBridge_T,"-37.81753741, 144.97329734"
1231720250131,123,2025-01-31,17,27,21,48,BirBridge_T,"-37.81753741, 144.97329734"
1092020240718,109,2024-07-18,20,92,82,174,LatWill_T,"-37.81193681, 144.95621105"
192020250206,19,2025-02-06,20,494,482,976,LtB210_T,"-37.81237202, 144.96550671"
412220231116,41,2023-11-16,22,968,1021,1989,Swa31,"-37.81668634, 144.96689733"
59620240227,59,2024-02-27,6,91,94,185,RMIT_T,"-37.80825648, 144.96304859"
71820231116,71,2023-11-16,8,11,13,24,WestWP_T,"-37.81235775, 144.97136962"
291820241117,29,2024-11-17,18,311,459,770,AG_T,"-37.8199817, 144.96872865"
28220231027,28,2023-10-27,2,9,10,19,VAC_T,"-37.82129925, 144.96879309"
28420231028,28,2023-10-28,4,10,11,21,VAC_T,"-37.82129925, 144.96879309"
292020240627,29,2024-06-27,20,83,130,213,AG_T,"-37.8199817, 144.96872865"
542120241009,54,2024-10-09,21,97,142,239,Swa607_T,"-37.804024, 144.96308399"
282320251015,28,2025-10-15,23,45,46,91,VAC_T,"-37.82129925, 144.96879309"
47020240904,47,2024-09-04,0,53,34,87,Eli250_T,"-37.81258467, 144.9625775"
47820240401,47,2024-04-01,8,79,160,239,Eli250_T,"-37.81258467, 144.9625775"
47520241231,47,2024-12-31,5,10,34,44,Eli250_T,"-37.81258467, 144.9625775"
45820240816,45,2024-08-16,8,316,257,573,Swa148_T,"-37.81414075, 144.96609379"
5020241028,5,2024-10-28,0,27,76,103,PriNW_T,"-37.81874249, 144.96787656"
211420240921,21,2024-09-21,14,383,394,777,Bourke155_T,"-37.81267313, 144.96788288"
211020240211,21,2024-02-11,10,932,667,1599,Bourke155_T,"-37.81267313, 144.96788288"
50520231213,50,2023-12-13,5,12,4,16,Lyg309_T,"-37.79808192, 144.96721013"
431120250402,43,2025-04-02,11,217,295,512,UM2_T,"-37.79844526, 144.96411782"
132120250625,132,2025-06-25,1,7,5,12,King335_T,"-37.81267639, 144.95386444"
1331520251011,133,2025-10-11,15,589,474,1063,Spen229_T,"-37.81531435, 144.95227769"
118620240121,118,2024-01-21,6,3,1,4,Fli114C_T,"-37.81632783, 144.97090512"
871920250429,87,2025-04-29,19,69,62,131,Errol23_T,"-37.80454949, 144.94921863"
611220250203,61,2025-02-03,12,352,574,926,RMIT14_T,"-37.80767455, 144.96309114"
871220231204,87,2023-12-04,12,153,135,288,Errol23_T,"-37.80454949, 144.94921863"
61620250705,61,2025-07-05,6,3,20,23,RMIT14_T,"-37.80767455, 144.96309114"
611020240902,61,2024-09-02,10,177,340,517,RMIT14_T,"-37.80767455, 144.96309114"
182520250525,182,2025-05-25,5,28,52,80,King163_T,"-37.81627451, 144.95550503"
1842020251009,184,2025-10-09,20,486,858,1344,Eli124_T,"-37.81512416, 144.96371988"
1661220241005,166,2024-10-05,12,62,64,126,Spen484_T,"-37.80896733, 144.94931703"
165420250225,165,2025-02-25,4,0,1,1,Spen475_T,"-37.80953359, 144.94939004"
140520250102,140,2025-01-02,5,0,1,1,Boyd2837_T,"-37.82590962, 144.96185972"
17120240109,17,2024-01-09,1,7,4,11,Col15_T,"-37.81362543, 144.97323591"
67020250811,67,2025-08-11,0,2,10,12,FLDegS_T,"-37.81688755, 144.96562569"
681020231108,68,2023-11-08,10,126,74,200,FLDegN_T,"-37.8168479, 144.96559789"
47620240426,47,2024-04-26,6,29,87,116,Eli250_T,"-37.81258467, 144.9625775"
211620240513,21,2024-05-13,16,317,331,648,Bourke155_T,"-37.81267313, 144.96788288"
1181420250421,118,2025-04-21,14,23,105,128,Fli114C_T,"-37.81632783, 144.97090512"
50320250315,50,2025-03-15,3,8,2,10,Lyg309_T,"-37.79808192, 144.96721013"
441820250531,44,2025-05-31,18,25,39,64,UM3_T,"-37.79698741, 144.96441306"
431220240918,43,2024-09-18,12,230,285,515,UM2_T,"-37.79844526, 144.96411782"
1792320250527,179,2025-05-27,23,14,13,27,Pow61_T,"-37.82392385, 144.96299677"
1672020240831,167,2024-08-31,20,2,15,17,Lat526_T,"-37.81304149, 144.95155955"
1312020250710,131,2025-07-10,20,79,88,167,King2_T,"-37.82009057, 144.95758725"
132420241216,132,2024-12-16,4,6,2,8,King335_T,"-37.81267639, 144.95386444"
1321620250219,132,2025-02-19,16,154,129,283,King335_T,"-37.81267639, 144.95386444"
1321020231215,132,2023-12-15,10,153,75,228,King335_T,"-37.81267639, 144.95386444"
1322320231216,132,2023-12-16,23,100,90,190,King335_T,"-37.81267639, 144.95386444"
1352220241106,135,2024-11-06,22,97,102,199,Spen161_T,"-37.8172861, 144.95319102"
1331020240610,133,2024-06-10,10,443,547,990,Spen229_T,"-37.81531435, 144.95227769"
85520250225,85,2025-02-25,5,9,3,12,488Mac_T,"-37.79432415, 144.92973378"
632320240820,63,2024-08-20,23,54,71,125,Bou231_T,"-37.81333081, 144.96675571"
18820231218,18,2023-12-18,8,82,970,1052,Col12_T,"-37.81344862, 144.97305353"
861720250706,86,2025-07-06,17,34,43,77,574Qub_T,"-37.80309992, 144.94908064"
63420250530,63,2025-05-30,4,0,5,5,Bou231_T,"-37.81333081, 144.96675571"
111420241103,11,2024-11-03,14,168,141,309,WatCit_T,"-37.81564989, 144.93970694"
241420231214,24,2023-12-14,14,490,783,1273,Col620_T,"-37.81887963, 144.95449198"
122020240907,12,2024-09-07,20,138,148,286,NewQ_T,"-37.81457988, 144.94292398"
121220250406,12,2025-04-06,12,680,387,1067,NewQ_T,"-37.81457988, 144.94292398"
101120250211,10,2025-02-11,11,135,75,210,BouHbr_T,"-37.81876474, 144.94710545"
101420250311,10,2025-03-11,14,125,57,182,BouHbr_T,"-37.81876474, 144.94710545"
22120240808,2,2024-08-08,21,73,139,212,Bou283_T,"-37.81380668, 144.96516718"
581520240102,58,2024-01-02,15,468,360,828,Bou688_T,"-37.81686075, 144.95358075"
271220241211,27,2024-12-11,12,115,121,236,Vic_T,"-37.80606888, 144.95644692"
271120231024,27,2023-10-24,11,95,101,196,Vic_T,"-37.80606888, 144.95644692"
27120240222,27,2024-02-22,1,18,4,22,Vic_T,"-37.80606888, 144.95644692"
9120250629,9,2025-06-29,1,2,8,10,Col700_T,"-37.81982992, 144.95102555"
531820250209,53,2025-02-09,18,219,238,457,Col254_T,"-37.81564191, 144.965499"
531420250218,53,2025-02-18,14,752,736,1488,Col254_T,"-37.81564191, 144.965499"
231120250319,23,2025-03-19,11,280,297,577,Col623_T,"-37.81909256, 144.95452748"
251520250225,25,2025-02-25,15,655,483,1138,MCEC_T,"-37.82401776, 144.95604426"
461320241022,46,2024-10-22,13,174,147,321,Pel147_T,"-37.80240719, 144.9615673"
461620250717,46,2025-07-17,16,38,62,100,Pel147_T,"-37.80240719, 144.9615673"
1362220240130,136,2024-01-30,22,7,2,9,BirFed1120_T,"-37.8184141, 144.97357915"
136820250518,136,2025-05-18,8,113,78,191,BirFed1120_T,"-37.8184141, 144.97357915"
1301820250917,130,2025-09-17,18,62,48,110,Bou892T,"-37.8204637, 144.94126826"
138620241214,138,2024-12-14,6,1,0,1,EntPark1671_T,"-37.81996544, 144.95981454"
1611420250310,161,2025-03-10,14,1304,1280,2584,BirArt1109_T,"-37.81851276, 144.97131336"
1411420250216,141,2025-02-16,14,160,158,318,474Fl_T,"-37.81997273, 144.95834911"
49420251003,49,2025-10-03,4,9,7,16,Eli501_T,"-37.80730068, 144.95956055"
192020250227,19,2025-02-27,20,469,612,1081,LtB210_T,"-37.81237202, 144.96550671"
661420250715,66,2025-07-15,14,1173,1147,2320,QVN_T,"-37.81057846, 144.96444294"
662220250725,66,2025-07-25,22,671,433,1104,QVN_T,"-37.81057846, 144.96444294"
61820240312,6,2024-03-12,18,1294,781,2075,FliS_T,"-37.81911705, 144.96558255"
841220240327,84,2024-03-27,12,1108,1141,2249,ElFi_T,"-37.81798049, 144.96503383"
31120240309,3,2024-03-09,11,525,643,1168,Swa295_T,"-37.81101524, 144.96429485"
702320250815,70,2025-08-15,23,16,23,39,Errol20_T,"-37.80456984, 144.94946228"
751320231118,75,2023-11-18,13,54,71,125,SprFli_T,"-37.81515276, 144.97467661"
751520231208,75,2023-12-08,15,36,57,93,SprFli_T,"-37.81515276, 144.97467661"
42120250320,42,2025-03-20,1,9,7,16,UM1_T,"-37.80008566, 144.96386412"
141720231215,14,2023-12-15,17,776,242,1018,SanBri_T,"-37.82011242, 144.96291897"
282120250813,28,2025-08-13,21,232,338,570,VAC_T,"-37.82129925, 144.96879309"
292120250407,29,2025-04-07,21,78,135,213,AG_T,"-37.8199817, 144.96872865"
312020240502,31,2024-05-02,20,179,239,418,Lyg161_T,"-37.80169681, 144.96658911"
371020240920,37,2024-09-20,10,51,54,105,Lyg260_T,"-37.80107122, 144.96704554"
47420250208,47,2025-02-08,4,41,52,93,Eli250_T,"-37.81258467, 144.9625775"
1182020250610,118,2025-06-10,20,4,7,11,Fli114C_T,"-37.81632783, 144.97090512"
61720250917,61,2025-09-17,7,109,130,239,RMIT14_T,"-37.80767455, 144.96309114"
611920250920,61,2025-09-20,19,299,327,626,RMIT14_T,"-37.80767455, 144.96309114"
166120250408,166,2025-04-08,1,2,0,2,Spen484_T,"-37.80896733, 144.94931703"
140820231223,140,2023-12-23,8,70,16,86,Boyd2837_T,"-37.82590962, 144.96185972"
1621120241108,162,2024-11-08,11,386,545,931,Eli489_T,"-37.80740397, 144.95987909"
1821620250803,182,2025-08-03,16,300,168,468,King163_T,"-37.81627451, 144.95550503"
1322020241023,132,2024-10-23,20,102,149,251,King335_T,"-37.81267639, 144.95386444"
1331820240829,133,2024-08-29,18,464,380,844,Spen229_T,"-37.81531435, 144.95227769"
51720250114,51,2025-01-14,7,26,30,56,Fra118_T,"-37.80841815, 144.95906316"
25820241212,25,2024-12-12,8,305,609,914,MCEC_T,"-37.82401776, 144.95604426"
202320240529,20,2024-05-29,23,98,151,249,LtB170_T,"-37.81172914, 144.9682466"
202120231028,20,2023-10-28,21,323,524,847,LtB170_T,"-37.81172914, 144.9682466"
1371720240412,137,2024-04-12,17,27,160,187,BouHbr2353_T,"-37.81894815, 144.94612292"
137520231207,137,2023-12-07,5,1,1,2,BouHbr2353_T,"-37.81894815, 144.94612292"
1412320240308,141,2024-03-08,23,110,189,299,474Fl_T,"-37.81997273, 144.95834911"
142820241010,142,2024-10-10,8,608,407,1015,Hammer1584_T,"-37.81970749, 144.96795734"
1611020250211,161,2025-02-11,10,44,44,88,BirArt1109_T,"-37.81851276, 144.97131336"
117720241027,117,2024-10-27,7,28,21,49,Fli114F_T,"-37.81629332, 144.97090877"
492120241009,49,2024-10-09,21,204,278,482,Eli501_T,"-37.80730068, 144.95956055"
109720250312,109,2025-03-12,7,50,268,318,LatWill_T,"-37.81193681, 144.95621105"
192020240906,19,2024-09-06,20,584,636,1220,LtB210_T,"-37.81237202, 144.96550671"
671220240331,67,2024-03-31,12,380,488,868,FLDegS_T,"-37.81688755, 144.96562569"
68720240205,68,2024-02-05,7,63,35,98,FLDegN_T,"-37.8168479, 144.96559789"
851820240707,85,2024-07-07,18,37,51,88,488Mac_T,"-37.79432415, 144.92973378"
182320250712,18,2025-07-12,23,5,7,12,Col12_T,"-37.81344862, 144.97305353"
63020240207,63,2024-02-07,0,23,55,78,Bou231_T,"-37.81333081, 144.96675571"
112020241223,11,2024-12-23,20,156,92,248,WatCit_T,"-37.81564989, 144.93970694"
241420241015,24,2024-10-15,14,516,966,1482,Col620_T,"-37.81887963, 144.95449198"
102020241031,10,2024-10-31,20,52,63,115,BouHbr_T,"-37.81876474, 144.94710545"
72820250722,72,2025-07-22,8,699,95,794,ACMI_T,"-37.81726338, 144.96872809"
761220250327,76,2025-03-27,12,69,66,135,KenMac_T,"-37.79453803, 144.93036194"
761720250730,76,2025-07-30,17,55,76,131,KenMac_T,"-37.79453803, 144.93036194"
76720231020,76,2023-10-20,7,44,26,70,KenMac_T,"-37.79453803, 144.93036194"
9520250614,9,2025-06-14,5,13,7,20,Col700_T,"-37.81982992, 144.95102555"
53420231104,53,2023-11-04,4,5,10,15,Col254_T,"-37.81564191, 144.965499"
301820250421,30,2025-04-21,18,326,459,785,Lon189_T,"-37.8112185, 144.96656806"
231120250226,23,2025-02-26,11,275,306,581,Col623_T,"-37.81909256, 144.95452748"
71320251014,71,2025-10-14,3,0,1,1,WestWP_T,"-37.81235775, 144.97136962"
711220241124,71,2024-11-24,12,11,3,14,WestWP_T,"-37.81235775, 144.97136962"
71420250727,71,2025-07-27,4,3,2,5,WestWP_T,"-37.81235775, 144.97136962"
65020231124,65,2023-11-24,0,29,49,78,SwaCs_T,"-37.81569416, 144.9668064"
54720231227,54,2023-12-27,7,15,7,22,Swa607_T,"-37.804024, 144.96308399"
312220250604,31,2025-06-04,22,28,66,94,Lyg161_T,"-37.80169681, 144.96658911"
36520250323,36,2025-03-23,5,10,31,41,Que85_T,"-37.81652527, 144.96121062"
52020240226,5,2024-02-26,20,1315,536,1851,PriNW_T,"-37.81874249, 144.96787656"
21520251001,21,2025-10-01,5,4,9,13,Bourke155_T,"-37.81267313, 144.96788288"
1071220250502,107,2025-05-02,12,174,201,375,280Will_T,"-37.81246271, 144.95690188"
108920250710,108,2025-07-10,9,212,911,1123,261Will_T,"-37.81295822, 144.95678789"
1181820250927,118,2025-09-27,18,33,13,46,Fli114C_T,"-37.81632783, 144.97090512"
1081520240628,108,2024-06-28,15,172,193,365,261Will_T,"-37.81295822, 144.95678789"
108120240828,108,2024-08-28,1,4,10,14,261Will_T,"-37.81295822, 144.95678789"
1081420231114,108,2023-11-14,14,508,238,746,261Will_T,"-37.81295822, 144.95678789"
50720240707,50,2024-07-07,7,7,11,18,Lyg309_T,"-37.79808192, 144.96721013"
50820240801,50,2024-08-01,8,24,84,108,Lyg309_T,"-37.79808192, 144.96721013"
1851120250901,185,2025-09-01,11,352,428,780,Eli197_T,"-37.81374643, 144.96276183"
1651820241029,165,2024-10-29,18,64,29,93,Spen475_T,"-37.80953359, 144.94939004"
133220250107,133,2025-01-07,2,21,9,30,Spen229_T,"-37.81531435, 144.95227769"
1242020250221,124,2025-02-21,20,2,3,5,BirBridge_T,"-37.81757416, 144.97329934"
662020240310,66,2024-03-10,20,1049,939,1988,QVN_T,"-37.81057846, 144.96444294"
842220250302,84,2025-03-02,22,299,364,663,ElFi_T,"-37.81798049, 144.96503383"
41720240211,4,2024-02-11,17,1651,1289,2940,Swa123_T,"-37.81487988, 144.9660878"
70920250515,70,2025-05-15,9,54,64,118,Errol20_T,"-37.80456984, 144.94946228"
3920250226,3,2025-02-26,9,256,375,631,Swa295_T,"-37.81101524, 144.96429485"
75920240316,75,2024-03-16,9,45,33,78,SprFli_T,"-37.81515276, 144.97467661"
82320240107,8,2024-01-07,23,4,3,7,WebBN_T,"-37.82293543, 144.9471751"
421120241111,42,2024-11-11,11,120,205,325,UM1_T,"-37.80008566, 144.96386412"
68320240930,68,2024-09-30,3,1,0,1,FLDegN_T,"-37.8168479, 144.96559789"
181120240616,18,2024-06-16,11,70,51,121,Col12_T,"-37.81344862, 144.97305353"
181920250422,18,2025-04-22,19,25,30,55,Col12_T,"-37.81344862, 144.97305353"
861120241128,86,2024-11-28,11,56,48,104,574Qub_T,"-37.80309992, 144.94908064"
62920240801,62,2024-08-01,9,122,188,310,Lat224_T,"-37.80996494, 144.96216521"
111620241106,11,2024-11-06,16,42,37,79,WatCit_T,"-37.81564989, 144.93970694"
11520250316,11,2025-03-16,5,4,7,11,WatCit_T,"-37.81564989, 144.93970694"
11820250404,11,2025-04-04,8,86,63,149,WatCit_T,"-37.81564989, 144.93970694"
102020250521,10,2025-05-21,20,26,38,64,BouHbr_T,"-37.81876474, 144.94710545"
351120231208,35,2023-12-08,11,1001,1086,2087,SouthB_T,"-37.82018685, 144.96508508"
351020241219,35,2024-12-19,10,724,577,1301,SouthB_T,"-37.82018685, 144.96508508"
2820250605,2,2025-06-05,8,102,247,349,Bou283_T,"-37.81380668, 144.96516718"
9620240322,9,2024-03-22,6,36,234,270,Col700_T,"-37.81982992, 144.95102555"
511120240320,51,2024-03-20,11,102,70,172,Fra118_T,"-37.80841815, 144.95906316"
461620250619,46,2025-06-19,16,72,109,181,Pel147_T,"-37.80240719, 144.9615673"
1371520241114,137,2024-11-14,15,10,89,99,BouHbr2353_T,"-37.81894815, 144.94612292"
1372020250202,137,2025-02-02,20,4,10,14,BouHbr2353_T,"-37.81894815, 144.94612292"
1421020241020,142,2024-10-20,10,443,371,814,Hammer1584_T,"-37.81970749, 144.96795734"
1301920250527,130,2025-05-27,19,16,34,50,Bou892T,"-37.8204637, 144.94126826"
1172120250511,117,2025-05-11,21,98,67,165,Fli114F_T,"-37.81629332, 144.97090877"
491620240801,49,2024-08-01,16,229,250,479,Eli501_T,"-37.80730068, 144.95956055"
492220231231,49,2023-12-31,22,256,245,501,Eli501_T,"-37.80730068, 144.95956055"
66720231113,66,2023-11-13,7,54,203,257,QVN_T,"-37.81057846, 144.96444294"
692220241206,69,2024-12-06,22,37,42,79,FLDegC_T,"-37.81687226, 144.96559144"
41420250126,4,2025-01-26,14,2604,1850,4454,Swa123_T,"-37.81487988, 144.9660878"
41220250625,4,2025-06-25,12,1550,1003,2553,Swa123_T,"-37.81487988, 144.9660878"
781120231130,78,2023-11-30,11,17,28,45,HarEsB_T,"-37.81471642, 144.9446508"
411920250413,41,2025-04-13,19,1215,1756,2971,Swa31,"-37.81668634, 144.96689733"
781920250410,78,2025-04-10,19,10,14,24,HarEsB_T,"-37.81471642, 144.9446508"
78920250802,78,2025-08-02,9,66,66,132,HarEsB_T,"-37.81471642, 144.9446508"
59320250725,59,2025-07-25,3,18,14,32,RMIT_T,"-37.80825648, 144.96304859"
65820231031,65,2023-10-31,8,659,199,858,SwaCs_T,"-37.81569416, 144.9668064"
282120240928,28,2024-09-28,21,110,205,315,VAC_T,"-37.82129925, 144.96879309"
361820250819,36,2025-08-19,18,189,168,357,Que85_T,"-37.81652527, 144.96121062"
45620241210,45,2024-12-10,6,33,56,89,Swa148_T,"-37.81414075, 144.96609379"
5920250417,5,2025-04-17,9,409,937,1346,PriNW_T,"-37.81874249, 144.96787656"
1071220241109,107,2024-11-09,12,96,103,199,280Will_T,"-37.81246271, 144.95690188"
61620240508,61,2024-05-08,6,29,59,88,RMIT14_T,"-37.80767455, 144.96309114"
611520240815,61,2024-08-15,15,556,577,1133,RMIT14_T,"-37.80767455, 144.96309114"
50720240115,50,2024-01-15,7,14,32,46,Lyg309_T,"-37.79808192, 144.96721013"
1651720241110,165,2024-11-10,17,56,28,84,Spen475_T,"-37.80953359, 144.94939004"
1811620250626,181,2025-06-26,16,735,1096,1831,Eli368_T,"-37.81009465, 144.96143149"
1821120250515,182,2025-05-15,11,178,149,327,King163_T,"-37.81627451, 144.95550503"
1431420240605,143,2024-06-05,14,280,215,495,Spencer_T,"-37.821728, 144.95557015"
132920250622,132,2025-06-22,9,112,50,162,King335_T,"-37.81267639, 144.95386444"
1351720241120,135,2024-11-20,17,804,597,1401,Spen161_T,"-37.8172861, 144.95319102"
281820240402,28,2024-04-02,18,538,589,1127,VAC_T,"-37.82129925, 144.96879309"
282220240921,28,2024-09-21,22,234,452,686,VAC_T,"-37.82129925, 144.96879309"
47720240425,47,2024-04-25,7,77,82,159,Eli250_T,"-37.81258467, 144.9625775"
47920240428,47,2024-04-28,9,290,414,704,Eli250_T,"-37.81258467, 144.9625775"
40920240822,40,2024-08-22,9,167,326,493,Spr201_T,"-37.80999341, 144.97227587"
36820250422,36,2025-04-22,8,199,152,351,Que85_T,"-37.81652527, 144.96121062"
36820251009,36,2025-10-09,8,209,171,380,Que85_T,"-37.81652527, 144.96121062"
362020241217,36,2024-12-17,20,116,133,249,Que85_T,"-37.81652527, 144.96121062"
441920250614,44,2025-06-14,19,28,39,67,UM3_T,"-37.79698741, 144.96441306"
451720240414,45,2024-04-14,17,758,1283,2041,Swa148_T,"-37.81414075, 144.96609379"
5320231117,5,2023-11-17,3,21,22,43,PriNW_T,"-37.81874249, 144.96787656"
5020241011,5,2024-10-11,0,39,74,113,PriNW_T,"-37.81874249, 144.96787656"
1651220250124,165,2025-01-24,12,35,73,108,Spen475_T,"-37.80953359, 144.94939004"
1621120241225,162,2024-12-25,11,171,263,434,Eli489_T,"-37.80740397, 144.95987909"
131220240705,131,2024-07-05,2,8,7,15,King2_T,"-37.82009057, 144.95758725"
131120241108,131,2024-11-08,1,19,16,35,King2_T,"-37.82009057, 144.95758725"
143320241105,143,2024-11-05,3,26,8,34,Spencer_T,"-37.821728, 144.95557015"
1321520250503,132,2025-05-03,15,136,173,309,King335_T,"-37.81267639, 144.95386444"
1321420240315,132,2024-03-15,14,187,157,344,King335_T,"-37.81267639, 144.95386444"
134120240929,134,2024-09-29,1,109,57,166,Spen201_T,"-37.81694221, 144.95303935"
134020250618,134,2025-06-18,0,28,53,81,Spen201_T,"-37.81694221, 144.95303935"
1351120231126,135,2023-11-26,11,459,478,937,Spen161_T,"-37.8172861, 144.95319102"
1072320240609,107,2024-06-09,23,53,22,75,280Will_T,"-37.81246271, 144.95690188"
133920231213,133,2023-12-13,9,576,471,1047,Spen229_T,"-37.81531435, 144.95227769"
1182120250915,118,2025-09-15,21,2,5,7,Fli114C_T,"-37.81632783, 144.97090512"
118620240207,118,2024-02-07,6,6,2,8,Fli114C_T,"-37.81632783, 144.97090512"
1822320250711,182,2025-07-11,23,195,174,369,King163_T,"-37.81627451, 144.95550503"
166820250822,166,2025-08-22,8,35,39,74,Spen484_T,"-37.80896733, 144.94931703"
17520241026,17,2024-10-26,5,13,6,19,Col15_T,"-37.81362543, 144.97323591"
12320240919,1,2024-09-19,23,48,45,93,Bou292_T,"-37.81349441, 144.96515323"
11920231121,11,2023-11-21,9,50,56,106,WatCit_T,"-37.81564989, 144.93970694"
621620240805,62,2024-08-05,16,234,152,386,Lat224_T,"-37.80996494, 144.96216521"
561620240310,56,2024-03-10,16,278,310,588,Lon364_T,"-37.81234775, 144.96153311"
561720250629,56,2025-06-29,17,350,440,790,Lon364_T,"-37.81234775, 144.96153311"
24220240420,24,2024-04-20,2,46,62,108,Col620_T,"-37.81887963, 144.95449198"
761920240404,76,2024-04-04,19,32,31,63,KenMac_T,"-37.79453803, 144.93036194"
72620240916,72,2024-09-16,6,32,21,53,ACMI_T,"-37.81726338, 144.96872809"
72020241002,72,2024-10-02,0,6,14,20,ACMI_T,"-37.81726338, 144.96872809"
582220250125,58,2025-01-25,22,198,225,423,Bou688_T,"-37.81686075, 144.95358075"
581520231216,58,2023-12-16,15,565,333,898,Bou688_T,"-37.81686075, 144.95358075"
21220240630,2,2024-06-30,12,663,713,1376,Bou283_T,"-37.81380668, 144.96516718"
27120231026,27,2023-10-26,1,19,7,26,Vic_T,"-37.80606888, 144.95644692"
27520240609,27,2024-06-09,5,6,5,11,Vic_T,"-37.80606888, 144.95644692"
792120240429,79,2024-04-29,21,140,156,296,FliSS_T,"-37.81794046, 144.96616678"
9120250106,9,2025-01-06,1,0,6,6,Col700_T,"-37.81982992, 144.95102555"
231020231113,23,2023-11-13,10,227,218,445,Col623_T,"-37.81909256, 144.95452748"
231920231122,23,2023-11-22,19,156,248,404,Col623_T,"-37.81909256, 144.95452748"
23020231127,23,2023-11-27,0,69,17,86,Col623_T,"-37.81909256, 144.95452748"
491620250413,49,2025-04-13,16,183,326,509,Eli501_T,"-37.80730068, 144.95956055"
251120240305,25,2024-03-05,11,222,401,623,MCEC_T,"-37.82401776, 144.95604426"
251120241102,25,2024-11-02,11,489,878,1367,MCEC_T,"-37.82401776, 144.95604426"
251720250313,25,2025-03-13,17,1123,396,1519,MCEC_T,"-37.82401776, 144.95604426"
1411720250101,141,2025-01-01,17,133,114,247,474Fl_T,"-37.81997273, 144.95834911"
1421820240707,142,2024-07-07,18,371,195,566,Hammer1584_T,"-37.81970749, 144.96795734"
182320231110,18,2023-11-10,23,11,12,23,Col12_T,"-37.81344862, 144.97305353"
631320250227,63,2025-02-27,13,480,615,1095,Bou231_T,"-37.81333081, 144.96675571"
682320240721,68,2024-07-21,23,6,0,6,FLDegN_T,"-37.8168479, 144.96559789"
1320250925,1,2025-09-25,3,2,8,10,Bou292_T,"-37.81349441, 144.96515323"
861920250525,86,2025-05-25,19,55,44,99,574Qub_T,"-37.80309992, 144.94908064"
62820250420,62,2025-04-20,8,30,42,72,Lat224_T,"-37.80996494, 144.96216521"
11720240930,11,2024-09-30,7,37,38,75,WatCit_T,"-37.81564989, 144.93970694"
111720250115,11,2025-01-15,17,66,45,111,WatCit_T,"-37.81564989, 144.93970694"
24420240523,24,2024-05-23,4,19,21,40,Col620_T,"-37.81887963, 144.95449198"
101220231116,10,2023-11-16,12,171,153,324,BouHbr_T,"-37.81876474, 144.94710545"
72220250218,72,2025-02-18,2,2,1,3,ACMI_T,"-37.81726338, 144.96872809"
21120241215,2,2024-12-15,11,797,792,1589,Bou283_T,"-37.81380668, 144.96516718"
58320241231,58,2024-12-31,3,9,15,24,Bou688_T,"-37.81686075, 144.95358075"
271620241008,27,2024-10-08,16,134,107,241,Vic_T,"-37.80606888, 144.95644692"
9120231125,9,2023-11-25,1,14,9,23,Col700_T,"-37.81982992, 144.95102555"
53520240831,53,2024-08-31,5,11,6,17,Col254_T,"-37.81564191, 144.965499"
791620240123,79,2024-01-23,16,667,617,1284,FliSS_T,"-37.81794046, 144.96616678"
301420240613,30,2024-06-13,14,189,368,557,Lon189_T,"-37.8112185, 144.96656806"
232320241209,23,2024-12-09,23,22,51,73,Col623_T,"-37.81909256, 144.95452748"
481520231202,48,2023-12-02,15,375,208,583,QVMQ_T,"-37.80631581, 144.95866697"
461820231118,46,2023-11-18,18,51,47,98,Pel147_T,"-37.80240719, 144.9615673"
52020240410,52,2024-04-10,0,15,33,48,Eli263_T,"-37.81252157, 144.9619401"
1392020231208,139,2023-12-08,20,127,71,198,Signal1647_T,"-37.81959923, 144.9632832"
139520250510,139,2025-05-10,5,0,3,3,Signal1647_T,"-37.81959923, 144.9632832"
1422120240515,142,2024-05-15,21,96,73,169,Hammer1584_T,"-37.81970749, 144.96795734"
180820250403,180,2025-04-03,8,119,29,148,Mac330_T,"-37.79497059, 144.93530329"
1381220231213,138,2023-12-13,12,5,5,10,EntPark1671_T,"-37.81996544, 144.95981454"
1381620250214,138,2025-02-14,16,16,6,22,EntPark1671_T,"-37.81996544, 144.95981454"
161520240606,161,2024-06-06,5,0,2,2,BirArt1109_T,"-37.81851276, 144.97131336"
1231420231215,123,2023-12-15,14,42,28,70,BirBridge_T,"-37.81753741, 144.97329734"
1231620250327,123,2025-03-27,16,34,18,52,BirBridge_T,"-37.81753741, 144.97329734"
49020250429,49,2025-04-29,0,48,44,92,Eli501_T,"-37.80730068, 144.95956055"
19420241211,19,2024-12-11,4,18,2,20,LtB210_T,"-37.81237202, 144.96550671"
841020250111,84,2025-01-11,10,833,626,1459,ElFi_T,"-37.81798049, 144.96503383"
41420231213,4,2023-12-13,14,1511,1291,2802,Swa123_T,"-37.81487988, 144.9660878"
4820240513,4,2024-05-13,8,556,249,805,Swa123_T,"-37.81487988, 144.9660878"
3320250215,3,2025-02-15,3,85,57,142,Swa295_T,"-37.81101524, 144.96429485"
4020250113,4,2025-01-13,0,231,97,328,Swa123_T,"-37.81487988, 144.9660878"
752120241229,75,2024-12-29,21,7,16,23,SprFli_T,"-37.81515276, 144.97467661"
391720241103,39,2024-11-03,17,60,63,123,AlfPl_T,"-37.81379749, 144.96995745"
78420240813,78,2024-08-13,4,1,0,1,HarEsB_T,"-37.81471642, 144.9446508"
781320250903,78,2025-09-03,13,33,47,80,HarEsB_T,"-37.81471642, 144.9446508"
59920231119,59,2023-11-19,9,112,175,287,RMIT_T,"-37.80825648, 144.96304859"
59820240307,59,2024-03-07,8,1737,296,2033,RMIT_T,"-37.80825648, 144.96304859"
65720240923,65,2024-09-23,7,331,156,487,SwaCs_T,"-37.81569416, 144.9668064"
141220241120,14,2024-11-20,12,322,154,476,SanBri_T,"-37.82011242, 144.96291897"
451520231218,45,2023-12-18,15,545,797,1342,Swa148_T,"-37.81414075, 144.96609379"
51920251011,5,2025-10-11,19,1164,1262,2426,PriNW_T,"-37.81874249, 144.96787656"
51520240424,5,2024-04-24,15,939,836,1775,PriNW_T,"-37.81874249, 144.96787656"
211220240227,21,2024-02-27,12,563,516,1079,Bourke155_T,"-37.81267313, 144.96788288"
361820241220,36,2024-12-20,18,196,174,370,Que85_T,"-37.81652527, 144.96121062"
501120240713,50,2024-07-13,11,188,191,379,Lyg309_T,"-37.79808192, 144.96721013"
501320240830,50,2024-08-30,13,192,228,420,Lyg309_T,"-37.79808192, 144.96721013"
1331420241220,133,2024-12-20,14,407,491,898,Spen229_T,"-37.81531435, 144.95227769"
133320250119,133,2025-01-19,3,20,28,48,Spen229_T,"-37.81531435, 144.95227769"
671420250912,67,2025-09-12,14,395,588,983,FLDegS_T,"-37.81688755, 144.96562569"
851020240918,85,2024-09-18,10,72,53,125,488Mac_T,"-37.79432415, 144.92973378"
17520231210,17,2023-12-10,5,10,6,16,Col15_T,"-37.81362543, 144.97323591"
67720241112,67,2024-11-12,7,212,181,393,FLDegS_T,"-37.81688755, 144.96562569"
182220240517,18,2024-05-17,22,1,1,2,Col12_T,"-37.81344862, 144.97305353"
62120241122,62,2024-11-22,1,43,45,88,Lat224_T,"-37.80996494, 144.96216521"
561320231024,56,2023-10-24,13,309,185,494,Lon364_T,"-37.81234775, 144.96153311"
112020240328,11,2024-03-28,20,78,86,164,WatCit_T,"-37.81564989, 144.93970694"
11120250225,11,2025-02-25,1,8,5,13,WatCit_T,"-37.81564989, 144.93970694"
121320240808,12,2024-08-08,13,210,107,317,NewQ_T,"-37.81457988, 144.94292398"
121320240911,12,2024-09-11,13,120,89,209,NewQ_T,"-37.81457988, 144.94292398"
101420250205,10,2025-02-05,14,107,60,167,BouHbr_T,"-37.81876474, 144.94710545"
72520231019,72,2023-10-19,5,22,29,51,ACMI_T,"-37.81726338, 144.96872809"
24720250907,24,2025-09-07,7,100,133,233,Col620_T,"-37.81887963, 144.95449198"
351720240123,35,2024-01-23,17,2234,1454,3688,SouthB_T,"-37.82018685, 144.96508508"
58120241226,58,2024-12-26,1,46,53,99,Bou688_T,"-37.81686075, 144.95358075"
512320241031,51,2024-10-31,23,57,19,76,Fra118_T,"-37.80841815, 144.95906316"
511220241102,51,2024-11-02,12,157,111,268,Fra118_T,"-37.80841815, 144.95906316"
201620240918,20,2024-09-18,16,177,184,361,LtB170_T,"-37.81172914, 144.9682466"
201720240420,20,2024-04-20,17,657,500,1157,LtB170_T,"-37.81172914, 144.9682466"
52620250127,52,2025-01-27,6,10,7,17,Eli263_T,"-37.81252157, 144.9619401"
461820240917,46,2024-09-17,18,49,98,147,Pel147_T,"-37.80240719, 144.9615673"
46020250213,46,2025-02-13,0,1,0,1,Pel147_T,"-37.80240719, 144.9615673"
1372020240423,137,2024-04-23,20,4,6,10,BouHbr2353_T,"-37.81894815, 144.94612292"
1371920240801,137,2024-08-01,19,2,6,8,BouHbr2353_T,"-37.81894815, 144.94612292"
141320240330,141,2024-03-30,3,31,32,63,474Fl_T,"-37.81997273, 144.95834911"
1361820241112,136,2024-11-12,18,264,51,315,BirFed1120_T,"-37.8184141, 144.97357915"
1361520250216,136,2025-02-16,15,44,41,85,BirFed1120_T,"-37.8184141, 144.97357915"
1642020250329,164,2025-03-29,20,73,90,163,Lat526_T,"-37.813005, 144.95160411"
180720250404,180,2025-04-04,7,45,12,57,Mac330_T,"-37.79497059, 144.93530329"
117420241130,117,2024-11-30,4,6,4,10,Fli114F_T,"-37.81629332, 144.97090877"
1171820250902,117,2025-09-02,18,100,236,336,Fli114F_T,"-37.81629332, 144.97090877"
48720250902,48,2025-09-02,7,74,67,141,QVMQ_T,"-37.80631581, 144.95866697"
138720240705,138,2024-07-05,7,1,2,3,EntPark1671_T,"-37.81996544, 144.95981454"
109220240812,109,2024-08-12,2,5,1,6,LatWill_T,"-37.81193681, 144.95621105"
192020240809,19,2024-08-09,20,689,735,1424,LtB210_T,"-37.81237202, 144.96550671"
661120250824,66,2025-08-24,11,1446,852,2298,QVN_T,"-37.81057846, 144.96444294"
41020241217,4,2024-12-17,10,1127,678,1805,Swa123_T,"-37.81487988, 144.9660878"
392220240716,39,2024-07-16,22,13,14,27,AlfPl_T,"-37.81379749, 144.96995745"
41920250902,41,2025-09-02,9,1607,683,2290,Swa31,"-37.81668634, 144.96689733"
781020240329,78,2024-03-29,10,62,68,130,HarEsB_T,"-37.81471642, 144.9446508"
42320250129,42,2025-01-29,3,6,2,8,UM1_T,"-37.80008566, 144.96386412"
291820250827,29,2025-08-27,18,201,225,426,AG_T,"-37.8199817, 144.96872865"
291320251014,29,2025-10-14,13,217,348,565,AG_T,"-37.8199817, 144.96872865"
401920240316,40,2024-03-16,19,113,237,350,Spr201_T,"-37.80999341, 144.97227587"
31620240427,31,2024-04-27,6,8,4,12,Lyg161_T,"-37.80169681, 144.96658911"
311020240516,31,2024-05-16,10,103,96,199,Lyg161_T,"-37.80169681, 144.96658911"
45820241226,45,2024-12-26,8,73,123,196,Swa148_T,"-37.81414075, 144.96609379"
45620250107,45,2025-01-07,6,20,37,57,Swa148_T,"-37.81414075, 144.96609379"
51820240203,5,2024-02-03,18,1229,1816,3045,PriNW_T,"-37.81874249, 144.96787656"
5520241006,5,2024-10-06,5,19,18,37,PriNW_T,"-37.81874249, 144.96787656"
1611120250502,161,2025-05-02,11,184,134,318,BirArt1109_T,"-37.81851276, 144.97131336"
1641020251012,164,2025-10-12,10,94,63,157,Lat526_T,"-37.813005, 144.95160411"
1231120241112,123,2024-11-12,11,3,2,5,BirBridge_T,"-37.81753741, 144.97329734"
1171420240611,117,2024-06-11,14,108,132,240,Fli114F_T,"-37.81629332, 144.97090877"
69620250401,69,2025-04-01,6,25,9,34,FLDegC_T,"-37.81687226, 144.96559144"
841020240725,84,2024-07-25,10,539,382,921,ElFi_T,"-37.81798049, 144.96503383"
84120250614,84,2025-06-14,1,37,87,124,ElFi_T,"-37.81798049, 144.96503383"
66820240413,66,2024-04-13,8,67,128,195,QVN_T,"-37.81057846, 144.96444294"
66020240416,66,2024-04-16,0,60,30,90,QVN_T,"-37.81057846, 144.96444294"
661820240511,66,2024-05-11,18,1381,1300,2681,QVN_T,"-37.81057846, 144.96444294"
41820240609,41,2024-06-09,8,338,202,540,Swa31,"-37.81668634, 144.96689733"
411220240919,41,2024-09-19,12,419,387,806,Swa31,"-37.81668634, 144.96689733"
781520251010,78,2025-10-10,15,25,113,138,HarEsB_T,"-37.81471642, 144.9446508"
781120250303,78,2025-03-03,11,49,43,92,HarEsB_T,"-37.81471642, 144.9446508"
42820250917,42,2025-09-17,8,228,76,304,UM1_T,"-37.80008566, 144.96386412"
291120250413,29,2025-04-13,11,307,331,638,AG_T,"-37.8199817, 144.96872865"
291320250201,29,2025-02-01,13,408,470,878,AG_T,"-37.8199817, 144.96872865"
292220240425,29,2024-04-25,22,157,81,238,AG_T,"-37.8199817, 144.96872865"
141520250416,14,2025-04-16,15,465,135,600,SanBri_T,"-37.82011242, 144.96291897"
281720231204,28,2023-12-04,17,515,955,1470,VAC_T,"-37.82129925, 144.96879309"
282220240831,28,2024-08-31,22,370,258,628,VAC_T,"-37.82129925, 144.96879309"
31720231206,31,2023-12-06,7,29,35,64,Lyg161_T,"-37.80169681, 144.96658911"
311220250815,31,2025-08-15,12,165,161,326,Lyg161_T,"-37.80169681, 144.96658911"
431820241227,43,2024-12-27,18,39,31,70,UM2_T,"-37.79844526, 144.96411782"
441320250407,44,2025-04-07,13,156,132,288,UM3_T,"-37.79698741, 144.96441306"
452220250131,45,2025-01-31,22,381,642,1023,Swa148_T,"-37.81414075, 144.96609379"
52220250922,5,2025-09-22,22,138,157,295,PriNW_T,"-37.81874249, 144.96787656"
5620240516,5,2024-05-16,6,63,185,248,PriNW_T,"-37.81874249, 144.96787656"
5320240522,5,2024-05-22,3,9,4,13,PriNW_T,"-37.81874249, 144.96787656"
162820250104,162,2025-01-04,8,191,143,334,Eli489_T,"-37.80740397, 144.95987909"
1311120240706,131,2024-07-06,11,201,238,439,King2_T,"-37.82009057, 144.95758725"
134520250713,134,2025-07-13,5,32,42,74,Spen201_T,"-37.81694221, 144.95303935"
1072120240808,107,2024-08-08,21,61,42,103,280Will_T,"-37.81246271, 144.95690188"
1331120231024,133,2023-10-24,11,366,405,771,Spen229_T,"-37.81531435, 144.95227769"
1331120240415,133,2024-04-15,11,405,467,872,Spen229_T,"-37.81531435, 144.95227769"
118520250418,118,2025-04-18,5,0,1,1,Fli114C_T,"-37.81632783, 144.97090512"
1822220250705,182,2025-07-05,22,564,376,940,King163_T,"-37.81627451, 144.95550503"
70220240713,70,2024-07-13,2,0,2,2,Errol20_T,"-37.80456984, 144.94946228"
185320250719,185,2025-07-19,3,29,16,45,Eli197_T,"-37.81374643, 144.96276183"
171520240328,17,2024-03-28,15,286,315,601,Col15_T,"-37.81362543, 144.97323591"
67720240926,67,2024-09-26,7,173,143,316,FLDegS_T,"-37.81688755, 144.96562569"
63720250920,63,2025-09-20,7,21,48,69,Bou231_T,"-37.81333081, 144.96675571"
181220240519,18,2024-05-19,12,76,85,161,Col12_T,"-37.81344862, 144.97305353"
621820251005,62,2025-10-05,18,283,294,577,Lat224_T,"-37.80996494, 144.96216521"
632020240512,63,2024-05-12,20,102,172,274,Bou231_T,"-37.81333081, 144.96675571"
63020241203,63,2024-12-03,0,2,28,30,Bou231_T,"-37.81333081, 144.96675571"
63820250502,63,2025-05-02,8,137,119,256,Bou231_T,"-37.81333081, 144.96675571"
121720231108,12,2023-11-08,17,57,93,150,NewQ_T,"-37.81457988, 144.94292398"
121720240426,12,2024-04-26,17,165,247,412,NewQ_T,"-37.81457988, 144.94292398"
861020231112,86,2023-11-12,10,34,24,58,574Qub_T,"-37.80309992, 144.94908064"
101320240217,10,2024-02-17,13,51,28,79,BouHbr_T,"-37.81876474, 144.94710545"
101520240220,10,2024-02-20,15,182,39,221,BouHbr_T,"-37.81876474, 144.94710545"
24720251007,24,2025-10-07,7,1282,304,1586,Col620_T,"-37.81887963, 144.95449198"
35220231103,35,2023-11-03,2,11,18,29,SouthB_T,"-37.82018685, 144.96508508"
721620250818,72,2025-08-18,16,79,482,561,ACMI_T,"-37.81726338, 144.96872809"
352220241007,35,2024-10-07,22,206,275,481,SouthB_T,"-37.82018685, 144.96508508"
35520241224,35,2024-12-24,5,51,29,80,SouthB_T,"-37.82018685, 144.96508508"
791120241026,79,2024-10-26,11,525,423,948,FliSS_T,"-37.81794046, 144.96616678"
302220231219,30,2023-12-19,22,187,244,431,Lon189_T,"-37.8112185, 144.96656806"
51020240713,51,2024-07-13,0,16,18,34,Fra118_T,"-37.80841815, 144.95906316"
51120231025,51,2023-10-25,1,16,6,22,Fra118_T,"-37.80841815, 144.95906316"
491120231127,49,2023-11-27,11,55,103,158,Eli501_T,"-37.80730068, 144.95956055"
19020240517,19,2024-05-17,0,92,79,171,LtB210_T,"-37.81237202, 144.96550671"
251720241222,25,2024-12-22,17,1185,756,1941,MCEC_T,"-37.82401776, 144.95604426"
1392020240422,139,2024-04-22,20,18,14,32,Signal1647_T,"-37.81959923, 144.9632832"
1391120240910,139,2024-09-10,11,34,63,97,Signal1647_T,"-37.81959923, 144.9632832"
142420250319,142,2025-03-19,4,1,0,1,Hammer1584_T,"-37.81970749, 144.96795734"
117920240716,117,2024-07-16,9,208,93,301,Fli114F_T,"-37.81629332, 144.97090877"
1171320250121,117,2025-01-21,13,228,194,422,Fli114F_T,"-37.81629332, 144.97090877"
1091320250405,109,2025-04-05,13,106,89,195,LatWill_T,"-37.81193681, 144.95621105"
109920231218,109,2023-12-18,9,75,224,299,LatWill_T,"-37.81193681, 144.95621105"
661620241004,66,2024-10-04,16,1462,1693,3155,QVN_T,"-37.81057846, 144.96444294"
69220250416,69,2025-04-16,2,2,2,4,FLDegC_T,"-37.81687226, 144.96559144"
69220250503,69,2025-05-03,2,5,1,6,FLDegC_T,"-37.81687226, 144.96559144"
84520240224,84,2024-02-24,5,44,40,84,ElFi_T,"-37.81798049, 144.96503383"
61720250715,6,2025-07-15,17,2603,1196,3799,FliS_T,"-37.81911705, 144.96558255"
4520241011,4,2024-10-11,5,30,15,45,Swa123_T,"-37.81487988, 144.9660878"
702320240612,70,2024-06-12,23,1,7,8,Errol20_T,"-37.80456984, 144.94946228"
81720241101,8,2024-11-01,17,259,306,565,WebBN_T,"-37.82293543, 144.9471751"
81920240319,8,2024-03-19,19,102,131,233,WebBN_T,"-37.82293543, 144.9471751"
41620250303,41,2025-03-03,6,350,166,516,Swa31,"-37.81668634, 144.96689733"
41720231112,41,2023-11-12,7,171,132,303,Swa31,"-37.81668634, 144.96689733"
78820240105,78,2024-01-05,8,27,39,66,HarEsB_T,"-37.81471642, 144.9446508"
421620250324,42,2025-03-24,16,274,483,757,UM1_T,"-37.80008566, 144.96386412"
77520251010,77,2025-10-10,5,5,14,19,HarEsP_T,"-37.81441438, 144.94433026"
291220250626,29,2025-06-26,12,193,173,366,AG_T,"-37.8199817, 144.96872865"
29620231020,29,2023-10-20,6,48,67,115,AG_T,"-37.8199817, 144.96872865"
292120240622,29,2024-06-22,21,160,181,341,AG_T,"-37.8199817, 144.96872865"
136420250427,136,2025-04-27,4,3,0,3,BirFed1120_T,"-37.8184141, 144.97357915"
1231320250116,123,2025-01-16,13,97,83,180,BirBridge_T,"-37.81753741, 144.97329734"
1381620241229,138,2024-12-29,16,7,7,14,EntPark1671_T,"-37.81996544, 144.95981454"
1171920251010,117,2025-10-10,19,148,220,368,Fli114F_T,"-37.81629332, 144.97090877"
68520240604,68,2024-06-04,5,1,0,1,FLDegN_T,"-37.8168479, 144.96559789"
682220240801,68,2024-08-01,22,18,2,20,FLDegN_T,"-37.8168479, 144.96559789"
85920240520,85,2024-05-20,9,75,42,117,488Mac_T,"-37.79432415, 144.92973378"
171920231210,17,2023-12-10,19,146,72,218,Col15_T,"-37.81362543, 144.97323591"
672020250603,67,2025-06-03,20,110,178,288,FLDegS_T,"-37.81688755, 144.96562569"
682020250719,68,2025-07-19,20,157,104,261,FLDegN_T,"-37.8168479, 144.96559789"
181320240506,18,2024-05-06,13,230,210,440,Col12_T,"-37.81344862, 144.97305353"
861720250606,86,2025-06-06,17,56,64,120,574Qub_T,"-37.80309992, 144.94908064"
111720250414,11,2025-04-14,17,184,166,350,WatCit_T,"-37.81564989, 144.93970694"
621620240305,62,2024-03-05,16,249,184,433,Lat224_T,"-37.80996494, 144.96216521"
62820240308,62,2024-03-08,8,72,126,198,Lat224_T,"-37.80996494, 144.96216521"
562020231121,56,2023-11-21,20,223,163,386,Lon364_T,"-37.81234775, 144.96153311"
56620241105,56,2024-11-05,6,27,7,34,Lon364_T,"-37.81234775, 144.96153311"
86620241112,86,2024-11-12,6,13,3,16,574Qub_T,"-37.80309992, 144.94908064"
56020250506,56,2025-05-06,0,9,10,19,Lon364_T,"-37.81234775, 144.96153311"
102320240110,10,2024-01-10,23,1,3,4,BouHbr_T,"-37.81876474, 144.94710545"
761120250511,76,2025-05-11,11,62,71,133,KenMac_T,"-37.79453803, 144.93036194"
761420251005,76,2025-10-05,14,35,32,67,KenMac_T,"-37.79453803, 144.93036194"
721820241006,72,2024-10-06,18,153,255,408,ACMI_T,"-37.81726338, 144.96872809"
721720241108,72,2024-11-08,17,266,734,1000,ACMI_T,"-37.81726338, 144.96872809"
582220250714,58,2025-07-14,22,134,125,259,Bou688_T,"-37.81686075, 144.95358075"
27620240702,27,2024-07-02,6,19,25,44,Vic_T,"-37.80606888, 144.95644692"
27620240805,27,2024-08-05,6,17,8,25,Vic_T,"-37.80606888, 144.95644692"
232220240106,23,2024-01-06,22,71,111,182,Col623_T,"-37.81909256, 144.95452748"
522320250410,52,2025-04-10,23,82,90,172,Eli263_T,"-37.81252157, 144.9619401"
51920250623,51,2025-06-23,9,45,53,98,Fra118_T,"-37.80841815, 144.95906316"
512320250902,51,2025-09-02,23,18,20,38,Fra118_T,"-37.80841815, 144.95906316"
231520250226,23,2025-02-26,15,172,324,496,Col623_T,"-37.81909256, 144.95452748"
49020250416,49,2025-04-16,0,45,42,87,Eli501_T,"-37.80730068, 144.95956055"
191220231205,19,2023-12-05,12,448,420,868,LtB210_T,"-37.81237202, 144.96550671"
481920240119,48,2024-01-19,19,128,134,262,QVMQ_T,"-37.80631581, 144.95866697"
30320250726,30,2025-07-26,3,116,145,261,Lon189_T,"-37.8112185, 144.96656806"
25620250418,25,2025-04-18,6,32,44,76,MCEC_T,"-37.82401776, 144.95604426"
1411620231211,141,2023-12-11,16,113,100,213,474Fl_T,"-37.81997273, 144.95834911"
137820250422,137,2025-04-22,8,94,12,106,BouHbr2353_T,"-37.81894815, 144.94612292"
1371620250919,137,2025-09-19,16,10,136,146,BouHbr2353_T,"-37.81894815, 144.94612292"
1411620240425,141,2024-04-25,16,191,117,308,474Fl_T,"-37.81997273, 144.95834911"
1391420250217,139,2025-02-17,14,62,71,133,Signal1647_T,"-37.81959923, 144.9632832"
1361620250911,136,2025-09-11,16,118,43,161,BirFed1120_T,"-37.8184141, 144.97357915"
712320240205,71,2024-02-05,23,0,1,1,WestWP_T,"-37.81235775, 144.97136962"
36420250716,36,2025-07-16,4,1,1,2,Que85_T,"-37.81652527, 144.96121062"
361620250919,36,2025-09-19,16,179,187,366,Que85_T,"-37.81652527, 144.96121062"
361920241021,36,2024-10-21,19,106,102,208,Que85_T,"-37.81652527, 144.96121062"
871420240116,87,2024-01-16,14,74,69,143,Errol23_T,"-37.80454949, 144.94921863"
871820241206,87,2024-12-06,18,112,105,217,Errol23_T,"-37.80454949, 144.94921863"
452020240925,45,2024-09-25,20,243,538,781,Swa148_T,"-37.81414075, 144.96609379"
442320250727,44,2025-07-27,23,2,4,6,UM3_T,"-37.79698741, 144.96441306"
451620240305,45,2024-03-05,16,442,747,1189,Swa148_T,"-37.81414075, 144.96609379"
1311120250421,131,2025-04-21,11,113,171,284,King2_T,"-37.82009057, 144.95758725"
131120250518,131,2025-05-18,1,97,109,206,King2_T,"-37.82009057, 144.95758725"
131120251001,131,2025-10-01,1,11,9,20,King2_T,"-37.82009057, 144.95758725"
143020240728,143,2024-07-28,0,132,56,188,Spencer_T,"-37.821728, 144.95557015"
132120250110,132,2025-01-10,1,15,21,36,King335_T,"-37.81267639, 144.95386444"
1322220240808,132,2024-08-08,22,55,60,115,King335_T,"-37.81267639, 144.95386444"
135120231223,135,2023-12-23,1,52,43,95,Spen161_T,"-37.8172861, 144.95319102"
107420240726,107,2024-07-26,4,9,1,10,280Will_T,"-37.81246271, 144.95690188"
1331920240322,133,2024-03-22,19,726,457,1183,Spen229_T,"-37.81531435, 144.95227769"
1331520241226,133,2024-12-26,15,447,418,865,Spen229_T,"-37.81531435, 144.95227769"
1082020240208,108,2024-02-08,20,172,117,289,261Will_T,"-37.81295822, 144.95678789"
1081420250618,108,2025-06-18,14,419,207,626,261Will_T,"-37.81295822, 144.95678789"
1081820250707,108,2025-07-07,18,454,155,609,261Will_T,"-37.81295822, 144.95678789"
181520241026,18,2024-10-26,15,123,67,190,Col12_T,"-37.81344862, 144.97305353"
182220250330,18,2025-03-30,22,8,14,22,Col12_T,"-37.81344862, 144.97305353"
18220240512,18,2024-05-12,2,0,1,1,Col12_T,"-37.81344862, 144.97305353"
111220240908,11,2024-09-08,12,114,128,242,WatCit_T,"-37.81564989, 144.93970694"
101420231225,10,2023-12-25,14,21,6,27,BouHbr_T,"-37.81876474, 144.94710545"
24920241127,24,2024-11-27,9,1330,410,1740,Col620_T,"-37.81887963, 144.95449198"
72020250125,72,2025-01-25,0,24,49,73,ACMI_T,"-37.81726338, 144.96872809"
581520241103,58,2024-11-03,15,570,397,967,Bou688_T,"-37.81686075, 144.95358075"
35020240828,35,2024-08-28,0,50,71,121,SouthB_T,"-37.82018685, 144.96508508"
35720250113,35,2025-01-13,7,443,650,1093,SouthB_T,"-37.82018685, 144.96508508"
2020241211,2,2024-12-11,0,19,31,50,Bou283_T,"-37.81380668, 144.96516718"
22220231021,2,2023-10-21,22,54,194,248,Bou283_T,"-37.81380668, 144.96516718"
21420240411,2,2024-04-11,14,907,995,1902,Bou283_T,"-37.81380668, 144.96516718"
9120240827,9,2024-08-27,1,1,6,7,Col700_T,"-37.81982992, 144.95102555"
27920231109,27,2023-11-09,9,85,94,179,Vic_T,"-37.80606888, 144.95644692"
91220250522,9,2025-05-22,12,736,625,1361,Col700_T,"-37.81982992, 144.95102555"
512320250227,51,2025-02-27,23,34,20,54,Fra118_T,"-37.80841815, 144.95906316"
201620250531,20,2025-05-31,16,328,441,769,LtB170_T,"-37.81172914, 144.9682466"
201520240213,20,2024-02-13,15,132,197,329,LtB170_T,"-37.81172914, 144.9682466"
251520240425,25,2024-04-25,15,1111,975,2086,MCEC_T,"-37.82401776, 144.95604426"
1801220250403,180,2025-04-03,12,42,35,77,Mac330_T,"-37.79497059, 144.93530329"
137820250513,137,2025-05-13,8,123,28,151,BouHbr2353_T,"-37.81894815, 144.94612292"
1171020231114,117,2023-11-14,10,99,103,202,Fli114F_T,"-37.81629332, 144.97090877"
1171420241004,117,2024-10-04,14,141,166,307,Fli114F_T,"-37.81629332, 144.97090877"
691620240804,69,2024-08-04,16,166,133,299,FLDegC_T,"-37.81687226, 144.96559144"
31020250108,3,2025-01-08,10,328,390,718,Swa295_T,"-37.81101524, 144.96429485"
661520240701,66,2024-07-01,15,1242,1221,2463,QVN_T,"-37.81057846, 144.96444294"
41020240816,4,2024-08-16,10,795,543,1338,Swa123_T,"-37.81487988, 144.9660878"
81720250920,8,2025-09-20,17,171,168,339,WebBN_T,"-37.82293543, 144.9471751"
751920250127,75,2025-01-27,19,17,22,39,SprFli_T,"-37.81515276, 144.97467661"
411720240309,41,2024-03-09,17,1781,1424,3205,Swa31,"-37.81668634, 144.96689733"
41620240328,41,2024-03-28,6,413,165,578,Swa31,"-37.81668634, 144.96689733"
591520231030,59,2023-10-30,15,558,733,1291,RMIT_T,"-37.80825648, 144.96304859"
591620250214,59,2025-02-14,16,241,331,572,RMIT_T,"-37.80825648, 144.96304859"
65220231028,65,2023-10-28,2,19,91,110,SwaCs_T,"-37.81569416, 144.9668064"
291620240511,29,2024-05-11,16,512,555,1067,AG_T,"-37.8199817, 144.96872865"
711620231209,71,2023-12-09,16,9,2,11,WestWP_T,"-37.81235775, 144.97136962"
311520241007,31,2024-10-07,15,106,115,221,Lyg161_T,"-37.80169681, 144.96658911"
54420231030,54,2023-10-30,4,6,7,13,Swa607_T,"-37.804024, 144.96308399"
542320240209,54,2024-02-09,23,62,26,88,Swa607_T,"-37.804024, 144.96308399"
28420241230,28,2024-12-30,4,4,19,23,VAC_T,"-37.82129925, 144.96879309"
362220250424,36,2025-04-24,22,123,109,232,Que85_T,"-37.81652527, 144.96121062"
362320250526,36,2025-05-26,23,16,11,27,Que85_T,"-37.81652527, 144.96121062"
43020231215,43,2023-12-15,0,3,1,4,UM2_T,"-37.79844526, 144.96411782"
5920250225,5,2025-02-25,9,296,1224,1520,PriNW_T,"-37.81874249, 144.96787656"
1071120240827,107,2024-08-27,11,86,112,198,280Will_T,"-37.81246271, 144.95690188"
1081020250405,108,2025-04-05,10,161,111,272,261Will_T,"-37.81295822, 144.95678789"
118820250927,118,2025-09-27,8,10,8,18,Fli114C_T,"-37.81632783, 144.97090512"
1081620231020,108,2023-10-20,16,678,186,864,261Will_T,"-37.81295822, 144.95678789"
87620241107,87,2024-11-07,6,16,9,25,Errol23_T,"-37.80454949, 144.94921863"
612020251009,61,2025-10-09,20,433,429,862,RMIT14_T,"-37.80767455, 144.96309114"
61620231103,61,2023-11-03,6,38,55,93,RMIT14_T,"-37.80767455, 144.96309114"
501420250507,50,2025-05-07,14,179,184,363,Lyg309_T,"-37.79808192, 144.96721013"
1811020250908,181,2025-09-08,10,351,524,875,Eli368_T,"-37.81009465, 144.96143149"
1622220251012,162,2025-10-12,22,166,82,248,Eli489_T,"-37.80740397, 144.95987909"
1312320250807,131,2025-08-07,23,175,79,254,King2_T,"-37.82009057, 144.95758725"
1311320231028,131,2023-10-28,13,138,106,244,King2_T,"-37.82009057, 144.95758725"
682020231128,68,2023-11-28,20,100,38,138,FLDegN_T,"-37.8168479, 144.96559789"
851420250627,85,2025-06-27,14,60,60,120,488Mac_T,"-37.79432415, 144.92973378"
171320250712,17,2025-07-12,13,211,88,299,Col15_T,"-37.81362543, 144.97323591"
171620250903,17,2025-09-03,16,252,427,679,Col15_T,"-37.81362543, 144.97323591"
682220250413,68,2025-04-13,22,27,20,47,FLDegN_T,"-37.8168479, 144.96559789"
631720250818,63,2025-08-18,17,275,397,672,Bou231_T,"-37.81333081, 144.96675571"
632020250829,63,2025-08-29,20,180,253,433,Bou231_T,"-37.81333081, 144.96675571"
631620240208,63,2024-02-08,16,321,436,757,Bou231_T,"-37.81333081, 144.96675571"
622120240225,62,2024-02-25,21,194,112,306,Lat224_T,"-37.80996494, 144.96216521"
561520240914,56,2024-09-14,15,369,316,685,Lon364_T,"-37.81234775, 144.96153311"
111620250408,11,2025-04-08,16,93,87,180,WatCit_T,"-37.81564989, 144.93970694"
12020250812,1,2025-08-12,20,129,118,247,Bou292_T,"-37.81349441, 144.96515323"
12120250412,12,2025-04-12,1,16,15,31,NewQ_T,"-37.81457988, 144.94292398"
241920250521,24,2025-05-21,19,334,618,952,Col620_T,"-37.81887963, 144.95449198"
562120250519,56,2025-05-19,21,172,225,397,Lon364_T,"-37.81234775, 144.96153311"
58320240126,58,2024-01-26,3,14,36,50,Bou688_T,"-37.81686075, 144.95358075"
58520240314,58,2024-03-14,5,101,26,127,Bou688_T,"-37.81686075, 144.95358075"
27420250125,27,2025-01-25,4,6,6,12,Vic_T,"-37.80606888, 144.95644692"
531020241219,53,2024-12-19,10,624,500,1124,Col254_T,"-37.81564191, 144.965499"
27320250927,27,2025-09-27,3,10,2,12,Vic_T,"-37.80606888, 144.95644692"
30320240908,30,2024-09-08,3,194,190,384,Lon189_T,"-37.8112185, 144.96656806"
791120240608,79,2024-06-08,11,528,361,889,FliSS_T,"-37.81794046, 144.96616678"
51020241113,51,2024-11-13,0,26,12,38,Fra118_T,"-37.80841815, 144.95906316"
461220240221,46,2024-02-21,12,124,116,240,Pel147_T,"-37.80240719, 144.9615673"
139320250526,139,2025-05-26,3,0,1,1,Signal1647_T,"-37.81959923, 144.9632832"
161720240613,161,2024-06-13,7,43,82,125,BirArt1109_T,"-37.81851276, 144.97131336"
191320241029,19,2024-10-29,13,390,428,818,LtB210_T,"-37.81237202, 144.96550671"
69920250420,69,2025-04-20,9,93,48,141,FLDegC_T,"-37.81687226, 144.96559144"
62120241101,6,2024-11-01,21,787,610,1397,FliS_T,"-37.81911705, 144.96558255"
4720240328,4,2024-03-28,7,250,149,399,Swa123_T,"-37.81487988, 144.9660878"
70520240603,70,2024-06-03,5,6,0,6,Errol20_T,"-37.80456984, 144.94946228"
32220241001,3,2024-10-01,22,298,299,597,Swa295_T,"-37.81101524, 144.96429485"
31320240530,3,2024-05-30,13,1001,1044,2045,Swa295_T,"-37.81101524, 144.96429485"
391520241022,39,2024-10-22,15,111,99,210,AlfPl_T,"-37.81379749, 144.96995745"
162820240804,162,2024-08-04,8,172,109,281,Eli489_T,"-37.80740397, 144.95987909"
1822020250803,182,2025-08-03,20,221,234,455,King163_T,"-37.81627451, 144.95550503"
1822320250814,182,2025-08-14,23,78,78,156,King163_T,"-37.81627451, 144.95550503"
1311720250714,131,2025-07-14,17,113,141,254,King2_T,"-37.82009057, 144.95758725"
1311620231024,131,2023-10-24,16,82,138,220,King2_T,"-37.82009057, 144.95758725"
1431420250905,143,2025-09-05,14,189,222,411,Spencer_T,"-37.821728, 144.95557015"
1431520240508,143,2024-05-08,15,577,305,882,Spencer_T,"-37.821728, 144.95557015"
1351020240827,135,2024-08-27,10,417,304,721,Spen161_T,"-37.8172861, 144.95319102"
107620240109,107,2024-01-09,6,11,24,35,280Will_T,"-37.81246271, 144.95690188"
1331520240622,133,2024-06-22,15,427,440,867,Spen229_T,"-37.81531435, 144.95227769"
1081020240707,108,2024-07-07,10,51,96,147,261Will_T,"-37.81295822, 144.95678789"
67520240320,67,2024-03-20,5,11,14,25,FLDegS_T,"-37.81688755, 144.96562569"
851820250819,85,2025-08-19,18,58,95,153,488Mac_T,"-37.79432415, 144.92973378"
1820250112,1,2025-01-12,8,61,69,130,Bou292_T,"-37.81349441, 144.96515323"
18020250828,18,2025-08-28,0,5,2,7,Col12_T,"-37.81344862, 144.97305353"
1020251005,1,2025-10-05,0,61,84,145,Bou292_T,"-37.81349441, 144.96515323"
861020231026,86,2023-10-26,10,40,31,71,574Qub_T,"-37.80309992, 144.94908064"
11020250219,11,2025-02-19,0,15,3,18,WatCit_T,"-37.81564989, 144.93970694"
621220241101,62,2024-11-01,12,235,309,544,Lat224_T,"-37.80996494, 144.96216521"
562020231104,56,2023-11-04,20,322,207,529,Lon364_T,"-37.81234775, 144.96153311"
86220231206,86,2023-12-06,2,1,0,1,574Qub_T,"-37.80309992, 144.94908064"
861120241029,86,2024-10-29,11,55,37,92,574Qub_T,"-37.80309992, 144.94908064"
121320250621,12,2025-06-21,13,143,194,337,NewQ_T,"-37.81457988, 144.94292398"
581720241016,58,2024-10-16,17,867,1311,2178,Bou688_T,"-37.81686075, 144.95358075"
35020241005,35,2024-10-05,0,256,395,651,SouthB_T,"-37.82018685, 144.96508508"
2820240923,2,2024-09-23,8,90,180,270,Bou283_T,"-37.81380668, 144.96516718"
21220241113,2,2024-11-13,12,338,438,776,Bou283_T,"-37.81380668, 144.96516718"
301220250218,30,2025-02-18,12,234,425,659,Lon189_T,"-37.8112185, 144.96656806"
301920240612,30,2024-06-12,19,278,334,612,Lon189_T,"-37.8112185, 144.96656806"
46220240714,46,2024-07-14,2,1,5,6,Pel147_T,"-37.80240719, 144.9615673"
51420250506,51,2025-05-06,4,2,3,5,Fra118_T,"-37.80841815, 144.95906316"
23620250803,23,2025-08-03,6,16,14,30,Col623_T,"-37.81909256, 144.95452748"
481620240108,48,2024-01-08,16,77,135,212,QVMQ_T,"-37.80631581, 144.95866697"
481620240125,48,2024-01-25,16,152,165,317,QVMQ_T,"-37.80631581, 144.95866697"
141820240428,141,2024-04-28,8,45,30,75,474Fl_T,"-37.81997273, 144.95834911"
1361020250221,136,2025-02-21,10,36,26,62,BirFed1120_T,"-37.8184141, 144.97357915"
142320250313,142,2025-03-13,3,3,1,4,Hammer1584_T,"-37.81970749, 144.96795734"
123820241015,123,2024-10-15,8,14,1,15,BirBridge_T,"-37.81753741, 144.97329734"
1171720250604,117,2025-06-04,17,129,466,595,Fli114F_T,"-37.81629332, 144.97090877"
109820250201,109,2025-02-01,8,29,41,70,LatWill_T,"-37.81193681, 144.95621105"
66020231206,66,2023-12-06,0,77,47,124,QVN_T,"-37.81057846, 144.96444294"
69320250511,69,2025-05-11,3,6,3,9,FLDegC_T,"-37.81687226, 144.96559144"
3820231130,3,2023-11-30,8,186,341,527,Swa295_T,"-37.81101524, 144.96429485"
66020240507,66,2024-05-07,0,39,28,67,QVN_T,"-37.81057846, 144.96444294"
31520240719,3,2024-07-19,15,1015,1132,2147,Swa295_T,"-37.81101524, 144.96429485"
66820231026,66,2023-10-26,8,135,543,678,QVN_T,"-37.81057846, 144.96444294"
8920241226,8,2024-12-26,9,160,411,571,WebBN_T,"-37.82293543, 144.9471751"
411820241004,41,2024-10-04,18,273,215,488,Swa31,"-37.81668634, 144.96689733"
78920240513,78,2024-05-13,9,40,25,65,HarEsB_T,"-37.81471642, 144.9446508"
42820251004,42,2025-10-04,8,15,23,38,UM1_T,"-37.80008566, 144.96386412"
422320251008,42,2025-10-08,23,19,25,44,UM1_T,"-37.80008566, 144.96386412"
29920250207,29,2025-02-07,9,117,142,259,AG_T,"-37.8199817, 144.96872865"
54020250710,54,2025-07-10,0,10,12,22,Swa607_T,"-37.804024, 144.96308399"
441120241229,44,2024-12-29,11,12,19,31,UM3_T,"-37.79698741, 144.96441306"
45720241216,45,2024-12-16,7,65,115,180,Swa148_T,"-37.81414075, 144.96609379"
131120241112,131,2024-11-12,1,13,8,21,King2_T,"-37.82009057, 144.95758725"
1072120250710,107,2025-07-10,21,82,27,109,280Will_T,"-37.81246271, 144.95690188"
1181020231209,118,2023-12-09,10,16,11,27,Fli114C_T,"-37.81632783, 144.97090512"
162520250918,162,2025-09-18,5,15,10,25,Eli489_T,"-37.80740397, 144.95987909"
85620250128,85,2025-01-28,6,23,6,29,488Mac_T,"-37.79432415, 144.92973378"
12120250104,1,2025-01-04,21,428,306,734,Bou292_T,"-37.81349441, 144.96515323"
12020250825,1,2025-08-25,20,303,304,607,Bou292_T,"-37.81349441, 144.96515323"
182220231216,18,2023-12-16,22,20,13,33,Col12_T,"-37.81344862, 144.97305353"
181020240529,18,2024-05-29,10,137,232,369,Col12_T,"-37.81344862, 144.97305353"
111020240509,11,2024-05-09,10,37,48,85,WatCit_T,"-37.81564989, 144.93970694"
101620231213,10,2023-12-13,16,272,104,376,BouHbr_T,"-37.81876474, 144.94710545"
111320250717,11,2025-07-17,13,141,104,245,WatCit_T,"-37.81564989, 144.93970694"
24520240925,24,2024-09-25,5,110,46,156,Col620_T,"-37.81887963, 144.95449198"
24120241031,24,2024-10-31,1,23,36,59,Col620_T,"-37.81887963, 144.95449198"
53520240711,53,2024-07-11,5,11,10,21,Col254_T,"-37.81564191, 144.965499"
53720231119,53,2023-11-19,7,27,31,58,Col254_T,"-37.81564191, 144.965499"
791320250428,79,2025-04-28,13,453,437,890,FliSS_T,"-37.81794046, 144.96616678"
79220250217,79,2025-02-17,2,6,20,26,FliSS_T,"-37.81794046, 144.96616678"
251920240612,25,2024-06-12,19,148,144,292,MCEC_T,"-37.82401776, 144.95604426"
462020241206,46,2024-12-06,20,20,20,40,Pel147_T,"-37.80240719, 144.9615673"
1421120250903,142,2025-09-03,11,252,278,530,Hammer1584_T,"-37.81970749, 144.96795734"
1421320240828,142,2024-08-28,13,467,309,776,Hammer1584_T,"-37.81970749, 144.96795734"
130920250830,130,2025-08-30,9,53,26,79,Bou892T,"-37.8204637, 144.94126826"
1301420240709,130,2024-07-09,14,3,6,9,Bou892T,"-37.8204637, 144.94126826"
491520250313,49,2025-03-13,15,263,440,703,Eli501_T,"-37.80730068, 144.95956055"
491520231106,49,2023-11-06,15,140,131,271,Eli501_T,"-37.80730068, 144.95956055"
661420250318,66,2025-03-18,14,1158,1436,2594,QVN_T,"-37.81057846, 144.96444294"
692120240129,69,2024-01-29,21,27,18,45,FLDegC_T,"-37.81687226, 144.96559144"
692320250303,69,2025-03-03,23,1,3,4,FLDegC_T,"-37.81687226, 144.96559144"
84520240816,84,2024-08-16,5,56,37,93,ElFi_T,"-37.81798049, 144.96503383"
3720240919,3,2024-09-19,7,80,160,240,Swa295_T,"-37.81101524, 144.96429485"
39620241213,39,2024-12-13,6,29,10,39,AlfPl_T,"-37.81379749, 144.96995745"
8320240816,8,2024-08-16,3,2,2,4,WebBN_T,"-37.82293543, 144.9471751"
82320231225,8,2023-12-25,23,8,10,18,WebBN_T,"-37.82293543, 144.9471751"
591620240501,59,2024-05-01,16,1277,1695,2972,RMIT_T,"-37.80825648, 144.96304859"
41120231019,41,2023-10-19,1,60,60,120,Swa31,"-37.81668634, 144.96689733"
41320240507,41,2024-05-07,3,58,64,122,Swa31,"-37.81668634, 144.96689733"
77720250612,77,2025-06-12,7,66,101,167,HarEsP_T,"-37.81441438, 144.94433026"
78320240504,78,2024-05-04,3,1,1,2,HarEsB_T,"-37.81471642, 144.9446508"
771720240126,77,2024-01-26,17,206,135,341,HarEsP_T,"-37.81441438, 144.94433026"
14520251015,14,2025-10-15,5,20,14,34,SanBri_T,"-37.82011242, 144.96291897"
59220250303,59,2025-03-03,2,12,7,19,RMIT_T,"-37.80825648, 144.96304859"
28020250729,28,2025-07-29,0,21,2,23,VAC_T,"-37.82129925, 144.96879309"
29320250114,29,2025-01-14,3,3,3,6,AG_T,"-37.8199817, 144.96872865"
40920231207,40,2023-12-07,9,232,263,495,Spr201_T,"-37.80999341, 144.97227587"
401820240325,40,2024-03-25,18,74,118,192,Spr201_T,"-37.80999341, 144.97227587"
401720250930,40,2025-09-30,17,206,299,505,Spr201_T,"-37.80999341, 144.97227587"
31320240503,31,2024-05-03,3,6,0,6,Lyg161_T,"-37.80169681, 144.96658911"
361520250610,36,2025-06-10,15,144,157,301,Que85_T,"-37.81652527, 144.96121062"
51420250220,5,2025-02-20,14,770,980,1750,PriNW_T,"-37.81874249, 144.96787656"
21920250729,21,2025-07-29,9,107,82,189,Bourke155_T,"-37.81267313, 144.96788288"
211520241210,21,2024-12-10,15,259,286,545,Bourke155_T,"-37.81267313, 144.96788288"
107120241213,107,2024-12-13,1,18,9,27,280Will_T,"-37.81246271, 144.95690188"
118720240531,118,2024-05-31,7,11,5,16,Fli114C_T,"-37.81632783, 144.97090512"
108920240804,108,2024-08-04,9,39,80,119,261Will_T,"-37.81295822, 144.95678789"
871720250228,87,2025-02-28,17,119,134,253,Errol23_T,"-37.80454949, 144.94921863"
501020250807,50,2025-08-07,10,113,142,255,Lyg309_T,"-37.79808192, 144.96721013"
501720241001,50,2024-10-01,17,212,152,364,Lyg309_T,"-37.79808192, 144.96721013"
1651920240929,165,2024-09-29,19,9,11,20,Spen475_T,"-37.80953359, 144.94939004"
162620250511,162,2025-05-11,6,22,15,37,Eli489_T,"-37.80740397, 144.95987909"
1341920240914,134,2024-09-14,19,245,251,496,Spen201_T,"-37.81694221, 144.95303935"
133120251017,133,2025-10-17,1,31,13,44,Spen229_T,"-37.81531435, 144.95227769"
611520250721,61,2025-07-21,15,509,655,1164,RMIT14_T,"-37.80767455, 144.96309114"
43320250823,43,2025-08-23,3,3,1,4,UM2_T,"-37.79844526, 144.96411782"
432220240223,43,2024-02-23,22,25,14,39,UM2_T,"-37.79844526, 144.96411782"
1622020240909,162,2024-09-09,20,201,141,342,Eli489_T,"-37.80740397, 144.95987909"
1821020250912,182,2025-09-12,10,143,155,298,King163_T,"-37.81627451, 144.95550503"
131520231212,131,2023-12-12,5,12,4,16,King2_T,"-37.82009057, 144.95758725"
134720250616,134,2025-06-16,7,254,194,448,Spen201_T,"-37.81694221, 144.95303935"
1341020240405,134,2024-04-05,10,245,283,528,Spen201_T,"-37.81694221, 144.95303935"
672020231103,67,2023-11-03,20,284,381,665,FLDegS_T,"-37.81688755, 144.96562569"
631520241107,63,2024-11-07,15,354,430,784,Bou231_T,"-37.81333081, 144.96675571"
671320250605,67,2025-06-05,13,531,752,1283,FLDegS_T,"-37.81688755, 144.96562569"
181120231212,18,2023-12-12,11,181,284,465,Col12_T,"-37.81344862, 144.97305353"
62320240204,62,2024-02-04,3,44,39,83,Lat224_T,"-37.80996494, 144.96216521"
111120250724,11,2025-07-24,11,67,109,176,WatCit_T,"-37.81564989, 144.93970694"
10620240429,10,2024-04-29,6,13,31,44,BouHbr_T,"-37.81876474, 144.94710545"
24620231210,24,2023-12-10,6,55,90,145,Col620_T,"-37.81887963, 144.95449198"
12720250430,12,2025-04-30,7,129,88,217,NewQ_T,"-37.81457988, 144.94292398"
721020241229,72,2024-12-29,10,137,183,320,ACMI_T,"-37.81726338, 144.96872809"
722220240419,72,2024-04-19,22,318,376,694,ACMI_T,"-37.81726338, 144.96872809"
581220241122,58,2024-11-22,12,773,425,1198,Bou688_T,"-37.81686075, 144.95358075"
761820240728,76,2024-07-28,18,15,18,33,KenMac_T,"-37.79453803, 144.93036194"
581420250621,58,2025-06-21,14,626,359,985,Bou688_T,"-37.81686075, 144.95358075"
531120240903,53,2024-09-03,11,521,463,984,Col254_T,"-37.81564191, 144.965499"
30620241103,30,2024-11-03,6,18,60,78,Lon189_T,"-37.8112185, 144.96656806"
23120231116,23,2023-11-16,1,6,25,31,Col623_T,"-37.81909256, 144.95452748"
251020250718,25,2025-07-18,10,233,763,996,MCEC_T,"-37.82401776, 144.95604426"
20120240120,20,2024-01-20,1,66,132,198,LtB170_T,"-37.81172914, 144.9682466"
52920231127,52,2023-11-27,9,112,117,229,Eli263_T,"-37.81252157, 144.9619401"
1392120240801,139,2024-08-01,21,19,4,23,Signal1647_T,"-37.81959923, 144.9632832"
142020250405,142,2025-04-05,0,10,5,15,Hammer1584_T,"-37.81970749, 144.96795734"
1421220231222,142,2023-12-22,12,667,824,1491,Hammer1584_T,"-37.81970749, 144.96795734"
1381620240811,138,2024-08-11,16,7,1,8,EntPark1671_T,"-37.81996544, 144.95981454"
49520241023,49,2024-10-23,5,32,25,57,Eli501_T,"-37.80730068, 144.95956055"
1091620250321,109,2025-03-21,16,274,146,420,LatWill_T,"-37.81193681, 144.95621105"
491420250912,49,2025-09-12,14,287,490,777,Eli501_T,"-37.80730068, 144.95956055"
661520231020,66,2023-10-20,15,1110,1165,2275,QVN_T,"-37.81057846, 144.96444294"
691720240928,69,2024-09-28,17,151,83,234,FLDegC_T,"-37.81687226, 144.96559144"
84620240408,84,2024-04-08,6,301,106,407,ElFi_T,"-37.81798049, 144.96503383"
84820240911,84,2024-09-11,8,1652,446,2098,ElFi_T,"-37.81798049, 144.96503383"
41920240511,4,2024-05-11,19,1810,904,2714,Swa123_T,"-37.81487988, 144.9660878"
3220231110,3,2023-11-10,2,111,47,158,Swa295_T,"-37.81101524, 144.96429485"
4120250326,4,2025-03-26,1,32,40,72,Swa123_T,"-37.81487988, 144.9660878"
70120241203,70,2024-12-03,1,4,0,4,Errol20_T,"-37.80456984, 144.94946228"
701020250911,70,2025-09-11,10,100,108,208,Errol20_T,"-37.80456984, 144.94946228"
391720240917,39,2024-09-17,17,94,49,143,AlfPl_T,"-37.81379749, 144.96995745"
8620250110,8,2025-01-10,6,43,51,94,WebBN_T,"-37.82293543, 144.9471751"
8720240322,8,2024-03-22,7,100,91,191,WebBN_T,"-37.82293543, 144.9471751"
411520250114,41,2025-01-14,15,1520,1624,3144,Swa31,"-37.81668634, 144.96689733"
781120250816,78,2025-08-16,11,71,67,138,HarEsB_T,"-37.81471642, 144.9446508"
141620231109,14,2023-11-09,16,643,133,776,SanBri_T,"-37.82011242, 144.96291897"
28620250717,28,2025-07-17,6,147,48,195,VAC_T,"-37.82129925, 144.96879309"
28420250129,28,2025-01-29,4,7,31,38,VAC_T,"-37.82129925, 144.96879309"
47020250310,47,2025-03-10,0,142,112,254,Eli250_T,"-37.81258467, 144.9625775"
472120250325,47,2025-03-25,21,408,108,516,Eli250_T,"-37.81258467, 144.9625775"
211720250905,21,2025-09-05,17,444,358,802,Bourke155_T,"-37.81267313, 144.96788288"
1181120250824,118,2025-08-24,11,11,35,46,Fli114C_T,"-37.81632783, 144.97090512"
872220251014,87,2025-10-14,22,17,13,30,Errol23_T,"-37.80454949, 144.94921863"
1081120231120,108,2023-11-20,11,330,275,605,261Will_T,"-37.81295822, 144.95678789"
691620250708,69,2025-07-08,16,134,217,351,FLDegC_T,"-37.81687226, 144.96559144"
841320241217,84,2024-12-17,13,1155,1341,2496,ElFi_T,"-37.81798049, 144.96503383"
8520250916,8,2025-09-16,5,6,1,7,WebBN_T,"-37.82293543, 144.9471751"
42620250708,42,2025-07-08,6,6,19,25,UM1_T,"-37.80008566, 144.96386412"
77120231109,77,2023-11-09,1,6,3,9,HarEsP_T,"-37.81441438, 144.94433026"
711320250413,71,2025-04-13,13,9,6,15,WestWP_T,"-37.81235775, 144.97136962"
712220240325,71,2024-03-25,22,4,10,14,WestWP_T,"-37.81235775, 144.97136962"
711520240220,71,2024-02-20,15,21,13,34,WestWP_T,"-37.81235775, 144.97136962"
71220231122,71,2023-11-22,2,2,0,2,WestWP_T,"-37.81235775, 144.97136962"
281620231031,28,2023-10-31,16,355,891,1246,VAC_T,"-37.82129925, 144.96879309"
54220241031,54,2024-10-31,2,16,17,33,Swa607_T,"-37.804024, 144.96308399"
37820250913,37,2025-09-13,8,19,25,44,Lyg260_T,"-37.80107122, 144.96704554"
45220240120,45,2024-01-20,2,44,150,194,Swa148_T,"-37.81414075, 144.96609379"
54420240417,54,2024-04-17,4,7,10,17,Swa607_T,"-37.804024, 144.96308399"
471020240209,47,2024-02-09,10,464,595,1059,Eli250_T,"-37.81258467, 144.9625775"
47420240414,47,2024-04-14,4,50,55,105,Eli250_T,"-37.81258467, 144.9625775"
471620240515,47,2024-05-15,16,1003,755,1758,Eli250_T,"-37.81258467, 144.9625775"
361920250409,36,2025-04-09,19,117,144,261,Que85_T,"-37.81652527, 144.96121062"
432220241125,43,2024-11-25,22,20,24,44,UM2_T,"-37.79844526, 144.96411782"
441020250227,44,2025-02-27,10,47,82,129,UM3_T,"-37.79698741, 144.96441306"
441620250603,44,2025-06-03,16,101,52,153,UM3_T,"-37.79698741, 144.96441306"
451720231113,45,2023-11-13,17,467,667,1134,Swa148_T,"-37.81414075, 144.96609379"
51220231026,5,2023-10-26,12,625,680,1305,PriNW_T,"-37.81874249, 144.96787656"
1671620250327,167,2025-03-27,16,5,13,18,Lat526_T,"-37.81304149, 144.95155955"
162820240714,162,2024-07-14,8,126,84,210,Eli489_T,"-37.80740397, 144.95987909"
131920240825,131,2024-08-25,9,29,88,117,King2_T,"-37.82009057, 144.95758725"
135320250118,135,2025-01-18,3,28,21,49,Spen161_T,"-37.8172861, 144.95319102"
1851220250804,185,2025-08-04,12,817,736,1553,Eli197_T,"-37.81374643, 144.96276183"
85720240426,85,2024-04-26,7,58,20,78,488Mac_T,"-37.79432415, 144.92973378"
85420240506,85,2024-05-06,4,1,0,1,488Mac_T,"-37.79432415, 144.92973378"
11120240306,1,2024-03-06,11,822,706,1528,Bou292_T,"-37.81349441, 144.96515323"
631520250823,63,2025-08-23,15,589,673,1262,Bou231_T,"-37.81333081, 144.96675571"
11220250424,1,2025-04-24,12,1443,1258,2701,Bou292_T,"-37.81349441, 144.96515323"
63120240816,63,2024-08-16,1,23,32,55,Bou231_T,"-37.81333081, 144.96675571"
861420240419,86,2024-04-19,14,55,78,133,574Qub_T,"-37.80309992, 144.94908064"
11020240121,11,2024-01-21,0,30,31,61,WatCit_T,"-37.81564989, 144.93970694"
241120240123,24,2024-01-23,11,660,421,1081,Col620_T,"-37.81887963, 144.95449198"
86320250920,86,2025-09-20,3,0,2,2,574Qub_T,"-37.80309992, 144.94908064"
24220250309,24,2025-03-09,2,40,70,110,Col620_T,"-37.81887963, 144.95449198"
242020240813,24,2024-08-13,20,259,417,676,Col620_T,"-37.81887963, 144.95449198"
762320240521,76,2024-05-21,23,1,1,2,KenMac_T,"-37.79453803, 144.93036194"
762020250415,76,2025-04-15,20,11,11,22,KenMac_T,"-37.79453803, 144.93036194"
722320250911,72,2025-09-11,23,16,180,196,ACMI_T,"-37.81726338, 144.96872809"
721220240702,72,2024-07-02,12,211,370,581,ACMI_T,"-37.81726338, 144.96872809"
351620250219,35,2025-02-19,16,1310,1014,2324,SouthB_T,"-37.82018685, 144.96508508"
2320250524,2,2025-05-24,3,3,16,19,Bou283_T,"-37.81380668, 144.96516718"
9120240913,9,2024-09-13,1,3,7,10,Col700_T,"-37.81982992, 144.95102555"
30420240418,30,2024-04-18,4,24,45,69,Lon189_T,"-37.8112185, 144.96656806"
231920240527,23,2024-05-27,19,135,246,381,Col623_T,"-37.81909256, 144.95452748"
791820250910,79,2025-09-10,18,458,374,832,FliSS_T,"-37.81794046, 144.96616678"
461920240910,46,2024-09-10,19,9,1,10,Pel147_T,"-37.80240719, 144.9615673"
51020240129,51,2024-01-29,0,13,15,28,Fra118_T,"-37.80841815, 144.95906316"
23320250723,23,2025-07-23,3,1,8,9,Col623_T,"-37.81909256, 144.95452748"
192220250424,19,2025-04-24,22,427,555,982,LtB210_T,"-37.81237202, 144.96550671"
48220240419,48,2024-04-19,2,10,8,18,QVMQ_T,"-37.80631581, 144.95866697"
202220241217,20,2024-12-17,22,119,175,294,LtB170_T,"-37.81172914, 144.9682466"
251420241010,25,2024-10-10,14,759,617,1376,MCEC_T,"-37.82401776, 144.95604426"
1411120231229,141,2023-12-29,11,167,148,315,474Fl_T,"-37.81997273, 144.95834911"
139220250222,139,2025-02-22,2,5,3,8,Signal1647_T,"-37.81959923, 144.9632832"
1421520240331,142,2024-03-31,15,1079,448,1527,Hammer1584_T,"-37.81970749, 144.96795734"
142520241025,142,2024-10-25,5,4,1,5,Hammer1584_T,"-37.81970749, 144.96795734"
1301220231219,130,2023-12-19,12,35,43,78,Bou892T,"-37.8204637, 144.94126826"
1611120241027,161,2024-10-27,11,130,184,314,BirArt1109_T,"-37.81851276, 144.97131336"
109820240905,109,2024-09-05,8,93,597,690,LatWill_T,"-37.81193681, 144.95621105"
69820251014,69,2025-10-14,8,331,69,400,FLDegC_T,"-37.81687226, 144.96559144"
6720250302,6,2025-03-02,7,115,82,197,FliS_T,"-37.81911705, 144.96558255"
661220240426,66,2024-04-26,12,1049,1213,2262,QVN_T,"-37.81057846, 144.96444294"
39820250220,39,2025-02-20,8,122,120,242,AlfPl_T,"-37.81379749, 144.96995745"
752220250121,75,2025-01-21,22,5,5,10,SprFli_T,"-37.81515276, 144.97467661"
752020250219,75,2025-02-19,20,12,17,29,SprFli_T,"-37.81515276, 144.97467661"
41020250226,41,2025-02-26,0,156,171,327,Swa31,"-37.81668634, 144.96689733"
591920250314,59,2025-03-14,19,351,367,718,RMIT_T,"-37.80825648, 144.96304859"
54220250803,54,2025-08-03,2,34,14,48,Swa607_T,"-37.804024, 144.96308399"
281120250819,28,2025-08-19,11,549,430,979,VAC_T,"-37.82129925, 144.96879309"
281620250305,28,2025-03-05,16,362,1029,1391,VAC_T,"-37.82129925, 144.96879309"
361220231218,36,2023-12-18,12,352,234,586,Que85_T,"-37.81652527, 144.96121062"
87220240121,87,2024-01-21,2,2,0,2,Errol23_T,"-37.80454949, 144.94921863"
61420241024,61,2024-10-24,4,11,22,33,RMIT14_T,"-37.80767455, 144.96309114"
611220250326,61,2025-03-26,12,1001,1258,2259,RMIT14_T,"-37.80767455, 144.96309114"
50520241014,50,2024-10-14,5,11,5,16,Lyg309_T,"-37.79808192, 144.96721013"
44420240317,44,2024-03-17,4,1,0,1,UM3_T,"-37.79698741, 144.96441306"
43120240210,43,2024-02-10,1,8,3,11,UM2_T,"-37.79844526, 144.96411782"
44720240608,44,2024-06-08,7,4,6,10,UM3_T,"-37.79698741, 144.96441306"
441820240821,44,2024-08-21,18,62,91,153,UM3_T,"-37.79698741, 144.96441306"
441120250828,44,2025-08-28,11,113,142,255,UM3_T,"-37.79698741, 144.96441306"
1671020250329,167,2025-03-29,10,43,81,124,Lat526_T,"-37.81304149, 144.95155955"
162120241201,162,2024-12-01,1,55,32,87,Eli489_T,"-37.80740397, 144.95987909"
131420240811,131,2024-08-11,4,22,48,70,King2_T,"-37.82009057, 144.95758725"
1182020231212,118,2023-12-12,20,8,15,23,Fli114C_T,"-37.81632783, 144.97090512"
1181520241005,118,2024-10-05,15,47,11,58,Fli114C_T,"-37.81632783, 144.97090512"
1841120250906,184,2025-09-06,11,882,806,1688,Eli124_T,"-37.81512416, 144.96371988"
179620250215,179,2025-02-15,6,7,4,11,Pow61_T,"-37.82392385, 144.96299677"
681920240219,68,2024-02-19,19,131,105,236,FLDegN_T,"-37.8168479, 144.96559789"
172320240304,17,2024-03-04,23,38,50,88,Col15_T,"-37.81362543, 144.97323591"
11320231122,1,2023-11-22,13,1738,1674,3412,Bou292_T,"-37.81349441, 144.96515323"
68720240624,68,2024-06-24,7,34,11,45,FLDegN_T,"-37.8168479, 144.96559789"
682220241215,68,2024-12-15,22,39,23,62,FLDegN_T,"-37.8168479, 144.96559789"
181320231122,18,2023-11-22,13,279,252,531,Col12_T,"-37.81344862, 144.97305353"
18820240220,18,2024-02-20,8,107,1569,1676,Col12_T,"-37.81344862, 144.97305353"
86820240501,86,2024-05-01,8,72,34,106,574Qub_T,"-37.80309992, 144.94908064"
681420250821,68,2025-08-21,14,342,333,675,FLDegN_T,"-37.8168479, 144.96559789"
621320250622,62,2025-06-22,13,228,241,469,Lat224_T,"-37.80996494, 144.96216521"
101620240103,10,2024-01-03,16,106,35,141,BouHbr_T,"-37.81876474, 144.94710545"
722020240223,72,2024-02-23,20,127,223,350,ACMI_T,"-37.81726338, 144.96872809"
58620240223,58,2024-02-23,6,167,51,218,Bou688_T,"-37.81686075, 144.95358075"
22120231127,2,2023-11-27,21,55,235,290,Bou283_T,"-37.81380668, 144.96516718"
53720240903,53,2024-09-03,7,131,137,268,Col254_T,"-37.81564191, 144.965499"
51920250520,51,2025-05-20,9,44,43,87,Fra118_T,"-37.80841815, 144.95906316"
251920240302,25,2024-03-02,19,536,445,981,MCEC_T,"-37.82401776, 144.95604426"
1412020240628,141,2024-06-28,20,97,93,190,474Fl_T,"-37.81997273, 144.95834911"
1362120250419,136,2025-04-19,21,8,1,9,BirFed1120_T,"-37.8184141, 144.97357915"
142120241027,142,2024-10-27,1,14,8,22,Hammer1584_T,"-37.81970749, 144.96795734"
1301520231126,130,2023-11-26,15,8,25,33,Bou892T,"-37.8204637, 144.94126826"
1381120250701,138,2025-07-01,11,10,3,13,EntPark1671_T,"-37.81996544, 144.95981454"
1232020240327,123,2024-03-27,20,1,0,1,BirBridge_T,"-37.81753741, 144.97329734"
109020250728,109,2025-07-28,0,25,14,39,LatWill_T,"-37.81193681, 144.95621105"
661020241204,66,2024-12-04,10,407,535,942,QVN_T,"-37.81057846, 144.96444294"
661920240928,66,2024-09-28,19,1228,1217,2445,QVN_T,"-37.81057846, 144.96444294"
84820250112,84,2025-01-12,8,299,251,550,ElFi_T,"-37.81798049, 144.96503383"
6920250925,6,2025-09-25,9,688,979,1667,FliS_T,"-37.81911705, 144.96558255"
4320240820,4,2024-08-20,3,7,5,12,Swa123_T,"-37.81487988, 144.9660878"
70720240225,70,2024-02-25,7,8,6,14,Errol20_T,"-37.80456984, 144.94946228"
70920240402,70,2024-04-02,9,94,107,201,Errol20_T,"-37.80456984, 144.94946228"
702320240509,70,2024-05-09,23,4,13,17,Errol20_T,"-37.80456984, 144.94946228"
41120231205,41,2023-12-05,1,56,58,114,Swa31,"-37.81668634, 144.96689733"
411120240831,41,2024-08-31,11,294,275,569,Swa31,"-37.81668634, 144.96689733"
411220240402,41,2024-04-02,12,1809,1242,3051,Swa31,"-37.81668634, 144.96689733"
771520250116,77,2025-01-16,15,167,96,263,HarEsP_T,"-37.81441438, 144.94433026"
59420250118,59,2025-01-18,4,16,5,21,RMIT_T,"-37.80825648, 144.96304859"
141220250905,14,2025-09-05,12,294,112,406,SanBri_T,"-37.82011242, 144.96291897"
14420240909,14,2024-09-09,4,25,0,25,SanBri_T,"-37.82011242, 144.96291897"
711120241222,71,2024-12-22,11,4,8,12,WestWP_T,"-37.81235775, 144.97136962"
40920231107,40,2023-11-07,9,45,41,86,Spr201_T,"-37.80999341, 144.97227587"
37320240117,37,2024-01-17,3,6,3,9,Lyg260_T,"-37.80107122, 144.96704554"
502220250530,50,2025-05-30,22,147,55,202,Lyg309_T,"-37.79808192, 144.96721013"
43120250925,43,2025-09-25,1,7,4,11,UM2_T,"-37.79844526, 144.96411782"
451120251009,45,2025-10-09,11,409,501,910,Swa148_T,"-37.81414075, 144.96609379"
21220250526,21,2025-05-26,2,2,7,9,Bourke155_T,"-37.81267313, 144.96788288"
211320251003,21,2025-10-03,13,430,477,907,Bourke155_T,"-37.81267313, 144.96788288"
1671120250427,167,2025-04-27,11,34,66,100,Lat526_T,"-37.81304149, 144.95155955"
1671320250701,167,2025-07-01,13,17,46,63,Lat526_T,"-37.81304149, 144.95155955"
1321920240711,132,2024-07-11,19,71,124,195,King335_T,"-37.81267639, 144.95386444"
1341720240716,134,2024-07-16,17,576,479,1055,Spen201_T,"-37.81694221, 144.95303935"
1351720240823,135,2024-08-23,17,394,363,757,Spen161_T,"-37.8172861, 144.95319102"
1071620240416,107,2024-04-16,16,163,129,292,280Will_T,"-37.81246271, 144.95690188"
1072120240718,107,2024-07-18,21,82,46,128,280Will_T,"-37.81246271, 144.95690188"
1612220241104,161,2024-11-04,22,2,9,11,BirArt1109_T,"-37.81851276, 144.97131336"
49420250731,49,2025-07-31,4,11,13,24,Eli501_T,"-37.80730068, 144.95956055"
1091520251012,109,2025-10-12,15,96,94,190,LatWill_T,"-37.81193681, 144.95621105"
851920240613,85,2024-06-13,19,40,38,78,488Mac_T,"-37.79432415, 144.92973378"
1220250404,1,2025-04-04,2,17,30,47,Bou292_T,"-37.81349441, 144.96515323"
86020250806,86,2025-08-06,0,2,2,4,574Qub_T,"-37.80309992, 144.94908064"
682220250101,68,2025-01-01,22,24,35,59,FLDegN_T,"-37.8168479, 144.96559789"
621420241007,62,2024-10-07,14,224,277,501,Lat224_T,"-37.80996494, 144.96216521"
12620241019,12,2024-10-19,6,41,55,96,NewQ_T,"-37.81457988, 144.94292398"
761220250530,76,2025-05-30,12,91,85,176,KenMac_T,"-37.79453803, 144.93036194"
5720240505,5,2024-05-05,7,92,67,159,PriNW_T,"-37.81874249, 144.96787656"
1071920250124,107,2025-01-24,19,76,134,210,280Will_T,"-37.81246271, 144.95690188"
1082220240322,108,2024-03-22,22,186,153,339,261Will_T,"-37.81295822, 144.95678789"
431920240731,43,2024-07-31,19,79,239,318,UM2_T,"-37.79844526, 144.96411782"
1851120250811,185,2025-08-11,11,473,473,946,Eli197_T,"-37.81374643, 144.96276183"
179820250412,179,2025-04-12,8,32,25,57,Pow61_T,"-37.82392385, 144.96299677"
182320250518,182,2025-05-18,3,104,95,199,King163_T,"-37.81627451, 144.95550503"
1671120250311,167,2025-03-11,11,45,86,131,Lat526_T,"-37.81304149, 144.95155955"
167520250403,167,2025-04-03,5,0,5,5,Lat526_T,"-37.81304149, 144.95155955"
162720241117,162,2024-11-17,7,81,70,151,Eli489_T,"-37.80740397, 144.95987909"
1621420241206,162,2024-12-06,14,418,597,1015,Eli489_T,"-37.80740397, 144.95987909"
1311520241119,131,2024-11-19,15,155,107,262,King2_T,"-37.82009057, 144.95758725"
1321420241125,132,2024-11-25,14,91,112,203,King335_T,"-37.81267639, 144.95386444"
1341720250328,134,2025-03-28,17,682,590,1272,Spen201_T,"-37.81694221, 144.95303935"
1332320231220,133,2023-12-20,23,115,69,184,Spen229_T,"-37.81531435, 144.95227769"
1331420240720,133,2024-07-20,14,371,349,720,Spen229_T,"-37.81531435, 144.95227769"
1422120240117,142,2024-01-17,21,231,335,566,Hammer1584_T,"-37.81970749, 144.96795734"
130820231219,130,2023-12-19,8,5,6,11,Bou892T,"-37.8204637, 144.94126826"
1611120250316,161,2025-03-16,11,31,29,60,BirArt1109_T,"-37.81851276, 144.97131336"
117620240411,117,2024-04-11,6,42,19,61,Fli114F_T,"-37.81629332, 144.97090877"
85120240406,85,2024-04-06,1,2,2,4,488Mac_T,"-37.79432415, 144.92973378"
181620240301,18,2024-03-01,16,411,113,524,Col12_T,"-37.81344862, 144.97305353"
632320231019,63,2023-10-19,23,75,114,189,Bou231_T,"-37.81333081, 144.96675571"
62820240207,62,2024-02-07,8,73,117,190,Lat224_T,"-37.80996494, 144.96216521"
561520231113,56,2023-11-13,15,251,149,400,Lon364_T,"-37.81234775, 144.96153311"
111420240521,11,2024-05-21,14,71,50,121,WatCit_T,"-37.81564989, 144.93970694"
241820240715,24,2024-07-15,18,464,1158,1622,Col620_T,"-37.81887963, 144.95449198"
10120250724,10,2025-07-24,1,0,2,2,BouHbr_T,"-37.81876474, 144.94710545"
2020240209,2,2024-02-09,0,19,33,52,Bou283_T,"-37.81380668, 144.96516718"
21020240229,2,2024-02-29,10,297,396,693,Bou283_T,"-37.81380668, 144.96516718"
351220250725,35,2025-07-25,12,1501,1706,3207,SouthB_T,"-37.82018685, 144.96508508"
58020250505,58,2025-05-05,0,37,65,102,Bou688_T,"-37.81686075, 144.95358075"
272020250926,27,2025-09-26,20,68,84,152,Vic_T,"-37.80606888, 144.95644692"
531720251002,53,2025-10-02,17,779,601,1380,Col254_T,"-37.81564191, 144.965499"
79220250907,79,2025-09-07,2,59,56,115,FliSS_T,"-37.81794046, 144.96616678"
48020240101,48,2024-01-01,0,220,93,313,QVMQ_T,"-37.80631581, 144.95866697"
25720241109,25,2024-11-09,7,106,181,287,MCEC_T,"-37.82401776, 144.95604426"
522120240820,52,2024-08-20,21,172,138,310,Eli263_T,"-37.81252157, 144.9619401"
52320241202,52,2024-12-02,3,3,5,8,Eli263_T,"-37.81252157, 144.9619401"
1371820250123,137,2025-01-23,18,8,46,54,BouHbr2353_T,"-37.81894815, 144.94612292"
1391920241003,139,2024-10-03,19,28,40,68,Signal1647_T,"-37.81959923, 144.9632832"
1392120250204,139,2025-02-04,21,19,15,34,Signal1647_T,"-37.81959923, 144.9632832"
691920241129,69,2024-11-29,19,155,124,279,FLDegC_T,"-37.81687226, 144.96559144"
691020250804,69,2025-08-04,10,186,153,339,FLDegC_T,"-37.81687226, 144.96559144"
842020250430,84,2025-04-30,20,471,744,1215,ElFi_T,"-37.81798049, 144.96503383"
702320250315,70,2025-03-15,23,126,61,187,Errol20_T,"-37.80456984, 144.94946228"
3320251015,3,2025-10-15,3,19,14,33,Swa295_T,"-37.81101524, 144.96429485"
65920240312,65,2024-03-12,9,391,211,602,SwaCs_T,"-37.81569416, 144.9668064"
401720240512,40,2024-05-12,17,98,151,249,Spr201_T,"-37.80999341, 144.97227587"
36920241130,36,2024-11-30,9,71,55,126,Que85_T,"-37.81652527, 144.96121062"
451620240925,45,2024-09-25,16,535,734,1269,Swa148_T,"-37.81414075, 144.96609379"
21720240824,21,2024-08-24,7,15,27,42,Bourke155_T,"-37.81267313, 144.96788288"
107920250512,107,2025-05-12,9,92,207,299,280Will_T,"-37.81246271, 144.95690188"
87920240605,87,2024-06-05,9,74,72,146,Errol23_T,"-37.80454949, 144.94921863"
50920240608,50,2024-06-08,9,78,103,181,Lyg309_T,"-37.79808192, 144.96721013"
441920250424,44,2025-04-24,19,25,77,102,UM3_T,"-37.79698741, 144.96441306"
50320241013,50,2024-10-13,3,3,0,3,Lyg309_T,"-37.79808192, 144.96721013"
1652320241115,165,2024-11-15,23,20,10,30,Spen475_T,"-37.80953359, 144.94939004"
166920241013,166,2024-10-13,9,26,47,73,Spen484_T,"-37.80896733, 144.94931703"
1821220250603,182,2025-06-03,12,248,199,447,King163_T,"-37.81627451, 144.95550503"
162420250910,162,2025-09-10,4,3,8,11,Eli489_T,"-37.80740397, 144.95987909"
1401020250131,140,2025-01-31,10,126,52,178,Boyd2837_T,"-37.82590962, 144.96185972"
1311520250921,131,2025-09-21,15,127,96,223,King2_T,"-37.82009057, 144.95758725"
1321220231218,132,2023-12-18,12,128,104,232,King335_T,"-37.81267639, 144.95386444"
134920240509,134,2024-05-09,9,247,337,584,Spen201_T,"-37.81694221, 144.95303935"
135920240102,135,2024-01-02,9,224,248,472,Spen161_T,"-37.8172861, 144.95319102"
67620241003,67,2024-10-03,6,127,60,187,FLDegS_T,"-37.81688755, 144.96562569"
631220250325,63,2025-03-25,12,550,683,1233,Bou231_T,"-37.81333081, 144.96675571"
18820250403,18,2025-04-03,8,113,1386,1499,Col12_T,"-37.81344862, 144.97305353"
621320240320,62,2024-03-20,13,298,168,466,Lat224_T,"-37.80996494, 144.96216521"
56120240627,56,2024-06-27,1,13,21,34,Lon364_T,"-37.81234775, 144.96153311"
562320250203,56,2025-02-03,23,33,56,89,Lon364_T,"-37.81234775, 144.96153311"
111620250512,11,2025-05-12,16,101,72,173,WatCit_T,"-37.81564989, 144.93970694"
242220241012,24,2024-10-12,22,283,510,793,Col620_T,"-37.81887963, 144.95449198"
101720250919,10,2025-09-19,17,160,36,196,BouHbr_T,"-37.81876474, 144.94710545"
721420231212,72,2023-12-12,14,173,288,461,ACMI_T,"-37.81726338, 144.96872809"
581320240630,58,2024-06-30,13,582,408,990,Bou688_T,"-37.81686075, 144.95358075"
76820250118,76,2025-01-18,8,42,28,70,KenMac_T,"-37.79453803, 144.93036194"
301420250415,30,2025-04-15,14,251,420,671,Lon189_T,"-37.8112185, 144.96656806"
301220240403,30,2024-04-03,12,330,468,798,Lon189_T,"-37.8112185, 144.96656806"
532320250422,53,2025-04-22,23,25,25,50,Col254_T,"-37.81564191, 144.965499"
51320241107,51,2024-11-07,3,2,5,7,Fra118_T,"-37.80841815, 144.95906316"
20720240730,20,2024-07-30,7,20,23,43,LtB170_T,"-37.81172914, 144.9682466"
201520240512,20,2024-05-12,15,231,539,770,LtB170_T,"-37.81172914, 144.9682466"
201320240526,20,2024-05-26,13,315,356,671,LtB170_T,"-37.81172914, 144.9682466"
462120231024,46,2023-10-24,21,56,59,115,Pel147_T,"-37.80240719, 144.9615673"
52320240131,52,2024-01-31,3,4,4,8,Eli263_T,"-37.81252157, 144.9619401"
1372220240726,137,2024-07-26,22,19,3,22,BouHbr2353_T,"-37.81894815, 144.94612292"
1361920241207,136,2024-12-07,19,155,39,194,BirFed1120_T,"-37.8184141, 144.97357915"
1301020240827,130,2024-08-27,10,18,11,29,Bou892T,"-37.8204637, 144.94126826"
1301520231023,130,2023-10-23,15,0,2,2,Bou892T,"-37.8204637, 144.94126826"
1411220240428,141,2024-04-28,12,125,106,231,474Fl_T,"-37.81997273, 144.95834911"
109420250318,109,2025-03-18,4,2,5,7,LatWill_T,"-37.81193681, 144.95621105"
1091620250418,109,2025-04-18,16,72,129,201,LatWill_T,"-37.81193681, 144.95621105"
141620250713,14,2025-07-13,16,277,174,451,SanBri_T,"-37.82011242, 144.96291897"
71920240510,71,2024-05-10,9,35,31,66,WestWP_T,"-37.81235775, 144.97136962"
651420240423,65,2024-04-23,14,379,486,865,SwaCs_T,"-37.81569416, 144.9668064"
50020241222,50,2024-12-22,0,54,7,61,Lyg309_T,"-37.79808192, 144.96721013"
501820231028,50,2023-10-28,18,250,303,553,Lyg309_T,"-37.79808192, 144.96721013"
451820250729,45,2025-07-29,18,363,745,1108,Swa148_T,"-37.81414075, 144.96609379"
1342220250327,134,2025-03-27,22,515,282,797,Spen201_T,"-37.81694221, 144.95303935"
1312220240710,131,2024-07-10,22,25,60,85,King2_T,"-37.82009057, 144.95758725"
135120241007,135,2024-10-07,1,28,29,57,Spen161_T,"-37.8172861, 144.95319102"
1071820250629,107,2025-06-29,18,70,82,152,280Will_T,"-37.81246271, 144.95690188"
1181520231130,118,2023-11-30,15,10,31,41,Fli114C_T,"-37.81632783, 144.97090512"
871420241217,87,2024-12-17,14,117,130,247,Errol23_T,"-37.80454949, 144.94921863"
611820240627,61,2024-06-27,18,267,364,631,RMIT14_T,"-37.80767455, 144.96309114"
1092120231023,109,2023-10-23,21,106,95,201,LatWill_T,"-37.81193681, 144.95621105"
191320240828,19,2024-08-28,13,388,423,811,LtB210_T,"-37.81237202, 144.96550671"
671220240921,67,2024-09-21,12,459,464,923,FLDegS_T,"-37.81688755, 144.96562569"
682320250709,68,2025-07-09,23,9,5,14,FLDegN_T,"-37.8168479, 144.96559789"
851420250731,85,2025-07-31,14,63,62,125,488Mac_T,"-37.79432415, 144.92973378"
172020240720,17,2024-07-20,20,178,130,308,Col15_T,"-37.81362543, 144.97323591"
63520240715,63,2024-07-15,5,8,15,23,Bou231_T,"-37.81333081, 144.96675571"
181420250820,18,2025-08-20,14,287,195,482,Col12_T,"-37.81344862, 144.97305353"
67620240412,67,2024-04-12,6,14,12,26,FLDegS_T,"-37.81688755, 144.96562569"
671220240818,67,2024-08-18,12,389,550,939,FLDegS_T,"-37.81688755, 144.96562569"
671720241121,67,2024-11-21,17,454,661,1115,FLDegS_T,"-37.81688755, 144.96562569"
56920240306,56,2024-03-06,9,158,156,314,Lon364_T,"-37.81234775, 144.96153311"
861420250325,86,2025-03-25,14,40,50,90,574Qub_T,"-37.80309992, 144.94908064"
101620240116,10,2024-01-16,16,273,47,320,BouHbr_T,"-37.81876474, 144.94710545"
121720250127,12,2025-01-27,17,62,92,154,NewQ_T,"-37.81457988, 144.94292398"
241620241024,24,2024-10-24,16,567,2013,2580,Col620_T,"-37.81887963, 144.95449198"
21020231229,2,2023-12-29,10,534,593,1127,Bou283_T,"-37.81380668, 144.96516718"
92320240703,9,2024-07-03,23,22,4,26,Col700_T,"-37.81982992, 144.95102555"
92220231210,9,2023-12-10,22,19,24,43,Col700_T,"-37.81982992, 144.95102555"
531520250503,53,2025-05-03,15,817,498,1315,Col254_T,"-37.81564191, 144.965499"
532020250928,53,2025-09-28,20,94,203,297,Col254_T,"-37.81564191, 144.965499"
271720250312,27,2025-03-12,17,155,123,278,Vic_T,"-37.80606888, 144.95644692"
30820241112,30,2024-11-12,8,132,93,225,Lon189_T,"-37.8112185, 144.96656806"
79820250403,79,2025-04-03,8,747,354,1101,FliSS_T,"-37.81794046, 144.96616678"
23120240605,23,2024-06-05,1,2,13,15,Col623_T,"-37.81909256, 144.95452748"
251920240124,25,2024-01-24,19,389,288,677,MCEC_T,"-37.82401776, 144.95604426"
52920250731,52,2025-07-31,9,155,184,339,Eli263_T,"-37.81252157, 144.9619401"
52420250613,52,2025-06-13,4,8,5,13,Eli263_T,"-37.81252157, 144.9619401"
461620250220,46,2025-02-20,16,62,70,132,Pel147_T,"-37.80240719, 144.9615673"
1361320250720,136,2025-07-20,13,1338,91,1429,BirFed1120_T,"-37.8184141, 144.97357915"
1641220250618,164,2025-06-18,12,115,86,201,Lat526_T,"-37.813005, 144.95160411"
1802120250419,180,2025-04-19,21,3,0,3,Mac330_T,"-37.79497059, 144.93530329"
491120250918,49,2025-09-18,11,356,450,806,Eli501_T,"-37.80730068, 144.95956055"
192320250306,19,2025-03-06,23,120,170,290,LtB210_T,"-37.81237202, 144.96550671"
19820240717,19,2024-07-17,8,65,48,113,LtB210_T,"-37.81237202, 144.96550671"
191320241001,19,2024-10-01,13,548,526,1074,LtB210_T,"-37.81237202, 144.96550671"
691920250102,69,2025-01-02,19,55,26,81,FLDegC_T,"-37.81687226, 144.96559144"
62320250219,6,2025-02-19,23,216,135,351,FliS_T,"-37.81911705, 144.96558255"
66420231119,66,2023-11-19,4,63,23,86,QVN_T,"-37.81057846, 144.96444294"
70720241123,70,2024-11-23,7,25,30,55,Errol20_T,"-37.80456984, 144.94946228"
751620231101,75,2023-11-01,16,44,44,88,SprFli_T,"-37.81515276, 144.97467661"
8220240722,8,2024-07-22,2,1,0,1,WebBN_T,"-37.82293543, 144.9471751"
412020250523,41,2025-05-23,20,232,170,402,Swa31,"-37.81668634, 144.96689733"
591820250707,59,2025-07-07,18,639,422,1061,RMIT_T,"-37.80825648, 144.96304859"
141420241212,14,2024-12-12,14,404,134,538,SanBri_T,"-37.82011242, 144.96291897"
291120250314,29,2025-03-14,11,197,284,481,AG_T,"-37.8199817, 144.96872865"
471820241102,47,2024-11-02,18,932,891,1823,Eli250_T,"-37.81258467, 144.9625775"
211920231123,21,2023-11-23,19,480,409,889,Bourke155_T,"-37.81267313, 144.96788288"
21520240212,21,2024-02-12,5,6,10,16,Bourke155_T,"-37.81267313, 144.96788288"
108520250628,108,2025-06-28,5,15,28,43,261Will_T,"-37.81295822, 144.95678789"
87320250915,87,2025-09-15,3,0,1,1,Errol23_T,"-37.80454949, 144.94921863"
871220241026,87,2024-10-26,12,142,174,316,Errol23_T,"-37.80454949, 144.94921863"
611020241006,61,2024-10-06,10,201,263,464,RMIT14_T,"-37.80767455, 144.96309114"
501020241026,50,2024-10-26,10,159,191,350,Lyg309_T,"-37.79808192, 144.96721013"
1822120250629,182,2025-06-29,21,97,110,207,King163_T,"-37.81627451, 144.95550503"
1792220250508,179,2025-05-08,22,39,36,75,Pow61_T,"-37.82392385, 144.96299677"
1792120250812,179,2025-08-12,21,43,25,68,Pow61_T,"-37.82392385, 144.96299677"
1812020250722,181,2025-07-22,20,502,521,1023,Eli368_T,"-37.81009465, 144.96143149"
131320250411,131,2025-04-11,3,7,13,20,King2_T,"-37.82009057, 144.95758725"
1311920250119,131,2025-01-19,19,156,70,226,King2_T,"-37.82009057, 144.95758725"
132520240808,132,2024-08-08,5,8,4,12,King335_T,"-37.81267639, 144.95386444"
1241020250904,124,2025-09-04,10,2,2,4,BirBridge_T,"-37.81757416, 144.97329934"
17820250309,17,2025-03-09,8,53,46,99,Col15_T,"-37.81362543, 144.97323591"
1220240702,1,2024-07-02,2,6,5,11,Bou292_T,"-37.81349441, 144.96515323"
11220240709,1,2024-07-09,12,875,769,1644,Bou292_T,"-37.81349441, 144.96515323"
63220250908,63,2025-09-08,2,1,17,18,Bou231_T,"-37.81333081, 144.96675571"
11620250605,1,2025-06-05,16,1084,959,2043,Bou292_T,"-37.81349441, 144.96515323"
622020250707,62,2025-07-07,20,132,184,316,Lat224_T,"-37.80996494, 144.96216521"
111820231226,11,2023-12-26,18,163,130,293,WatCit_T,"-37.81564989, 144.93970694"
101720241208,10,2024-12-08,17,42,44,86,BouHbr_T,"-37.81876474, 144.94710545"
351120240522,35,2024-05-22,11,962,797,1759,SouthB_T,"-37.82018685, 144.96508508"
35820241015,35,2024-10-15,8,775,2178,2953,SouthB_T,"-37.82018685, 144.96508508"
21320250904,2,2025-09-04,13,819,861,1680,Bou283_T,"-37.81380668, 144.96516718"
531720241109,53,2024-11-09,17,595,508,1103,Col254_T,"-37.81564191, 144.965499"
9220240316,9,2024-03-16,2,6,13,19,Col700_T,"-37.81982992, 144.95102555"
9220240816,9,2024-08-16,2,1,10,11,Col700_T,"-37.81982992, 144.95102555"
1411620250915,141,2025-09-15,16,115,97,212,474Fl_T,"-37.81997273, 144.95834911"
1842120250831,184,2025-08-31,21,158,184,342,Eli124_T,"-37.81512416, 144.96371988"
140720250624,140,2025-06-24,7,72,11,83,Boyd2837_T,"-37.82590962, 144.96185972"
140820240321,140,2024-03-21,8,261,40,301,Boyd2837_T,"-37.82590962, 144.96185972"
682320231019,68,2023-10-19,23,13,1,14,FLDegN_T,"-37.8168479, 144.96559789"
17020250902,17,2025-09-02,0,15,8,23,Col15_T,"-37.81362543, 144.97323591"
1320240225,1,2024-02-25,3,29,39,68,Bou292_T,"-37.81349441, 144.96515323"
632120240821,63,2024-08-21,21,118,233,351,Bou231_T,"-37.81333081, 144.96675571"
63820250116,63,2025-01-16,8,161,151,312,Bou231_T,"-37.81333081, 144.96675571"
67820241122,67,2024-11-22,8,341,334,675,FLDegS_T,"-37.81688755, 144.96562569"
11220251011,1,2025-10-11,12,1428,1300,2728,Bou292_T,"-37.81349441, 144.96515323"
56620240203,56,2024-02-03,6,18,12,30,Lon364_T,"-37.81234775, 144.96153311"
352320241129,35,2024-11-29,23,1077,1624,2701,SouthB_T,"-37.82018685, 144.96508508"
35320250122,35,2025-01-22,3,12,16,28,SouthB_T,"-37.82018685, 144.96508508"
30320250308,30,2025-03-08,3,78,135,213,Lon189_T,"-37.8112185, 144.96656806"
79220241107,79,2024-11-07,2,6,11,17,FliSS_T,"-37.81794046, 144.96616678"
51920241231,51,2024-12-31,9,75,66,141,Fra118_T,"-37.80841815, 144.95906316"
512320250128,51,2025-01-28,23,24,20,44,Fra118_T,"-37.80841815, 144.95906316"
30020250904,30,2025-09-04,0,51,73,124,Lon189_T,"-37.8112185, 144.96656806"
521620240812,52,2024-08-12,16,360,238,598,Eli263_T,"-37.81252157, 144.9619401"
461020250929,46,2025-09-29,10,43,36,79,Pel147_T,"-37.80240719, 144.9615673"
1411120250209,141,2025-02-09,11,177,203,380,474Fl_T,"-37.81997273, 144.95834911"
1361520240901,136,2024-09-01,15,140,76,216,BirFed1120_T,"-37.8184141, 144.97357915"
142720241201,142,2024-12-01,7,155,89,244,Hammer1584_T,"-37.81970749, 144.96795734"
491520250627,49,2025-06-27,15,177,442,619,Eli501_T,"-37.80730068, 144.95956055"
1171920241127,117,2024-11-27,19,98,156,254,Fli114F_T,"-37.81629332, 144.97090877"
1171420231120,117,2023-11-20,14,145,131,276,Fli114F_T,"-37.81629332, 144.97090877"
1171520240824,117,2024-08-24,15,240,206,446,Fli114F_T,"-37.81629332, 144.97090877"
49620231211,49,2023-12-11,6,24,29,53,Eli501_T,"-37.80730068, 144.95956055"
66520250125,66,2025-01-25,5,12,21,33,QVN_T,"-37.81057846, 144.96444294"
61420241118,6,2024-11-18,14,839,657,1496,FliS_T,"-37.81911705, 144.96558255"
39820250706,39,2025-07-06,8,7,6,13,AlfPl_T,"-37.81379749, 144.96995745"
81920241220,8,2024-12-20,19,128,212,340,WebBN_T,"-37.82293543, 144.9471751"
412320250827,41,2025-08-27,23,202,292,494,Swa31,"-37.81668634, 144.96689733"
77220250721,77,2025-07-21,2,6,5,11,HarEsP_T,"-37.81441438, 144.94433026"
281920240423,28,2024-04-23,19,288,502,790,VAC_T,"-37.82129925, 144.96879309"
281520251009,28,2025-10-09,15,428,597,1025,VAC_T,"-37.82129925, 144.96879309"
40120250714,40,2025-07-14,1,2,2,4,Spr201_T,"-37.80999341, 144.97227587"
401720241012,40,2024-10-12,17,237,210,447,Spr201_T,"-37.80999341, 144.97227587"
31220250812,31,2025-08-12,2,3,0,3,Lyg161_T,"-37.80169681, 144.96658911"
45320240315,45,2024-03-15,3,8,40,48,Swa148_T,"-37.81414075, 144.96609379"
212220250704,21,2025-07-04,22,328,365,693,Bourke155_T,"-37.81267313, 144.96788288"
1331120250129,133,2025-01-29,11,415,401,816,Spen229_T,"-37.81531435, 144.95227769"
118120231227,118,2023-12-27,1,0,2,2,Fli114C_T,"-37.81632783, 144.97090512"
1851120250914,185,2025-09-14,11,447,443,890,Eli197_T,"-37.81374643, 144.96276183"
1662120250331,166,2025-03-31,21,7,6,13,Spen484_T,"-37.80896733, 144.94931703"
1621620250114,162,2025-01-14,16,234,375,609,Eli489_T,"-37.80740397, 144.95987909"
1432220251002,143,2025-10-02,22,128,88,216,Spencer_T,"-37.821728, 144.95557015"
621620241219,62,2024-12-19,16,176,133,309,Lat224_T,"-37.80996494, 144.96216521"
56820240727,56,2024-07-27,8,72,46,118,Lon364_T,"-37.81234775, 144.96153311"
111120240609,11,2024-06-09,11,56,81,137,WatCit_T,"-37.81564989, 144.93970694"
241020250727,24,2025-07-27,10,524,398,922,Col620_T,"-37.81887963, 144.95449198"
242220251002,24,2025-10-02,22,193,368,561,Col620_T,"-37.81887963, 144.95449198"
102220250823,10,2025-08-23,22,19,20,39,BouHbr_T,"-37.81876474, 144.94710545"
2720250125,2,2025-01-25,7,18,38,56,Bou283_T,"-37.81380668, 144.96516718"
581520250509,58,2025-05-09,15,641,541,1182,Bou688_T,"-37.81686075, 144.95358075"
2320250520,2,2025-05-20,3,3,11,14,Bou283_T,"-37.81380668, 144.96516718"
91820241024,9,2024-10-24,18,1056,192,1248,Col700_T,"-37.81982992, 144.95102555"
9720250613,9,2025-06-13,7,55,610,665,Col700_T,"-37.81982992, 144.95102555"
791920250505,79,2025-05-05,19,232,237,469,FliSS_T,"-37.81794046, 144.96616678"
79420250725,79,2025-07-25,4,8,6,14,FliSS_T,"-37.81794046, 144.96616678"
511420241209,51,2024-12-09,14,71,97,168,Fra118_T,"-37.80841815, 144.95906316"
511120241215,51,2024-12-15,11,127,121,248,Fra118_T,"-37.80841815, 144.95906316"
482220250725,48,2025-07-25,22,52,59,111,QVMQ_T,"-37.80631581, 144.95866697"
48520240825,48,2024-08-25,5,10,29,39,QVMQ_T,"-37.80631581, 144.95866697"
20920250119,20,2025-01-19,9,67,88,155,LtB170_T,"-37.81172914, 144.9682466"
20420240805,20,2024-08-05,4,3,8,11,LtB170_T,"-37.81172914, 144.9682466"
52320250705,52,2025-07-05,3,99,65,164,Eli263_T,"-37.81252157, 144.9619401"
521420240803,52,2024-08-03,14,436,397,833,Eli263_T,"-37.81252157, 144.9619401"
462120240312,46,2024-03-12,21,45,50,95,Pel147_T,"-37.80240719, 144.9615673"
136120250828,136,2025-08-28,1,1,1,2,BirFed1120_T,"-37.8184141, 144.97357915"
1801920250505,180,2025-05-05,19,4,7,11,Mac330_T,"-37.79497059, 144.93530329"
1801220250727,180,2025-07-27,12,38,26,64,Mac330_T,"-37.79497059, 144.93530329"
141920250928,141,2025-09-28,9,79,100,179,474Fl_T,"-37.81997273, 144.95834911"
1172120250907,117,2025-09-07,21,61,63,124,Fli114F_T,"-37.81629332, 144.97090877"
1092120250227,109,2025-02-27,21,77,128,205,LatWill_T,"-37.81193681, 144.95621105"
1091320240119,109,2024-01-19,13,203,197,400,LatWill_T,"-37.81193681, 144.95621105"
661020250605,66,2025-06-05,10,390,516,906,QVN_T,"-37.81057846, 144.96444294"
691020240917,69,2024-09-17,10,223,185,408,FLDegC_T,"-37.81687226, 144.96559144"
41820250912,4,2025-09-12,18,1883,1261,3144,Swa123_T,"-37.81487988, 144.9660878"
701020240110,70,2024-01-10,10,89,86,175,Errol20_T,"-37.80456984, 144.94946228"
70420240227,70,2024-02-27,4,1,2,3,Errol20_T,"-37.80456984, 144.94946228"
70620241215,70,2024-12-15,6,3,6,9,Errol20_T,"-37.80456984, 144.94946228"
78520250115,78,2025-01-15,5,0,2,2,HarEsB_T,"-37.81471642, 144.9446508"
78520240321,78,2024-03-21,5,0,2,2,HarEsB_T,"-37.81471642, 144.9446508"
29820241117,29,2024-11-17,8,81,122,203,AG_T,"-37.8199817, 144.96872865"
47220250207,47,2025-02-07,2,38,36,74,Eli250_T,"-37.81258467, 144.9625775"
401120250119,40,2025-01-19,11,137,220,357,Spr201_T,"-37.80999341, 144.97227587"
451820240325,45,2024-03-25,18,404,632,1036,Swa148_T,"-37.81414075, 144.96609379"
36520250310,36,2025-03-10,5,7,12,19,Que85_T,"-37.81652527, 144.96121062"
502220241111,50,2024-11-11,22,90,22,112,Lyg309_T,"-37.79808192, 144.96721013"
45520250913,45,2025-09-13,5,8,25,33,Swa148_T,"-37.81414075, 144.96609379"
1311120240727,131,2024-07-27,11,94,161,255,King2_T,"-37.82009057, 144.95758725"
1181620240310,118,2024-03-10,16,16,20,36,Fli114C_T,"-37.81632783, 144.97090512"
612120250904,61,2025-09-04,21,226,156,382,RMIT14_T,"-37.80767455, 144.96309114"
181820250629,181,2025-06-29,8,100,200,300,Eli368_T,"-37.81009465, 144.96143149"
1811320250913,181,2025-09-13,13,833,1236,2069,Eli368_T,"-37.81009465, 144.96143149"
1401320240224,140,2024-02-24,13,141,74,215,Boyd2837_T,"-37.82590962, 144.96185972"
1431820250504,143,2025-05-04,18,158,170,328,Spencer_T,"-37.821728, 144.95557015"
671720240219,67,2024-02-19,17,324,455,779,FLDegS_T,"-37.81688755, 144.96562569"
1520241107,1,2024-11-07,5,7,7,14,Bou292_T,"-37.81349441, 144.96515323"
1020241116,1,2024-11-16,0,75,91,166,Bou292_T,"-37.81349441, 144.96515323"
182020240417,18,2024-04-17,20,6,5,11,Col12_T,"-37.81344862, 144.97305353"
62520250909,62,2025-09-09,5,8,5,13,Lat224_T,"-37.80996494, 144.96216521"
63020250918,63,2025-09-18,0,17,45,62,Bou231_T,"-37.81333081, 144.96675571"
86820250803,86,2025-08-03,8,40,16,56,574Qub_T,"-37.80309992, 144.94908064"
102320240628,10,2024-06-28,23,27,13,40,BouHbr_T,"-37.81876474, 144.94710545"
11720250217,11,2025-02-17,7,52,65,117,WatCit_T,"-37.81564989, 144.93970694"
10420250304,10,2025-03-04,4,1,0,1,BouHbr_T,"-37.81876474, 144.94710545"
121620251003,12,2025-10-03,16,158,200,358,NewQ_T,"-37.81457988, 144.94292398"
761020250309,76,2025-03-09,10,60,42,102,KenMac_T,"-37.79453803, 144.93036194"
72520240910,72,2024-09-10,5,21,9,30,ACMI_T,"-37.81726338, 144.96872809"
22120240829,2,2024-08-29,21,65,221,286,Bou283_T,"-37.81380668, 144.96516718"
2320240216,2,2024-02-16,3,7,9,16,Bou283_T,"-37.81380668, 144.96516718"
2520240702,2,2024-07-02,5,1,8,9,Bou283_T,"-37.81380668, 144.96516718"
581620240927,58,2024-09-27,16,630,376,1006,Bou688_T,"-37.81686075, 144.95358075"
271520240718,27,2024-07-18,15,127,165,292,Vic_T,"-37.80606888, 144.95644692"
482020240325,48,2024-03-25,20,78,87,165,QVMQ_T,"-37.80631581, 144.95866697"
1371520240426,137,2024-04-26,15,3,68,71,BouHbr2353_T,"-37.81894815, 144.94612292"
1391220240809,139,2024-08-09,12,54,54,108,Signal1647_T,"-37.81959923, 144.9632832"
1362320240802,136,2024-08-02,23,3,0,3,BirFed1120_T,"-37.8184141, 144.97357915"
1642320250426,164,2025-04-26,23,85,69,154,Lat526_T,"-37.813005, 144.95160411"
1092320241026,109,2024-10-26,23,83,58,141,LatWill_T,"-37.81193681, 144.95621105"
25220240614,25,2024-06-14,2,5,10,15,MCEC_T,"-37.82401776, 144.95604426"
20520241119,20,2024-11-19,5,3,4,7,LtB170_T,"-37.81172914, 144.9682466"
20820240219,20,2024-02-19,8,49,64,113,LtB170_T,"-37.81172914, 144.9682466"
521020240213,52,2024-02-13,10,225,198,423,Eli263_T,"-37.81252157, 144.9619401"
1371920240711,137,2024-07-11,19,1,3,4,BouHbr2353_T,"-37.81894815, 144.94612292"
136520250819,136,2025-08-19,5,0,1,1,BirFed1120_T,"-37.8184141, 144.97357915"
491020250803,49,2025-08-03,10,371,455,826,Eli501_T,"-37.80730068, 144.95956055"
117120250421,117,2025-04-21,1,30,8,38,Fli114F_T,"-37.81629332, 144.97090877"
138820240904,138,2024-09-04,8,6,6,12,EntPark1671_T,"-37.81996544, 144.95981454"
1091320241203,109,2024-12-03,13,202,191,393,LatWill_T,"-37.81193681, 144.95621105"
692020250706,69,2025-07-06,20,21,18,39,FLDegC_T,"-37.81687226, 144.96559144"
61220240408,6,2024-04-08,12,883,804,1687,FliS_T,"-37.81911705, 144.96558255"
42120240912,4,2024-09-12,21,328,503,831,Swa123_T,"-37.81487988, 144.9660878"
701020240715,70,2024-07-15,10,98,101,199,Errol20_T,"-37.80456984, 144.94946228"
702120240910,70,2024-09-10,21,81,60,141,Errol20_T,"-37.80456984, 144.94946228"
75520241004,75,2024-10-04,5,12,7,19,SprFli_T,"-37.81515276, 144.97467661"
39120241201,39,2024-12-01,1,0,2,2,AlfPl_T,"-37.81379749, 144.96995745"
82120250709,8,2025-07-09,21,6,9,15,WebBN_T,"-37.82293543, 144.9471751"
41120240423,41,2024-04-23,1,41,45,86,Swa31,"-37.81668634, 144.96689733"
772120240930,77,2024-09-30,21,93,82,175,HarEsP_T,"-37.81441438, 144.94433026"
771620250725,77,2025-07-25,16,252,101,353,HarEsP_T,"-37.81441438, 144.94433026"
14020241214,14,2024-12-14,0,486,90,576,SanBri_T,"-37.82011242, 144.96291897"
282120231212,28,2023-12-12,21,303,241,544,VAC_T,"-37.82129925, 144.96879309"
40120240829,40,2024-08-29,1,1,1,2,Spr201_T,"-37.80999341, 144.97227587"
54520240805,54,2024-08-05,5,5,4,9,Swa607_T,"-37.804024, 144.96308399"
361320240324,36,2024-03-24,13,100,97,197,Que85_T,"-37.81652527, 144.96121062"
37120250917,37,2025-09-17,1,2,9,11,Lyg260_T,"-37.80107122, 144.96704554"
371320231117,37,2023-11-17,13,115,94,209,Lyg260_T,"-37.80107122, 144.96704554"
45820240713,45,2024-07-13,8,121,99,220,Swa148_T,"-37.81414075, 144.96609379"
51220240314,5,2024-03-14,12,832,938,1770,PriNW_T,"-37.81874249, 144.96787656"
211820231202,21,2023-12-02,18,590,586,1176,Bourke155_T,"-37.81267313, 144.96788288"
211220240111,21,2024-01-11,12,455,396,851,Bourke155_T,"-37.81267313, 144.96788288"
107820250705,107,2025-07-05,8,53,41,94,280Will_T,"-37.81246271, 144.95690188"
118820240229,118,2024-02-29,8,40,13,53,Fli114C_T,"-37.81632783, 144.97090512"
44820250503,44,2025-05-03,8,17,21,38,UM3_T,"-37.79698741, 144.96441306"
432020240220,43,2024-02-20,20,104,73,177,UM2_T,"-37.79844526, 144.96411782"
184020250713,184,2025-07-13,0,94,165,259,Eli124_T,"-37.81512416, 144.96371988"
1651620250307,165,2025-03-07,16,79,57,136,Spen475_T,"-37.80953359, 144.94939004"
1821020250503,182,2025-05-03,10,137,159,296,King163_T,"-37.81627451, 144.95550503"
162820250416,162,2025-04-16,8,252,183,435,Eli489_T,"-37.80740397, 144.95987909"
1621020250426,162,2025-04-26,10,553,557,1110,Eli489_T,"-37.80740397, 144.95987909"
143320240705,143,2024-07-05,3,15,3,18,Spencer_T,"-37.821728, 144.95557015"
132920250202,132,2025-02-02,9,156,41,197,King335_T,"-37.81267639, 144.95386444"
134620250723,134,2025-07-23,6,129,121,250,Spen201_T,"-37.81694221, 144.95303935"
67620250402,67,2025-04-02,6,126,60,186,FLDegS_T,"-37.81688755, 144.96562569"
68020241109,68,2024-11-09,0,16,6,22,FLDegN_T,"-37.8168479, 144.96559789"
631320241018,63,2024-10-18,13,363,446,809,Bou231_T,"-37.81333081, 144.96675571"
18020240111,18,2024-01-11,0,0,3,3,Col12_T,"-37.81344862, 144.97305353"
1520250930,1,2025-09-30,5,14,12,26,Bou292_T,"-37.81349441, 144.96515323"
72620240903,72,2024-09-03,6,67,48,115,ACMI_T,"-37.81726338, 144.96872809"
242320250707,24,2025-07-07,23,90,126,216,Col620_T,"-37.81887963, 144.95449198"
351620240609,35,2024-06-09,16,1549,1924,3473,SouthB_T,"-37.82018685, 144.96508508"
761320241012,76,2024-10-12,13,51,49,100,KenMac_T,"-37.79453803, 144.93036194"
762120250205,76,2025-02-05,21,7,8,15,KenMac_T,"-37.79453803, 144.93036194"
53520240913,53,2024-09-13,5,6,8,14,Col254_T,"-37.81564191, 144.965499"
53520231112,53,2023-11-12,5,13,4,17,Col254_T,"-37.81564191, 144.965499"
53420231208,53,2023-12-08,4,9,7,16,Col254_T,"-37.81564191, 144.965499"
53220240402,53,2024-04-02,2,2,0,2,Col254_T,"-37.81564191, 144.965499"
301120250318,30,2025-03-18,11,169,223,392,Lon189_T,"-37.8112185, 144.96656806"
791620241111,79,2024-11-11,16,436,522,958,FliSS_T,"-37.81794046, 144.96616678"
792220240612,79,2024-06-12,22,164,122,286,FliSS_T,"-37.81794046, 144.96616678"
23520250118,23,2025-01-18,5,2,18,20,Col623_T,"-37.81909256, 144.95452748"
23820250825,23,2025-08-25,8,706,307,1013,Col623_T,"-37.81909256, 144.95452748"
51820240326,51,2024-03-26,8,81,59,140,Fra118_T,"-37.80841815, 144.95906316"
48920250422,48,2025-04-22,9,176,181,357,QVMQ_T,"-37.80631581, 144.95866697"
461120240404,46,2024-04-04,11,54,56,110,Pel147_T,"-37.80240719, 144.9615673"
201820240921,20,2024-09-21,18,573,530,1103,LtB170_T,"-37.81172914, 144.9682466"
20820240311,20,2024-03-11,8,35,34,69,LtB170_T,"-37.81172914, 144.9682466"
521020241215,52,2024-12-15,10,214,135,349,Eli263_T,"-37.81252157, 144.9619401"
1391620240926,139,2024-09-26,16,114,41,155,Signal1647_T,"-37.81959923, 144.9632832"
1641720250908,164,2025-09-08,17,142,124,266,Lat526_T,"-37.813005, 144.95160411"
1641420250125,164,2025-01-25,14,117,49,166,Lat526_T,"-37.813005, 144.95160411"
161720250428,161,2025-04-28,7,84,141,225,BirArt1109_T,"-37.81851276, 144.97131336"
1172120231207,117,2023-12-07,21,183,158,341,Fli114F_T,"-37.81629332, 144.97090877"
117820240706,117,2024-07-06,8,44,65,109,Fli114F_T,"-37.81629332, 144.97090877"
1091220240819,109,2024-08-19,12,250,206,456,LatWill_T,"-37.81193681, 144.95621105"
19520250417,19,2025-04-17,5,5,1,6,LtB210_T,"-37.81237202, 144.96550671"
19420240711,19,2024-07-11,4,2,1,3,LtB210_T,"-37.81237202, 144.96550671"
691220240122,69,2024-01-22,12,280,352,632,FLDegC_T,"-37.81687226, 144.96559144"
691120241223,69,2024-12-23,11,370,350,720,FLDegC_T,"-37.81687226, 144.96559144"
84820240502,84,2024-05-02,8,1589,426,2015,ElFi_T,"-37.81798049, 144.96503383"
701520241106,70,2024-11-06,15,148,143,291,Errol20_T,"-37.80456984, 144.94946228"
81720250228,8,2025-02-28,17,231,339,570,WebBN_T,"-37.82293543, 144.9471751"
772120240430,77,2024-04-30,21,65,38,103,HarEsP_T,"-37.81441438, 144.94433026"
771220240619,77,2024-06-19,12,212,134,346,HarEsP_T,"-37.81441438, 144.94433026"
781320241201,78,2024-12-01,13,34,60,94,HarEsB_T,"-37.81471642, 144.9446508"
59820250122,59,2025-01-22,8,208,148,356,RMIT_T,"-37.80825648, 144.96304859"
54120231209,54,2023-12-09,1,23,12,35,Swa607_T,"-37.804024, 144.96308399"
292020240813,29,2024-08-13,20,50,96,146,AG_T,"-37.8199817, 144.96872865"
311220240115,31,2024-01-15,12,171,118,289,Lyg161_T,"-37.80169681, 144.96658911"
311120251016,31,2025-10-16,11,117,122,239,Lyg161_T,"-37.80169681, 144.96658911"
31120240517,31,2024-05-17,1,5,8,13,Lyg161_T,"-37.80169681, 144.96658911"
361020250801,36,2025-08-01,10,164,138,302,Que85_T,"-37.81652527, 144.96121062"
471120250814,47,2025-08-14,11,600,719,1319,Eli250_T,"-37.81258467, 144.9625775"
451720240531,45,2024-05-31,17,646,645,1291,Swa148_T,"-37.81414075, 144.96609379"
5420250916,5,2025-09-16,4,30,8,38,PriNW_T,"-37.81874249, 144.96787656"
21920240323,21,2024-03-23,9,70,115,185,Bourke155_T,"-37.81267313, 144.96788288"
1071620241227,107,2024-12-27,16,69,81,150,280Will_T,"-37.81246271, 144.95690188"
1081220241204,108,2024-12-04,12,403,451,854,261Will_T,"-37.81295822, 144.95678789"
611320250129,61,2025-01-29,13,401,424,825,RMIT14_T,"-37.80767455, 144.96309114"
612320250503,61,2025-05-03,23,155,80,235,RMIT14_T,"-37.80767455, 144.96309114"
441120250518,44,2025-05-18,11,41,55,96,UM3_T,"-37.79698741, 144.96441306"
1661320250110,166,2025-01-10,13,68,63,131,Spen484_T,"-37.80896733, 144.94931703"
162520250315,162,2025-03-15,5,44,29,73,Eli489_T,"-37.80740397, 144.95987909"
1311420250402,131,2025-04-02,14,90,110,200,King2_T,"-37.82009057, 144.95758725"
1322120250715,132,2025-07-15,21,92,82,174,King335_T,"-37.81267639, 144.95386444"
1352120240626,135,2024-06-26,21,80,96,176,Spen161_T,"-37.8172861, 144.95319102"
1820241126,1,2024-11-26,8,275,327,602,Bou292_T,"-37.81349441, 144.96515323"
681020231212,68,2023-12-12,10,150,114,264,FLDegN_T,"-37.8168479, 144.96559789"
862320241221,86,2024-12-21,23,3,23,26,574Qub_T,"-37.80309992, 144.94908064"
241220231025,24,2023-10-25,12,743,653,1396,Col620_T,"-37.81887963, 144.95449198"
241820250426,24,2025-04-26,18,496,475,971,Col620_T,"-37.81887963, 144.95449198"
351120240418,35,2024-04-18,11,718,745,1463,SouthB_T,"-37.82018685, 144.96508508"
271920241002,27,2024-10-02,19,168,104,272,Vic_T,"-37.80606888, 144.95644692"
791320240829,79,2024-08-29,13,451,379,830,FliSS_T,"-37.81794046, 144.96616678"
481420250402,48,2025-04-02,14,194,129,323,QVMQ_T,"-37.80631581, 144.95866697"
25920250501,25,2025-05-01,9,149,703,852,MCEC_T,"-37.82401776, 144.95604426"
46220240403,46,2024-04-03,2,9,5,14,Pel147_T,"-37.80240719, 144.9615673"
201020241015,20,2024-10-15,10,71,87,158,LtB170_T,"-37.81172914, 144.9682466"
201520241115,20,2024-11-15,15,195,251,446,LtB170_T,"-37.81172914, 144.9682466"
52620241230,52,2024-12-30,6,16,7,23,Eli263_T,"-37.81252157, 144.9619401"
522020231129,52,2023-11-29,20,297,160,457,Eli263_T,"-37.81252157, 144.9619401"
1372020240902,137,2024-09-02,20,4,1,5,BouHbr2353_T,"-37.81894815, 144.94612292"
139020250622,139,2025-06-22,0,3,3,6,Signal1647_T,"-37.81959923, 144.9632832"
1231220240907,123,2024-09-07,12,19,2,21,BirBridge_T,"-37.81753741, 144.97329734"
1092220250807,109,2025-08-07,22,54,64,118,LatWill_T,"-37.81193681, 144.95621105"
109820231221,109,2023-12-21,8,81,390,471,LatWill_T,"-37.81193681, 144.95621105"
491920250825,49,2025-08-25,19,207,149,356,Eli501_T,"-37.80730068, 144.95956055"
19020250819,19,2025-08-19,0,43,71,114,LtB210_T,"-37.81237202, 144.96550671"
66420231022,66,2023-10-22,4,51,18,69,QVN_T,"-37.81057846, 144.96444294"
691720250813,69,2025-08-13,17,76,146,222,FLDegC_T,"-37.81687226, 144.96559144"
6020240203,6,2024-02-03,0,391,181,572,FliS_T,"-37.81911705, 144.96558255"
6520240531,6,2024-05-31,5,63,78,141,FliS_T,"-37.81911705, 144.96558255"
61620240727,6,2024-07-27,16,738,741,1479,FliS_T,"-37.81911705, 144.96558255"
842320250924,84,2025-09-24,23,47,70,117,ElFi_T,"-37.81798049, 144.96503383"
4020241016,4,2024-10-16,0,44,19,63,Swa123_T,"-37.81487988, 144.9660878"
70620250517,70,2025-05-17,6,4,5,9,Errol20_T,"-37.80456984, 144.94946228"
8320240114,8,2024-01-14,3,5,9,14,WebBN_T,"-37.82293543, 144.9471751"
41520240318,41,2024-03-18,5,98,78,176,Swa31,"-37.81668634, 144.96689733"
421120250829,42,2025-08-29,11,260,281,541,UM1_T,"-37.80008566, 144.96386412"
781520250111,78,2025-01-11,15,24,30,54,HarEsB_T,"-37.81471642, 144.9446508"
28920250318,28,2025-03-18,9,668,223,891,VAC_T,"-37.82129925, 144.96879309"
29420231213,29,2023-12-13,4,2,1,3,AG_T,"-37.8199817, 144.96872865"
402320250304,40,2025-03-04,23,37,11,48,Spr201_T,"-37.80999341, 144.97227587"
361720240217,36,2024-02-17,17,200,230,430,Que85_T,"-37.81652527, 144.96121062"
36220241010,36,2024-10-10,2,2,5,7,Que85_T,"-37.81652527, 144.96121062"
36920240617,36,2024-06-17,9,171,125,296,Que85_T,"-37.81652527, 144.96121062"
37020251007,37,2025-10-07,0,6,19,25,Lyg260_T,"-37.80107122, 144.96704554"
107020250422,107,2025-04-22,0,24,10,34,280Will_T,"-37.81246271, 144.95690188"
501520250407,50,2025-04-07,15,230,192,422,Lyg309_T,"-37.79808192, 144.96721013"
166820241005,166,2024-10-05,8,65,37,102,Spen484_T,"-37.80896733, 144.94931703"
1311920240214,131,2024-02-14,19,125,150,275,King2_T,"-37.82009057, 144.95758725"
1321520241214,132,2024-12-14,15,144,125,269,King335_T,"-37.81267639, 144.95386444"
1321820250606,132,2025-06-06,18,165,170,335,King335_T,"-37.81267639, 144.95386444"
134820240826,134,2024-08-26,8,313,236,549,Spen201_T,"-37.81694221, 144.95303935"
1351920250414,135,2025-04-14,19,168,217,385,Spen161_T,"-37.8172861, 144.95319102"
1351120240414,135,2024-04-14,11,370,463,833,Spen161_T,"-37.8172861, 144.95319102"
133920240927,133,2024-09-27,9,358,410,768,Spen229_T,"-37.81531435, 144.95227769"
63220251006,63,2025-10-06,2,3,16,19,Bou231_T,"-37.81333081, 144.96675571"
1820250428,1,2025-04-28,8,228,236,464,Bou292_T,"-37.81349441, 144.96515323"
86020250221,86,2025-02-21,0,1,2,3,574Qub_T,"-37.80309992, 144.94908064"
721720240621,72,2024-06-21,17,424,702,1126,ACMI_T,"-37.81726338, 144.96872809"
24420250810,24,2025-08-10,4,44,42,86,Col620_T,"-37.81887963, 144.95449198"
35520240413,35,2024-04-13,5,45,39,84,SouthB_T,"-37.82018685, 144.96508508"
272120250706,27,2025-07-06,21,67,32,99,Vic_T,"-37.80606888, 144.95644692"
79420250807,79,2025-08-07,4,5,3,8,FliSS_T,"-37.81794046, 144.96616678"
511020251005,51,2025-10-05,10,95,110,205,Fra118_T,"-37.80841815, 144.95906316"
231720250525,23,2025-05-25,17,174,185,359,Col623_T,"-37.81909256, 144.95452748"
201620250218,20,2025-02-18,16,187,179,366,LtB170_T,"-37.81172914, 144.9682466"
48520240407,48,2024-04-07,5,15,26,41,QVMQ_T,"-37.80631581, 144.95866697"
251720240911,25,2024-09-11,17,13,44,57,MCEC_T,"-37.82401776, 144.95604426"
25420250404,25,2025-04-04,4,10,4,14,MCEC_T,"-37.82401776, 144.95604426"
20020240314,20,2024-03-14,0,18,25,43,LtB170_T,"-37.81172914, 144.9682466"
521520240621,52,2024-06-21,15,401,330,731,Eli263_T,"-37.81252157, 144.9619401"
139020241217,139,2024-12-17,0,3,9,12,Signal1647_T,"-37.81959923, 144.9632832"
1391520250103,139,2025-01-03,15,136,44,180,Signal1647_T,"-37.81959923, 144.9632832"
136820231214,136,2023-12-14,8,108,162,270,BirFed1120_T,"-37.8184141, 144.97357915"
1422320250530,142,2025-05-30,23,7,15,22,Hammer1584_T,"-37.81970749, 144.96795734"
130520250324,130,2025-03-24,5,1,0,1,Bou892T,"-37.8204637, 144.94126826"
1381020251014,138,2025-10-14,10,5,6,11,EntPark1671_T,"-37.81996544, 144.95981454"
19620251008,19,2025-10-08,6,26,11,37,LtB210_T,"-37.81237202, 144.96550671"
492220240519,49,2024-05-19,22,100,68,168,Eli501_T,"-37.80730068, 144.95956055"
19520241115,19,2024-11-15,5,9,7,16,LtB210_T,"-37.81237202, 144.96550671"
6420250511,6,2025-05-11,4,27,29,56,FliS_T,"-37.81911705, 144.96558255"
841420231202,84,2023-12-02,14,790,978,1768,ElFi_T,"-37.81798049, 144.96503383"
841320250428,84,2025-04-28,13,938,1095,2033,ElFi_T,"-37.81798049, 144.96503383"
662020240211,66,2024-02-11,20,904,646,1550,QVN_T,"-37.81057846, 144.96444294"
3720240803,3,2024-08-03,7,43,52,95,Swa295_T,"-37.81101524, 144.96429485"
411620240916,41,2024-09-16,16,302,227,529,Swa31,"-37.81668634, 144.96689733"
77820250122,77,2025-01-22,8,99,189,288,HarEsP_T,"-37.81441438, 144.94433026"
422120250819,42,2025-08-19,21,54,84,138,UM1_T,"-37.80008566, 144.96386412"
78820240916,78,2024-09-16,8,89,48,137,HarEsB_T,"-37.81471642, 144.9446508"
651220240802,65,2024-08-02,12,875,638,1513,SwaCs_T,"-37.81569416, 144.9668064"
141320240912,141,2024-09-12,3,6,5,11,474Fl_T,"-37.81997273, 144.95834911"
117720241006,117,2024-10-06,7,19,20,39,Fli114F_T,"-37.81629332, 144.97090877"
85020231110,85,2023-11-10,0,1,1,2,488Mac_T,"-37.79432415, 144.92973378"
851820240506,85,2024-05-06,18,47,82,129,488Mac_T,"-37.79432415, 144.92973378"
851320241221,85,2024-12-21,13,130,131,261,488Mac_T,"-37.79432415, 144.92973378"
851020250706,85,2025-07-06,10,115,77,192,488Mac_T,"-37.79432415, 144.92973378"
861920241125,86,2024-11-25,19,21,37,58,574Qub_T,"-37.80309992, 144.94908064"
861420250219,86,2025-02-19,14,45,43,88,574Qub_T,"-37.80309992, 144.94908064"
622320241226,62,2024-12-26,23,74,44,118,Lat224_T,"-37.80996494, 144.96216521"
621820250106,62,2025-01-06,18,198,165,363,Lat224_T,"-37.80996494, 144.96216521"
562320240813,56,2024-08-13,23,40,57,97,Lon364_T,"-37.81234775, 144.96153311"
86120231130,86,2023-11-30,1,0,2,2,574Qub_T,"-37.80309992, 144.94908064"
121320241009,12,2024-10-09,13,244,207,451,NewQ_T,"-37.81457988, 144.94292398"
12420250923,12,2025-09-23,4,1,1,2,NewQ_T,"-37.81457988, 144.94292398"
241620250423,24,2025-04-23,16,564,1727,2291,Col620_T,"-37.81887963, 144.95449198"
101620250314,10,2025-03-14,16,152,67,219,BouHbr_T,"-37.81876474, 144.94710545"
351920231114,35,2023-11-14,19,1239,1014,2253,SouthB_T,"-37.82018685, 144.96508508"
582120250205,58,2025-02-05,21,153,204,357,Bou688_T,"-37.81686075, 144.95358075"
27620231021,27,2023-10-21,6,10,10,20,Vic_T,"-37.80606888, 144.95644692"
25020240611,25,2024-06-11,0,14,17,31,MCEC_T,"-37.82401776, 144.95604426"
137720240701,137,2024-07-01,7,36,7,43,BouHbr2353_T,"-37.81894815, 144.94612292"
1422220250511,142,2025-05-11,22,12,8,20,Hammer1584_T,"-37.81970749, 144.96795734"
1301620240614,130,2024-06-14,16,14,25,39,Bou892T,"-37.8204637, 144.94126826"
1172020250201,117,2025-02-01,20,143,225,368,Fli114F_T,"-37.81629332, 144.97090877"
311520240907,31,2024-09-07,15,227,255,482,Lyg161_T,"-37.80169681, 144.96658911"
31320241204,31,2024-12-04,3,2,0,2,Lyg161_T,"-37.80169681, 144.96658911"
542120240612,54,2024-06-12,21,81,94,175,Swa607_T,"-37.804024, 144.96308399"
54020240327,54,2024-03-27,0,27,27,54,Swa607_T,"-37.804024, 144.96308399"
191120250610,19,2025-06-10,11,241,169,410,LtB210_T,"-37.81237202, 144.96550671"
191220241126,19,2024-11-26,12,443,410,853,LtB210_T,"-37.81237202, 144.96550671"
691920250115,69,2025-01-15,19,69,41,110,FLDegC_T,"-37.81687226, 144.96559144"
61920250402,6,2025-04-02,19,799,651,1450,FliS_T,"-37.81911705, 144.96558255"
841120240509,84,2024-05-09,11,702,617,1319,ElFi_T,"-37.81798049, 144.96503383"
3620250612,3,2025-06-12,6,17,54,71,Swa295_T,"-37.81101524, 144.96429485"
751620250515,75,2025-05-15,16,84,58,142,SprFli_T,"-37.81515276, 144.97467661"
8520240218,8,2024-02-18,5,2,1,3,WebBN_T,"-37.82293543, 144.9471751"
772320231128,77,2023-11-28,23,30,14,44,HarEsP_T,"-37.81441438, 144.94433026"
711220251009,71,2025-10-09,12,17,28,45,WestWP_T,"-37.81235775, 144.97136962"
71920240910,71,2024-09-10,9,31,19,50,WestWP_T,"-37.81235775, 144.97136962"
291520231105,29,2023-11-05,15,506,505,1011,AG_T,"-37.8199817, 144.96872865"
29120231215,29,2023-12-15,1,4,45,49,AG_T,"-37.8199817, 144.96872865"
142020250911,14,2025-09-11,20,138,68,206,SanBri_T,"-37.82011242, 144.96291897"
54920250820,54,2025-08-20,9,233,70,303,Swa607_T,"-37.804024, 144.96308399"
401120250209,40,2025-02-09,11,158,180,338,Spr201_T,"-37.80999341, 144.97227587"
40820231024,40,2023-10-24,8,249,418,667,Spr201_T,"-37.80999341, 144.97227587"
40720240315,40,2024-03-15,7,66,91,157,Spr201_T,"-37.80999341, 144.97227587"
36820250319,36,2025-03-19,8,262,178,440,Que85_T,"-37.81652527, 144.96121062"
501720250218,50,2025-02-18,17,190,166,356,Lyg309_T,"-37.79808192, 144.96721013"
501720231130,50,2023-11-30,17,254,197,451,Lyg309_T,"-37.79808192, 144.96721013"
44620241012,44,2024-10-12,6,4,3,7,UM3_T,"-37.79698741, 144.96441306"
1342320250415,134,2025-04-15,23,98,117,215,Spen201_T,"-37.81694221, 144.95303935"
1341520250515,134,2025-05-15,15,398,445,843,Spen201_T,"-37.81694221, 144.95303935"
135520240422,135,2024-04-22,5,23,23,46,Spen161_T,"-37.8172861, 144.95319102"
1331720240531,133,2024-05-31,17,563,601,1164,Spen229_T,"-37.81531435, 144.95227769"
1181520240522,118,2024-05-22,15,17,22,39,Fli114C_T,"-37.81632783, 144.97090512"
87620250806,87,2025-08-06,6,19,7,26,Errol23_T,"-37.80454949, 144.94921863"
611020240923,61,2024-09-23,10,317,489,806,RMIT14_T,"-37.80767455, 144.96309114"
185820250817,185,2025-08-17,8,94,101,195,Eli197_T,"-37.81374643, 144.96276183"
140820250706,140,2025-07-06,8,61,26,87,Boyd2837_T,"-37.82590962, 144.96185972"
1431420250422,143,2025-04-22,14,109,182,291,Spencer_T,"-37.821728, 144.95557015"
852220250924,85,2025-09-24,22,8,19,27,488Mac_T,"-37.79432415, 144.92973378"
63720240603,63,2024-06-03,7,63,67,130,Bou231_T,"-37.81333081, 144.96675571"
671620240114,67,2024-01-14,16,352,553,905,FLDegS_T,"-37.81688755, 144.96562569"
632220250701,63,2025-07-01,22,5,26,31,Bou231_T,"-37.81333081, 144.96675571"
682320250605,68,2025-06-05,23,23,14,37,FLDegN_T,"-37.8168479, 144.96559789"
62220240131,62,2024-01-31,2,30,47,77,Lat224_T,"-37.80996494, 144.96216521"
62420240718,62,2024-07-18,4,7,9,16,Lat224_T,"-37.80996494, 144.96216521"
12420251006,12,2025-10-06,4,1,1,2,NewQ_T,"-37.81457988, 144.94292398"
722320240110,72,2024-01-10,23,36,44,80,ACMI_T,"-37.81726338, 144.96872809"
21720240503,2,2024-05-03,17,627,579,1206,Bou283_T,"-37.81380668, 144.96516718"
2320240705,2,2024-07-05,3,3,18,21,Bou283_T,"-37.81380668, 144.96516718"
56420251010,56,2025-10-10,4,2,1,3,Lon364_T,"-37.81234775, 144.96153311"
58520240127,58,2024-01-27,5,27,25,52,Bou688_T,"-37.81686075, 144.95358075"
9720240403,9,2024-04-03,7,64,1112,1176,Col700_T,"-37.81982992, 144.95102555"
53720241231,53,2024-12-31,7,57,34,91,Col254_T,"-37.81564191, 144.965499"
791920250802,79,2025-08-02,19,483,460,943,FliSS_T,"-37.81794046, 144.96616678"
51820250210,51,2025-02-10,8,66,53,119,Fra118_T,"-37.80841815, 144.95906316"
482120241104,48,2024-11-04,21,46,60,106,QVMQ_T,"-37.80631581, 144.95866697"
211920240507,21,2024-05-07,19,372,415,787,Bourke155_T,"-37.81267313, 144.96788288"
502020250314,50,2025-03-14,20,324,320,644,Lyg309_T,"-37.79808192, 144.96721013"
44620250417,44,2025-04-17,6,9,8,17,UM3_T,"-37.79698741, 144.96441306"
432120241202,43,2024-12-02,21,19,19,38,UM2_T,"-37.79844526, 144.96411782"
1791720250522,179,2025-05-22,17,99,89,188,Pow61_T,"-37.82392385, 144.96299677"
166920241103,166,2024-11-03,9,30,40,70,Spen484_T,"-37.80896733, 144.94931703"
181420250422,181,2025-04-22,4,27,31,58,Eli368_T,"-37.81009465, 144.96143149"
162020251010,162,2025-10-10,0,78,56,134,Eli489_T,"-37.80740397, 144.95987909"
1401920241028,140,2024-10-28,19,100,121,221,Boyd2837_T,"-37.82590962, 144.96185972"
131420241121,131,2024-11-21,4,6,11,17,King2_T,"-37.82009057, 144.95758725"
131520241013,131,2024-10-13,5,17,65,82,King2_T,"-37.82009057, 144.95758725"
1321220250522,132,2025-05-22,12,203,184,387,King335_T,"-37.81267639, 144.95386444"
132320250527,132,2025-05-27,3,0,3,3,King335_T,"-37.81267639, 144.95386444"
1341320240313,134,2024-03-13,13,567,469,1036,Spen201_T,"-37.81694221, 144.95303935"
133620240723,133,2024-07-23,6,362,155,517,Spen229_T,"-37.81531435, 144.95227769"
682320250626,68,2025-06-26,23,16,10,26,FLDegN_T,"-37.8168479, 144.96559789"
68920240225,68,2024-02-25,9,86,85,171,FLDegN_T,"-37.8168479, 144.96559789"
632320250323,63,2025-03-23,23,4,67,71,Bou231_T,"-37.81333081, 144.96675571"
68620241125,68,2024-11-25,6,28,10,38,FLDegN_T,"-37.8168479, 144.96559789"
671720250611,67,2025-06-11,17,365,548,913,FLDegS_T,"-37.81688755, 144.96562569"
561420240715,56,2024-07-15,14,315,268,583,Lon364_T,"-37.81234775, 144.96153311"
111920240531,11,2024-05-31,19,119,57,176,WatCit_T,"-37.81564989, 144.93970694"
122020240817,12,2024-08-17,20,216,201,417,NewQ_T,"-37.81457988, 144.94292398"
121820240202,12,2024-02-02,18,165,230,395,NewQ_T,"-37.81457988, 144.94292398"
722020250105,72,2025-01-05,20,90,139,229,ACMI_T,"-37.81726338, 144.96872809"
721120250806,72,2025-08-06,11,90,177,267,ACMI_T,"-37.81726338, 144.96872809"
92220250311,9,2025-03-11,22,63,33,96,Col700_T,"-37.81982992, 144.95102555"
53620240921,53,2024-09-21,6,19,16,35,Col254_T,"-37.81564191, 144.965499"
301320250608,30,2025-06-08,13,293,511,804,Lon189_T,"-37.8112185, 144.96656806"
30820240509,30,2024-05-09,8,105,93,198,Lon189_T,"-37.8112185, 144.96656806"
79220240904,79,2024-09-04,2,19,15,34,FliSS_T,"-37.81794046, 144.96616678"
51520250527,51,2025-05-27,5,7,7,14,Fra118_T,"-37.80841815, 144.95906316"
251620250608,25,2025-06-08,16,1434,559,1993,MCEC_T,"-37.82401776, 144.95604426"
462120240928,46,2024-09-28,21,3,0,3,Pel147_T,"-37.80240719, 144.9615673"
461720250412,46,2025-04-12,17,64,78,142,Pel147_T,"-37.80240719, 144.9615673"
52820231119,52,2023-11-19,8,57,62,119,Eli263_T,"-37.81252157, 144.9619401"
1371320240525,137,2024-05-25,13,5,96,101,BouHbr2353_T,"-37.81894815, 144.94612292"
1391220240608,139,2024-06-08,12,49,56,105,Signal1647_T,"-37.81959923, 144.9632832"
1391320240610,139,2024-06-10,13,89,46,135,Signal1647_T,"-37.81959923, 144.9632832"
1362120240101,136,2024-01-01,21,6,3,9,BirFed1120_T,"-37.8184141, 144.97357915"
1802020250718,180,2025-07-18,20,2,4,6,Mac330_T,"-37.79497059, 144.93530329"
1171120250227,117,2025-02-27,11,144,171,315,Fli114F_T,"-37.81629332, 144.97090877"
141420240424,141,2024-04-24,4,5,7,12,474Fl_T,"-37.81997273, 144.95834911"
141720250203,141,2025-02-03,7,38,30,68,474Fl_T,"-37.81997273, 144.95834911"
19620250910,19,2025-09-10,6,21,12,33,LtB210_T,"-37.81237202, 144.96550671"
69720240301,69,2024-03-01,7,70,19,89,FLDegC_T,"-37.81687226, 144.96559144"
61220231107,6,2023-11-07,12,681,728,1409,FliS_T,"-37.81911705, 144.96558255"
6120231211,6,2023-12-11,1,51,37,88,FliS_T,"-37.81911705, 144.96558255"
3020231107,3,2023-11-07,0,371,316,687,Swa295_T,"-37.81101524, 144.96429485"
79020241001,79,2024-10-01,0,20,50,70,FliSS_T,"-37.81794046, 144.96616678"
9420250723,9,2025-07-23,4,5,1,6,Col700_T,"-37.81982992, 144.95102555"
53720240229,53,2024-02-29,7,144,157,301,Col254_T,"-37.81564191, 144.965499"
23820240519,23,2024-05-19,8,107,76,183,Col623_T,"-37.81909256, 144.95452748"
302120250402,30,2025-04-02,21,191,444,635,Lon189_T,"-37.8112185, 144.96656806"
52720240706,52,2024-07-06,7,16,15,31,Eli263_T,"-37.81252157, 144.9619401"
521920240823,52,2024-08-23,19,500,403,903,Eli263_T,"-37.81252157, 144.9619401"
51820240122,51,2024-01-22,8,53,39,92,Fra118_T,"-37.80841815, 144.95906316"
191020241003,19,2024-10-03,10,239,192,431,LtB210_T,"-37.81237202, 144.96550671"
201120250601,20,2025-06-01,11,232,169,401,LtB170_T,"-37.81172914, 144.9682466"
52120250721,52,2025-07-21,1,5,15,20,Eli263_T,"-37.81252157, 144.9619401"
19820251013,19,2025-10-13,8,56,49,105,LtB210_T,"-37.81237202, 144.96550671"
136620240923,136,2024-09-23,6,40,44,84,BirFed1120_T,"-37.8184141, 144.97357915"
391320240515,39,2024-05-15,13,201,179,380,AlfPl_T,"-37.81379749, 144.96995745"
391520250527,39,2025-05-27,15,77,65,142,AlfPl_T,"-37.81379749, 144.96995745"
781820250320,78,2025-03-20,18,34,89,123,HarEsB_T,"-37.81471642, 144.9446508"
781220240830,78,2024-08-30,12,32,32,64,HarEsB_T,"-37.81471642, 144.9446508"
591620250320,59,2025-03-20,16,959,1349,2308,RMIT_T,"-37.80825648, 144.96304859"
59520250109,59,2025-01-09,5,20,13,33,RMIT_T,"-37.80825648, 144.96304859"
421620250328,42,2025-03-28,16,276,562,838,UM1_T,"-37.80008566, 144.96386412"
771220250122,77,2025-01-22,12,224,124,348,HarEsP_T,"-37.81441438, 144.94433026"
282220240917,28,2024-09-17,22,124,394,518,VAC_T,"-37.82129925, 144.96879309"
472020240718,47,2024-07-18,20,583,513,1096,Eli250_T,"-37.81258467, 144.9625775"
361420250725,36,2025-07-25,14,189,222,411,Que85_T,"-37.81652527, 144.96121062"
371220250913,37,2025-09-13,12,62,73,135,Lyg260_T,"-37.80107122, 144.96704554"
872020231123,87,2023-11-23,20,101,101,202,Errol23_T,"-37.80454949, 144.94921863"
50720250319,50,2025-03-19,7,12,26,38,Lyg309_T,"-37.79808192, 144.96721013"
441020240129,44,2024-01-29,10,54,42,96,UM3_T,"-37.79698741, 144.96441306"
451620240309,45,2024-03-09,16,436,1078,1514,Swa148_T,"-37.81414075, 144.96609379"
21820250130,21,2025-01-30,8,69,83,152,Bourke155_T,"-37.81267313, 144.96788288"
5720250708,5,2025-07-08,7,164,374,538,PriNW_T,"-37.81874249, 144.96787656"
5020231106,5,2023-11-06,0,70,79,149,PriNW_T,"-37.81874249, 144.96787656"
211820240813,21,2024-08-13,18,438,394,832,Bourke155_T,"-37.81267313, 144.96788288"
211820240916,21,2024-09-16,18,299,273,572,Bourke155_T,"-37.81267313, 144.96788288"
162820250619,162,2025-06-19,8,209,157,366,Eli489_T,"-37.80740397, 144.95987909"
1401820250923,140,2025-09-23,18,61,77,138,Boyd2837_T,"-37.82590962, 144.96185972"
1311720250125,131,2025-01-25,17,193,125,318,King2_T,"-37.82009057, 144.95758725"
134020240502,134,2024-05-02,0,36,59,95,Spen201_T,"-37.81694221, 144.95303935"
134620250606,134,2025-06-06,6,113,90,203,Spen201_T,"-37.81694221, 144.95303935"
1341520240215,134,2024-02-15,15,416,449,865,Spen201_T,"-37.81694221, 144.95303935"
1342020231221,134,2023-12-21,20,270,288,558,Spen201_T,"-37.81694221, 144.95303935"
1071220250601,107,2025-06-01,12,103,155,258,280Will_T,"-37.81246271, 144.95690188"
107020250608,107,2025-06-08,0,20,8,28,280Will_T,"-37.81246271, 144.95690188"
1331820250903,133,2025-09-03,18,714,532,1246,Spen229_T,"-37.81531435, 144.95227769"
251420250502,25,2025-05-02,14,1081,616,1697,MCEC_T,"-37.82401776, 144.95604426"
202320241016,20,2024-10-16,23,45,70,115,LtB170_T,"-37.81172914, 144.9682466"
1361820250518,136,2025-05-18,18,36,39,75,BirFed1120_T,"-37.8184141, 144.97357915"
1421420240511,142,2024-05-11,14,536,619,1155,Hammer1584_T,"-37.81970749, 144.96795734"
138820241202,138,2024-12-02,8,5,5,10,EntPark1671_T,"-37.81996544, 144.95981454"
117120250921,117,2025-09-21,1,47,31,78,Fli114F_T,"-37.81629332, 144.97090877"
1172120241111,117,2024-11-11,21,59,72,131,Fli114F_T,"-37.81629332, 144.97090877"
1171420241124,117,2024-11-24,14,130,158,288,Fli114F_T,"-37.81629332, 144.97090877"
109920240911,109,2024-09-11,9,99,456,555,LatWill_T,"-37.81193681, 144.95621105"
19220251010,19,2025-10-10,2,19,37,56,LtB210_T,"-37.81237202, 144.96550671"
661920250731,66,2025-07-31,19,1094,1002,2096,QVN_T,"-37.81057846, 144.96444294"
691020241017,69,2024-10-17,10,225,98,323,FLDegC_T,"-37.81687226, 144.96559144"
69320241226,69,2024-12-26,3,3,1,4,FLDegC_T,"-37.81687226, 144.96559144"
84720250205,84,2025-02-05,7,711,260,971,ElFi_T,"-37.81798049, 144.96503383"
661120240321,66,2024-03-21,11,664,859,1523,QVN_T,"-37.81057846, 144.96444294"
70920241226,70,2024-12-26,9,90,82,172,Errol20_T,"-37.80456984, 144.94946228"
781220240225,78,2024-02-25,12,75,111,186,HarEsB_T,"-37.81471642, 144.9446508"
781920240907,78,2024-09-07,19,8,19,27,HarEsB_T,"-37.81471642, 144.9446508"
651420240721,65,2024-07-21,14,1193,1146,2339,SwaCs_T,"-37.81569416, 144.9668064"
65520240403,65,2024-04-03,5,7,9,16,SwaCs_T,"-37.81569416, 144.9668064"
541820250804,54,2025-08-04,18,185,404,589,Swa607_T,"-37.804024, 144.96308399"
312120240107,31,2024-01-07,21,164,232,396,Lyg161_T,"-37.80169681, 144.96658911"
47820240505,47,2024-05-05,8,120,208,328,Eli250_T,"-37.81258467, 144.9625775"
45620240118,45,2024-01-18,6,37,50,87,Swa148_T,"-37.81414075, 144.96609379"
36520231103,36,2023-11-03,5,13,11,24,Que85_T,"-37.81652527, 144.96121062"
361320231105,36,2023-11-05,13,138,84,222,Que85_T,"-37.81652527, 144.96121062"
431320231022,43,2023-10-22,13,73,71,144,UM2_T,"-37.79844526, 144.96411782"
442120240809,44,2024-08-09,21,21,41,62,UM3_T,"-37.79698741, 144.96441306"
441020241113,44,2024-11-13,10,25,44,69,UM3_T,"-37.79698741, 144.96441306"
44120250416,44,2025-04-16,1,10,2,12,UM3_T,"-37.79698741, 144.96441306"
44820250524,44,2025-05-24,8,17,23,40,UM3_T,"-37.79698741, 144.96441306"
1351720250106,135,2025-01-06,17,402,428,830,Spen161_T,"-37.8172861, 144.95319102"
1352020250503,135,2025-05-03,20,150,197,347,Spen161_T,"-37.8172861, 144.95319102"
108920240407,108,2024-04-07,9,109,70,179,261Will_T,"-37.81295822, 144.95678789"
108120240410,108,2024-04-10,1,0,20,20,261Will_T,"-37.81295822, 144.95678789"
1181720250802,118,2025-08-02,17,26,79,105,Fli114C_T,"-37.81632783, 144.97090512"
611120250820,61,2025-08-20,11,408,544,952,RMIT14_T,"-37.80767455, 144.96309114"
179220250716,179,2025-07-16,2,3,1,4,Pow61_T,"-37.82392385, 144.96299677"
167920241211,167,2024-12-11,9,19,61,80,Lat526_T,"-37.81304149, 144.95155955"
167820250317,167,2025-03-17,8,32,108,140,Lat526_T,"-37.81304149, 144.95155955"
1812320250616,181,2025-06-16,23,174,141,315,Eli368_T,"-37.81009465, 144.96143149"
1811820250629,181,2025-06-29,18,826,744,1570,Eli368_T,"-37.81009465, 144.96143149"
1401820231223,140,2023-12-23,18,62,40,102,Boyd2837_T,"-37.82590962, 144.96185972"
1621720250720,162,2025-07-20,17,234,224,458,Eli489_T,"-37.80740397, 144.95987909"
1431420250926,143,2025-09-26,14,179,253,432,Spencer_T,"-37.821728, 144.95557015"
751120240718,75,2024-07-18,11,40,40,80,SprFli_T,"-37.81515276, 144.97467661"
412020250103,41,2025-01-03,20,954,1093,2047,Swa31,"-37.81668634, 144.96689733"
781720241116,78,2024-11-16,17,77,70,147,HarEsB_T,"-37.81471642, 144.9446508"
781320250606,78,2025-06-06,13,24,53,77,HarEsB_T,"-37.81471642, 144.9446508"
711720240617,71,2024-06-17,17,34,38,72,WestWP_T,"-37.81235775, 144.97136962"
651620240502,65,2024-05-02,16,593,723,1316,SwaCs_T,"-37.81569416, 144.9668064"
541720241225,54,2024-12-25,17,30,44,74,Swa607_T,"-37.804024, 144.96308399"
54620240315,54,2024-03-15,6,20,8,28,Swa607_T,"-37.804024, 144.96308399"
36820241004,36,2024-10-04,8,157,176,333,Que85_T,"-37.81652527, 144.96121062"
37920240621,37,2024-06-21,9,49,47,96,Lyg260_T,"-37.80107122, 144.96704554"
45820231030,45,2023-10-30,8,257,236,493,Swa148_T,"-37.81414075, 144.96609379"
61520231227,61,2023-12-27,5,9,21,30,RMIT14_T,"-37.80767455, 144.96309114"
50020250924,50,2025-09-24,0,3,2,5,Lyg309_T,"-37.79808192, 144.96721013"
182920250704,182,2025-07-04,9,97,170,267,King163_T,"-37.81627451, 144.95550503"
681720250113,68,2025-01-13,17,267,221,488,FLDegN_T,"-37.8168479, 144.96559789"
171820250906,17,2025-09-06,18,161,121,282,Col15_T,"-37.81362543, 144.97323591"
681920251010,68,2025-10-10,19,219,164,383,FLDegN_T,"-37.8168479, 144.96559789"
621520231227,62,2023-12-27,15,159,79,238,Lat224_T,"-37.80996494, 144.96216521"
62020240712,62,2024-07-12,0,47,30,77,Lat224_T,"-37.80996494, 144.96216521"
621920250612,62,2025-06-12,19,162,243,405,Lat224_T,"-37.80996494, 144.96216521"
56620250304,56,2025-03-04,6,25,23,48,Lon364_T,"-37.81234775, 144.96153311"
111120240423,11,2024-04-23,11,49,58,107,WatCit_T,"-37.81564989, 144.93970694"
12620240915,12,2024-09-15,6,13,14,27,NewQ_T,"-37.81457988, 144.94292398"
10920240531,10,2024-05-31,9,57,96,153,BouHbr_T,"-37.81876474, 144.94710545"
72620250113,72,2025-01-13,6,51,31,82,ACMI_T,"-37.81726338, 144.96872809"
72120231103,72,2023-11-03,1,10,2,12,ACMI_T,"-37.81726338, 144.96872809"
72720240409,72,2024-04-09,7,238,45,283,ACMI_T,"-37.81726338, 144.96872809"
581120250104,58,2025-01-04,11,572,153,725,Bou688_T,"-37.81686075, 144.95358075"
27320231027,27,2023-10-27,3,6,2,8,Vic_T,"-37.80606888, 144.95644692"
271720231209,27,2023-12-09,17,133,73,206,Vic_T,"-37.80606888, 144.95644692"
581520250522,58,2025-05-22,15,576,645,1221,Bou688_T,"-37.81686075, 144.95358075"
2520250421,2,2025-04-21,5,6,5,11,Bou283_T,"-37.81380668, 144.96516718"
53320240927,53,2024-09-27,3,14,16,30,Col254_T,"-37.81564191, 144.965499"
53820250127,53,2025-01-27,8,69,42,111,Col254_T,"-37.81564191, 144.965499"
301820250512,30,2025-05-12,18,268,321,589,Lon189_T,"-37.8112185, 144.96656806"
79020250704,79,2025-07-04,0,44,48,92,FliSS_T,"-37.81794046, 144.96616678"
231720250504,23,2025-05-04,17,111,149,260,Col623_T,"-37.81909256, 144.95452748"
231520250526,23,2025-05-26,15,141,352,493,Col623_T,"-37.81909256, 144.95452748"
25320240709,25,2024-07-09,3,7,6,13,MCEC_T,"-37.82401776, 144.95604426"
462020240204,46,2024-02-04,20,27,32,59,Pel147_T,"-37.80240719, 144.9615673"
142520240408,142,2024-04-08,5,2,3,5,Hammer1584_T,"-37.81970749, 144.96795734"
1301120250314,130,2025-03-14,11,28,48,76,Bou892T,"-37.8204637, 144.94126826"
136620250206,136,2025-02-06,6,50,53,103,BirFed1120_T,"-37.8184141, 144.97357915"
1231420240516,123,2024-05-16,14,28,7,35,BirBridge_T,"-37.81753741, 144.97329734"
1802220250830,180,2025-08-30,22,2,4,6,Mac330_T,"-37.79497059, 144.93530329"
681320231119,68,2023-11-19,13,273,93,366,FLDegN_T,"-37.8168479, 144.96559789"
682320231122,68,2023-11-22,23,30,3,33,FLDegN_T,"-37.8168479, 144.96559789"
851820231218,85,2023-12-18,18,68,95,163,488Mac_T,"-37.79432415, 144.92973378"
851420240411,85,2024-04-11,14,70,76,146,488Mac_T,"-37.79432415, 144.92973378"
171220250809,17,2025-08-09,12,214,146,360,Col15_T,"-37.81362543, 144.97323591"
1220250525,1,2025-05-25,2,31,43,74,Bou292_T,"-37.81349441, 144.96515323"
631020240612,63,2024-06-12,10,155,201,356,Bou231_T,"-37.81333081, 144.96675571"
672020240301,67,2024-03-01,20,278,289,567,FLDegS_T,"-37.81688755, 144.96562569"
68120250419,68,2025-04-19,1,1,3,4,FLDegN_T,"-37.8168479, 144.96559789"
63720250903,63,2025-09-03,7,77,80,157,Bou231_T,"-37.81333081, 144.96675571"
682220250517,68,2025-05-17,22,84,73,157,FLDegN_T,"-37.8168479, 144.96559789"
86420241031,86,2024-10-31,4,0,1,1,574Qub_T,"-37.80309992, 144.94908064"
861120250728,86,2025-07-28,11,36,46,82,574Qub_T,"-37.80309992, 144.94908064"
622020250204,62,2025-02-04,20,212,159,371,Lat224_T,"-37.80996494, 144.96216521"
121620241222,12,2024-12-22,16,245,217,462,NewQ_T,"-37.81457988, 144.94292398"
121520250128,12,2025-01-28,15,131,121,252,NewQ_T,"-37.81457988, 144.94292398"
35720240830,35,2024-08-30,7,399,496,895,SouthB_T,"-37.82018685, 144.96508508"
351520231018,35,2023-10-18,15,1013,948,1961,SouthB_T,"-37.82018685, 144.96508508"
531420240815,53,2024-08-15,14,750,654,1404,Col254_T,"-37.81564191, 144.965499"
531320240624,53,2024-06-24,13,896,659,1555,Col254_T,"-37.81564191, 144.965499"
301620240207,30,2024-02-07,16,201,354,555,Lon189_T,"-37.8112185, 144.96656806"
20620250929,20,2025-09-29,6,7,9,16,LtB170_T,"-37.81172914, 144.9682466"
481120231119,48,2023-11-19,11,384,366,750,QVMQ_T,"-37.80631581, 144.95866697"
52420231113,52,2023-11-13,4,7,7,14,Eli263_T,"-37.81252157, 144.9619401"
371120240726,37,2024-07-26,11,76,91,167,Lyg260_T,"-37.80107122, 144.96704554"
501020240505,50,2024-05-05,10,116,162,278,Lyg309_T,"-37.79808192, 144.96721013"
441120240216,44,2024-02-16,11,14,23,37,UM3_T,"-37.79698741, 144.96441306"
1082120250304,108,2025-03-04,21,215,88,303,261Will_T,"-37.81295822, 144.95678789"
1351120250314,135,2025-03-14,11,542,808,1350,Spen161_T,"-37.8172861, 144.95319102"
107020250123,107,2025-01-23,0,29,14,43,280Will_T,"-37.81246271, 144.95690188"
118120240130,118,2024-01-30,1,0,3,3,Fli114C_T,"-37.81632783, 144.97090512"
182820250624,182,2025-06-24,8,117,194,311,King163_T,"-37.81627451, 144.95550503"
1671320250129,167,2025-01-29,13,6,15,21,Lat526_T,"-37.81304149, 144.95155955"
167820250817,167,2025-08-17,8,19,32,51,Lat526_T,"-37.81304149, 144.95155955"
140920250131,140,2025-01-31,9,89,55,144,Boyd2837_T,"-37.82590962, 144.96185972"
662320241101,66,2024-11-01,23,388,321,709,QVN_T,"-37.81057846, 144.96444294"
6620250423,6,2025-04-23,6,176,231,407,FliS_T,"-37.81911705, 144.96558255"
841620250221,84,2025-02-21,16,1057,1546,2603,ElFi_T,"-37.81798049, 144.96503383"
31820231124,3,2023-11-24,18,1154,1066,2220,Swa295_T,"-37.81101524, 144.96429485"
3220240911,3,2024-09-11,2,48,22,70,Swa295_T,"-37.81101524, 144.96429485"
70120240806,70,2024-08-06,1,2,1,3,Errol20_T,"-37.80456984, 144.94946228"
701020250829,70,2025-08-29,10,92,87,179,Errol20_T,"-37.80456984, 144.94946228"
751020231128,75,2023-11-28,10,47,26,73,SprFli_T,"-37.81515276, 144.97467661"
8820231117,8,2023-11-17,8,138,155,293,WebBN_T,"-37.82293543, 144.9471751"
591320240107,59,2024-01-07,13,67,74,141,RMIT_T,"-37.80825648, 144.96304859"
28720250625,28,2025-06-25,7,209,97,306,VAC_T,"-37.82129925, 144.96879309"
141820240724,14,2024-07-24,18,485,160,645,SanBri_T,"-37.82011242, 144.96291897"
541020250803,54,2025-08-03,10,76,81,157,Swa607_T,"-37.804024, 144.96308399"
541620241014,54,2024-10-14,16,138,307,445,Swa607_T,"-37.804024, 144.96308399"
542320240110,54,2024-01-10,23,60,38,98,Swa607_T,"-37.804024, 144.96308399"
28520250506,28,2025-05-06,5,38,38,76,VAC_T,"-37.82129925, 144.96879309"
211120250128,21,2025-01-28,11,251,193,444,Bourke155_T,"-37.81267313, 144.96788288"
681320250115,68,2025-01-15,13,524,512,1036,FLDegN_T,"-37.8168479, 144.96559789"
85320231022,85,2023-10-22,3,1,1,2,488Mac_T,"-37.79432415, 144.92973378"
85020231028,85,2023-10-28,0,3,5,8,488Mac_T,"-37.79432415, 144.92973378"
85120240419,85,2024-04-19,1,1,0,1,488Mac_T,"-37.79432415, 144.92973378"
17620241006,17,2024-10-06,6,6,6,12,Col15_T,"-37.81362543, 144.97323591"
63020240703,63,2024-07-03,0,29,39,68,Bou231_T,"-37.81333081, 144.96675571"
672220240607,67,2024-06-07,22,143,195,338,FLDegS_T,"-37.81688755, 144.96562569"
631520241004,63,2024-10-04,15,475,643,1118,Bou231_T,"-37.81333081, 144.96675571"
63320241028,63,2024-10-28,3,4,4,8,Bou231_T,"-37.81333081, 144.96675571"
68120241217,68,2024-12-17,1,1,0,1,FLDegN_T,"-37.8168479, 144.96559789"
101420250123,10,2025-01-23,14,93,61,154,BouHbr_T,"-37.81876474, 144.94710545"
121420240615,12,2024-06-15,14,202,162,364,NewQ_T,"-37.81457988, 144.94292398"
102320240226,10,2024-02-26,23,1,0,1,BouHbr_T,"-37.81876474, 144.94710545"
58620241204,58,2024-12-04,6,260,59,319,Bou688_T,"-37.81686075, 144.95358075"
91520240614,9,2024-06-14,15,579,160,739,Col700_T,"-37.81982992, 144.95102555"
92220240321,9,2024-03-21,22,94,72,166,Col700_T,"-37.81982992, 144.95102555"
531920250306,53,2025-03-06,19,289,232,521,Col254_T,"-37.81564191, 144.965499"
531420240501,53,2024-05-01,14,693,654,1347,Col254_T,"-37.81564191, 144.965499"
792220250429,79,2025-04-29,22,66,129,195,FliSS_T,"-37.81794046, 144.96616678"
51520241121,51,2024-11-21,5,4,10,14,Fra118_T,"-37.80841815, 144.95906316"
231120250401,23,2025-04-01,11,206,238,444,Col623_T,"-37.81909256, 144.95452748"
25920241101,25,2024-11-01,9,157,458,615,MCEC_T,"-37.82401776, 144.95604426"
201220241121,20,2024-11-21,12,305,293,598,LtB170_T,"-37.81172914, 144.9682466"
461220241130,46,2024-11-30,12,15,21,36,Pel147_T,"-37.80240719, 144.9615673"
1391320250826,139,2025-08-26,13,47,45,92,Signal1647_T,"-37.81959923, 144.9632832"
1642120240911,164,2024-09-11,21,19,38,57,Lat526_T,"-37.813005, 144.95160411"
1091520240326,109,2024-03-26,15,269,128,397,LatWill_T,"-37.81193681, 144.95621105"
491120250828,49,2025-08-28,11,340,398,738,Eli501_T,"-37.80730068, 144.95956055"
691720231212,69,2023-12-12,17,124,170,294,FLDegC_T,"-37.81687226, 144.96559144"
61720240729,6,2024-07-29,17,2042,831,2873,FliS_T,"-37.81911705, 144.96558255"
61220250709,6,2025-07-09,12,897,770,1667,FliS_T,"-37.81911705, 144.96558255"
702320231108,70,2023-11-08,23,2,4,6,Errol20_T,"-37.80456984, 144.94946228"
31820240412,3,2024-04-12,18,1636,1837,3473,Swa295_T,"-37.81101524, 144.96429485"
75920241113,75,2024-11-13,9,43,26,69,SprFli_T,"-37.81515276, 144.97467661"
164620240828,164,2024-08-28,6,10,21,31,Lat526_T,"-37.813005, 144.95160411"
1231920241122,123,2024-11-22,19,16,6,22,BirBridge_T,"-37.81753741, 144.97329734"
1092220250704,109,2025-07-04,22,83,117,200,LatWill_T,"-37.81193681, 144.95621105"
1091220240227,109,2024-02-27,12,242,226,468,LatWill_T,"-37.81193681, 144.95621105"
191020250826,19,2025-08-26,10,144,117,261,LtB210_T,"-37.81237202, 144.96550671"
66320250613,66,2025-06-13,3,16,5,21,QVN_T,"-37.81057846, 144.96444294"
84720250604,84,2025-06-04,7,713,221,934,ElFi_T,"-37.81798049, 144.96503383"
70820231022,70,2023-10-22,8,39,36,75,Errol20_T,"-37.80456984, 144.94946228"
751320250707,75,2025-07-07,13,124,102,226,SprFli_T,"-37.81515276, 144.97467661"
8920250211,8,2025-02-11,9,264,161,425,WebBN_T,"-37.82293543, 144.9471751"
81620250528,8,2025-05-28,16,131,249,380,WebBN_T,"-37.82293543, 144.9471751"
771320250512,77,2025-05-12,13,151,126,277,HarEsP_T,"-37.81441438, 144.94433026"
78720250204,78,2025-02-04,7,55,31,86,HarEsB_T,"-37.81471642, 144.9446508"
591620240103,59,2024-01-03,16,360,568,928,RMIT_T,"-37.80825648, 144.96304859"
651920240524,65,2024-05-24,19,336,346,682,SwaCs_T,"-37.81569416, 144.9668064"
281720241208,28,2024-12-08,17,654,612,1266,VAC_T,"-37.82129925, 144.96879309"
291320251001,29,2025-10-01,13,282,363,645,AG_T,"-37.8199817, 144.96872865"
311820250104,31,2025-01-04,18,253,141,394,Lyg161_T,"-37.80169681, 144.96658911"
361920240209,36,2024-02-09,19,159,141,300,Que85_T,"-37.81652527, 144.96121062"
51020250626,5,2025-06-26,10,339,811,1150,PriNW_T,"-37.81874249, 144.96787656"
118620250321,118,2025-03-21,6,2,2,4,Fli114C_T,"-37.81632783, 144.97090512"
87820251016,87,2025-10-16,8,114,71,185,Errol23_T,"-37.80454949, 144.94921863"
871620240823,87,2024-08-23,16,96,115,211,Errol23_T,"-37.80454949, 144.94921863"
611120241108,61,2024-11-08,11,417,446,863,RMIT14_T,"-37.80767455, 144.96309114"
611520240503,61,2024-05-03,15,375,712,1087,RMIT14_T,"-37.80767455, 144.96309114"
50820250915,50,2025-09-15,8,33,91,124,Lyg309_T,"-37.79808192, 144.96721013"
1651620250828,165,2025-08-28,16,54,39,93,Spen475_T,"-37.80953359, 144.94939004"
1621120250923,162,2025-09-23,11,435,545,980,Eli489_T,"-37.80740397, 144.95987909"
167320250814,167,2025-08-14,3,2,0,2,Lat526_T,"-37.81304149, 144.95155955"
131520240115,131,2024-01-15,5,1,7,8,King2_T,"-37.82009057, 144.95758725"
1312320241005,131,2024-10-05,23,173,229,402,King2_T,"-37.82009057, 144.95758725"
143720250907,143,2025-09-07,7,49,67,116,Spencer_T,"-37.821728, 144.95557015"
1321220240115,132,2024-01-15,12,144,106,250,King335_T,"-37.81267639, 144.95386444"
135320240508,135,2024-05-08,3,18,10,28,Spen161_T,"-37.8172861, 144.95319102"
851420240528,85,2024-05-28,14,47,45,92,488Mac_T,"-37.79432415, 144.92973378"
11820250629,1,2025-06-29,18,863,524,1387,Bou292_T,"-37.81349441, 144.96515323"
63820240803,63,2024-08-03,8,40,99,139,Bou231_T,"-37.81333081, 144.96675571"
681620240610,68,2024-06-10,16,153,74,227,FLDegN_T,"-37.8168479, 144.96559789"
63120250428,63,2025-04-28,1,1,10,11,Bou231_T,"-37.81333081, 144.96675571"
861020240513,86,2024-05-13,10,49,42,91,574Qub_T,"-37.80309992, 144.94908064"
56820250529,56,2025-05-29,8,117,202,319,Lon364_T,"-37.81234775, 144.96153311"
24520250818,24,2025-08-18,5,73,72,145,Col620_T,"-37.81887963, 144.95449198"
352120240101,35,2024-01-01,21,1090,1368,2458,SouthB_T,"-37.82018685, 144.96508508"
2620240315,2,2024-03-15,6,16,22,38,Bou283_T,"-37.81380668, 144.96516718"
30420240518,30,2024-05-18,4,77,97,174,Lon189_T,"-37.8112185, 144.96656806"
301620240722,30,2024-07-22,16,211,311,522,Lon189_T,"-37.8112185, 144.96656806"
411220231118,41,2023-11-18,12,2074,1375,3449,Swa31,"-37.81668634, 144.96689733"
78120240330,78,2024-03-30,1,0,3,3,HarEsB_T,"-37.81471642, 144.9446508"
71320240712,71,2024-07-12,3,2,1,3,WestWP_T,"-37.81235775, 144.97136962"
711620250724,71,2025-07-24,16,13,11,24,WestWP_T,"-37.81235775, 144.97136962"
281320240105,28,2024-01-05,13,1285,1311,2596,VAC_T,"-37.82129925, 144.96879309"
292220240412,29,2024-04-12,22,151,182,333,AG_T,"-37.8199817, 144.96872865"
14420250509,14,2025-05-09,4,13,2,15,SanBri_T,"-37.82011242, 144.96291897"
142120240716,14,2024-07-16,21,167,62,229,SanBri_T,"-37.82011242, 144.96291897"
541020240416,54,2024-04-16,10,268,127,395,Swa607_T,"-37.804024, 144.96308399"
471220240414,47,2024-04-14,12,805,921,1726,Eli250_T,"-37.81258467, 144.9625775"
40520241211,40,2024-12-11,5,8,13,21,Spr201_T,"-37.80999341, 144.97227587"
5320241022,5,2024-10-22,3,11,6,17,PriNW_T,"-37.81874249, 144.96787656"
211820240912,21,2024-09-12,18,349,294,643,Bourke155_T,"-37.81267313, 144.96788288"
37220241022,37,2024-10-22,2,1,6,7,Lyg260_T,"-37.80107122, 144.96704554"
502320250223,50,2025-02-23,23,24,29,53,Lyg309_T,"-37.79808192, 144.96721013"
1311220231123,131,2023-11-23,12,51,100,151,King2_T,"-37.82009057, 144.95758725"
1351020240917,135,2024-09-17,10,286,236,522,Spen161_T,"-37.8172861, 144.95319102"
133220250210,133,2025-02-10,2,10,3,13,Spen229_T,"-37.81531435, 144.95227769"
133920250814,133,2025-08-14,9,395,468,863,Spen229_T,"-37.81531435, 144.95227769"
1241220250325,124,2025-03-25,12,10,16,26,BirBridge_T,"-37.81757416, 144.97329934"
1081420240312,108,2024-03-12,14,459,251,710,261Will_T,"-37.81295822, 144.95678789"
1182320240907,118,2024-09-07,23,29,3,32,Fli114C_T,"-37.81632783, 144.97090512"
871920250619,87,2025-06-19,19,81,77,158,Errol23_T,"-37.80454949, 144.94921863"
611820250923,61,2025-09-23,18,613,616,1229,RMIT14_T,"-37.80767455, 144.96309114"
1851020250814,185,2025-08-14,10,355,393,748,Eli197_T,"-37.81374643, 144.96276183"
1651020250108,165,2025-01-08,10,36,19,55,Spen475_T,"-37.80953359, 144.94939004"
1401820241121,140,2024-11-21,18,109,158,267,Boyd2837_T,"-37.82590962, 144.96185972"
852220250221,85,2025-02-21,22,29,26,55,488Mac_T,"-37.79432415, 144.92973378"
17520240905,17,2024-09-05,5,41,15,56,Col15_T,"-37.81362543, 144.97323591"
11920240630,1,2024-06-30,19,473,267,740,Bou292_T,"-37.81349441, 144.96515323"
67320240905,67,2024-09-05,3,9,14,23,FLDegS_T,"-37.81688755, 144.96562569"
621820250608,62,2025-06-08,18,177,196,373,Lat224_T,"-37.80996494, 144.96216521"
56220241220,56,2024-12-20,2,15,19,34,Lon364_T,"-37.81234775, 144.96153311"
112020231027,11,2023-10-27,20,244,157,401,WatCit_T,"-37.81564989, 144.93970694"
101720240307,10,2024-03-07,17,265,84,349,BouHbr_T,"-37.81876474, 144.94710545"
101420241009,10,2024-10-09,14,72,51,123,BouHbr_T,"-37.81876474, 144.94710545"
241920240219,24,2024-02-19,19,256,525,781,Col620_T,"-37.81887963, 144.95449198"
24120250812,24,2025-08-12,1,23,3,26,Col620_T,"-37.81887963, 144.95449198"
24820250816,24,2025-08-16,8,335,260,595,Col620_T,"-37.81887963, 144.95449198"
72920240505,72,2024-05-05,9,95,133,228,ACMI_T,"-37.81726338, 144.96872809"
21520231224,2,2023-12-24,15,1190,1153,2343,Bou283_T,"-37.81380668, 144.96516718"
27320250128,27,2025-01-28,3,4,2,6,Vic_T,"-37.80606888, 144.95644692"
9020240903,9,2024-09-03,0,3,4,7,Col700_T,"-37.81982992, 144.95102555"
792220250309,79,2025-03-09,22,343,1021,1364,FliSS_T,"-37.81794046, 144.96616678"
30320240408,30,2024-04-08,3,15,51,66,Lon189_T,"-37.8112185, 144.96656806"
51820250523,51,2025-05-23,8,65,45,110,Fra118_T,"-37.80841815, 144.95906316"
302120250730,30,2025-07-30,21,197,286,483,Lon189_T,"-37.8112185, 144.96656806"
25620240430,25,2024-04-30,6,91,147,238,MCEC_T,"-37.82401776, 144.95604426"
251420240713,25,2024-07-13,14,1045,1140,2185,MCEC_T,"-37.82401776, 144.95604426"
192020240309,19,2024-03-09,20,641,658,1299,LtB210_T,"-37.81237202, 144.96550671"
1371420241026,137,2024-10-26,14,8,29,37,BouHbr2353_T,"-37.81894815, 144.94612292"
141820250228,141,2025-02-28,8,92,105,197,474Fl_T,"-37.81997273, 144.95834911"
1391520250402,139,2025-04-02,15,88,40,128,Signal1647_T,"-37.81959923, 144.9632832"
1301720240323,130,2024-03-23,17,11,5,16,Bou892T,"-37.8204637, 144.94126826"
164620240815,164,2024-08-15,6,24,13,37,Lat526_T,"-37.813005, 144.95160411"
118220240707,118,2024-07-07,2,0,7,7,Fli114C_T,"-37.81632783, 144.97090512"
1181720250110,118,2025-01-10,17,40,60,100,Fli114C_T,"-37.81632783, 144.97090512"
66420250813,66,2025-08-13,4,3,5,8,QVN_T,"-37.81057846, 144.96444294"
692020231102,69,2023-11-02,20,58,40,98,FLDegC_T,"-37.81687226, 144.96559144"
69720240628,69,2024-06-28,7,61,13,74,FLDegC_T,"-37.81687226, 144.96559144"
69420240725,69,2024-07-25,4,4,9,13,FLDegC_T,"-37.81687226, 144.96559144"
69420241225,69,2024-12-25,4,2,1,3,FLDegC_T,"-37.81687226, 144.96559144"
69320251015,69,2025-10-15,3,1,0,1,FLDegC_T,"-37.81687226, 144.96559144"
42320250830,4,2025-08-30,23,574,470,1044,Swa123_T,"-37.81487988, 144.9660878"
702320231208,70,2023-12-08,23,32,52,84,Errol20_T,"-37.80456984, 144.94946228"
701820250706,70,2025-07-06,18,120,128,248,Errol20_T,"-37.80456984, 144.94946228"
17520250328,17,2025-03-28,5,51,20,71,Col15_T,"-37.81362543, 144.97323591"
11320240514,1,2024-05-14,13,1313,1144,2457,Bou292_T,"-37.81349441, 144.96515323"
631320240116,63,2024-01-16,13,500,569,1069,Bou231_T,"-37.81333081, 144.96675571"
63220241227,63,2024-12-27,2,1,19,20,Bou231_T,"-37.81333081, 144.96675571"
111520231118,11,2023-11-18,15,189,154,343,WatCit_T,"-37.81564989, 144.93970694"
11820231228,11,2023-12-28,8,22,12,34,WatCit_T,"-37.81564989, 144.93970694"
622220240218,62,2024-02-18,22,124,73,197,Lat224_T,"-37.80996494, 144.96216521"
112220250827,11,2025-08-27,22,21,18,39,WatCit_T,"-37.81564989, 144.93970694"
112320251006,11,2025-10-06,23,22,21,43,WatCit_T,"-37.81564989, 144.93970694"
721120231101,72,2023-11-01,11,252,237,489,ACMI_T,"-37.81726338, 144.96872809"
58520240628,58,2024-06-28,5,82,22,104,Bou688_T,"-37.81686075, 144.95358075"
581120240205,58,2024-02-05,11,421,184,605,Bou688_T,"-37.81686075, 144.95358075"
352220250826,35,2025-08-26,22,39,52,91,SouthB_T,"-37.82018685, 144.96508508"
53620250707,53,2025-07-07,6,32,22,54,Col254_T,"-37.81564191, 144.965499"
791220250610,79,2025-06-10,12,492,337,829,FliSS_T,"-37.81794046, 144.96616678"
52720250109,52,2025-01-09,7,52,39,91,Eli263_T,"-37.81252157, 144.9619401"
51720250517,51,2025-05-17,7,20,18,38,Fra118_T,"-37.80841815, 144.95906316"
512220240826,51,2024-08-26,22,27,34,61,Fra118_T,"-37.80841815, 144.95906316"
231120250716,23,2025-07-16,11,262,348,610,Col623_T,"-37.81909256, 144.95452748"
25320250407,25,2025-04-07,3,3,8,11,MCEC_T,"-37.82401776, 144.95604426"
52320251015,52,2025-10-15,3,2,2,4,Eli263_T,"-37.81252157, 144.9619401"
1361020250310,136,2025-03-10,10,96,130,226,BirFed1120_T,"-37.8184141, 144.97357915"
3620240724,3,2024-07-24,6,52,118,170,Swa295_T,"-37.81101524, 144.96429485"
31520240822,3,2024-08-22,15,1011,1144,2155,Swa295_T,"-37.81101524, 144.96429485"
31920250619,3,2025-06-19,19,758,1016,1774,Swa295_T,"-37.81101524, 144.96429485"
82020240428,8,2024-04-28,20,40,40,80,WebBN_T,"-37.82293543, 144.9471751"
41320250117,41,2025-01-17,3,75,57,132,Swa31,"-37.81668634, 144.96689733"
41820240108,41,2024-01-08,8,1406,348,1754,Swa31,"-37.81668634, 144.96689733"
59220250617,59,2025-06-17,2,18,11,29,RMIT_T,"-37.80825648, 144.96304859"
591420231028,59,2023-10-28,14,595,567,1162,RMIT_T,"-37.80825648, 144.96304859"
59520240221,59,2024-02-21,5,33,36,69,RMIT_T,"-37.80825648, 144.96304859"
161020240615,161,2024-06-15,0,2,0,2,BirArt1109_T,"-37.81851276, 144.97131336"
1091120231111,109,2023-11-11,11,83,107,190,LatWill_T,"-37.81193681, 144.95621105"
6020240601,6,2024-06-01,0,296,156,452,FliS_T,"-37.81911705, 144.96558255"
842320250821,84,2025-08-21,23,179,231,410,ElFi_T,"-37.81798049, 144.96503383"
31620231123,3,2023-11-23,16,1075,1194,2269,Swa295_T,"-37.81101524, 144.96429485"
32020241212,3,2024-12-12,20,938,876,1814,Swa295_T,"-37.81101524, 144.96429485"
42320241218,4,2024-12-18,23,344,397,741,Swa123_T,"-37.81487988, 144.9660878"
701420240206,70,2024-02-06,14,116,98,214,Errol20_T,"-37.80456984, 144.94946228"
701420240311,70,2024-03-11,14,69,80,149,Errol20_T,"-37.80456984, 144.94946228"
70720241227,70,2024-12-27,7,14,10,24,Errol20_T,"-37.80456984, 144.94946228"
391820231029,39,2023-10-29,18,66,47,113,AlfPl_T,"-37.81379749, 144.96995745"
82020241114,8,2024-11-14,20,69,98,167,WebBN_T,"-37.82293543, 144.9471751"
412020240706,41,2024-07-06,20,88,86,174,Swa31,"-37.81668634, 144.96689733"
411820240119,41,2024-01-19,18,1687,1522,3209,Swa31,"-37.81668634, 144.96689733"
422220241027,42,2024-10-27,22,45,53,98,UM1_T,"-37.80008566, 144.96386412"
42620250625,42,2025-06-25,6,6,12,18,UM1_T,"-37.80008566, 144.96386412"
712020240713,71,2024-07-13,20,8,3,11,WestWP_T,"-37.81235775, 144.97136962"
711020250107,71,2025-01-07,10,27,21,48,WestWP_T,"-37.81235775, 144.97136962"
71720250708,71,2025-07-08,7,4,6,10,WestWP_T,"-37.81235775, 144.97136962"
291620240424,29,2024-04-24,16,224,231,455,AG_T,"-37.8199817, 144.96872865"
14120240125,14,2024-01-25,1,18,43,61,SanBri_T,"-37.82011242, 144.96291897"
311420250406,31,2025-04-06,14,381,358,739,Lyg161_T,"-37.80169681, 144.96658911"
5020240507,5,2024-05-07,0,31,39,70,PriNW_T,"-37.81874249, 144.96787656"
361620250829,36,2025-08-29,16,195,192,387,Que85_T,"-37.81652527, 144.96121062"
36120240104,36,2024-01-04,1,4,4,8,Que85_T,"-37.81652527, 144.96121062"
36720240424,36,2024-04-24,7,98,58,156,Que85_T,"-37.81652527, 144.96121062"
361320250221,36,2025-02-21,13,316,362,678,Que85_T,"-37.81652527, 144.96121062"
431520240830,43,2024-08-30,15,159,193,352,UM2_T,"-37.79844526, 144.96411782"
43220250401,43,2025-04-01,2,0,1,1,UM2_T,"-37.79844526, 144.96411782"
43520250710,43,2025-07-10,5,3,1,4,UM2_T,"-37.79844526, 144.96411782"
44220250517,44,2025-05-17,2,1,0,1,UM3_T,"-37.79698741, 144.96441306"
132220240303,132,2024-03-03,2,38,8,46,King335_T,"-37.81267639, 144.95386444"
1341120240923,134,2024-09-23,11,295,335,630,Spen201_T,"-37.81694221, 144.95303935"
133720250604,133,2025-06-04,7,629,342,971,Spen229_T,"-37.81531435, 144.95227769"
1071020250311,107,2025-03-11,10,128,141,269,280Will_T,"-37.81246271, 144.95690188"
611020250103,61,2025-01-03,10,139,251,390,RMIT14_T,"-37.80767455, 144.96309114"
61620250215,61,2025-02-15,6,20,35,55,RMIT14_T,"-37.80767455, 144.96309114"
871020231103,87,2023-11-03,10,72,88,160,Errol23_T,"-37.80454949, 144.94921863"
871220240422,87,2024-04-22,12,203,160,363,Errol23_T,"-37.80454949, 144.94921863"
1791320250524,179,2025-05-24,13,64,61,125,Pow61_T,"-37.82392385, 144.96299677"
1791920251001,179,2025-10-01,19,75,48,123,Pow61_T,"-37.82392385, 144.96299677"
1622220241112,162,2024-11-12,22,132,85,217,Eli489_T,"-37.80740397, 144.95987909"
851120250802,85,2025-08-02,11,126,104,230,488Mac_T,"-37.79432415, 144.92973378"
171020240303,17,2024-03-03,10,119,82,201,Col15_T,"-37.81362543, 144.97323591"
171220240507,17,2024-05-07,12,755,757,1512,Col15_T,"-37.81362543, 144.97323591"
171820241125,17,2024-11-25,18,179,272,451,Col15_T,"-37.81362543, 144.97323591"
1220250504,1,2025-05-04,2,30,78,108,Bou292_T,"-37.81349441, 144.96515323"
181220231231,18,2023-12-31,12,58,84,142,Col12_T,"-37.81344862, 144.97305353"
621620251015,62,2025-10-15,16,246,258,504,Lat224_T,"-37.80996494, 144.96216521"
121620240304,12,2024-03-04,16,166,132,298,NewQ_T,"-37.81457988, 144.94292398"
24520231217,24,2023-12-17,5,36,57,93,Col620_T,"-37.81887963, 144.95449198"
121920241026,12,2024-10-26,19,343,366,709,NewQ_T,"-37.81457988, 144.94292398"
76820240831,76,2024-08-31,8,39,38,77,KenMac_T,"-37.79453803, 144.93036194"
30620240902,30,2024-09-02,6,19,26,45,Lon189_T,"-37.8112185, 144.96656806"
79520250815,79,2025-08-15,5,24,34,58,FliSS_T,"-37.81794046, 144.96616678"
20620250401,20,2025-04-01,6,6,19,25,LtB170_T,"-37.81172914, 144.9682466"
201420250926,20,2025-09-26,14,216,289,505,LtB170_T,"-37.81172914, 144.9682466"
482220231227,48,2023-12-27,22,64,92,156,QVMQ_T,"-37.80631581, 144.95866697"
522320250828,52,2025-08-28,23,83,73,156,Eli263_T,"-37.81252157, 144.9619401"
46820250713,46,2025-07-13,8,5,10,15,Pel147_T,"-37.80240719, 144.9615673"
1372020250223,137,2025-02-23,20,4,8,12,BouHbr2353_T,"-37.81894815, 144.94612292"
1391020240605,139,2024-06-05,10,21,31,52,Signal1647_T,"-37.81959923, 144.9632832"
142720240102,142,2024-01-02,7,98,73,171,Hammer1584_T,"-37.81970749, 144.96795734"
1422120240528,142,2024-05-28,21,48,45,93,Hammer1584_T,"-37.81970749, 144.96795734"
138920250617,138,2025-06-17,9,5,4,9,EntPark1671_T,"-37.81996544, 144.95981454"
1171520250312,117,2025-03-12,15,143,226,369,Fli114F_T,"-37.81629332, 144.97090877"
48620250724,48,2025-07-24,6,37,36,73,QVMQ_T,"-37.80631581, 144.95866697"
491020240828,49,2024-08-28,10,117,204,321,Eli501_T,"-37.80730068, 144.95956055"
1091920240422,109,2024-04-22,19,87,101,188,LatWill_T,"-37.81193681, 144.95621105"
661320240814,66,2024-08-14,13,1276,1314,2590,QVN_T,"-37.81057846, 144.96444294"
61920240129,6,2024-01-29,19,583,579,1162,FliS_T,"-37.81911705, 144.96558255"
6820240131,6,2024-01-31,8,788,2189,2977,FliS_T,"-37.81911705, 144.96558255"
6720240620,6,2024-06-20,7,400,689,1089,FliS_T,"-37.81911705, 144.96558255"
4820241013,4,2024-10-13,8,198,182,380,Swa123_T,"-37.81487988, 144.9660878"
41320241228,4,2024-12-28,13,2166,1730,3896,Swa123_T,"-37.81487988, 144.9660878"
82020231210,8,2023-12-10,20,43,71,114,WebBN_T,"-37.82293543, 144.9471751"
591120250701,59,2025-07-01,11,300,302,602,RMIT_T,"-37.80825648, 144.96304859"
281420250714,28,2025-07-14,14,1056,859,1915,VAC_T,"-37.82129925, 144.96879309"
292120231201,29,2023-12-01,21,179,305,484,AG_T,"-37.8199817, 144.96872865"
401720241025,40,2024-10-25,17,158,325,483,Spr201_T,"-37.80999341, 144.97227587"
31720250927,31,2025-09-27,7,11,19,30,Lyg161_T,"-37.80169681, 144.96658911"
31220240630,31,2024-06-30,2,72,84,156,Lyg161_T,"-37.80169681, 144.96658911"
542020250919,54,2025-09-19,20,177,256,433,Swa607_T,"-37.804024, 144.96308399"
361020250216,36,2025-02-16,10,105,62,167,Que85_T,"-37.81652527, 144.96121062"
47520250113,47,2025-01-13,5,14,50,64,Eli250_T,"-37.81258467, 144.9625775"
118720240621,118,2024-06-21,7,8,2,10,Fli114C_T,"-37.81632783, 144.97090512"
871520241102,87,2024-11-02,15,112,79,191,Errol23_T,"-37.80454949, 144.94921863"
611120241018,61,2024-10-18,11,203,335,538,RMIT14_T,"-37.80767455, 144.96309114"
441820250503,44,2025-05-03,18,30,58,88,UM3_T,"-37.79698741, 144.96441306"
43820250908,43,2025-09-08,8,168,62,230,UM2_T,"-37.79844526, 144.96411782"
1652020250514,165,2025-05-14,20,49,18,67,Spen475_T,"-37.80953359, 144.94939004"
165520250611,165,2025-06-11,5,0,2,2,Spen475_T,"-37.80953359, 144.94939004"
166920250315,166,2025-03-15,9,49,46,95,Spen484_T,"-37.80896733, 144.94931703"
1311820240223,131,2024-02-23,18,127,136,263,King2_T,"-37.82009057, 144.95758725"
1341820241027,134,2024-10-27,18,470,398,868,Spen201_T,"-37.81694221, 144.95303935"
133920231113,133,2023-11-13,9,394,386,780,Spen229_T,"-37.81531435, 144.95227769"
682220251004,68,2025-10-04,22,84,97,181,FLDegN_T,"-37.8168479, 144.96559789"
18920250411,18,2025-04-11,9,110,447,557,Col12_T,"-37.81344862, 144.97305353"
631020240124,63,2024-01-24,10,198,256,454,Bou231_T,"-37.81333081, 144.96675571"
762020250816,76,2025-08-16,20,8,12,20,KenMac_T,"-37.79453803, 144.93036194"
581720241115,58,2024-11-15,17,1017,998,2015,Bou688_T,"-37.81686075, 144.95358075"
58020250106,58,2025-01-06,0,46,39,85,Bou688_T,"-37.81686075, 144.95358075"
56620250817,56,2025-08-17,6,19,10,29,Lon364_T,"-37.81234775, 144.96153311"
2720250511,2,2025-05-11,7,14,26,40,Bou283_T,"-37.81380668, 144.96516718"
91720250928,9,2025-09-28,17,62,60,122,Col700_T,"-37.81982992, 144.95102555"
531620241109,53,2024-11-09,16,762,567,1329,Col254_T,"-37.81564191, 144.965499"
791120241108,79,2024-11-08,11,446,319,765,FliSS_T,"-37.81794046, 144.96616678"
791520240802,79,2024-08-02,15,393,400,793,FliSS_T,"-37.81794046, 144.96616678"
51020241217,51,2024-12-17,0,22,16,38,Fra118_T,"-37.80841815, 144.95906316"
20520250512,20,2025-05-12,5,2,6,8,LtB170_T,"-37.81172914, 144.9682466"
25920240701,25,2024-07-01,9,124,325,449,MCEC_T,"-37.82401776, 144.95604426"
52320240805,52,2024-08-05,3,5,7,12,Eli263_T,"-37.81252157, 144.9619401"
462120250718,46,2025-07-18,21,1,0,1,Pel147_T,"-37.80240719, 144.9615673"
1361920251009,136,2025-10-09,19,71,67,138,BirFed1120_T,"-37.8184141, 144.97357915"
1361020231211,136,2023-12-11,10,29,27,56,BirFed1120_T,"-37.8184141, 144.97357915"
1361920240616,136,2024-06-16,19,0,1,1,BirFed1120_T,"-37.8184141, 144.97357915"
1302220250508,130,2025-05-08,22,12,6,18,Bou892T,"-37.8204637, 144.94126826"
1642120250811,164,2025-08-11,21,45,85,130,Lat526_T,"-37.813005, 144.95160411"
117820250908,117,2025-09-08,8,371,103,474,Fli114F_T,"-37.81629332, 144.97090877"
123720241001,123,2024-10-01,7,17,1,18,BirBridge_T,"-37.81753741, 144.97329734"
491220250806,49,2025-08-06,12,273,357,630,Eli501_T,"-37.80730068, 144.95956055"
491220231112,49,2023-11-12,12,367,670,1037,Eli501_T,"-37.80730068, 144.95956055"
1091620240601,109,2024-06-01,16,80,80,160,LatWill_T,"-37.81193681, 144.95621105"
661820250330,66,2025-03-30,18,1204,1213,2417,QVN_T,"-37.81057846, 144.96444294"
69220240701,69,2024-07-01,2,3,2,5,FLDegC_T,"-37.81687226, 144.96559144"
84520251013,84,2025-10-13,5,36,21,57,ElFi_T,"-37.81798049, 144.96503383"
41820240109,4,2024-01-09,18,1609,1431,3040,Swa123_T,"-37.81487988, 144.9660878"
66920231118,66,2023-11-18,9,166,235,401,QVN_T,"-37.81057846, 144.96444294"
752020240816,75,2024-08-16,20,15,32,47,SprFli_T,"-37.81515276, 144.97467661"
751420241121,75,2024-11-21,14,54,87,141,SprFli_T,"-37.81515276, 144.97467661"
42820250904,42,2025-09-04,8,200,73,273,UM1_T,"-37.80008566, 144.96386412"
651820240330,65,2024-03-30,18,855,760,1615,SwaCs_T,"-37.81569416, 144.9668064"
291220250227,29,2025-02-27,12,268,358,626,AG_T,"-37.8199817, 144.96872865"
14620240116,14,2024-01-16,6,80,106,186,SanBri_T,"-37.82011242, 144.96291897"
37920250923,37,2025-09-23,9,23,52,75,Lyg260_T,"-37.80107122, 144.96704554"
471220240725,47,2024-07-25,12,619,676,1295,Eli250_T,"-37.81258467, 144.9625775"
40920240904,40,2024-09-04,9,190,261,451,Spr201_T,"-37.80999341, 144.97227587"
40920241008,40,2024-10-08,9,185,293,478,Spr201_T,"-37.80999341, 144.97227587"
402220231212,40,2023-12-12,22,94,38,132,Spr201_T,"-37.80999341, 144.97227587"
51420250305,5,2025-03-05,14,690,741,1431,PriNW_T,"-37.81874249, 144.96787656"
5720231204,5,2023-12-04,7,243,408,651,PriNW_T,"-37.81874249, 144.96787656"
51020240414,5,2024-04-14,10,403,570,973,PriNW_T,"-37.81874249, 144.96787656"
50520240129,50,2024-01-29,5,7,3,10,Lyg309_T,"-37.79808192, 144.96721013"
442120240623,44,2024-06-23,21,5,1,6,UM3_T,"-37.79698741, 144.96441306"
44020241024,44,2024-10-24,0,1,1,2,UM3_T,"-37.79698741, 144.96441306"
1321920250610,132,2025-06-10,19,92,94,186,King335_T,"-37.81267639, 144.95386444"
1341020240823,134,2024-08-23,10,361,388,749,Spen201_T,"-37.81694221, 144.95303935"
1341020250123,134,2025-01-23,10,362,344,706,Spen201_T,"-37.81694221, 144.95303935"
134420250726,134,2025-07-26,4,22,25,47,Spen201_T,"-37.81694221, 144.95303935"
1312320250201,131,2025-02-01,23,162,123,285,King2_T,"-37.82009057, 144.95758725"
612020240205,61,2024-02-05,20,254,270,524,RMIT14_T,"-37.80767455, 144.96309114"
621820250621,62,2025-06-21,18,161,246,407,Lat224_T,"-37.80996494, 144.96216521"
11420250329,11,2025-03-29,4,1,1,2,WatCit_T,"-37.81564989, 144.93970694"
122120241130,12,2024-11-30,21,253,964,1217,NewQ_T,"-37.81457988, 144.94292398"
121520231027,12,2023-10-27,15,563,565,1128,NewQ_T,"-37.81457988, 144.94292398"
122120250502,12,2025-05-02,21,185,189,374,NewQ_T,"-37.81457988, 144.94292398"
121420250825,12,2025-08-25,14,104,133,237,NewQ_T,"-37.81457988, 144.94292398"
101520240709,10,2024-07-09,15,81,14,95,BouHbr_T,"-37.81876474, 144.94710545"
101720250510,10,2025-05-10,17,97,54,151,BouHbr_T,"-37.81876474, 144.94710545"
581320240527,58,2024-05-27,13,698,448,1146,Bou688_T,"-37.81686075, 144.95358075"
761520250403,76,2025-04-03,15,50,63,113,KenMac_T,"-37.79453803, 144.93036194"
761020240126,76,2024-01-26,10,62,52,114,KenMac_T,"-37.79453803, 144.93036194"
22320250810,2,2025-08-10,23,35,57,92,Bou283_T,"-37.81380668, 144.96516718"
581020250525,58,2025-05-25,10,613,177,790,Bou688_T,"-37.81686075, 144.95358075"
53720231029,53,2023-10-29,7,38,20,58,Col254_T,"-37.81564191, 144.965499"
9920240506,9,2024-05-06,9,146,1397,1543,Col700_T,"-37.81982992, 144.95102555"
301220250119,30,2025-01-19,12,278,361,639,Lon189_T,"-37.8112185, 144.96656806"
301120250408,30,2025-04-08,11,220,298,518,Lon189_T,"-37.8112185, 144.96656806"
79420241005,79,2024-10-05,4,5,11,16,FliSS_T,"-37.81794046, 144.96616678"
23620240410,23,2024-04-10,6,144,84,228,Col623_T,"-37.81909256, 144.95452748"
481320250526,48,2025-05-26,13,147,122,269,QVMQ_T,"-37.80631581, 144.95866697"
1372020250726,137,2025-07-26,20,2,1,3,BouHbr2353_T,"-37.81894815, 144.94612292"
139620250520,139,2025-05-20,6,6,13,19,Signal1647_T,"-37.81959923, 144.9632832"
1391720231210,139,2023-12-10,17,50,57,107,Signal1647_T,"-37.81959923, 144.9632832"
1392320240105,139,2024-01-05,23,17,33,50,Signal1647_T,"-37.81959923, 144.9632832"
1362320250123,136,2025-01-23,23,2,7,9,BirFed1120_T,"-37.8184141, 144.97357915"
1421820240106,142,2024-01-06,18,688,558,1246,Hammer1584_T,"-37.81970749, 144.96795734"
491320250118,49,2025-01-18,13,376,532,908,Eli501_T,"-37.80730068, 144.95956055"
123720240918,123,2024-09-18,7,14,2,16,BirBridge_T,"-37.81753741, 144.97329734"
661420250212,66,2025-02-12,14,812,961,1773,QVN_T,"-37.81057846, 144.96444294"
691220250320,69,2025-03-20,12,345,322,667,FLDegC_T,"-37.81687226, 144.96559144"
661620231122,66,2023-11-22,16,1281,1265,2546,QVN_T,"-37.81057846, 144.96444294"
842320241019,84,2024-10-19,23,462,561,1023,ElFi_T,"-37.81798049, 144.96503383"
84820250714,84,2025-07-14,8,1154,373,1527,ElFi_T,"-37.81798049, 144.96503383"
66420240511,66,2024-05-11,4,16,8,24,QVN_T,"-37.81057846, 144.96444294"
70620250926,70,2025-09-26,6,5,6,11,Errol20_T,"-37.80456984, 144.94946228"
39420240330,39,2024-03-30,4,10,6,16,AlfPl_T,"-37.81379749, 144.96995745"
8920240329,8,2024-03-29,9,63,117,180,WebBN_T,"-37.82293543, 144.9471751"
781520241221,78,2024-12-21,15,48,37,85,HarEsB_T,"-37.81471642, 144.9446508"
142120240319,14,2024-03-19,21,249,80,329,SanBri_T,"-37.82011242, 144.96291897"
71420250121,71,2025-01-21,4,3,0,3,WestWP_T,"-37.81235775, 144.97136962"
281520240207,28,2024-02-07,15,598,1708,2306,VAC_T,"-37.82129925, 144.96879309"
29220240511,29,2024-05-11,2,2,19,21,AG_T,"-37.8199817, 144.96872865"
40120250108,40,2025-01-08,1,4,3,7,Spr201_T,"-37.80999341, 144.97227587"
36720231206,36,2023-12-06,7,114,90,204,Que85_T,"-37.81652527, 144.96121062"
51320240301,5,2024-03-01,13,1113,1480,2593,PriNW_T,"-37.81874249, 144.96787656"
211820240412,21,2024-04-12,18,874,722,1596,Bourke155_T,"-37.81267313, 144.96788288"
1071020240712,107,2024-07-12,10,84,122,206,280Will_T,"-37.81246271, 144.95690188"
1071220250411,107,2025-04-11,12,167,179,346,280Will_T,"-37.81246271, 144.95690188"
872220240714,87,2024-07-14,22,12,25,37,Errol23_T,"-37.80454949, 144.94921863"
501620240221,50,2024-02-21,16,178,176,354,Lyg309_T,"-37.79808192, 144.96721013"
50120241215,50,2024-12-15,1,23,6,29,Lyg309_T,"-37.79808192, 144.96721013"
1851920251009,185,2025-10-09,19,749,620,1369,Eli197_T,"-37.81374643, 144.96276183"
1791920250410,179,2025-04-10,19,56,60,116,Pow61_T,"-37.82392385, 144.96299677"
167220250823,167,2025-08-23,2,2,4,6,Lat526_T,"-37.81304149, 144.95155955"
1311620240207,131,2024-02-07,16,92,124,216,King2_T,"-37.82009057, 144.95758725"
1821820250603,182,2025-06-03,18,257,193,450,King163_T,"-37.81627451, 144.95550503"
167720250820,167,2025-08-20,7,12,46,58,Lat526_T,"-37.81304149, 144.95155955"
140620240915,140,2024-09-15,6,13,2,15,Boyd2837_T,"-37.82590962, 144.96185972"
143820250504,143,2025-05-04,8,97,164,261,Spencer_T,"-37.821728, 144.95557015"
682320240219,68,2024-02-19,23,15,3,18,FLDegN_T,"-37.8168479, 144.96559789"
171620250821,17,2025-08-21,16,274,447,721,Col15_T,"-37.81362543, 144.97323591"
631120250909,63,2025-09-09,11,216,277,493,Bou231_T,"-37.81333081, 144.96675571"
56320240106,56,2024-01-06,3,30,34,64,Lon364_T,"-37.81234775, 144.96153311"
861620240610,86,2024-06-10,16,36,34,70,574Qub_T,"-37.80309992, 144.94908064"
622220240720,62,2024-07-20,22,146,126,272,Lat224_T,"-37.80996494, 144.96216521"
562220250109,56,2025-01-09,22,145,185,330,Lon364_T,"-37.81234775, 144.96153311"
112220241025,11,2024-10-25,22,38,43,81,WatCit_T,"-37.81564989, 144.93970694"
24120240531,24,2024-05-31,1,49,60,109,Col620_T,"-37.81887963, 144.95449198"
111820250812,11,2025-08-12,18,5,4,9,WatCit_T,"-37.81564989, 144.93970694"
101620250904,10,2025-09-04,16,172,44,216,BouHbr_T,"-37.81876474, 144.94710545"
241720240830,24,2024-08-30,17,651,1630,2281,Col620_T,"-37.81887963, 144.95449198"
762120240323,76,2024-03-23,21,17,22,39,KenMac_T,"-37.79453803, 144.93036194"
11220240905,11,2024-09-05,2,0,1,1,WatCit_T,"-37.81564989, 144.93970694"
351320240626,35,2024-06-26,13,1088,1314,2402,SouthB_T,"-37.82018685, 144.96508508"
2320231020,2,2023-10-20,3,4,11,15,Bou283_T,"-37.81380668, 144.96516718"
92220240911,9,2024-09-11,22,70,18,88,Col700_T,"-37.81982992, 144.95102555"
9420250710,9,2025-07-10,4,5,3,8,Col700_T,"-37.81982992, 144.95102555"
91020240221,9,2024-02-21,10,241,623,864,Col700_T,"-37.81982992, 144.95102555"
531520241214,53,2024-12-14,15,1057,691,1748,Col254_T,"-37.81564191, 144.965499"
531820240612,53,2024-06-12,18,335,247,582,Col254_T,"-37.81564191, 144.965499"
521520251012,52,2025-10-12,15,372,390,762,Eli263_T,"-37.81252157, 144.9619401"
251920240315,25,2024-03-15,19,631,396,1027,MCEC_T,"-37.82401776, 144.95604426"
139720250720,139,2025-07-20,7,7,5,12,Signal1647_T,"-37.81959923, 144.9632832"
142120241006,142,2024-10-06,1,2,1,3,Hammer1584_T,"-37.81970749, 144.96795734"
130120241204,130,2024-12-04,1,1,0,1,Bou892T,"-37.8204637, 144.94126826"
1381920250105,138,2025-01-05,19,3,8,11,EntPark1671_T,"-37.81996544, 144.95981454"
19020241220,19,2024-12-20,0,85,110,195,LtB210_T,"-37.81237202, 144.96550671"
691020250920,69,2025-09-20,10,342,156,498,FLDegC_T,"-37.81687226, 144.96559144"
84420250714,84,2025-07-14,4,8,16,24,ElFi_T,"-37.81798049, 144.96503383"
31220241208,3,2024-12-08,12,966,1216,2182,Swa295_T,"-37.81101524, 144.96429485"
66220240320,66,2024-03-20,2,15,15,30,QVN_T,"-37.81057846, 144.96444294"
41120250406,4,2025-04-06,11,2647,1024,3671,Swa123_T,"-37.81487988, 144.9660878"
751720240908,75,2024-09-08,17,16,9,25,SprFli_T,"-37.81515276, 144.97467661"
81020240628,8,2024-06-28,10,123,149,272,WebBN_T,"-37.82293543, 144.9471751"
81020241025,8,2024-10-25,10,94,117,211,WebBN_T,"-37.82293543, 144.9471751"
781620241017,78,2024-10-17,16,32,199,231,HarEsB_T,"-37.81471642, 144.9446508"
78820250719,78,2025-07-19,8,31,27,58,HarEsB_T,"-37.81471642, 144.9446508"
78120240817,78,2024-08-17,1,0,5,5,HarEsB_T,"-37.81471642, 144.9446508"
592120250302,59,2025-03-02,21,111,95,206,RMIT_T,"-37.80825648, 144.96304859"
712120241005,71,2024-10-05,21,13,14,27,WestWP_T,"-37.81235775, 144.97136962"
291620240614,29,2024-06-14,16,175,193,368,AG_T,"-37.8199817, 144.96872865"
14320250510,14,2025-05-10,3,36,9,45,SanBri_T,"-37.82011242, 144.96291897"
47820250807,47,2025-08-07,8,311,741,1052,Eli250_T,"-37.81258467, 144.9625775"
47920231024,47,2023-10-24,9,308,717,1025,Eli250_T,"-37.81258467, 144.9625775"
401520240128,40,2024-01-28,15,111,123,234,Spr201_T,"-37.80999341, 144.97227587"
45920240706,45,2024-07-06,9,242,195,437,Swa148_T,"-37.81414075, 144.96609379"
361520250623,36,2025-06-23,15,149,163,312,Que85_T,"-37.81652527, 144.96121062"
1431320250822,143,2025-08-22,13,191,239,430,Spencer_T,"-37.821728, 144.95557015"
1321920231030,132,2023-10-30,19,106,104,210,King335_T,"-37.81267639, 144.95386444"
1341420250317,134,2025-03-17,14,390,362,752,Spen201_T,"-37.81694221, 144.95303935"
511420241230,51,2024-12-30,14,120,79,199,Fra118_T,"-37.80841815, 144.95906316"
48220240605,48,2024-06-05,2,0,10,10,QVMQ_T,"-37.80631581, 144.95866697"
461020240128,46,2024-01-28,10,18,39,57,Pel147_T,"-37.80240719, 144.9615673"
521720250804,52,2025-08-04,17,405,295,700,Eli263_T,"-37.81252157, 144.9619401"
461620250723,46,2025-07-23,16,44,87,131,Pel147_T,"-37.80240719, 144.9615673"
1412120231119,141,2023-11-19,21,56,88,144,474Fl_T,"-37.81997273, 144.95834911"
1361420240606,136,2024-06-06,14,62,40,102,BirFed1120_T,"-37.8184141, 144.97357915"
142520240908,142,2024-09-08,5,5,10,15,Hammer1584_T,"-37.81970749, 144.96795734"
130720250413,130,2025-04-13,7,9,9,18,Bou892T,"-37.8204637, 144.94126826"
142320241110,142,2024-11-10,3,0,1,1,Hammer1584_T,"-37.81970749, 144.96795734"
1091520250113,109,2025-01-13,15,132,83,215,LatWill_T,"-37.81193681, 144.95621105"
85720250302,85,2025-03-02,7,7,3,10,488Mac_T,"-37.79432415, 144.92973378"
85120250722,85,2025-07-22,1,1,0,1,488Mac_T,"-37.79432415, 144.92973378"
1920240217,1,2024-02-17,9,310,445,755,Bou292_T,"-37.81349441, 144.96515323"
12120250117,1,2025-01-17,21,446,333,779,Bou292_T,"-37.81349441, 144.96515323"
1520250409,1,2025-04-09,5,5,10,15,Bou292_T,"-37.81349441, 144.96515323"
622220240603,62,2024-06-03,22,99,63,162,Lat224_T,"-37.80996494, 144.96216521"
11520241001,11,2024-10-01,5,5,5,10,WatCit_T,"-37.81564989, 144.93970694"
101420231022,10,2023-10-22,14,26,32,58,BouHbr_T,"-37.81876474, 144.94710545"
24520240912,24,2024-09-12,5,101,46,147,Col620_T,"-37.81887963, 144.95449198"
12320250924,12,2025-09-24,3,2,0,2,NewQ_T,"-37.81457988, 144.94292398"
35720241016,35,2024-10-16,7,479,792,1271,SouthB_T,"-37.82018685, 144.96508508"
76520240301,76,2024-03-01,5,1,0,1,KenMac_T,"-37.79453803, 144.93036194"
21320251008,2,2025-10-08,13,911,967,1878,Bou283_T,"-37.81380668, 144.96516718"
581120250524,58,2025-05-24,11,1055,666,1721,Bou688_T,"-37.81686075, 144.95358075"
531020240217,53,2024-02-17,10,673,526,1199,Col254_T,"-37.81564191, 144.965499"
79920250424,79,2025-04-24,9,446,222,668,FliSS_T,"-37.81794046, 144.96616678"
231120250819,23,2025-08-19,11,202,292,494,Col623_T,"-37.81909256, 144.95452748"
28520250709,28,2025-07-09,5,26,33,59,VAC_T,"-37.82129925, 144.96879309"
311820240616,31,2024-06-16,18,209,165,374,Lyg161_T,"-37.80169681, 144.96658911"
311720240906,31,2024-09-06,17,243,151,394,Lyg161_T,"-37.80169681, 144.96658911"
371420240620,37,2024-06-20,14,98,97,195,Lyg260_T,"-37.80107122, 144.96704554"
47820250820,47,2025-08-20,8,257,663,920,Eli250_T,"-37.81258467, 144.9625775"
47720250726,47,2025-07-26,7,53,82,135,Eli250_T,"-37.81258467, 144.9625775"
451020240604,45,2024-06-04,10,251,231,482,Swa148_T,"-37.81414075, 144.96609379"
1071520241103,107,2024-11-03,15,115,172,287,280Will_T,"-37.81246271, 144.95690188"
1071320250406,107,2025-04-06,13,116,139,255,280Will_T,"-37.81246271, 144.95690188"
118620250924,118,2025-09-24,6,5,2,7,Fli114C_T,"-37.81632783, 144.97090512"
502320240506,50,2024-05-06,23,16,6,22,Lyg309_T,"-37.79808192, 144.96721013"
362220240203,36,2024-02-03,22,114,143,257,Que85_T,"-37.81652527, 144.96121062"
36420240430,36,2024-04-30,4,8,5,13,Que85_T,"-37.81652527, 144.96121062"
50820240301,50,2024-03-01,8,44,80,124,Lyg309_T,"-37.79808192, 144.96721013"
431120250820,43,2025-08-20,11,259,269,528,UM2_T,"-37.79844526, 144.96411782"
44620240615,44,2024-06-15,6,1,5,6,UM3_T,"-37.79698741, 144.96441306"
442020250819,44,2025-08-19,20,32,44,76,UM3_T,"-37.79698741, 144.96441306"
45020250608,45,2025-06-08,0,282,225,507,Swa148_T,"-37.81414075, 144.96609379"
1351720250422,135,2025-04-22,17,459,474,933,Spen161_T,"-37.8172861, 144.95319102"
1352120250428,135,2025-04-28,21,128,143,271,Spen161_T,"-37.8172861, 144.95319102"
1352220231117,135,2023-11-17,22,143,172,315,Spen161_T,"-37.8172861, 144.95319102"
1071020251012,107,2025-10-12,10,76,140,216,280Will_T,"-37.81246271, 144.95690188"
1241420240109,124,2024-01-09,14,1,10,11,BirBridge_T,"-37.81757416, 144.97329934"
108520231027,108,2023-10-27,5,14,43,57,261Will_T,"-37.81295822, 144.95678789"
872020240424,87,2024-04-24,20,89,84,173,Errol23_T,"-37.80454949, 144.94921863"
612120250331,61,2025-03-31,21,351,192,543,RMIT14_T,"-37.80767455, 144.96309114"
872220240109,87,2024-01-09,22,14,14,28,Errol23_T,"-37.80454949, 144.94921863"
1812120251001,181,2025-10-01,21,654,560,1214,Eli368_T,"-37.81009465, 144.96143149"
143320250424,143,2025-04-24,3,19,3,22,Spencer_T,"-37.821728, 144.95557015"
143020250430,143,2025-04-30,0,11,12,23,Spencer_T,"-37.821728, 144.95557015"
422020250617,42,2025-06-17,20,34,32,66,UM1_T,"-37.80008566, 144.96386412"
771320240627,77,2024-06-27,13,157,174,331,HarEsP_T,"-37.81441438, 144.94433026"
591320241119,59,2024-11-19,13,351,315,666,RMIT_T,"-37.80825648, 144.96304859"
281420250224,28,2025-02-24,14,724,758,1482,VAC_T,"-37.82129925, 144.96879309"
281920240514,28,2024-05-14,19,178,208,386,VAC_T,"-37.82129925, 144.96879309"
14320240714,14,2024-07-14,3,47,10,57,SanBri_T,"-37.82011242, 144.96291897"
54220240414,54,2024-04-14,2,20,12,32,Swa607_T,"-37.804024, 144.96308399"
37720250804,37,2025-08-04,7,12,12,24,Lyg260_T,"-37.80107122, 144.96704554"
431520241003,43,2024-10-03,15,185,255,440,UM2_T,"-37.79844526, 144.96411782"
442120241123,44,2024-11-23,21,8,0,8,UM3_T,"-37.79698741, 144.96441306"
1321720250206,132,2025-02-06,17,160,164,324,King335_T,"-37.81267639, 144.95386444"
1341520250605,134,2025-06-05,15,356,429,785,Spen201_T,"-37.81694221, 144.95303935"
131720240719,131,2024-07-19,7,47,25,72,King2_T,"-37.82009057, 144.95758725"
131320241213,131,2024-12-13,3,8,28,36,King2_T,"-37.82009057, 144.95758725"
1331920240425,133,2024-04-25,19,376,274,650,Spen229_T,"-37.81531435, 144.95227769"
1081420250718,108,2025-07-18,14,399,251,650,261Will_T,"-37.81295822, 144.95678789"
1792320241231,179,2024-12-31,23,197,74,271,Pow61_T,"-37.82392385, 144.96299677"
165920250324,165,2025-03-24,9,23,41,64,Spen475_T,"-37.80953359, 144.94939004"
1401820241001,140,2024-10-01,18,69,87,156,Boyd2837_T,"-37.82590962, 144.96185972"
271820250207,27,2025-02-07,18,97,92,189,Vic_T,"-37.80606888, 144.95644692"
91720240523,9,2024-05-23,17,3059,323,3382,Col700_T,"-37.81982992, 144.95102555"
531720250411,53,2025-04-11,17,974,543,1517,Col254_T,"-37.81564191, 144.965499"
53420240905,53,2024-09-05,4,0,2,2,Col254_T,"-37.81564191, 144.965499"
92120250218,9,2025-02-18,21,57,34,91,Col700_T,"-37.81982992, 144.95102555"
431820250908,43,2025-09-08,18,139,274,413,UM2_T,"-37.79844526, 144.96411782"
432320240214,43,2024-02-14,23,4,12,16,UM2_T,"-37.79844526, 144.96411782"
179520250708,179,2025-07-08,5,5,2,7,Pow61_T,"-37.82392385, 144.96299677"
1651820250413,165,2025-04-13,18,33,22,55,Spen475_T,"-37.80953359, 144.94939004"
166620250714,166,2025-07-14,6,2,4,6,Spen484_T,"-37.80896733, 144.94931703"
1432220250605,143,2025-06-05,22,120,437,557,Spencer_T,"-37.821728, 144.95557015"
134620240907,134,2024-09-07,6,88,100,188,Spen201_T,"-37.81694221, 144.95303935"
1351320250205,135,2025-02-05,13,457,476,933,Spen161_T,"-37.8172861, 144.95319102"
135120250706,135,2025-07-06,1,65,47,112,Spen161_T,"-37.8172861, 144.95319102"
1351820250902,135,2025-09-02,18,248,313,561,Spen161_T,"-37.8172861, 144.95319102"
1331420250625,133,2025-06-25,14,322,328,650,Spen229_T,"-37.81531435, 144.95227769"
661020240803,66,2024-08-03,10,496,480,976,QVN_T,"-37.81057846, 144.96444294"
841420240420,84,2024-04-20,14,931,1359,2290,ElFi_T,"-37.81798049, 144.96503383"
701920250106,70,2025-01-06,19,99,112,211,Errol20_T,"-37.80456984, 144.94946228"
702220241231,70,2024-12-31,22,82,82,164,Errol20_T,"-37.80456984, 144.94946228"
32120240506,3,2024-05-06,21,627,541,1168,Swa295_T,"-37.81101524, 144.96429485"
392320250710,39,2025-07-10,23,8,9,17,AlfPl_T,"-37.81379749, 144.96995745"
81420250519,8,2025-05-19,14,186,272,458,WebBN_T,"-37.82293543, 144.9471751"
781220240714,78,2024-07-14,12,35,61,96,HarEsB_T,"-37.81471642, 144.9446508"
67620240912,67,2024-09-12,6,105,78,183,FLDegS_T,"-37.81688755, 144.96562569"
67020250211,67,2025-02-11,0,16,35,51,FLDegS_T,"-37.81688755, 144.96562569"
67020250414,67,2025-04-14,0,9,14,23,FLDegS_T,"-37.81688755, 144.96562569"
63020250905,63,2025-09-05,0,8,52,60,Bou231_T,"-37.81333081, 144.96675571"
11520250210,11,2025-02-10,5,4,4,8,WatCit_T,"-37.81564989, 144.93970694"
112120250407,11,2025-04-07,21,77,53,130,WatCit_T,"-37.81564989, 144.93970694"
241320241229,24,2024-12-29,13,384,392,776,Col620_T,"-37.81887963, 144.95449198"
101320250622,10,2025-06-22,13,67,46,113,BouHbr_T,"-37.81876474, 144.94710545"
102120250813,10,2025-08-13,21,16,27,43,BouHbr_T,"-37.81876474, 144.94710545"
721720241225,72,2024-12-25,17,95,124,219,ACMI_T,"-37.81726338, 144.96872809"
721820240121,72,2024-01-21,18,348,377,725,ACMI_T,"-37.81726338, 144.96872809"
76720241118,76,2024-11-18,7,38,26,64,KenMac_T,"-37.79453803, 144.93036194"
761520241122,76,2024-11-22,15,45,60,105,KenMac_T,"-37.79453803, 144.93036194"
582220250528,58,2025-05-28,22,115,135,250,Bou688_T,"-37.81686075, 144.95358075"
91620250720,9,2025-07-20,16,62,67,129,Col700_T,"-37.81982992, 144.95102555"
91920250817,9,2025-08-17,19,59,58,117,Col700_T,"-37.81982992, 144.95102555"
30020240914,30,2024-09-14,0,228,251,479,Lon189_T,"-37.8112185, 144.96656806"
791020250711,79,2025-07-11,10,383,285,668,FliSS_T,"-37.81794046, 144.96616678"
301520231027,30,2023-10-27,15,243,410,653,Lon189_T,"-37.8112185, 144.96656806"
23720241026,23,2024-10-26,7,22,30,52,Col623_T,"-37.81909256, 144.95452748"
511920240914,51,2024-09-14,19,96,65,161,Fra118_T,"-37.80841815, 144.95906316"
48620231122,48,2023-11-22,6,26,19,45,QVMQ_T,"-37.80631581, 144.95866697"
25420240219,25,2024-02-19,4,4,9,13,MCEC_T,"-37.82401776, 144.95604426"
461820250720,46,2025-07-20,18,1,1,2,Pel147_T,"-37.80240719, 144.9615673"
139220240218,139,2024-02-18,2,7,2,9,Signal1647_T,"-37.81959923, 144.9632832"
136220250308,136,2025-03-08,2,3,1,4,BirFed1120_T,"-37.8184141, 144.97357915"
136920250325,136,2025-03-25,9,62,76,138,BirFed1120_T,"-37.8184141, 144.97357915"
142120240626,142,2024-06-26,1,9,4,13,Hammer1584_T,"-37.81970749, 144.96795734"
1421920241029,142,2024-10-29,19,550,291,841,Hammer1584_T,"-37.81970749, 144.96795734"
164120250519,164,2025-05-19,1,10,10,20,Lat526_T,"-37.813005, 144.95160411"
1641720250818,164,2025-08-18,17,160,143,303,Lat526_T,"-37.813005, 144.95160411"
1231820250328,123,2025-03-28,18,42,26,68,BirBridge_T,"-37.81753741, 144.97329734"
1411220250228,141,2025-02-28,12,172,179,351,474Fl_T,"-37.81997273, 144.95834911"
66320250717,66,2025-07-17,3,4,4,8,QVN_T,"-37.81057846, 144.96444294"
6620241018,6,2024-10-18,6,164,275,439,FliS_T,"-37.81911705, 144.96558255"
84220250105,84,2025-01-05,2,76,94,170,ElFi_T,"-37.81798049, 144.96503383"
371720240229,37,2024-02-29,17,136,154,290,Lyg260_T,"-37.80107122, 144.96704554"
371020240524,37,2024-05-24,10,55,65,120,Lyg260_T,"-37.80107122, 144.96704554"
87920240220,87,2024-02-20,9,65,65,130,Errol23_T,"-37.80454949, 144.94921863"
43220250819,43,2025-08-19,2,1,2,3,UM2_T,"-37.79844526, 144.96411782"
45020251001,45,2025-10-01,0,25,56,81,Swa148_T,"-37.81414075, 144.96609379"
452320241006,45,2024-10-06,23,36,179,215,Swa148_T,"-37.81414075, 144.96609379"
134820231025,134,2023-10-25,8,328,438,766,Spen201_T,"-37.81694221, 144.95303935"
1352120250825,135,2025-08-25,21,118,142,260,Spen161_T,"-37.8172861, 144.95319102"
681420250407,68,2025-04-07,14,365,348,713,FLDegN_T,"-37.8168479, 144.96559789"
181520231121,18,2023-11-21,15,313,151,464,Col12_T,"-37.81344862, 144.97305353"
18720250809,18,2025-08-09,7,4,10,14,Col12_T,"-37.81344862, 144.97305353"
631920231105,63,2023-11-05,19,179,265,444,Bou231_T,"-37.81333081, 144.96675571"
11620250224,11,2025-02-24,6,33,18,51,WatCit_T,"-37.81564989, 144.93970694"
671420250813,67,2025-08-13,14,481,569,1050,FLDegS_T,"-37.81688755, 144.96562569"
56920240115,56,2024-01-15,9,212,129,341,Lon364_T,"-37.81234775, 144.96153311"
562020240409,56,2024-04-09,20,198,285,483,Lon364_T,"-37.81234775, 144.96153311"
241320240328,24,2024-03-28,13,817,842,1659,Col620_T,"-37.81887963, 144.95449198"
76220250609,76,2025-06-09,2,1,0,1,KenMac_T,"-37.79453803, 144.93036194"
352220250330,35,2025-03-30,22,246,424,670,SouthB_T,"-37.82018685, 144.96508508"
351820240526,35,2024-05-26,18,881,1220,2101,SouthB_T,"-37.82018685, 144.96508508"
351820241009,35,2024-10-09,18,1603,1343,2946,SouthB_T,"-37.82018685, 144.96508508"
351420250902,35,2025-09-02,14,740,742,1482,SouthB_T,"-37.82018685, 144.96508508"
271620250711,27,2025-07-11,16,104,84,188,Vic_T,"-37.80606888, 144.95644692"
79020250303,79,2025-03-03,0,38,34,72,FliSS_T,"-37.81794046, 144.96616678"
531120250104,53,2025-01-04,11,611,368,979,Col254_T,"-37.81564191, 144.965499"
531420250115,53,2025-01-15,14,776,657,1433,Col254_T,"-37.81564191, 144.965499"
301320240926,30,2024-09-26,13,362,509,871,Lon189_T,"-37.8112185, 144.96656806"
461420241209,46,2024-12-09,14,58,61,119,Pel147_T,"-37.80240719, 144.9615673"
512320240910,51,2024-09-10,23,22,12,34,Fra118_T,"-37.80841815, 144.95906316"
49220240617,49,2024-06-17,2,24,35,59,Eli501_T,"-37.80730068, 144.95956055"
481520250516,48,2025-05-16,15,434,309,743,QVMQ_T,"-37.80631581, 144.95866697"
481220240922,48,2024-09-22,12,664,443,1107,QVMQ_T,"-37.80631581, 144.95866697"
52420250617,52,2025-06-17,4,3,1,4,Eli263_T,"-37.81252157, 144.9619401"
1391120240303,139,2024-03-03,11,59,82,141,Signal1647_T,"-37.81959923, 144.9632832"
1361020240404,136,2024-04-04,10,44,34,78,BirFed1120_T,"-37.8184141, 144.97357915"
1362120250510,136,2025-05-10,21,14,3,17,BirFed1120_T,"-37.8184141, 144.97357915"
1421320240414,142,2024-04-14,13,663,368,1031,Hammer1584_T,"-37.81970749, 144.96795734"
1421520240417,142,2024-04-17,15,301,203,504,Hammer1584_T,"-37.81970749, 144.96795734"
1421120240624,142,2024-06-24,11,262,213,475,Hammer1584_T,"-37.81970749, 144.96795734"
1421820250823,142,2025-08-23,18,126,151,277,Hammer1584_T,"-37.81970749, 144.96795734"
1381220250814,138,2025-08-14,12,14,14,28,EntPark1671_T,"-37.81996544, 144.95981454"
662020250513,66,2025-05-13,20,1011,834,1845,QVN_T,"-37.81057846, 144.96444294"
691120250417,69,2025-04-17,11,407,312,719,FLDegC_T,"-37.81687226, 144.96559144"
6020231218,6,2023-12-18,0,193,83,276,FliS_T,"-37.81911705, 144.96558255"
841920241019,84,2024-10-19,19,935,1059,1994,ElFi_T,"-37.81798049, 144.96503383"
841220250714,84,2025-07-14,12,1043,1207,2250,ElFi_T,"-37.81798049, 144.96503383"
4520231123,4,2023-11-23,5,37,22,59,Swa123_T,"-37.81487988, 144.9660878"
702220240420,70,2024-04-20,22,109,87,196,Errol20_T,"-37.80456984, 144.94946228"
392020240517,39,2024-05-17,20,21,54,75,AlfPl_T,"-37.81379749, 144.96995745"
39920250131,39,2025-01-31,9,80,84,164,AlfPl_T,"-37.81379749, 144.96995745"
78120241231,78,2024-12-31,1,1,9,10,HarEsB_T,"-37.81471642, 144.9446508"
29520240815,29,2024-08-15,5,10,27,37,AG_T,"-37.8199817, 144.96872865"
711220250127,71,2025-01-27,12,6,5,11,WestWP_T,"-37.81235775, 144.97136962"
31820240218,31,2024-02-18,8,43,32,75,Lyg161_T,"-37.80169681, 144.96658911"
28820250722,28,2025-07-22,8,505,281,786,VAC_T,"-37.82129925, 144.96879309"
541620240103,54,2024-01-03,16,160,240,400,Swa607_T,"-37.804024, 144.96308399"
47620250106,47,2025-01-06,6,28,98,126,Eli250_T,"-37.81258467, 144.9625775"
471220250201,47,2025-02-01,12,704,861,1565,Eli250_T,"-37.81258467, 144.9625775"
31220250502,31,2025-05-02,2,10,8,18,Lyg161_T,"-37.80169681, 144.96658911"
361820241103,36,2024-11-03,18,103,64,167,Que85_T,"-37.81652527, 144.96121062"
872120240129,87,2024-01-29,21,40,44,84,Errol23_T,"-37.80454949, 144.94921863"
501620251008,50,2025-10-08,16,162,152,314,Lyg309_T,"-37.79808192, 144.96721013"
212320250805,21,2025-08-05,23,57,82,139,Bourke155_T,"-37.81267313, 144.96788288"
1621520250906,162,2025-09-06,15,428,858,1286,Eli489_T,"-37.80740397, 144.95987909"
1671120250410,167,2025-04-10,11,42,74,116,Lat526_T,"-37.81304149, 144.95155955"
182420250930,182,2025-09-30,4,10,20,30,King163_T,"-37.81627451, 144.95550503"
132820240724,132,2024-07-24,8,210,123,333,King335_T,"-37.81267639, 144.95386444"
1321720240919,132,2024-09-19,17,225,165,390,King335_T,"-37.81267639, 144.95386444"
1341720250518,134,2025-05-18,17,467,334,801,Spen201_T,"-37.81694221, 144.95303935"
1342120231216,134,2023-12-16,21,210,246,456,Spen201_T,"-37.81694221, 144.95303935"
135120241024,135,2024-10-24,1,21,23,44,Spen161_T,"-37.8172861, 144.95319102"
107220250113,107,2025-01-13,2,2,3,5,280Will_T,"-37.81246271, 144.95690188"
1241220250202,124,2025-02-02,12,1,0,1,BirBridge_T,"-37.81757416, 144.97329934"
1241320250626,124,2025-06-26,13,10,11,21,BirBridge_T,"-37.81757416, 144.97329934"
1182120240114,118,2024-01-14,21,17,7,24,Fli114C_T,"-37.81632783, 144.97090512"
1661120250816,166,2025-08-16,11,63,57,120,Spen484_T,"-37.80896733, 144.94931703"
179620250321,179,2025-03-21,6,11,9,20,Pow61_T,"-37.82392385, 144.96299677"
181520240422,18,2024-04-22,15,274,127,401,Col12_T,"-37.81344862, 144.97305353"
631320240617,63,2024-06-17,13,420,520,940,Bou231_T,"-37.81333081, 144.96675571"
622320240911,62,2024-09-11,23,65,44,109,Lat224_T,"-37.80996494, 144.96216521"
101720250820,10,2025-08-20,17,226,78,304,BouHbr_T,"-37.81876474, 144.94710545"
35320240322,35,2024-03-22,3,12,36,48,SouthB_T,"-37.82018685, 144.96508508"
2720250627,2,2025-06-27,7,27,61,88,Bou283_T,"-37.81380668, 144.96516718"
51320240620,51,2024-06-20,3,5,1,6,Fra118_T,"-37.80841815, 144.95906316"
231520250127,23,2025-01-27,15,44,91,135,Col623_T,"-37.81909256, 144.95452748"
481920250731,48,2025-07-31,19,111,130,241,QVMQ_T,"-37.80631581, 144.95866697"
48720240330,48,2024-03-30,7,49,51,100,QVMQ_T,"-37.80631581, 144.95866697"
48420240405,48,2024-04-05,4,10,5,15,QVMQ_T,"-37.80631581, 144.95866697"
252320240501,25,2024-05-01,23,156,47,203,MCEC_T,"-37.82401776, 144.95604426"
141020240509,141,2024-05-09,0,15,15,30,474Fl_T,"-37.81997273, 144.95834911"
1641420240907,164,2024-09-07,14,101,87,188,Lat526_T,"-37.813005, 144.95160411"
1611320250104,161,2025-01-04,13,27,39,66,BirArt1109_T,"-37.81851276, 144.97131336"
491920250325,49,2025-03-25,19,259,187,446,Eli501_T,"-37.80730068, 144.95956055"
49120250409,49,2025-04-09,1,48,51,99,Eli501_T,"-37.80730068, 144.95956055"
492120240107,49,2024-01-07,21,110,73,183,Eli501_T,"-37.80730068, 144.95956055"
1220240118,1,2024-01-18,2,8,11,19,Bou292_T,"-37.81349441, 144.96515323"
1820240228,1,2024-02-28,8,225,219,444,Bou292_T,"-37.81349441, 144.96515323"
63320240627,63,2024-06-27,3,6,46,52,Bou231_T,"-37.81333081, 144.96675571"
181020231027,18,2023-10-27,10,162,219,381,Col12_T,"-37.81344862, 144.97305353"
562320240416,56,2024-04-16,23,47,59,106,Lon364_T,"-37.81234775, 144.96153311"
56220241030,56,2024-10-30,2,11,5,16,Lon364_T,"-37.81234775, 144.96153311"
241120241124,24,2024-11-24,11,620,496,1116,Col620_T,"-37.81887963, 144.95449198"
76920240328,76,2024-03-28,9,64,66,130,KenMac_T,"-37.79453803, 144.93036194"
761920250521,76,2025-05-21,19,18,26,44,KenMac_T,"-37.79453803, 144.93036194"
351120250809,35,2025-08-09,11,1064,931,1995,SouthB_T,"-37.82018685, 144.96508508"
22320240613,2,2024-06-13,23,5,30,35,Bou283_T,"-37.81380668, 144.96516718"
581320250327,58,2025-03-27,13,877,548,1425,Bou688_T,"-37.81686075, 144.95358075"
841720250814,84,2025-08-14,17,1240,2136,3376,ElFi_T,"-37.81798049, 144.96503383"
42120231113,4,2023-11-13,21,519,345,864,Swa123_T,"-37.81487988, 144.9660878"
42020241120,4,2024-11-20,20,802,531,1333,Swa123_T,"-37.81487988, 144.9660878"
78520250205,78,2025-02-05,5,1,0,1,HarEsB_T,"-37.81471642, 144.9446508"
291220240309,29,2024-03-09,12,693,682,1375,AG_T,"-37.8199817, 144.96872865"
141620240410,14,2024-04-10,16,696,164,860,SanBri_T,"-37.82011242, 144.96291897"
31020250309,31,2025-03-09,0,91,186,277,Lyg161_T,"-37.80169681, 144.96658911"
541520240808,54,2024-08-08,15,235,323,558,Swa607_T,"-37.804024, 144.96308399"
471020251011,47,2025-10-11,10,632,780,1412,Eli250_T,"-37.81258467, 144.9625775"
472220250730,47,2025-07-30,22,185,185,370,Eli250_T,"-37.81258467, 144.9625775"
5720250807,5,2025-08-07,7,262,479,741,PriNW_T,"-37.81874249, 144.96787656"
361020231115,36,2023-11-15,10,179,168,347,Que85_T,"-37.81652527, 144.96121062"
50820250428,50,2025-04-28,8,32,79,111,Lyg309_T,"-37.79808192, 144.96721013"
502220240711,50,2024-07-11,22,62,30,92,Lyg309_T,"-37.79808192, 144.96721013"
43420240520,43,2024-05-20,4,1,0,1,UM2_T,"-37.79844526, 144.96411782"
134220240505,134,2024-05-05,2,45,37,82,Spen201_T,"-37.81694221, 144.95303935"
1311720250112,131,2025-01-12,17,204,91,295,King2_T,"-37.82009057, 144.95758725"
1312120250502,131,2025-05-02,21,111,79,190,King2_T,"-37.82009057, 144.95758725"
107820250120,107,2025-01-20,8,59,229,288,280Will_T,"-37.81246271, 144.95690188"
107020250526,107,2025-05-26,0,16,11,27,280Will_T,"-37.81246271, 144.95690188"
133620240221,133,2024-02-21,6,357,255,612,Spen229_T,"-37.81531435, 144.95227769"
871520250301,87,2025-03-01,15,123,98,221,Errol23_T,"-37.80454949, 144.94921863"
87120250410,87,2025-04-10,1,3,1,4,Errol23_T,"-37.80454949, 144.94921863"
1841620250823,184,2025-08-23,16,1232,1457,2689,Eli124_T,"-37.81512416, 144.96371988"
1671120250914,167,2025-09-14,11,33,70,103,Lat526_T,"-37.81304149, 144.95155955"
165420240904,165,2024-09-04,4,1,0,1,Spen475_T,"-37.80953359, 144.94939004"
241820240728,24,2024-07-28,18,337,455,792,Col620_T,"-37.81887963, 144.95449198"
111520250219,11,2025-02-19,15,48,49,97,WatCit_T,"-37.81564989, 144.93970694"
721920231124,72,2023-11-24,19,354,594,948,ACMI_T,"-37.81726338, 144.96872809"
76920240307,76,2024-03-07,9,77,62,139,KenMac_T,"-37.79453803, 144.93036194"
721920250816,72,2025-08-16,19,81,352,433,ACMI_T,"-37.81726338, 144.96872809"
721620250719,72,2025-07-19,16,322,644,966,ACMI_T,"-37.81726338, 144.96872809"
72320240409,72,2024-04-09,3,1,2,3,ACMI_T,"-37.81726338, 144.96872809"
91420240914,9,2024-09-14,14,65,71,136,Col700_T,"-37.81982992, 144.95102555"
53720240830,53,2024-08-30,7,101,90,191,Col254_T,"-37.81564191, 144.965499"
531220231024,53,2023-10-24,12,839,705,1544,Col254_T,"-37.81564191, 144.965499"
301920250315,30,2025-03-15,19,503,537,1040,Lon189_T,"-37.8112185, 144.96656806"
51720240801,51,2024-08-01,7,24,26,50,Fra118_T,"-37.80841815, 144.95906316"
201720250313,20,2025-03-13,17,342,243,585,LtB170_T,"-37.81172914, 144.9682466"
20820250521,20,2025-05-21,8,70,66,136,LtB170_T,"-37.81172914, 144.9682466"
252020250807,25,2025-08-07,20,165,154,319,MCEC_T,"-37.82401776, 144.95604426"
202120240724,20,2024-07-24,21,120,360,480,LtB170_T,"-37.81172914, 144.9682466"
461020241116,46,2024-11-16,10,32,41,73,Pel147_T,"-37.80240719, 144.9615673"
461820250810,46,2025-08-10,18,6,7,13,Pel147_T,"-37.80240719, 144.9615673"
46620240130,46,2024-01-30,6,10,37,47,Pel147_T,"-37.80240719, 144.9615673"
141820240928,141,2024-09-28,8,109,75,184,474Fl_T,"-37.81997273, 144.95834911"
1642320240923,164,2024-09-23,23,13,30,43,Lat526_T,"-37.813005, 144.95160411"
1611020250129,161,2025-01-29,10,43,56,99,BirArt1109_T,"-37.81851276, 144.97131336"
161720250312,161,2025-03-12,7,92,193,285,BirArt1109_T,"-37.81851276, 144.97131336"
491820240722,49,2024-07-22,18,251,202,453,Eli501_T,"-37.80730068, 144.95956055"
49120241120,49,2024-11-20,1,39,43,82,Eli501_T,"-37.80730068, 144.95956055"
117820240122,117,2024-01-22,8,351,111,462,Fli114F_T,"-37.81629332, 144.97090877"
491220240504,49,2024-05-04,12,509,732,1241,Eli501_T,"-37.80730068, 144.95956055"
109420240815,109,2024-08-15,4,4,6,10,LatWill_T,"-37.81193681, 144.95621105"
19120241027,19,2024-10-27,1,122,166,288,LtB210_T,"-37.81237202, 144.96550671"
842120240317,84,2024-03-17,21,522,660,1182,ElFi_T,"-37.81798049, 144.96503383"
84320250301,84,2025-03-01,3,45,64,109,ElFi_T,"-37.81798049, 144.96503383"
841920250705,84,2025-07-05,19,729,940,1669,ElFi_T,"-37.81798049, 144.96503383"
75720250826,75,2025-08-26,7,32,29,61,SprFli_T,"-37.81515276, 144.97467661"
8920250511,8,2025-05-11,9,84,179,263,WebBN_T,"-37.82293543, 144.9471751"
8720240809,8,2024-08-09,7,99,73,172,WebBN_T,"-37.82293543, 144.9471751"
78720240510,78,2024-05-10,7,9,8,17,HarEsB_T,"-37.81471642, 144.9446508"
79420231123,79,2023-11-23,4,17,15,32,FliSS_T,"-37.81794046, 144.96616678"
531820240530,53,2024-05-30,18,311,183,494,Col254_T,"-37.81564191, 144.965499"
461020231018,46,2023-10-18,10,94,181,275,Pel147_T,"-37.80240719, 144.9615673"
192320250707,19,2025-07-07,23,100,214,314,LtB210_T,"-37.81237202, 144.96550671"
48920231205,48,2023-12-05,9,150,144,294,QVMQ_T,"-37.80631581, 144.95866697"
482020240203,48,2024-02-03,20,127,139,266,QVMQ_T,"-37.80631581, 144.95866697"
41920250915,41,2025-09-15,9,1439,717,2156,Swa31,"-37.81668634, 144.96689733"
29520250123,29,2025-01-23,5,9,29,38,AG_T,"-37.8199817, 144.96872865"
711720250820,71,2025-08-20,17,26,26,52,WestWP_T,"-37.81235775, 144.97136962"
311220231019,31,2023-10-19,12,189,177,366,Lyg161_T,"-37.80169681, 144.96658911"
54420240805,54,2024-08-05,4,1,3,4,Swa607_T,"-37.804024, 144.96308399"
401120241224,40,2024-12-24,11,79,166,245,Spr201_T,"-37.80999341, 144.97227587"
21420250516,21,2025-05-16,4,5,4,9,Bourke155_T,"-37.81267313, 144.96788288"
87920240506,87,2024-05-06,9,54,75,129,Errol23_T,"-37.80454949, 144.94921863"
61520250824,61,2025-08-24,5,6,17,23,RMIT14_T,"-37.80767455, 144.96309114"
611120240721,61,2024-07-21,11,200,266,466,RMIT14_T,"-37.80767455, 144.96309114"
502020241124,50,2024-11-24,20,210,156,366,Lyg309_T,"-37.79808192, 144.96721013"
182720250911,182,2025-09-11,7,35,50,85,King163_T,"-37.81627451, 144.95550503"
167220250505,167,2025-05-05,2,1,3,4,Lat526_T,"-37.81304149, 144.95155955"
162220250917,162,2025-09-17,2,18,11,29,Eli489_T,"-37.80740397, 144.95987909"
1431120250924,143,2025-09-24,11,99,198,297,Spencer_T,"-37.821728, 144.95557015"
67920241025,67,2024-10-25,9,409,322,731,FLDegS_T,"-37.81688755, 144.96562569"
85920250606,85,2025-06-06,9,81,73,154,488Mac_T,"-37.79432415, 144.92973378"
681520231109,68,2023-11-09,15,183,146,329,FLDegN_T,"-37.8168479, 144.96559789"
631520250810,63,2025-08-10,15,472,530,1002,Bou231_T,"-37.81333081, 144.96675571"
12620250120,12,2025-01-20,6,59,39,98,NewQ_T,"-37.81457988, 144.94292398"
11920250712,1,2025-07-12,19,1032,582,1614,Bou292_T,"-37.81349441, 144.96515323"
62020250406,62,2025-04-06,0,90,44,134,Lat224_T,"-37.80996494, 144.96216521"
162520250808,162,2025-08-08,5,15,3,18,Eli489_T,"-37.80740397, 144.95987909"
1621020241014,162,2024-10-14,10,289,271,560,Eli489_T,"-37.80740397, 144.95987909"
1432220250515,143,2025-05-15,22,130,94,224,Spencer_T,"-37.821728, 144.95557015"
1431520240603,143,2024-06-03,15,243,278,521,Spencer_T,"-37.821728, 144.95557015"
1351120240505,135,2024-05-05,11,469,505,974,Spen161_T,"-37.8172861, 144.95319102"
681420240317,68,2024-03-17,14,224,166,390,FLDegN_T,"-37.8168479, 144.96559789"
85920241007,85,2024-10-07,9,78,51,129,488Mac_T,"-37.79432415, 144.92973378"
11820231117,1,2023-11-17,18,1608,1182,2790,Bou292_T,"-37.81349441, 144.96515323"
631920250114,63,2025-01-14,19,256,326,582,Bou231_T,"-37.81333081, 144.96675571"
63320241015,63,2024-10-15,3,0,5,5,Bou231_T,"-37.81333081, 144.96675571"
58620231105,58,2023-11-05,6,36,45,81,Bou688_T,"-37.81686075, 144.95358075"
35220250208,35,2025-02-08,2,49,72,121,SouthB_T,"-37.82018685, 144.96508508"
35920231021,35,2023-10-21,9,651,492,1143,SouthB_T,"-37.82018685, 144.96508508"
21620240808,2,2024-08-08,16,497,528,1025,Bou283_T,"-37.81380668, 144.96516718"
22220231030,2,2023-10-30,22,19,55,74,Bou283_T,"-37.81380668, 144.96516718"
79820241121,79,2024-11-21,8,775,350,1125,FliSS_T,"-37.81794046, 144.96616678"
53620250806,53,2025-08-06,6,29,39,68,Col254_T,"-37.81564191, 144.965499"
23920250327,23,2025-03-27,9,569,418,987,Col623_T,"-37.81909256, 144.95452748"
232020240728,23,2024-07-28,20,41,126,167,Col623_T,"-37.81909256, 144.95452748"
30920250825,30,2025-08-25,9,84,111,195,Lon189_T,"-37.8112185, 144.96656806"
461220240228,46,2024-02-28,12,245,200,445,Pel147_T,"-37.80240719, 144.9615673"
141520240509,141,2024-05-09,5,18,9,27,474Fl_T,"-37.81997273, 144.95834911"
1362220240826,136,2024-08-26,22,1,0,1,BirFed1120_T,"-37.8184141, 144.97357915"
1612220250828,161,2025-08-28,22,3,37,40,BirArt1109_T,"-37.81851276, 144.97131336"
1172220241009,117,2024-10-09,22,136,245,381,Fli114F_T,"-37.81629332, 144.97090877"
69920240626,69,2024-06-26,9,239,91,330,FLDegC_T,"-37.81687226, 144.96559144"
841820231028,84,2023-10-28,18,849,1058,1907,ElFi_T,"-37.81798049, 144.96503383"
75920250129,75,2025-01-29,9,39,32,71,SprFli_T,"-37.81515276, 144.97467661"
75920250610,75,2025-06-10,9,27,41,68,SprFli_T,"-37.81515276, 144.97467661"
391520241217,39,2024-12-17,15,113,115,228,AlfPl_T,"-37.81379749, 144.96995745"
81920231031,8,2023-10-31,19,77,101,178,WebBN_T,"-37.82293543, 144.9471751"
78920240522,78,2024-05-22,9,60,36,96,HarEsB_T,"-37.81471642, 144.9446508"
59120250510,59,2025-05-10,1,67,44,111,RMIT_T,"-37.80825648, 144.96304859"
711320240827,71,2024-08-27,13,17,23,40,WestWP_T,"-37.81235775, 144.97136962"
711720250807,71,2025-08-07,17,29,20,49,WestWP_T,"-37.81235775, 144.97136962"
59820240815,59,2024-08-15,8,1171,274,1445,RMIT_T,"-37.80825648, 144.96304859"
541720240419,54,2024-04-19,17,170,510,680,Swa607_T,"-37.804024, 144.96308399"
54220250325,54,2025-03-25,2,12,2,14,Swa607_T,"-37.804024, 144.96308399"
281120240202,28,2024-02-02,11,622,394,1016,VAC_T,"-37.82129925, 144.96879309"
29420241229,29,2024-12-29,4,1,19,20,AG_T,"-37.8199817, 144.96872865"
401020231208,40,2023-12-08,10,133,177,310,Spr201_T,"-37.80999341, 144.97227587"
541020240618,54,2024-06-18,10,75,49,124,Swa607_T,"-37.804024, 144.96308399"
361220241204,36,2024-12-04,12,452,338,790,Que85_T,"-37.81652527, 144.96121062"
371720240527,37,2024-05-27,17,59,76,135,Lyg260_T,"-37.80107122, 144.96704554"
212320250904,21,2025-09-04,23,126,105,231,Bourke155_T,"-37.81267313, 144.96788288"
21220240215,21,2024-02-15,2,32,21,53,Bourke155_T,"-37.81267313, 144.96788288"
18520240307,18,2024-03-07,5,1,9,10,Col12_T,"-37.81344862, 144.97305353"
63320250317,63,2025-03-17,3,3,3,6,Bou231_T,"-37.81333081, 144.96675571"
621620240122,62,2024-01-22,16,211,191,402,Lat224_T,"-37.80996494, 144.96216521"
56720240724,56,2024-07-24,7,53,61,114,Lon364_T,"-37.81234775, 144.96153311"
86320250202,86,2025-02-02,3,1,0,1,574Qub_T,"-37.80309992, 144.94908064"
86620250530,86,2025-05-30,6,8,4,12,574Qub_T,"-37.80309992, 144.94908064"
111320241027,11,2024-10-27,13,157,129,286,WatCit_T,"-37.81564989, 144.93970694"
101520240903,10,2024-09-03,15,92,40,132,BouHbr_T,"-37.81876474, 144.94710545"
72520241208,72,2024-12-08,5,6,3,9,ACMI_T,"-37.81726338, 144.96872809"
76820250315,76,2025-03-15,8,37,26,63,KenMac_T,"-37.79453803, 144.93036194"
351920240303,35,2024-03-03,19,879,1210,2089,SouthB_T,"-37.82018685, 144.96508508"
22320240125,2,2024-01-25,23,52,126,178,Bou283_T,"-37.81380668, 144.96516718"
79320250113,79,2025-01-13,3,22,20,42,FliSS_T,"-37.81794046, 144.96616678"
30120240415,30,2024-04-15,1,85,76,161,Lon189_T,"-37.8112185, 144.96656806"
79820240225,79,2024-02-25,8,118,90,208,FliSS_T,"-37.81794046, 144.96616678"
53920241118,53,2024-11-18,9,459,276,735,Col254_T,"-37.81564191, 144.965499"
522020241123,52,2024-11-23,20,380,275,655,Eli263_T,"-37.81252157, 144.9619401"
49820240408,49,2024-04-08,8,111,151,262,Eli501_T,"-37.80730068, 144.95956055"
481620240923,48,2024-09-23,16,105,126,231,QVMQ_T,"-37.80631581, 144.95866697"
202220241225,20,2024-12-25,22,135,197,332,LtB170_T,"-37.81172914, 144.9682466"
1361020241120,136,2024-11-20,10,89,47,136,BirFed1120_T,"-37.8184141, 144.97357915"
136120250111,136,2025-01-11,1,1,1,2,BirFed1120_T,"-37.8184141, 144.97357915"
1362320250320,136,2025-03-20,23,4,111,115,BirFed1120_T,"-37.8184141, 144.97357915"
1421120250520,142,2025-05-20,11,227,227,454,Hammer1584_T,"-37.81970749, 144.96795734"
1421220241002,142,2024-10-02,12,669,481,1150,Hammer1584_T,"-37.81970749, 144.96795734"
1421820250123,142,2025-01-23,18,805,491,1296,Hammer1584_T,"-37.81970749, 144.96795734"
164120241225,164,2024-12-25,1,9,7,16,Lat526_T,"-37.813005, 144.95160411"
1092020250825,109,2025-08-25,20,73,85,158,LatWill_T,"-37.81193681, 144.95621105"
691620240817,69,2024-08-17,16,205,175,380,FLDegC_T,"-37.81687226, 144.96559144"
691620250825,69,2025-08-25,16,100,132,232,FLDegC_T,"-37.81687226, 144.96559144"
61820231213,6,2023-12-13,18,1333,1138,2471,FliS_T,"-37.81911705, 144.96558255"
841520240918,84,2024-09-18,15,920,1329,2249,ElFi_T,"-37.81798049, 144.96503383"
84320251016,84,2025-10-16,3,18,21,39,ElFi_T,"-37.81798049, 144.96503383"
42320240119,4,2024-01-19,23,729,446,1175,Swa123_T,"-37.81487988, 144.9660878"
752020250103,75,2025-01-03,20,21,32,53,SprFli_T,"-37.81515276, 144.97467661"
781820240507,78,2024-05-07,18,6,21,27,HarEsB_T,"-37.81471642, 144.9446508"
78720241017,78,2024-10-17,7,35,40,75,HarEsB_T,"-37.81471642, 144.9446508"
711320250801,71,2025-08-01,13,22,27,49,WestWP_T,"-37.81235775, 144.97136962"
711820240610,71,2024-06-10,18,5,8,13,WestWP_T,"-37.81235775, 144.97136962"
71920241225,71,2024-12-25,9,4,1,5,WestWP_T,"-37.81235775, 144.97136962"
542020240415,54,2024-04-15,20,110,216,326,Swa607_T,"-37.804024, 144.96308399"
37820250526,37,2025-05-26,8,24,41,65,Lyg260_T,"-37.80107122, 144.96704554"
371120250920,37,2025-09-20,11,78,77,155,Lyg260_T,"-37.80107122, 144.96704554"
471120250117,47,2025-01-17,11,636,803,1439,Eli250_T,"-37.81258467, 144.9625775"
51620250530,5,2025-05-30,16,855,738,1593,PriNW_T,"-37.81874249, 144.96787656"
51820240225,5,2024-02-25,18,898,829,1727,PriNW_T,"-37.81874249, 144.96787656"
36520240201,36,2024-02-01,5,15,9,24,Que85_T,"-37.81652527, 144.96121062"
1081620240606,108,2024-06-06,16,345,194,539,261Will_T,"-37.81295822, 144.95678789"
87620240921,87,2024-09-21,6,4,3,7,Errol23_T,"-37.80454949, 144.94921863"
612020240624,61,2024-06-24,20,177,209,386,RMIT14_T,"-37.80767455, 144.96309114"
502020250806,50,2025-08-06,20,148,108,256,Lyg309_T,"-37.79808192, 144.96721013"
441820240117,44,2024-01-17,18,21,11,32,UM3_T,"-37.79698741, 144.96441306"
1821520250520,182,2025-05-20,15,245,231,476,King163_T,"-37.81627451, 144.95550503"
1792120250424,179,2025-04-24,21,70,62,132,Pow61_T,"-37.82392385, 144.96299677"
132720250920,132,2025-09-20,7,45,19,64,King335_T,"-37.81267639, 144.95386444"
108920231219,108,2023-12-19,9,174,646,820,261Will_T,"-37.81295822, 144.95678789"
107920240425,107,2024-04-25,9,26,55,81,280Will_T,"-37.81246271, 144.95690188"
872220250228,87,2025-02-28,22,19,29,48,Errol23_T,"-37.80454949, 144.94921863"
612020231018,61,2023-10-18,20,294,319,613,RMIT14_T,"-37.80767455, 144.96309114"
501720250518,50,2025-05-18,17,179,184,363,Lyg309_T,"-37.79808192, 144.96721013"
1821820250416,182,2025-04-16,18,390,268,658,King163_T,"-37.81627451, 144.95550503"
1851020250827,185,2025-08-27,10,272,320,592,Eli197_T,"-37.81374643, 144.96276183"
1671320250317,167,2025-03-17,13,25,51,76,Lat526_T,"-37.81304149, 144.95155955"
1671320250211,167,2025-02-11,13,8,13,21,Lat526_T,"-37.81304149, 144.95155955"
131220231207,131,2023-12-07,2,8,19,27,King2_T,"-37.82009057, 144.95758725"
1621320250326,162,2025-03-26,13,515,569,1084,Eli489_T,"-37.80740397, 144.95987909"
162820240705,162,2024-07-05,8,228,178,406,Eli489_T,"-37.80740397, 144.95987909"
1321320240326,132,2024-03-26,13,206,172,378,King335_T,"-37.81267639, 144.95386444"
1352120241118,135,2024-11-18,21,153,206,359,Spen161_T,"-37.8172861, 144.95319102"
172120250117,17,2025-01-17,21,106,122,228,Col15_T,"-37.81362543, 144.97323591"
11720240819,1,2024-08-19,17,1056,760,1816,Bou292_T,"-37.81349441, 144.96515323"
632320240605,63,2024-06-05,23,47,81,128,Bou231_T,"-37.81333081, 144.96675571"
67820240326,67,2024-03-26,8,357,269,626,FLDegS_T,"-37.81688755, 144.96562569"
631020250209,63,2025-02-09,10,213,300,513,Bou231_T,"-37.81333081, 144.96675571"
112020240508,11,2024-05-08,20,62,110,172,WatCit_T,"-37.81564989, 144.93970694"
24920241223,24,2024-12-23,9,688,305,993,Col620_T,"-37.81887963, 144.95449198"
72420240701,72,2024-07-01,4,1,4,5,ACMI_T,"-37.81726338, 144.96872809"
761220241018,76,2024-10-18,12,61,56,117,KenMac_T,"-37.79453803, 144.93036194"
761020250622,76,2025-06-22,10,50,65,115,KenMac_T,"-37.79453803, 144.93036194"
35520250205,35,2025-02-05,5,78,73,151,SouthB_T,"-37.82018685, 144.96508508"
351220240416,35,2024-04-16,12,1254,1127,2381,SouthB_T,"-37.82018685, 144.96508508"
351920250806,35,2025-08-06,19,466,464,930,SouthB_T,"-37.82018685, 144.96508508"
22020240924,2,2024-09-24,20,122,173,295,Bou283_T,"-37.81380668, 144.96516718"
27920250111,27,2025-01-11,9,123,134,257,Vic_T,"-37.80606888, 144.95644692"
272320250105,27,2025-01-05,23,32,13,45,Vic_T,"-37.80606888, 144.95644692"
9120250114,9,2025-01-14,1,3,19,22,Col700_T,"-37.81982992, 144.95102555"
531520240326,53,2024-03-26,15,772,630,1402,Col254_T,"-37.81564191, 144.965499"
511520250717,51,2025-07-17,15,74,94,168,Fra118_T,"-37.80841815, 144.95906316"
461220250510,46,2025-05-10,12,37,64,101,Pel147_T,"-37.80240719, 144.9615673"
461620231024,46,2023-10-24,16,112,107,219,Pel147_T,"-37.80240719, 144.9615673"
252220240717,25,2024-07-17,22,115,68,183,MCEC_T,"-37.82401776, 144.95604426"
482220240515,48,2024-05-15,22,43,60,103,QVMQ_T,"-37.80631581, 144.95866697"
49820250619,49,2025-06-19,8,137,168,305,Eli501_T,"-37.80730068, 144.95956055"
49320250811,49,2025-08-11,3,6,10,16,Eli501_T,"-37.80730068, 144.95956055"
141820240506,141,2024-05-06,8,113,124,237,474Fl_T,"-37.81997273, 144.95834911"
1412320240510,141,2024-05-10,23,100,74,174,474Fl_T,"-37.81997273, 144.95834911"
139820250117,139,2025-01-17,8,26,225,251,Signal1647_T,"-37.81959923, 144.9632832"
142420250221,142,2025-02-21,4,1,1,2,Hammer1584_T,"-37.81970749, 144.96795734"
142620231110,142,2023-11-10,6,153,58,211,Hammer1584_T,"-37.81970749, 144.96795734"
1422020240915,142,2024-09-15,20,84,44,128,Hammer1584_T,"-37.81970749, 144.96795734"
1421320250115,142,2025-01-15,13,822,680,1502,Hammer1584_T,"-37.81970749, 144.96795734"
1612220250307,161,2025-03-07,22,6,162,168,BirArt1109_T,"-37.81851276, 144.97131336"
1612220250410,161,2025-04-10,22,0,2,2,BirArt1109_T,"-37.81851276, 144.97131336"
1611720250717,161,2025-07-17,17,76,617,693,BirArt1109_T,"-37.81851276, 144.97131336"
1611920250903,161,2025-09-03,19,5,10,15,BirArt1109_T,"-37.81851276, 144.97131336"
117320241216,117,2024-12-16,3,6,5,11,Fli114F_T,"-37.81629332, 144.97090877"
1171620250217,117,2025-02-17,16,126,210,336,Fli114F_T,"-37.81629332, 144.97090877"
167420240928,167,2024-09-28,4,0,2,2,Lat526_T,"-37.81304149, 144.95155955"
1401420250907,140,2025-09-07,14,102,102,204,Boyd2837_T,"-37.82590962, 144.96185972"
131920240609,131,2024-06-09,9,22,88,110,King2_T,"-37.82009057, 144.95758725"
1312320240617,131,2024-06-17,23,5,19,24,King2_T,"-37.82009057, 144.95758725"
1352120241105,135,2024-11-05,21,123,124,247,Spen161_T,"-37.8172861, 144.95319102"
1351720250823,135,2025-08-23,17,469,546,1015,Spen161_T,"-37.8172861, 144.95319102"
1181420240524,118,2024-05-24,14,19,16,35,Fli114C_T,"-37.81632783, 144.97090512"
681120231230,68,2023-12-30,11,203,195,398,FLDegN_T,"-37.8168479, 144.96559789"
851720240616,85,2024-06-16,17,40,55,95,488Mac_T,"-37.79432415, 144.92973378"
851720240822,85,2024-08-22,17,77,119,196,488Mac_T,"-37.79432415, 144.92973378"
851620250519,85,2025-05-19,16,70,106,176,488Mac_T,"-37.79432415, 144.92973378"
11120240607,1,2024-06-07,11,706,728,1434,Bou292_T,"-37.81349441, 144.96515323"
18720240930,18,2024-09-30,7,29,314,343,Col12_T,"-37.81344862, 144.97305353"
631120250930,63,2025-09-30,11,344,349,693,Bou231_T,"-37.81333081, 144.96675571"
671620250114,67,2025-01-14,16,406,554,960,FLDegS_T,"-37.81688755, 144.96562569"
561320231219,56,2023-12-19,13,363,332,695,Lon364_T,"-37.81234775, 144.96153311"
561020240703,56,2024-07-03,10,197,136,333,Lon364_T,"-37.81234775, 144.96153311"
561720241211,56,2024-12-11,17,413,393,806,Lon364_T,"-37.81234775, 144.96153311"
861120250818,86,2025-08-18,11,52,49,101,574Qub_T,"-37.80309992, 144.94908064"
111220240607,11,2024-06-07,12,80,78,158,WatCit_T,"-37.81564989, 144.93970694"
121720240611,12,2024-06-11,17,162,200,362,NewQ_T,"-37.81457988, 144.94292398"
1820250811,1,2025-08-11,8,193,207,400,Bou292_T,"-37.81349441, 144.96515323"
101720241125,10,2024-11-25,17,191,68,259,BouHbr_T,"-37.81876474, 144.94710545"
24820241022,24,2024-10-22,8,1914,219,2133,Col620_T,"-37.81887963, 144.95449198"
582020240605,58,2024-06-05,20,188,237,425,Bou688_T,"-37.81686075, 144.95358075"
58120240202,58,2024-02-02,1,23,37,60,Bou688_T,"-37.81686075, 144.95358075"
35720250203,35,2025-02-03,7,421,611,1032,SouthB_T,"-37.82018685, 144.96508508"
35320240421,35,2024-04-21,3,20,67,87,SouthB_T,"-37.82018685, 144.96508508"
271720240523,27,2024-05-23,17,169,102,271,Vic_T,"-37.80606888, 144.95644692"
27520241117,27,2024-11-17,5,17,3,20,Vic_T,"-37.80606888, 144.95644692"
511320250112,51,2025-01-12,13,78,106,184,Fra118_T,"-37.80841815, 144.95906316"
511720250425,51,2025-04-25,17,64,76,140,Fra118_T,"-37.80841815, 144.95906316"
49220241207,49,2024-12-07,2,36,41,77,Eli501_T,"-37.80730068, 144.95956055"
192320240811,19,2024-08-11,23,49,128,177,LtB210_T,"-37.81237202, 144.96550671"
252120250509,25,2025-05-09,21,537,277,814,MCEC_T,"-37.82401776, 144.95604426"
301920250628,30,2025-06-28,19,431,561,992,Lon189_T,"-37.8112185, 144.96656806"
20620250512,20,2025-05-12,6,15,14,29,LtB170_T,"-37.81172914, 144.9682466"
202320240508,20,2024-05-08,23,18,33,51,LtB170_T,"-37.81172914, 144.9682466"
130720250831,130,2025-08-31,7,7,4,11,Bou892T,"-37.8204637, 144.94126826"
1641520241220,164,2024-12-20,15,146,88,234,Lat526_T,"-37.813005, 144.95160411"
117520250725,117,2025-07-25,5,13,9,22,Fli114F_T,"-37.81629332, 144.97090877"
1092020240317,109,2024-03-17,20,67,114,181,LatWill_T,"-37.81193681, 144.95621105"
692220250516,69,2025-05-16,22,48,48,96,FLDegC_T,"-37.81687226, 144.96559144"
691920250901,69,2025-09-01,19,5,1,6,FLDegC_T,"-37.81687226, 144.96559144"
841720241022,84,2024-10-22,17,1234,2247,3481,ElFi_T,"-37.81798049, 144.96503383"
41220250509,4,2025-05-09,12,1850,1430,3280,Swa123_T,"-37.81487988, 144.9660878"
392120250718,39,2025-07-18,21,18,7,25,AlfPl_T,"-37.81379749, 144.96995745"
8520240912,8,2024-09-12,5,17,21,38,WebBN_T,"-37.82293543, 144.9471751"
752020250626,75,2025-06-26,20,11,15,26,SprFli_T,"-37.81515276, 144.97467661"
141020251002,14,2025-10-02,10,255,105,360,SanBri_T,"-37.82011242, 144.96291897"
711020241011,71,2024-10-11,10,33,42,75,WestWP_T,"-37.81235775, 144.97136962"
28020240109,28,2024-01-09,0,25,9,34,VAC_T,"-37.82129925, 144.96879309"
28920250810,28,2025-08-10,9,263,170,433,VAC_T,"-37.82129925, 144.96879309"
291820250214,29,2025-02-14,18,339,423,762,AG_T,"-37.8199817, 144.96872865"
291320250918,29,2025-09-18,13,1,1,2,AG_T,"-37.8199817, 144.96872865"
40620250514,40,2025-05-14,6,36,54,90,Spr201_T,"-37.80999341, 144.97227587"
371220250201,37,2025-02-01,12,73,118,191,Lyg260_T,"-37.80107122, 144.96704554"
37120240310,37,2024-03-10,1,6,10,16,Lyg260_T,"-37.80107122, 144.96704554"
87220240423,87,2024-04-23,2,0,2,2,Errol23_T,"-37.80454949, 144.94921863"
50120240118,50,2024-01-18,1,3,3,6,Lyg309_T,"-37.79808192, 144.96721013"
431220240501,43,2024-05-01,12,276,306,582,UM2_T,"-37.79844526, 144.96411782"
441120250505,44,2025-05-05,11,96,76,172,UM3_T,"-37.79698741, 144.96441306"
1661320241020,166,2024-10-20,13,44,57,101,Spen484_T,"-37.80896733, 144.94931703"
131520250306,131,2025-03-06,5,8,9,17,King2_T,"-37.82009057, 144.95758725"
1321220250306,132,2025-03-06,12,169,148,317,King335_T,"-37.81267639, 144.95386444"
1321920231121,132,2023-11-21,19,132,127,259,King335_T,"-37.81267639, 144.95386444"
133520240623,133,2024-06-23,5,10,23,33,Spen229_T,"-37.81531435, 144.95227769"
671420240728,67,2024-07-28,14,327,539,866,FLDegS_T,"-37.81688755, 144.96562569"
17020250115,17,2025-01-15,0,8,9,17,Col15_T,"-37.81362543, 144.97323591"
68920250508,68,2025-05-08,9,248,226,474,FLDegN_T,"-37.8168479, 144.96559789"
621220250202,62,2025-02-02,12,182,152,334,Lat224_T,"-37.80996494, 144.96216521"
561920250128,56,2025-01-28,19,229,234,463,Lon364_T,"-37.81234775, 144.96153311"
12420250311,12,2025-03-11,4,5,4,9,NewQ_T,"-37.81457988, 144.94292398"
11420250717,11,2025-07-17,4,4,2,6,WatCit_T,"-37.81564989, 144.93970694"
121920240415,12,2024-04-15,19,180,182,362,NewQ_T,"-37.81457988, 144.94292398"
241020240516,24,2024-05-16,10,747,368,1115,Col620_T,"-37.81887963, 144.95449198"
722220240828,72,2024-08-28,22,28,146,174,ACMI_T,"-37.81726338, 144.96872809"
761920250903,76,2025-09-03,19,18,25,43,KenMac_T,"-37.79453803, 144.93036194"
351220240507,35,2024-05-07,12,1308,1147,2455,SouthB_T,"-37.82018685, 144.96508508"
721220250817,72,2025-08-17,12,244,312,556,ACMI_T,"-37.81726338, 144.96872809"
762320240912,76,2024-09-12,23,0,3,3,KenMac_T,"-37.79453803, 144.93036194"
2820240227,2,2024-02-27,8,154,210,364,Bou283_T,"-37.81380668, 144.96516718"
532020231111,53,2023-11-11,20,229,240,469,Col254_T,"-37.81564191, 144.965499"
9620250302,9,2025-03-02,6,17,16,33,Col700_T,"-37.81982992, 144.95102555"
51420250202,51,2025-02-02,4,7,6,13,Fra118_T,"-37.80841815, 144.95906316"
511420250829,51,2025-08-29,14,99,114,213,Fra118_T,"-37.80841815, 144.95906316"
301520251003,30,2025-10-03,15,260,415,675,Lon189_T,"-37.8112185, 144.96656806"
49420251016,49,2025-10-16,4,28,38,66,Eli501_T,"-37.80730068, 144.95956055"
192020250924,19,2025-09-24,20,316,479,795,LtB210_T,"-37.81237202, 144.96550671"
141320250331,141,2025-03-31,3,8,15,23,474Fl_T,"-37.81997273, 144.95834911"
137820240422,137,2024-04-22,8,148,30,178,BouHbr2353_T,"-37.81894815, 144.94612292"
1371220240629,137,2024-06-29,12,10,40,50,BouHbr2353_T,"-37.81894815, 144.94612292"
1372120241030,137,2024-10-30,21,1,3,4,BouHbr2353_T,"-37.81894815, 144.94612292"
139520250107,139,2025-01-07,5,1,3,4,Signal1647_T,"-37.81959923, 144.9632832"
1301120250509,130,2025-05-09,11,34,28,62,Bou892T,"-37.8204637, 144.94126826"
1301620241002,130,2024-10-02,16,52,45,97,Bou892T,"-37.8204637, 144.94126826"
1642220241101,164,2024-11-01,22,35,81,116,Lat526_T,"-37.813005, 144.95160411"
117620250112,117,2025-01-12,6,17,6,23,Fli114F_T,"-37.81629332, 144.97090877"
109220240730,109,2024-07-30,2,8,1,9,LatWill_T,"-37.81193681, 144.95621105"
1091320240918,109,2024-09-18,13,254,244,498,LatWill_T,"-37.81193681, 144.95621105"
109720241002,109,2024-10-02,7,51,283,334,LatWill_T,"-37.81193681, 144.95621105"
6420250726,6,2025-07-26,4,35,19,54,FliS_T,"-37.81911705, 144.96558255"
4020250706,4,2025-07-06,0,532,789,1321,Swa123_T,"-37.81487988, 144.9660878"
31020250710,3,2025-07-10,10,361,345,706,Swa295_T,"-37.81101524, 144.96429485"
391620250517,39,2025-05-17,16,34,17,51,AlfPl_T,"-37.81379749, 144.96995745"
771020250111,77,2025-01-11,10,99,93,192,HarEsP_T,"-37.81441438, 144.94433026"
771920250428,77,2025-04-28,19,172,114,286,HarEsP_T,"-37.81441438, 144.94433026"
781920241221,78,2024-12-21,19,20,43,63,HarEsB_T,"-37.81471642, 144.9446508"
591520250610,59,2025-06-10,15,603,576,1179,RMIT_T,"-37.80825648, 144.96304859"
28520240311,28,2024-03-11,5,9,29,38,VAC_T,"-37.82129925, 144.96879309"
291720241017,29,2024-10-17,17,134,187,321,AG_T,"-37.8199817, 144.96872865"
312320240801,31,2024-08-01,23,33,45,78,Lyg161_T,"-37.80169681, 144.96658911"
312120240509,31,2024-05-09,21,85,154,239,Lyg161_T,"-37.80169681, 144.96658911"
471520241227,47,2024-12-27,15,1061,1081,2142,Eli250_T,"-37.81258467, 144.9625775"
472320240704,47,2024-07-04,23,122,127,249,Eli250_T,"-37.81258467, 144.9625775"
47220240829,47,2024-08-29,2,24,16,40,Eli250_T,"-37.81258467, 144.9625775"
87620240115,87,2024-01-15,6,20,7,27,Errol23_T,"-37.80454949, 144.94921863"
50020250808,50,2025-08-08,0,26,5,31,Lyg309_T,"-37.79808192, 144.96721013"
50920241116,50,2024-11-16,9,92,117,209,Lyg309_T,"-37.79808192, 144.96721013"
502020241129,50,2024-11-29,20,306,207,513,Lyg309_T,"-37.79808192, 144.96721013"
182020251004,182,2025-10-04,0,169,178,347,King163_T,"-37.81627451, 144.95550503"
179420250224,179,2025-02-24,4,2,2,4,Pow61_T,"-37.82392385, 144.96299677"
165620240914,165,2024-09-14,6,2,5,7,Spen475_T,"-37.80953359, 144.94939004"
1661320250430,166,2025-04-30,13,70,91,161,Spen484_T,"-37.80896733, 144.94931703"
1621920250511,162,2025-05-11,19,250,149,399,Eli489_T,"-37.80740397, 144.95987909"
1672020250430,167,2025-04-30,20,11,36,47,Lat526_T,"-37.81304149, 144.95155955"
1431520250628,143,2025-06-28,15,281,304,585,Spencer_T,"-37.821728, 144.95557015"
1321820240602,132,2024-06-02,18,84,110,194,King335_T,"-37.81267639, 144.95386444"
1181320240126,118,2024-01-26,13,11,55,66,Fli114C_T,"-37.81632783, 144.97090512"
1242020250628,124,2025-06-28,20,0,2,2,BirBridge_T,"-37.81757416, 144.97329934"
682220250114,68,2025-01-14,22,46,40,86,FLDegN_T,"-37.8168479, 144.96559789"
85120240330,85,2024-03-30,1,0,3,3,488Mac_T,"-37.79432415, 144.92973378"
11320240501,1,2024-05-01,13,1364,1219,2583,Bou292_T,"-37.81349441, 144.96515323"
1420250415,1,2025-04-15,4,2,6,8,Bou292_T,"-37.81349441, 144.96515323"
182120240118,18,2024-01-18,21,13,16,29,Col12_T,"-37.81344862, 144.97305353"
182120241028,18,2024-10-28,21,9,11,20,Col12_T,"-37.81344862, 144.97305353"
181620241106,18,2024-11-06,16,490,119,609,Col12_T,"-37.81344862, 144.97305353"
18320250928,18,2025-09-28,3,4,5,9,Col12_T,"-37.81344862, 144.97305353"
62520240510,62,2024-05-10,5,11,8,19,Lat224_T,"-37.80996494, 144.96216521"
86620231221,86,2023-12-21,6,5,4,9,574Qub_T,"-37.80309992, 144.94908064"
11820240213,11,2024-02-13,8,66,59,125,WatCit_T,"-37.81564989, 144.93970694"
11020240510,11,2024-05-10,0,1,3,4,WatCit_T,"-37.81564989, 144.93970694"
112120240904,11,2024-09-04,21,56,41,97,WatCit_T,"-37.81564989, 144.93970694"
122320240601,12,2024-06-01,23,36,49,85,NewQ_T,"-37.81457988, 144.94292398"
101720241022,10,2024-10-22,17,373,194,567,BouHbr_T,"-37.81876474, 144.94710545"
101220250127,10,2025-01-27,12,47,25,72,BouHbr_T,"-37.81876474, 144.94710545"
72820250804,72,2025-08-04,8,547,79,626,ACMI_T,"-37.81726338, 144.96872809"
58520250127,58,2025-01-27,5,15,24,39,Bou688_T,"-37.81686075, 144.95358075"
58920250718,58,2025-07-18,9,854,198,1052,Bou688_T,"-37.81686075, 144.95358075"
581820250822,58,2025-08-22,18,729,574,1303,Bou688_T,"-37.81686075, 144.95358075"
27120250413,27,2025-04-13,1,30,21,51,Vic_T,"-37.80606888, 144.95644692"
27420250112,27,2025-01-12,4,11,2,13,Vic_T,"-37.80606888, 144.95644692"
91820250908,9,2025-09-08,18,734,110,844,Col700_T,"-37.81982992, 144.95102555"
511220240213,51,2024-02-13,12,140,152,292,Fra118_T,"-37.80841815, 144.95906316"
461120240822,46,2024-08-22,11,77,85,162,Pel147_T,"-37.80240719, 144.9615673"
46720250813,46,2025-08-13,7,31,7,38,Pel147_T,"-37.80240719, 144.9615673"
511620250318,51,2025-03-18,16,112,129,241,Fra118_T,"-37.80841815, 144.95906316"
49420240731,49,2024-07-31,4,15,18,33,Eli501_T,"-37.80730068, 144.95956055"
491220241026,49,2024-10-26,12,482,730,1212,Eli501_T,"-37.80730068, 144.95956055"
49220240401,49,2024-04-01,2,60,31,91,Eli501_T,"-37.80730068, 144.95956055"
481220250303,48,2025-03-03,12,206,133,339,QVMQ_T,"-37.80631581, 144.95866697"
48220240807,48,2024-08-07,2,6,7,13,QVMQ_T,"-37.80631581, 144.95866697"
1391520250423,139,2025-04-23,15,70,38,108,Signal1647_T,"-37.81959923, 144.9632832"
1391520251015,139,2025-10-15,15,86,65,151,Signal1647_T,"-37.81959923, 144.9632832"
241020240331,24,2024-03-31,10,304,446,750,Col620_T,"-37.81887963, 144.95449198"
241320251005,24,2025-10-05,13,433,514,947,Col620_T,"-37.81887963, 144.95449198"
722220231126,72,2023-11-26,22,117,120,237,ACMI_T,"-37.81726338, 144.96872809"
35120240329,35,2024-03-29,1,103,194,297,SouthB_T,"-37.82018685, 144.96508508"
35920241114,35,2024-11-14,9,574,1019,1593,SouthB_T,"-37.82018685, 144.96508508"
27920240210,27,2024-02-10,9,120,125,245,Vic_T,"-37.80606888, 144.95644692"
531120240916,53,2024-09-16,11,622,528,1150,Col254_T,"-37.81564191, 144.965499"
51320240715,51,2024-07-15,3,4,5,9,Fra118_T,"-37.80841815, 144.95906316"
511320240502,51,2024-05-02,13,153,144,297,Fra118_T,"-37.80841815, 144.95906316"
481020240208,48,2024-02-08,10,184,171,355,QVMQ_T,"-37.80631581, 144.95866697"
481920240417,48,2024-04-17,19,158,587,745,QVMQ_T,"-37.80631581, 144.95866697"
481720240424,48,2024-04-24,17,147,607,754,QVMQ_T,"-37.80631581, 144.95866697"
20320241027,20,2024-10-27,3,42,93,135,LtB170_T,"-37.81172914, 144.9682466"
1371220250918,137,2025-09-18,12,64,112,176,BouHbr2353_T,"-37.81894815, 144.94612292"
1411120250131,141,2025-01-31,11,148,115,263,474Fl_T,"-37.81997273, 144.95834911"
1371220240910,137,2024-09-10,12,35,86,121,BouHbr2353_T,"-37.81894815, 144.94612292"
692220250330,69,2025-03-30,22,6,9,15,FLDegC_T,"-37.81687226, 144.96559144"
841420240929,84,2024-09-29,14,797,1066,1863,ElFi_T,"-37.81798049, 144.96503383"
841620250109,84,2025-01-09,16,1003,1599,2602,ElFi_T,"-37.81798049, 144.96503383"
32120240621,3,2024-06-21,21,1087,1055,2142,Swa295_T,"-37.81101524, 144.96429485"
661020240104,66,2024-01-04,10,438,377,815,QVN_T,"-37.81057846, 144.96444294"
4520250601,4,2025-06-01,5,37,41,78,Swa123_T,"-37.81487988, 144.9660878"
701520231026,70,2023-10-26,15,153,147,300,Errol20_T,"-37.80456984, 144.94946228"
70120250905,70,2025-09-05,1,1,1,2,Errol20_T,"-37.80456984, 144.94946228"
39620240804,39,2024-08-04,6,4,6,10,AlfPl_T,"-37.81379749, 144.96995745"
41820251005,41,2025-10-05,8,361,318,679,Swa31,"-37.81668634, 144.96689733"
651520231107,65,2023-11-07,15,249,253,502,SwaCs_T,"-37.81569416, 144.9668064"
29420250704,29,2025-07-04,4,7,3,10,AG_T,"-37.8199817, 144.96872865"
291920250311,29,2025-03-11,19,231,242,473,AG_T,"-37.8199817, 144.96872865"
14620240509,14,2024-05-09,6,96,114,210,SanBri_T,"-37.82011242, 144.96291897"
312020250120,31,2025-01-20,20,194,178,372,Lyg161_T,"-37.80169681, 144.96658911"
31520240305,31,2024-03-05,5,8,4,12,Lyg161_T,"-37.80169681, 144.96658911"
28420250519,28,2025-05-19,4,4,25,29,VAC_T,"-37.82129925, 144.96879309"
28320240711,28,2024-07-11,3,4,18,22,VAC_T,"-37.82129925, 144.96879309"
402220240628,40,2024-06-28,22,215,44,259,Spr201_T,"-37.80999341, 144.97227587"
21720250510,21,2025-05-10,7,10,23,33,Bourke155_T,"-37.81267313, 144.96788288"
87920240923,87,2024-09-23,9,73,63,136,Errol23_T,"-37.80454949, 144.94921863"
441220240331,44,2024-03-31,12,4,20,24,UM3_T,"-37.79698741, 144.96441306"
5620251011,5,2025-10-11,6,43,77,120,PriNW_T,"-37.81874249, 144.96787656"
5720250625,5,2025-06-25,7,121,298,419,PriNW_T,"-37.81874249, 144.96787656"
5820240322,5,2024-03-22,8,1411,1492,2903,PriNW_T,"-37.81874249, 144.96787656"
182520250929,182,2025-09-29,5,13,34,47,King163_T,"-37.81627451, 144.95550503"
1401520240927,140,2024-09-27,15,84,106,190,Boyd2837_T,"-37.82590962, 144.96185972"
1392020240530,139,2024-05-30,20,9,12,21,Signal1647_T,"-37.81959923, 144.9632832"
1392120240619,139,2024-06-19,21,10,6,16,Signal1647_T,"-37.81959923, 144.9632832"
1361220250705,136,2025-07-05,12,99,73,172,BirFed1120_T,"-37.8184141, 144.97357915"
1421820250505,142,2025-05-05,18,44,25,69,Hammer1584_T,"-37.81970749, 144.96795734"
1381220241022,138,2024-10-22,12,18,12,30,EntPark1671_T,"-37.81996544, 144.95981454"
109220251015,109,2025-10-15,2,6,5,11,LatWill_T,"-37.81193681, 144.95621105"
66320250806,66,2025-08-06,3,13,4,17,QVN_T,"-37.81057846, 144.96444294"
84420240224,84,2024-02-24,4,80,67,147,ElFi_T,"-37.81798049, 144.96503383"
4120240120,4,2024-01-20,1,173,145,318,Swa123_T,"-37.81487988, 144.9660878"
392320250820,39,2025-08-20,23,8,8,16,AlfPl_T,"-37.81379749, 144.96995745"
81720250705,8,2025-07-05,17,333,147,480,WebBN_T,"-37.82293543, 144.9471751"
81320231019,8,2023-10-19,13,295,301,596,WebBN_T,"-37.82293543, 144.9471751"
75620241104,75,2024-11-04,6,14,22,36,SprFli_T,"-37.81515276, 144.97467661"
411420240420,41,2024-04-20,14,1804,1591,3395,Swa31,"-37.81668634, 144.96689733"
41220250203,41,2025-02-03,2,33,53,86,Swa31,"-37.81668634, 144.96689733"
712220231227,71,2023-12-27,22,2,4,6,WestWP_T,"-37.81235775, 144.97136962"
541620240228,54,2024-02-28,16,235,573,808,Swa607_T,"-37.804024, 144.96308399"
291620250129,29,2025-01-29,16,268,309,577,AG_T,"-37.8199817, 144.96872865"
311820240603,31,2024-06-03,18,152,101,253,Lyg161_T,"-37.80169681, 144.96658911"
36820240824,36,2024-08-24,8,97,46,143,Que85_T,"-37.81652527, 144.96121062"
362320241215,36,2024-12-15,23,42,24,66,Que85_T,"-37.81652527, 144.96121062"
361320240712,36,2024-07-12,13,362,402,764,Que85_T,"-37.81652527, 144.96121062"
37520231119,37,2023-11-19,5,2,6,8,Lyg260_T,"-37.80107122, 144.96704554"
472120240725,47,2024-07-25,21,447,393,840,Eli250_T,"-37.81258467, 144.9625775"
451720250102,45,2025-01-02,17,1119,1093,2212,Swa148_T,"-37.81414075, 144.96609379"
52320250117,5,2025-01-17,23,283,586,869,PriNW_T,"-37.81874249, 144.96787656"
212020240107,21,2024-01-07,20,277,329,606,Bourke155_T,"-37.81267313, 144.96788288"
36520250711,36,2025-07-11,5,16,2,18,Que85_T,"-37.81652527, 144.96121062"
362120231214,36,2023-12-14,21,87,172,259,Que85_T,"-37.81652527, 144.96121062"
87020241003,87,2024-10-03,0,3,2,5,Errol23_T,"-37.80454949, 144.94921863"
501220240620,50,2024-06-20,12,180,232,412,Lyg309_T,"-37.79808192, 144.96721013"
50220231125,50,2023-11-25,2,3,2,5,Lyg309_T,"-37.79808192, 144.96721013"
431120250910,43,2025-09-10,11,247,225,472,UM2_T,"-37.79844526, 144.96411782"
442120250813,44,2025-08-13,21,17,31,48,UM3_T,"-37.79698741, 144.96441306"
1661120241007,166,2024-10-07,11,35,39,74,Spen484_T,"-37.80896733, 144.94931703"
166020250928,166,2025-09-28,0,2,2,4,Spen484_T,"-37.80896733, 144.94931703"
181620250807,181,2025-08-07,6,74,116,190,Eli368_T,"-37.81009465, 144.96143149"
1672220250217,167,2025-02-17,22,14,28,42,Lat526_T,"-37.81304149, 144.95155955"
131420250501,131,2025-05-01,4,2,6,8,King2_T,"-37.82009057, 144.95758725"
1311720240528,131,2024-05-28,17,63,150,213,King2_T,"-37.82009057, 144.95758725"
143920240515,143,2024-05-15,9,145,269,414,Spencer_T,"-37.821728, 144.95557015"
132120250115,132,2025-01-15,1,21,12,33,King335_T,"-37.81267639, 144.95386444"
134720250811,134,2025-08-11,7,299,243,542,Spen201_T,"-37.81694221, 144.95303935"
134220240414,134,2024-04-14,2,68,58,126,Spen201_T,"-37.81694221, 144.95303935"
135620240320,135,2024-03-20,6,41,79,120,Spen161_T,"-37.8172861, 144.95319102"
133720240812,133,2024-08-12,7,889,402,1291,Spen229_T,"-37.81531435, 144.95227769"
1642120250129,164,2025-01-29,21,51,66,117,Lat526_T,"-37.813005, 144.95160411"
1641020250711,164,2025-07-11,10,117,57,174,Lat526_T,"-37.813005, 144.95160411"
161620241024,161,2024-10-24,6,86,108,194,BirArt1109_T,"-37.81851276, 144.97131336"
117120241202,117,2024-12-02,1,2,4,6,Fli114F_T,"-37.81629332, 144.97090877"
1091620240130,109,2024-01-30,16,419,138,557,LatWill_T,"-37.81193681, 144.95621105"
671820250829,67,2025-08-29,18,417,514,931,FLDegS_T,"-37.81688755, 144.96562569"
851520250708,85,2025-07-08,15,85,64,149,488Mac_T,"-37.79432415, 144.92973378"
171320240717,17,2024-07-17,13,714,686,1400,Col15_T,"-37.81362543, 144.97323591"
182220241025,18,2024-10-25,22,1,27,28,Col12_T,"-37.81344862, 144.97305353"
62420250304,62,2025-03-04,4,7,11,18,Lat224_T,"-37.80996494, 144.96216521"
1071620231124,107,2023-11-24,16,153,192,345,280Will_T,"-37.81246271, 144.95690188"
135920250408,135,2025-04-08,9,242,358,600,Spen161_T,"-37.8172861, 144.95319102"
1352120250424,135,2025-04-24,21,172,235,407,Spen161_T,"-37.8172861, 144.95319102"
51520250923,5,2025-09-23,15,1054,740,1794,PriNW_T,"-37.81874249, 144.96787656"
51720241022,5,2024-10-22,17,1334,868,2202,PriNW_T,"-37.81874249, 144.96787656"
1792220250620,179,2025-06-20,22,36,46,82,Pow61_T,"-37.82392385, 144.96299677"
1652020250622,165,2025-06-22,20,11,2,13,Spen475_T,"-37.80953359, 144.94939004"
1661520250104,166,2025-01-04,15,30,41,71,Spen484_T,"-37.80896733, 144.94931703"
166220250910,166,2025-09-10,2,0,1,1,Spen484_T,"-37.80896733, 144.94931703"
1812320250501,181,2025-05-01,23,304,269,573,Eli368_T,"-37.81009465, 144.96143149"
1621620241215,162,2024-12-15,16,307,641,948,Eli489_T,"-37.80740397, 144.95987909"
132120250530,132,2025-05-30,1,16,12,28,King335_T,"-37.81267639, 144.95386444"
134220250110,134,2025-01-10,2,8,8,16,Spen201_T,"-37.81694221, 144.95303935"
1341020250201,134,2025-02-01,10,229,320,549,Spen201_T,"-37.81694221, 144.95303935"
134920250904,134,2025-09-04,9,238,307,545,Spen201_T,"-37.81694221, 144.95303935"
135220250822,135,2025-08-22,2,13,21,34,Spen161_T,"-37.8172861, 144.95319102"
133720240312,133,2024-03-12,7,786,466,1252,Spen229_T,"-37.81531435, 144.95227769"
181520231204,18,2023-12-04,15,279,128,407,Col12_T,"-37.81344862, 144.97305353"
632120241126,63,2024-11-26,21,37,176,213,Bou231_T,"-37.81333081, 144.96675571"
12620240902,12,2024-09-02,6,20,19,39,NewQ_T,"-37.81457988, 144.94292398"
622120250403,62,2025-04-03,21,183,157,340,Lat224_T,"-37.80996494, 144.96216521"
56020240709,56,2024-07-09,0,11,22,33,Lon364_T,"-37.81234775, 144.96153311"
111820250316,11,2025-03-16,18,74,69,143,WatCit_T,"-37.81564989, 144.93970694"
242120250329,24,2025-03-29,21,337,509,846,Col620_T,"-37.81887963, 144.95449198"
101420250131,10,2025-01-31,14,53,51,104,BouHbr_T,"-37.81876474, 144.94710545"
352320231118,35,2023-11-18,23,649,1239,1888,SouthB_T,"-37.82018685, 144.96508508"
76120231217,76,2023-12-17,1,3,6,9,KenMac_T,"-37.79453803, 144.93036194"
76720250308,76,2025-03-08,7,22,9,31,KenMac_T,"-37.79453803, 144.93036194"
581920251004,58,2025-10-04,19,532,310,842,Bou688_T,"-37.81686075, 144.95358075"
23720241228,23,2024-12-28,7,39,49,88,Col623_T,"-37.81909256, 144.95452748"
23720240917,23,2024-09-17,7,386,188,574,Col623_T,"-37.81909256, 144.95452748"
19220250705,19,2025-07-05,2,60,89,149,LtB210_T,"-37.81237202, 144.96550671"
30620250505,30,2025-05-05,6,31,21,52,Lon189_T,"-37.8112185, 144.96656806"
251520240611,25,2024-06-11,15,401,407,808,MCEC_T,"-37.82401776, 144.95604426"
1411620250528,141,2025-05-28,16,106,99,205,474Fl_T,"-37.81997273, 144.95834911"
123820250701,123,2025-07-01,8,41,7,48,BirBridge_T,"-37.81753741, 144.97329734"
1231420250826,123,2025-08-26,14,36,19,55,BirBridge_T,"-37.81753741, 144.97329734"
1301220250915,130,2025-09-15,12,117,81,198,Bou892T,"-37.8204637, 144.94126826"
491920250507,49,2025-05-07,19,355,542,897,Eli501_T,"-37.80730068, 144.95956055"
117020241209,117,2024-12-09,0,19,25,44,Fli114F_T,"-37.81629332, 144.97090877"
1092020250308,109,2025-03-08,20,77,110,187,LatWill_T,"-37.81193681, 144.95621105"
1092220250519,109,2025-05-19,22,36,50,86,LatWill_T,"-37.81193681, 144.95621105"
109220240109,109,2024-01-09,2,6,4,10,LatWill_T,"-37.81193681, 144.95621105"
1091620240419,109,2024-04-19,16,351,176,527,LatWill_T,"-37.81193681, 144.95621105"
662020250119,66,2025-01-19,20,772,670,1442,QVN_T,"-37.81057846, 144.96444294"
661520241209,66,2024-12-09,15,1172,1137,2309,QVN_T,"-37.81057846, 144.96444294"
691520241211,69,2024-12-11,15,200,240,440,FLDegC_T,"-37.81687226, 144.96559144"
62020240607,6,2024-06-07,20,713,675,1388,FliS_T,"-37.81911705, 144.96558255"
32020231214,3,2023-12-14,20,1070,1024,2094,Swa295_T,"-37.81101524, 144.96429485"
32020250626,3,2025-06-26,20,824,961,1785,Swa295_T,"-37.81101524, 144.96429485"
391820241113,39,2024-11-13,18,125,69,194,AlfPl_T,"-37.81379749, 144.96995745"
411120240818,41,2024-08-18,11,165,224,389,Swa31,"-37.81668634, 144.96689733"
592220240618,59,2024-06-18,22,201,130,331,RMIT_T,"-37.80825648, 144.96304859"
592020241113,59,2024-11-13,20,191,225,416,RMIT_T,"-37.80825648, 144.96304859"
59820250409,59,2025-04-09,8,1059,213,1272,RMIT_T,"-37.80825648, 144.96304859"
772020240922,77,2024-09-22,20,160,74,234,HarEsP_T,"-37.81441438, 144.94433026"
77520250622,77,2025-06-22,5,2,5,7,HarEsP_T,"-37.81441438, 144.94433026"
28520240316,28,2024-03-16,5,8,8,16,VAC_T,"-37.82129925, 144.96879309"
141420240807,14,2024-08-07,14,334,105,439,SanBri_T,"-37.82011242, 144.96291897"
54720250116,54,2025-01-16,7,31,29,60,Swa607_T,"-37.804024, 144.96308399"
311020240731,31,2024-07-31,10,89,84,173,Lyg161_T,"-37.80169681, 144.96658911"
54020231103,54,2023-11-03,0,23,59,82,Swa607_T,"-37.804024, 144.96308399"
282020250908,28,2025-09-08,20,138,316,454,VAC_T,"-37.82129925, 144.96879309"
402320240820,40,2024-08-20,23,24,16,40,Spr201_T,"-37.80999341, 144.97227587"
40620250906,40,2025-09-06,6,17,9,26,Spr201_T,"-37.80999341, 144.97227587"
36120250604,36,2025-06-04,1,3,5,8,Que85_T,"-37.81652527, 144.96121062"
502220240913,50,2024-09-13,22,131,71,202,Lyg309_T,"-37.79808192, 144.96721013"
66920250302,66,2025-03-02,9,203,244,447,QVN_T,"-37.81057846, 144.96444294"
69720241016,69,2024-10-16,7,104,25,129,FLDegC_T,"-37.81687226, 144.96559144"
62020240504,6,2024-05-04,20,766,730,1496,FliS_T,"-37.81911705, 144.96558255"
661320240602,66,2024-06-02,13,1313,1993,3306,QVN_T,"-37.81057846, 144.96444294"
41720231024,4,2023-10-24,17,1694,1319,3013,Swa123_T,"-37.81487988, 144.9660878"
42020240815,4,2024-08-15,20,675,662,1337,Swa123_T,"-37.81487988, 144.9660878"
3220250717,3,2025-07-17,2,37,21,58,Swa295_T,"-37.81101524, 144.96429485"
751420250523,75,2025-05-23,14,61,70,131,SprFli_T,"-37.81515276, 144.97467661"
41020240526,41,2024-05-26,0,368,492,860,Swa31,"-37.81668634, 144.96689733"
81420250406,8,2025-04-06,14,224,198,422,WebBN_T,"-37.82293543, 144.9471751"
412320231126,41,2023-11-26,23,468,324,792,Swa31,"-37.81668634, 144.96689733"
78520231024,78,2023-10-24,5,2,1,3,HarEsB_T,"-37.81471642, 144.9446508"
14520240702,14,2024-07-02,5,39,36,75,SanBri_T,"-37.82011242, 144.96291897"
141920250508,14,2025-05-08,19,358,95,453,SanBri_T,"-37.82011242, 144.96291897"
47020241107,47,2024-11-07,0,62,35,97,Eli250_T,"-37.81258467, 144.9625775"
311120250907,31,2025-09-07,11,250,135,385,Lyg161_T,"-37.80169681, 144.96658911"
211120241023,21,2024-10-23,11,279,198,477,Bourke155_T,"-37.81267313, 144.96788288"
36820231213,36,2023-12-13,8,232,178,410,Que85_T,"-37.81652527, 144.96121062"
871720240821,87,2024-08-21,17,117,91,208,Errol23_T,"-37.80454949, 144.94921863"
611620250221,61,2025-02-21,16,612,1002,1614,RMIT14_T,"-37.80767455, 144.96309114"
44020240424,44,2024-04-24,0,1,0,1,UM3_T,"-37.79698741, 144.96441306"
431020240216,43,2024-02-16,10,91,107,198,UM2_T,"-37.79844526, 144.96411782"
452120250924,45,2025-09-24,21,215,479,694,Swa148_T,"-37.81414075, 144.96609379"
5220241103,5,2024-11-03,2,30,55,85,PriNW_T,"-37.81874249, 144.96787656"
51620240711,5,2024-07-11,16,1160,823,1983,PriNW_T,"-37.81874249, 144.96787656"
5720240206,5,2024-02-06,7,381,612,993,PriNW_T,"-37.81874249, 144.96787656"
52020240409,5,2024-04-09,20,492,572,1064,PriNW_T,"-37.81874249, 144.96787656"
182920250713,182,2025-07-13,9,95,88,183,King163_T,"-37.81627451, 144.95550503"
121220250627,12,2025-06-27,12,120,130,250,NewQ_T,"-37.81457988, 144.94292398"
24020240406,24,2024-04-06,0,167,237,404,Col620_T,"-37.81887963, 144.95449198"
112220250526,11,2025-05-26,22,15,19,34,WatCit_T,"-37.81564989, 144.93970694"
722320250322,72,2025-03-22,23,110,339,449,ACMI_T,"-37.81726338, 144.96872809"
72320250324,72,2025-03-24,3,3,3,6,ACMI_T,"-37.81726338, 144.96872809"
2320241209,2,2024-12-09,3,8,2,10,Bou283_T,"-37.81380668, 144.96516718"
22220240706,2,2024-07-06,22,53,143,196,Bou283_T,"-37.81380668, 144.96516718"
53020231113,53,2023-11-13,0,11,22,33,Col254_T,"-37.81564191, 144.965499"
9120240711,9,2024-07-11,1,2,14,16,Col700_T,"-37.81982992, 144.95102555"
491120250111,49,2025-01-11,11,329,578,907,Eli501_T,"-37.80730068, 144.95956055"
49420240710,49,2024-07-10,4,8,10,18,Eli501_T,"-37.80730068, 144.95956055"
251420251009,25,2025-10-09,14,1001,822,1823,MCEC_T,"-37.82401776, 144.95604426"
191620240528,19,2024-05-28,16,390,316,706,LtB210_T,"-37.81237202, 144.96550671"
25620241021,25,2024-10-21,6,83,128,211,MCEC_T,"-37.82401776, 144.95604426"
201720250610,20,2025-06-10,17,308,229,537,LtB170_T,"-37.81172914, 144.9682466"
137820240823,137,2024-08-23,8,50,15,65,BouHbr2353_T,"-37.81894815, 144.94612292"
136820241229,136,2024-12-29,8,199,71,270,BirFed1120_T,"-37.8184141, 144.97357915"
391620240305,39,2024-03-05,16,150,118,268,AlfPl_T,"-37.81379749, 144.96995745"
39920240615,39,2024-06-15,9,49,48,97,AlfPl_T,"-37.81379749, 144.96995745"
752020250206,75,2025-02-06,20,21,50,71,SprFli_T,"-37.81515276, 144.97467661"
77420240309,77,2024-03-09,4,2,1,3,HarEsP_T,"-37.81441438, 144.94433026"
77420250228,77,2025-02-28,4,3,3,6,HarEsP_T,"-37.81441438, 144.94433026"
781120240819,78,2024-08-19,11,32,36,68,HarEsB_T,"-37.81471642, 144.9446508"
14120240717,14,2024-07-17,1,5,2,7,SanBri_T,"-37.82011242, 144.96291897"
142120250106,14,2025-01-06,21,199,70,269,SanBri_T,"-37.82011242, 144.96291897"
281020240914,28,2024-09-14,10,543,176,719,VAC_T,"-37.82129925, 144.96879309"
401520231205,40,2023-12-05,15,231,173,404,Spr201_T,"-37.80999341, 144.97227587"
31320250428,31,2025-04-28,3,1,0,1,Lyg161_T,"-37.80169681, 144.96658911"
541420240810,54,2024-08-10,14,202,161,363,Swa607_T,"-37.804024, 144.96308399"
371220240724,37,2024-07-24,12,130,124,254,Lyg260_T,"-37.80107122, 144.96704554"
472120231126,47,2023-11-26,21,441,350,791,Eli250_T,"-37.81258467, 144.9625775"
52320250710,5,2025-07-10,23,80,101,181,PriNW_T,"-37.81874249, 144.96787656"
451120250708,45,2025-07-08,11,391,387,778,Swa148_T,"-37.81414075, 144.96609379"
5520240320,5,2024-03-20,5,41,53,94,PriNW_T,"-37.81874249, 144.96787656"
21020250425,21,2025-04-25,0,168,153,321,Bourke155_T,"-37.81267313, 144.96788288"
108320250428,108,2025-04-28,3,5,8,13,261Will_T,"-37.81295822, 144.95678789"
432220240307,43,2024-03-07,22,36,40,76,UM2_T,"-37.79844526, 144.96411782"
431220250818,43,2025-08-18,12,261,301,562,UM2_T,"-37.79844526, 144.96411782"
1821220250526,182,2025-05-26,12,347,290,637,King163_T,"-37.81627451, 144.95550503"
1792020250823,179,2025-08-23,20,59,59,118,Pow61_T,"-37.82392385, 144.96299677"
1651020250424,165,2025-04-24,10,31,38,69,Spen475_T,"-37.80953359, 144.94939004"
1652220241214,165,2024-12-14,22,34,15,49,Spen475_T,"-37.80953359, 144.94939004"
181720251012,181,2025-10-12,7,63,141,204,Eli368_T,"-37.81009465, 144.96143149"
1622120251012,162,2025-10-12,21,210,124,334,Eli489_T,"-37.80740397, 144.95987909"
1321720250507,132,2025-05-07,17,235,186,421,King335_T,"-37.81267639, 144.95386444"
135820250506,135,2025-05-06,8,299,446,745,Spen161_T,"-37.8172861, 144.95319102"
1181420240420,118,2024-04-20,14,21,30,51,Fli114C_T,"-37.81632783, 144.97090512"
1071720231213,107,2023-12-13,17,225,188,413,280Will_T,"-37.81246271, 144.95690188"
691820241216,69,2024-12-16,18,85,56,141,FLDegC_T,"-37.81687226, 144.96559144"
691820250221,69,2025-02-21,18,163,168,331,FLDegC_T,"-37.81687226, 144.96559144"
1652020251006,165,2025-10-06,20,18,3,21,Spen475_T,"-37.80953359, 144.94939004"
1431920241219,143,2024-12-19,19,182,227,409,Spencer_T,"-37.821728, 144.95557015"
108120250206,108,2025-02-06,1,11,10,21,261Will_T,"-37.81295822, 144.95678789"
133220231105,133,2023-11-05,2,43,22,65,Spen229_T,"-37.81531435, 144.95227769"
1171320250125,117,2025-01-25,13,189,240,429,Fli114F_T,"-37.81629332, 144.97090877"
1232320231029,123,2023-10-29,23,1,0,1,BirBridge_T,"-37.81753741, 144.97329734"
109320251006,109,2025-10-06,3,4,5,9,LatWill_T,"-37.81193681, 144.95621105"
68720250221,68,2025-02-21,7,81,59,140,FLDegN_T,"-37.8168479, 144.96559789"
67820241201,67,2024-12-01,8,100,120,220,FLDegS_T,"-37.81688755, 144.96562569"
67120231211,67,2023-12-11,1,7,17,24,FLDegS_T,"-37.81688755, 144.96562569"
861220240613,86,2024-06-13,12,80,86,166,574Qub_T,"-37.80309992, 144.94908064"
111420240318,11,2024-03-18,14,51,41,92,WatCit_T,"-37.81564989, 144.93970694"
761520231207,76,2023-12-07,15,49,105,154,KenMac_T,"-37.79453803, 144.93036194"
762220250402,76,2025-04-02,22,2,5,7,KenMac_T,"-37.79453803, 144.93036194"
721720240704,72,2024-07-04,17,305,869,1174,ACMI_T,"-37.81726338, 144.96872809"
21620250730,2,2025-07-30,16,585,504,1089,Bou283_T,"-37.81380668, 144.96516718"
581720231224,58,2023-12-24,17,456,233,689,Bou688_T,"-37.81686075, 144.95358075"
2720231211,2,2023-12-11,7,35,52,87,Bou283_T,"-37.81380668, 144.96516718"
79020240630,79,2024-06-30,0,129,184,313,FliSS_T,"-37.81794046, 144.96616678"
79520241112,79,2024-11-12,5,32,34,66,FliSS_T,"-37.81794046, 144.96616678"
531520231203,53,2023-12-03,15,766,605,1371,Col254_T,"-37.81564191, 144.965499"
52620240531,52,2024-05-31,6,24,18,42,Eli263_T,"-37.81252157, 144.9619401"
51720250504,51,2025-05-04,7,17,12,29,Fra118_T,"-37.80841815, 144.95906316"
51820240130,51,2024-01-30,8,60,54,114,Fra118_T,"-37.80841815, 144.95906316"
482120240505,48,2024-05-05,21,34,73,107,QVMQ_T,"-37.80631581, 144.95866697"
201920241012,20,2024-10-12,19,706,616,1322,LtB170_T,"-37.81172914, 144.9682466"
1371520250912,137,2025-09-12,15,11,81,92,BouHbr2353_T,"-37.81894815, 144.94612292"
1392020241030,139,2024-10-30,20,10,20,30,Signal1647_T,"-37.81959923, 144.9632832"
1392120250105,139,2025-01-05,21,23,6,29,Signal1647_T,"-37.81959923, 144.9632832"
1362120250519,136,2025-05-19,21,3,2,5,BirFed1120_T,"-37.8184141, 144.97357915"
136620240725,136,2024-07-25,6,2,3,5,BirFed1120_T,"-37.8184141, 144.97357915"
130720240102,130,2024-01-02,7,2,2,4,Bou892T,"-37.8204637, 144.94126826"
1381020241019,138,2024-10-19,10,2,1,3,EntPark1671_T,"-37.81996544, 144.95981454"
117720250522,117,2025-05-22,7,129,49,178,Fli114F_T,"-37.81629332, 144.97090877"
1172120240908,117,2024-09-08,21,31,45,76,Fli114F_T,"-37.81629332, 144.97090877"
66820240314,66,2024-03-14,8,250,579,829,QVN_T,"-37.81057846, 144.96444294"
66420250731,66,2025-07-31,4,5,8,13,QVN_T,"-37.81057846, 144.96444294"
691020240525,69,2024-05-25,10,364,137,501,FLDegC_T,"-37.81687226, 144.96559144"
841520250531,84,2025-05-31,15,1130,1383,2513,ElFi_T,"-37.81798049, 144.96503383"
31920241202,3,2024-12-02,19,804,709,1513,Swa295_T,"-37.81101524, 144.96429485"
661020231028,66,2023-10-28,10,451,399,850,QVN_T,"-37.81057846, 144.96444294"
70120250926,70,2025-09-26,1,5,6,11,Errol20_T,"-37.80456984, 144.94946228"
81520241219,8,2024-12-19,15,200,508,708,WebBN_T,"-37.82293543, 144.9471751"
781920240829,78,2024-08-29,19,0,10,10,HarEsB_T,"-37.81471642, 144.9446508"
781520240902,78,2024-09-02,15,15,38,53,HarEsB_T,"-37.81471642, 144.9446508"
781420250212,78,2025-02-12,14,31,56,87,HarEsB_T,"-37.81471642, 144.9446508"
592120241009,59,2024-10-09,21,236,308,544,RMIT_T,"-37.80825648, 144.96304859"
32220250911,3,2025-09-11,22,492,409,901,Swa295_T,"-37.81101524, 144.96429485"
851220250124,85,2025-01-24,12,127,132,259,488Mac_T,"-37.79432415, 144.92973378"
11920241221,1,2024-12-21,19,1442,1920,3362,Bou292_T,"-37.81349441, 144.96515323"
181320231023,18,2023-10-23,13,242,182,424,Col12_T,"-37.81344862, 144.97305353"
181320250716,18,2025-07-16,13,287,253,540,Col12_T,"-37.81344862, 144.97305353"
181020250823,18,2025-08-23,10,48,76,124,Col12_T,"-37.81344862, 144.97305353"
621420231216,62,2023-12-16,14,245,159,404,Lat224_T,"-37.80996494, 144.96216521"
561320240312,56,2024-03-12,13,385,308,693,Lon364_T,"-37.81234775, 144.96153311"
861120241211,86,2024-12-11,11,65,61,126,574Qub_T,"-37.80309992, 144.94908064"
862320250531,86,2025-05-31,23,3,48,51,574Qub_T,"-37.80309992, 144.94908064"
11820241020,11,2024-10-20,8,63,82,145,WatCit_T,"-37.81564989, 144.93970694"
241220250514,24,2025-05-14,12,817,734,1551,Col620_T,"-37.81887963, 144.95449198"
58620240629,58,2024-06-29,6,64,20,84,Bou688_T,"-37.81686075, 144.95358075"
761620240712,76,2024-07-12,16,76,83,159,KenMac_T,"-37.79453803, 144.93036194"
21420250411,2,2025-04-11,14,746,856,1602,Bou283_T,"-37.81380668, 144.96516718"
461220250807,46,2025-08-07,12,130,134,264,Pel147_T,"-37.80240719, 144.9615673"
19020240921,19,2024-09-21,0,156,208,364,LtB210_T,"-37.81237202, 144.96550671"
191120250520,19,2025-05-20,11,270,207,477,LtB210_T,"-37.81237202, 144.96550671"
48720241130,48,2024-11-30,7,54,45,99,QVMQ_T,"-37.80631581, 144.95866697"
20820241108,20,2024-11-08,8,44,51,95,LtB170_T,"-37.81172914, 144.9682466"
20720240118,20,2024-01-18,7,30,25,55,LtB170_T,"-37.81172914, 144.9682466"
1411720250425,141,2025-04-25,17,94,105,199,474Fl_T,"-37.81997273, 144.95834911"
137820250814,137,2025-08-14,8,128,18,146,BouHbr2353_T,"-37.81894815, 144.94612292"
1391020250223,139,2025-02-23,10,36,29,65,Signal1647_T,"-37.81959923, 144.9632832"
1381020250701,138,2025-07-01,10,3,10,13,EntPark1671_T,"-37.81996544, 144.95981454"
1091320240521,109,2024-05-21,13,301,254,555,LatWill_T,"-37.81193681, 144.95621105"
61320240701,6,2024-07-01,13,769,694,1463,FliS_T,"-37.81911705, 144.96558255"
701720250830,70,2025-08-30,17,153,128,281,Errol20_T,"-37.80456984, 144.94946228"
81820240703,8,2024-07-03,18,85,112,197,WebBN_T,"-37.82293543, 144.9471751"
8520240727,8,2024-07-27,5,1,0,1,WebBN_T,"-37.82293543, 144.9471751"
81620250307,8,2025-03-07,16,157,307,464,WebBN_T,"-37.82293543, 144.9471751"
82320240531,8,2024-05-31,23,17,29,46,WebBN_T,"-37.82293543, 144.9471751"
77620240222,77,2024-02-22,6,51,73,124,HarEsP_T,"-37.81441438, 144.94433026"
781220250208,78,2025-02-08,12,48,97,145,HarEsB_T,"-37.81471642, 144.9446508"
781620231030,78,2023-10-30,16,44,106,150,HarEsB_T,"-37.81471642, 144.9446508"
54420231225,54,2023-12-25,4,9,1,10,Swa607_T,"-37.804024, 144.96308399"
312220250214,31,2025-02-14,22,238,290,528,Lyg161_T,"-37.80169681, 144.96658911"
31620240414,31,2024-04-14,6,7,3,10,Lyg161_T,"-37.80169681, 144.96658911"
47220250820,47,2025-08-20,2,14,21,35,Eli250_T,"-37.81258467, 144.9625775"
472120240328,47,2024-03-28,21,702,481,1183,Eli250_T,"-37.81258467, 144.9625775"
211020251002,21,2025-10-02,10,148,107,255,Bourke155_T,"-37.81267313, 144.96788288"
108220241226,108,2024-12-26,2,22,26,48,261Will_T,"-37.81295822, 144.95678789"
1081020250516,108,2025-05-16,10,219,345,564,261Will_T,"-37.81295822, 144.95678789"
87620250225,87,2025-02-25,6,15,7,22,Errol23_T,"-37.80454949, 144.94921863"
87120240721,87,2024-07-21,1,4,2,6,Errol23_T,"-37.80454949, 144.94921863"
612220250607,61,2025-06-07,22,67,40,107,RMIT14_T,"-37.80767455, 144.96309114"
501820250108,50,2025-01-08,18,202,222,424,Lyg309_T,"-37.79808192, 144.96721013"
501020231127,50,2023-11-27,10,93,132,225,Lyg309_T,"-37.79808192, 144.96721013"
43120250209,43,2025-02-09,1,0,1,1,UM2_T,"-37.79844526, 144.96411782"
1822120250824,182,2025-08-24,21,165,189,354,King163_T,"-37.81627451, 144.95550503"
1841820250731,184,2025-07-31,18,665,791,1456,Eli124_T,"-37.81512416, 144.96371988"
1852320250807,185,2025-08-07,23,134,119,253,Eli197_T,"-37.81374643, 144.96276183"
162020240924,162,2024-09-24,0,48,37,85,Eli489_T,"-37.80740397, 144.95987909"
131220231228,131,2023-12-28,2,33,62,95,King2_T,"-37.82009057, 144.95758725"
1431120241016,143,2024-10-16,11,117,166,283,Spencer_T,"-37.821728, 144.95557015"
134620241226,134,2024-12-26,6,53,74,127,Spen201_T,"-37.81694221, 144.95303935"
1181120231208,118,2023-12-08,11,22,30,52,Fli114C_T,"-37.81632783, 144.97090512"
118020231210,118,2023-12-10,0,17,3,20,Fli114C_T,"-37.81632783, 144.97090512"
118720241009,118,2024-10-09,7,9,7,16,Fli114C_T,"-37.81632783, 144.97090512"
172220231026,17,2023-10-26,22,81,115,196,Col15_T,"-37.81362543, 144.97323591"
68720240720,68,2024-07-20,7,12,6,18,FLDegN_T,"-37.8168479, 144.96559789"
682320241019,68,2024-10-19,23,95,31,126,FLDegN_T,"-37.8168479, 144.96559789"
622320250721,62,2025-07-21,23,53,71,124,Lat224_T,"-37.80996494, 144.96216521"
561520240609,56,2024-06-09,15,414,349,763,Lon364_T,"-37.81234775, 144.96153311"
561920241002,56,2024-10-02,19,296,336,632,Lon364_T,"-37.81234775, 144.96153311"
562320241201,56,2024-12-01,23,58,81,139,Lon364_T,"-37.81234775, 144.96153311"
861120240711,86,2024-07-11,11,40,34,74,574Qub_T,"-37.80309992, 144.94908064"
111520240428,11,2024-04-28,15,872,1018,1890,WatCit_T,"-37.81564989, 144.93970694"
101120240614,10,2024-06-14,11,76,43,119,BouHbr_T,"-37.81876474, 144.94710545"
24320240524,24,2024-05-24,3,19,29,48,Col620_T,"-37.81887963, 144.95449198"
21920250909,2,2025-09-09,19,228,242,470,Bou283_T,"-37.81380668, 144.96516718"
91320240707,9,2024-07-07,13,90,128,218,Col700_T,"-37.81982992, 144.95102555"
232320250829,23,2025-08-29,23,43,104,147,Col623_T,"-37.81909256, 144.95452748"
512120240706,51,2024-07-06,21,40,29,69,Fra118_T,"-37.80841815, 144.95906316"
30920241218,30,2024-12-18,9,80,120,200,Lon189_T,"-37.8112185, 144.96656806"
492120250319,49,2025-03-19,21,143,188,331,Eli501_T,"-37.80730068, 144.95956055"
481520240718,48,2024-07-18,15,338,176,514,QVMQ_T,"-37.80631581, 144.95866697"
252320241216,25,2024-12-16,23,53,73,126,MCEC_T,"-37.82401776, 144.95604426"
137920240507,137,2024-05-07,9,35,30,65,BouHbr2353_T,"-37.81894815, 144.94612292"
1391120240811,139,2024-08-11,11,70,59,129,Signal1647_T,"-37.81959923, 144.9632832"
1362320240609,136,2024-06-09,23,0,56,56,BirFed1120_T,"-37.8184141, 144.97357915"
1422020241006,142,2024-10-06,20,15,9,24,Hammer1584_T,"-37.81970749, 144.96795734"
1611920240809,161,2024-08-09,19,3,0,3,BirArt1109_T,"-37.81851276, 144.97131336"
842220240715,84,2024-07-15,22,127,190,317,ElFi_T,"-37.81798049, 144.96503383"
66520240420,66,2024-04-20,5,18,17,35,QVN_T,"-37.81057846, 144.96444294"
411220240704,41,2024-07-04,12,535,501,1036,Swa31,"-37.81668634, 144.96689733"
411420250701,41,2025-07-01,14,1080,1310,2390,Swa31,"-37.81668634, 144.96689733"
59820250819,59,2025-08-19,8,1303,225,1528,RMIT_T,"-37.80825648, 144.96304859"
712220250103,71,2025-01-03,22,11,1,12,WestWP_T,"-37.81235775, 144.97136962"
652220240531,65,2024-05-31,22,73,482,555,SwaCs_T,"-37.81569416, 144.9668064"
61120240221,61,2024-02-21,1,43,11,54,RMIT14_T,"-37.80767455, 144.96309114"
502120241008,50,2024-10-08,21,149,80,229,Lyg309_T,"-37.79808192, 144.96721013"
432120240814,43,2024-08-14,21,48,100,148,UM2_T,"-37.79844526, 144.96411782"
432120250421,43,2025-04-21,21,13,10,23,UM2_T,"-37.79844526, 144.96411782"
1821920250707,182,2025-07-07,19,251,268,519,King163_T,"-37.81627451, 144.95550503"
1652320240818,165,2024-08-18,23,2,0,2,Spen475_T,"-37.80953359, 144.94939004"
131420240426,131,2024-04-26,4,13,16,29,King2_T,"-37.82009057, 144.95758725"
1431620250527,143,2025-05-27,16,53,86,139,Spencer_T,"-37.821728, 144.95557015"
134720250901,134,2025-09-01,7,244,233,477,Spen201_T,"-37.81694221, 144.95303935"
132420250426,132,2025-04-26,4,20,16,36,King335_T,"-37.81267639, 144.95386444"
1341720241208,134,2024-12-08,17,530,420,950,Spen201_T,"-37.81694221, 144.95303935"
135120240516,135,2024-05-16,1,31,17,48,Spen161_T,"-37.8172861, 144.95319102"
107420250621,107,2025-06-21,4,6,10,16,280Will_T,"-37.81246271, 144.95690188"
1332320250628,133,2025-06-28,23,187,104,291,Spen229_T,"-37.81531435, 144.95227769"
1181120240426,118,2024-04-26,11,16,25,41,Fli114C_T,"-37.81632783, 144.97090512"
1071220240722,107,2024-07-22,12,126,191,317,280Will_T,"-37.81246271, 144.95690188"
682320250308,68,2025-03-08,23,78,61,139,FLDegN_T,"-37.8168479, 144.96559789"
681020240310,68,2024-03-10,10,182,141,323,FLDegN_T,"-37.8168479, 144.96559789"
101420240314,10,2024-03-14,14,76,48,124,BouHbr_T,"-37.81876474, 144.94710545"
721320250429,72,2025-04-29,13,194,294,488,ACMI_T,"-37.81726338, 144.96872809"
58020240501,58,2024-05-01,0,28,36,64,Bou688_T,"-37.81686075, 144.95358075"
35520241108,35,2024-11-08,5,59,55,114,SouthB_T,"-37.82018685, 144.96508508"
11320250908,11,2025-09-08,3,2,1,3,WatCit_T,"-37.81564989, 144.93970694"
352220250718,35,2025-07-18,22,548,628,1176,SouthB_T,"-37.82018685, 144.96508508"
581120250413,58,2025-04-13,11,694,228,922,Bou688_T,"-37.81686075, 144.95358075"
531120231202,53,2023-12-02,11,396,339,735,Col254_T,"-37.81564191, 144.965499"
79820241127,79,2024-11-27,8,406,307,713,FliSS_T,"-37.81794046, 144.96616678"
791720231130,79,2023-11-30,17,868,692,1560,FliSS_T,"-37.81794046, 144.96616678"
792120240131,79,2024-01-31,21,282,232,514,FliSS_T,"-37.81794046, 144.96616678"
79720250723,79,2025-07-23,7,180,109,289,FliSS_T,"-37.81794046, 144.96616678"
23320240429,23,2024-04-29,3,1,6,7,Col623_T,"-37.81909256, 144.95452748"
52320241119,52,2024-11-19,3,4,10,14,Eli263_T,"-37.81252157, 144.9619401"
19220241110,19,2024-11-10,2,59,77,136,LtB210_T,"-37.81237202, 144.96550671"
251820250429,25,2025-04-29,18,444,209,653,MCEC_T,"-37.82401776, 144.95604426"
20020250921,20,2025-09-21,0,463,561,1024,LtB170_T,"-37.81172914, 144.9682466"
30120250802,30,2025-08-02,1,184,217,401,Lon189_T,"-37.8112185, 144.96656806"
251020240508,25,2024-05-08,10,156,663,819,MCEC_T,"-37.82401776, 144.95604426"
201920250624,20,2025-06-24,19,216,286,502,LtB170_T,"-37.81172914, 144.9682466"
1361920250501,136,2025-05-01,19,7,0,7,BirFed1120_T,"-37.8184141, 144.97357915"
161920250427,161,2025-04-27,9,169,174,343,BirArt1109_T,"-37.81851276, 144.97131336"
117020240313,117,2024-03-13,0,24,18,42,Fli114F_T,"-37.81629332, 144.97090877"
109320250423,109,2025-04-23,3,10,7,17,LatWill_T,"-37.81193681, 144.95621105"
3020240727,3,2024-07-27,0,420,428,848,Swa295_T,"-37.81101524, 144.96429485"
751520231116,75,2023-11-16,15,66,37,103,SprFli_T,"-37.81515276, 144.97467661"
391420240831,39,2024-08-31,14,54,59,113,AlfPl_T,"-37.81379749, 144.96995745"
391220250420,39,2025-04-20,12,39,36,75,AlfPl_T,"-37.81379749, 144.96995745"
411120250707,41,2025-07-07,11,1780,897,2677,Swa31,"-37.81668634, 144.96689733"
781720250306,78,2025-03-06,17,54,268,322,HarEsB_T,"-37.81471642, 144.9446508"
77720231106,77,2023-11-06,7,68,70,138,HarEsP_T,"-37.81441438, 144.94433026"
59620250418,59,2025-04-18,6,14,21,35,RMIT_T,"-37.80825648, 144.96304859"
281220240314,28,2024-03-14,12,649,594,1243,VAC_T,"-37.82129925, 144.96879309"
28420240906,28,2024-09-06,4,6,27,33,VAC_T,"-37.82129925, 144.96879309"
281320241028,28,2024-10-28,13,475,407,882,VAC_T,"-37.82129925, 144.96879309"
291820250409,29,2025-04-09,18,803,941,1744,AG_T,"-37.8199817, 144.96872865"
29120240731,29,2024-07-31,1,1,13,14,AG_T,"-37.8199817, 144.96872865"
40120241113,40,2024-11-13,1,8,0,8,Spr201_T,"-37.80999341, 144.97227587"
37220231123,37,2023-11-23,2,2,6,8,Lyg260_T,"-37.80107122, 144.96704554"
21320250110,21,2025-01-10,3,11,16,27,Bourke155_T,"-37.81267313, 144.96788288"
87120241121,87,2024-11-21,1,1,1,2,Errol23_T,"-37.80454949, 144.94921863"
50620250727,50,2025-07-27,6,6,7,13,Lyg309_T,"-37.79808192, 144.96721013"
501620240616,50,2024-06-16,16,235,199,434,Lyg309_T,"-37.79808192, 144.96721013"
50320250802,50,2025-08-02,3,3,0,3,Lyg309_T,"-37.79808192, 144.96721013"
432320250104,43,2025-01-04,23,5,6,11,UM2_T,"-37.79844526, 144.96411782"
1652020250124,165,2025-01-24,20,41,32,73,Spen475_T,"-37.80953359, 144.94939004"
1661920250701,166,2025-07-01,19,24,33,57,Spen484_T,"-37.80896733, 144.94931703"
1671920250223,167,2025-02-23,19,74,80,154,Lat526_T,"-37.81304149, 144.95155955"
131720250425,131,2025-04-25,7,58,24,82,King2_T,"-37.82009057, 144.95758725"
133920240302,133,2024-03-02,9,357,327,684,Spen229_T,"-37.81531435, 144.95227769"
118020241213,118,2024-12-13,0,4,5,9,Fli114C_T,"-37.81632783, 144.97090512"
1241220250330,124,2025-03-30,12,1,0,1,BirBridge_T,"-37.81757416, 144.97329934"
501620251003,50,2025-10-03,16,207,216,423,Lyg309_T,"-37.79808192, 144.96721013"
501420240830,50,2024-08-30,14,206,125,331,Lyg309_T,"-37.79808192, 144.96721013"
1791820250307,179,2025-03-07,18,119,87,206,Pow61_T,"-37.82392385, 144.96299677"
1792320250507,179,2025-05-07,23,12,14,26,Pow61_T,"-37.82392385, 144.96299677"
1792220250625,179,2025-06-25,22,26,29,55,Pow61_T,"-37.82392385, 144.96299677"
179120250228,179,2025-02-28,1,1,4,5,Pow61_T,"-37.82392385, 144.96299677"
166920241216,166,2024-12-16,9,41,44,85,Spen484_T,"-37.80896733, 144.94931703"
1401120250810,140,2025-08-10,11,137,86,223,Boyd2837_T,"-37.82590962, 144.96185972"
1401720240514,140,2024-05-14,17,60,82,142,Boyd2837_T,"-37.82590962, 144.96185972"
1321720231231,132,2023-12-31,17,139,162,301,King335_T,"-37.81267639, 144.95386444"
135020250509,135,2025-05-09,0,19,30,49,Spen161_T,"-37.8172861, 144.95319102"
133120251004,133,2025-10-04,1,37,13,50,Spen229_T,"-37.81531435, 144.95227769"
67520250922,67,2025-09-22,5,6,10,16,FLDegS_T,"-37.81688755, 144.96562569"
851520240303,85,2024-03-03,15,49,50,99,488Mac_T,"-37.79432415, 144.92973378"
671220250228,67,2025-02-28,12,503,695,1198,FLDegS_T,"-37.81688755, 144.96562569"
68020240923,68,2024-09-23,0,1,0,1,FLDegN_T,"-37.8168479, 144.96559789"
68720241116,68,2024-11-16,7,29,30,59,FLDegN_T,"-37.8168479, 144.96559789"
672320250610,67,2025-06-10,23,18,22,40,FLDegS_T,"-37.81688755, 144.96562569"
121420250130,12,2025-01-30,14,127,116,243,NewQ_T,"-37.81457988, 144.94292398"
12120250523,12,2025-05-23,1,6,9,15,NewQ_T,"-37.81457988, 144.94292398"
12020250530,12,2025-05-30,0,2,5,7,NewQ_T,"-37.81457988, 144.94292398"
11320250905,1,2025-09-05,13,1247,1329,2576,Bou292_T,"-37.81349441, 144.96515323"
76220241212,76,2024-12-12,2,1,0,1,KenMac_T,"-37.79453803, 144.93036194"
76820250417,76,2025-04-17,8,67,38,105,KenMac_T,"-37.79453803, 144.93036194"
58720231111,58,2023-11-11,7,120,78,198,Bou688_T,"-37.81686075, 144.95358075"
351720250606,35,2025-06-06,17,1292,1024,2316,SouthB_T,"-37.82018685, 144.96508508"
351720250710,35,2025-07-10,17,1568,1046,2614,SouthB_T,"-37.82018685, 144.96508508"
35020231209,35,2023-12-09,0,468,700,1168,SouthB_T,"-37.82018685, 144.96508508"
761620240802,76,2024-08-02,16,45,78,123,KenMac_T,"-37.79453803, 144.93036194"
581920250122,58,2025-01-22,19,323,299,622,Bou688_T,"-37.81686075, 144.95358075"
21820250418,2,2025-04-18,18,369,300,669,Bou283_T,"-37.81380668, 144.96516718"
21820250508,2,2025-05-08,18,409,343,752,Bou283_T,"-37.81380668, 144.96516718"
91620241120,9,2024-11-20,16,2441,168,2609,Col700_T,"-37.81982992, 144.95102555"
92320241210,9,2024-12-10,23,13,23,36,Col700_T,"-37.81982992, 144.95102555"
79220231124,79,2023-11-24,2,20,22,42,FliSS_T,"-37.81794046, 144.96616678"
511320240825,51,2024-08-25,13,149,177,326,Fra118_T,"-37.80841815, 144.95906316"
231920231213,23,2023-12-13,19,79,220,299,Col623_T,"-37.81909256, 144.95452748"
512020250331,51,2025-03-31,20,64,36,100,Fra118_T,"-37.80841815, 144.95906316"
482020231119,48,2023-11-19,20,80,94,174,QVMQ_T,"-37.80631581, 144.95866697"
482320231113,48,2023-11-13,23,26,22,48,QVMQ_T,"-37.80631581, 144.95866697"
1411720240107,141,2024-01-07,17,98,63,161,474Fl_T,"-37.81997273, 144.95834911"
137520240516,137,2024-05-16,5,1,0,1,BouHbr2353_T,"-37.81894815, 144.94612292"
1421320250914,142,2025-09-14,13,638,651,1289,Hammer1584_T,"-37.81970749, 144.96795734"
1801820250422,180,2025-04-22,18,11,15,26,Mac330_T,"-37.79497059, 144.93530329"
1231420250504,123,2025-05-04,14,89,62,151,BirBridge_T,"-37.81753741, 144.97329734"
138720250825,138,2025-08-25,7,5,3,8,EntPark1671_T,"-37.81996544, 144.95981454"
109020250827,109,2025-08-27,0,6,10,16,LatWill_T,"-37.81193681, 144.95621105"
61820231020,6,2023-10-20,18,1208,1257,2465,FliS_T,"-37.81911705, 144.96558255"
62120250130,6,2025-01-30,21,647,482,1129,FliS_T,"-37.81911705, 144.96558255"
841120250324,84,2025-03-24,11,725,725,1450,ElFi_T,"-37.81798049, 144.96503383"
42120251013,4,2025-10-13,21,424,512,936,Swa123_T,"-37.81487988, 144.9660878"
702220250511,70,2025-05-11,22,13,21,34,Errol20_T,"-37.80456984, 144.94946228"
751720231220,75,2023-12-20,17,66,60,126,SprFli_T,"-37.81515276, 144.97467661"
391820250726,39,2025-07-26,18,24,17,41,AlfPl_T,"-37.81379749, 144.96995745"
751020250924,75,2025-09-24,10,36,36,72,SprFli_T,"-37.81515276, 144.97467661"
81620231119,8,2023-11-19,16,227,212,439,WebBN_T,"-37.82293543, 144.9471751"
8020240210,8,2024-02-10,0,19,26,45,WebBN_T,"-37.82293543, 144.9471751"
8120241116,8,2024-11-16,1,6,6,12,WebBN_T,"-37.82293543, 144.9471751"
8720241210,8,2024-12-10,7,189,94,283,WebBN_T,"-37.82293543, 144.9471751"
8120241220,8,2024-12-20,1,6,1,7,WebBN_T,"-37.82293543, 144.9471751"
78520240828,78,2024-08-28,5,1,2,3,HarEsB_T,"-37.81471642, 144.9446508"
782220250417,78,2025-04-17,22,11,10,21,HarEsB_T,"-37.81471642, 144.9446508"
781220250715,78,2025-07-15,12,36,64,100,HarEsB_T,"-37.81471642, 144.9446508"
141020240907,14,2024-09-07,10,322,115,437,SanBri_T,"-37.82011242, 144.96291897"
591220250616,59,2025-06-16,12,651,710,1361,RMIT_T,"-37.80825648, 144.96304859"
141420240519,14,2024-05-19,14,271,105,376,SanBri_T,"-37.82011242, 144.96291897"
65620240628,65,2024-06-28,6,114,31,145,SwaCs_T,"-37.81569416, 144.9668064"
291820250807,29,2025-08-07,18,375,274,649,AG_T,"-37.8199817, 144.96872865"
311820250801,31,2025-08-01,18,302,187,489,Lyg161_T,"-37.80169681, 144.96658911"
54620250913,54,2025-09-13,6,8,4,12,Swa607_T,"-37.804024, 144.96308399"
371720240923,37,2024-09-23,17,130,134,264,Lyg260_T,"-37.80107122, 144.96704554"
371120250623,37,2025-06-23,11,90,61,151,Lyg260_T,"-37.80107122, 144.96704554"
472120240307,47,2024-03-07,21,587,415,1002,Eli250_T,"-37.81258467, 144.9625775"
108020240513,108,2024-05-13,0,7,30,37,261Will_T,"-37.81295822, 144.95678789"
871220250213,87,2025-02-13,12,126,116,242,Errol23_T,"-37.80454949, 144.94921863"
611620241203,61,2024-12-03,16,524,719,1243,RMIT14_T,"-37.80767455, 144.96309114"
49420250925,49,2025-09-25,4,8,13,21,Eli501_T,"-37.80730068, 144.95956055"
1411120250629,141,2025-06-29,11,145,169,314,474Fl_T,"-37.81997273, 144.95834911"
1371220250401,137,2025-04-01,12,63,139,202,BouHbr2353_T,"-37.81894815, 144.94612292"
71320240527,71,2024-05-27,3,1,0,1,WestWP_T,"-37.81235775, 144.97136962"
28420231210,28,2023-12-10,4,18,16,34,VAC_T,"-37.82129925, 144.96879309"
40720240603,40,2024-06-03,7,105,99,204,Spr201_T,"-37.80999341, 144.97227587"
40720240707,40,2024-07-07,7,6,16,22,Spr201_T,"-37.80999341, 144.97227587"
361320240107,36,2024-01-07,13,32,35,67,Que85_T,"-37.81652527, 144.96121062"
37720250622,37,2025-06-22,7,3,6,9,Lyg260_T,"-37.80107122, 144.96704554"
37620250904,37,2025-09-04,6,6,9,15,Lyg260_T,"-37.80107122, 144.96704554"
611320240924,61,2024-09-24,13,633,697,1330,RMIT14_T,"-37.80767455, 144.96309114"
612120240127,61,2024-01-27,21,179,180,359,RMIT14_T,"-37.80767455, 144.96309114"
502320250321,50,2025-03-21,23,120,44,164,Lyg309_T,"-37.79808192, 144.96721013"
1671220240814,167,2024-08-14,12,4,30,34,Lat526_T,"-37.81304149, 144.95155955"
131620250102,131,2025-01-02,6,10,30,40,King2_T,"-37.82009057, 144.95758725"
133120250525,133,2025-05-25,1,37,24,61,Spen229_T,"-37.81531435, 144.95227769"
671420231116,67,2023-11-16,14,403,588,991,FLDegS_T,"-37.81688755, 144.96562569"
17120240503,17,2024-05-03,1,16,9,25,Col15_T,"-37.81362543, 144.97323591"
181020241004,18,2024-10-04,10,154,221,375,Col12_T,"-37.81344862, 144.97305353"
67920250908,67,2025-09-08,9,486,313,799,FLDegS_T,"-37.81688755, 144.96562569"
11920231125,11,2023-11-25,9,90,115,205,WatCit_T,"-37.81564989, 144.93970694"
241320240427,24,2024-04-27,13,716,516,1232,Col620_T,"-37.81887963, 144.95449198"
101220240310,10,2024-03-10,12,17,27,44,BouHbr_T,"-37.81876474, 144.94710545"
761720231119,76,2023-11-19,17,49,42,91,KenMac_T,"-37.79453803, 144.93036194"
2820241108,2,2024-11-08,8,135,182,317,Bou283_T,"-37.81380668, 144.96516718"
2820241225,2,2024-12-25,8,29,33,62,Bou283_T,"-37.81380668, 144.96516718"
91920240822,9,2024-08-22,19,313,80,393,Col700_T,"-37.81982992, 144.95102555"
23020240316,23,2024-03-16,0,28,72,100,Col623_T,"-37.81909256, 144.95452748"
492120231125,49,2023-11-25,21,115,80,195,Eli501_T,"-37.80730068, 144.95956055"
481120250121,48,2025-01-21,11,251,206,457,QVMQ_T,"-37.80631581, 144.95866697"
481520231228,48,2023-12-28,15,507,282,789,QVMQ_T,"-37.80631581, 144.95866697"
20620240930,20,2024-09-30,6,4,9,13,LtB170_T,"-37.81172914, 144.9682466"
20920250214,20,2025-02-14,9,76,72,148,LtB170_T,"-37.81172914, 144.9682466"
462120241213,46,2024-12-13,21,1,0,1,Pel147_T,"-37.80240719, 144.9615673"
1361920250201,136,2025-02-01,19,186,93,279,BirFed1120_T,"-37.8184141, 144.97357915"
142220241126,142,2024-11-26,2,1,0,1,Hammer1584_T,"-37.81970749, 144.96795734"
1302220240920,130,2024-09-20,22,7,6,13,Bou892T,"-37.8204637, 144.94126826"
1171820250721,117,2025-07-21,18,121,133,254,Fli114F_T,"-37.81629332, 144.97090877"
1091520250330,109,2025-03-30,15,78,101,179,LatWill_T,"-37.81193681, 144.95621105"
1092320250716,109,2025-07-16,23,20,27,47,LatWill_T,"-37.81193681, 144.95621105"
69120231210,69,2023-12-10,1,3,1,4,FLDegC_T,"-37.81687226, 144.96559144"
842320240506,84,2024-05-06,23,138,227,365,ElFi_T,"-37.81798049, 144.96503383"
841120250303,84,2025-03-03,11,709,714,1423,ElFi_T,"-37.81798049, 144.96503383"
66220240530,66,2024-05-30,2,8,14,22,QVN_T,"-37.81057846, 144.96444294"
6520250526,6,2025-05-26,5,58,106,164,FliS_T,"-37.81911705, 144.96558255"
702220250420,70,2025-04-20,22,25,31,56,Errol20_T,"-37.80456984, 144.94946228"
3720250701,3,2025-07-01,7,36,80,116,Swa295_T,"-37.81101524, 144.96429485"
751920240116,75,2024-01-16,19,34,32,66,SprFli_T,"-37.81515276, 144.97467661"
82220231107,8,2023-11-07,22,12,16,28,WebBN_T,"-37.82293543, 144.9471751"
82320231230,8,2023-12-30,23,39,27,66,WebBN_T,"-37.82293543, 144.9471751"
421620240725,42,2024-07-25,16,295,651,946,UM1_T,"-37.80008566, 144.96386412"
78320240725,78,2024-07-25,3,1,0,1,HarEsB_T,"-37.81471642, 144.9446508"
781620250429,78,2025-04-29,16,12,118,130,HarEsB_T,"-37.81471642, 144.9446508"
711320240222,71,2024-02-22,13,25,28,53,WestWP_T,"-37.81235775, 144.97136962"
712020240224,71,2024-02-24,20,14,13,27,WestWP_T,"-37.81235775, 144.97136962"
711820240314,71,2024-03-14,18,33,29,62,WestWP_T,"-37.81235775, 144.97136962"
542020250802,54,2025-08-02,20,167,97,264,Swa607_T,"-37.804024, 144.96308399"
36720240928,36,2024-09-28,7,31,36,67,Que85_T,"-37.81652527, 144.96121062"
21420240921,21,2024-09-21,4,21,17,38,Bourke155_T,"-37.81267313, 144.96788288"
21520250507,21,2025-05-07,5,5,11,16,Bourke155_T,"-37.81267313, 144.96788288"
108920240220,108,2024-02-20,9,264,1071,1335,261Will_T,"-37.81295822, 144.95678789"
871720231210,87,2023-12-10,17,65,68,133,Errol23_T,"-37.80454949, 144.94921863"
502320240618,50,2024-06-18,23,14,12,26,Lyg309_T,"-37.79808192, 144.96721013"
165620251009,165,2025-10-09,6,3,10,13,Spen475_T,"-37.80953359, 144.94939004"
1402020250306,140,2025-03-06,20,24,14,38,Boyd2837_T,"-37.82590962, 144.96185972"
1311920240328,131,2024-03-28,19,105,84,189,King2_T,"-37.82009057, 144.95758725"
107120250731,107,2025-07-31,1,8,5,13,280Will_T,"-37.81246271, 144.95690188"
1071020250921,107,2025-09-21,10,68,125,193,280Will_T,"-37.81246271, 144.95690188"
67320231112,67,2023-11-12,3,18,36,54,FLDegS_T,"-37.81688755, 144.96562569"
68820231202,68,2023-12-02,8,42,19,61,FLDegN_T,"-37.8168479, 144.96559789"
17620241011,17,2024-10-11,6,99,25,124,Col15_T,"-37.81362543, 144.97323591"
171620250314,17,2025-03-14,16,225,331,556,Col15_T,"-37.81362543, 144.97323591"
172320250424,17,2025-04-24,23,43,55,98,Col15_T,"-37.81362543, 144.97323591"
1020250214,1,2025-02-14,0,13,41,54,Bou292_T,"-37.81349441, 144.96515323"
671820250808,67,2025-08-08,18,396,463,859,FLDegS_T,"-37.81688755, 144.96562569"
181120250925,18,2025-09-25,11,185,288,473,Col12_T,"-37.81344862, 144.97305353"
62320250813,62,2025-08-13,3,16,12,28,Lat224_T,"-37.80996494, 144.96216521"
63920250709,63,2025-07-09,9,179,207,386,Bou231_T,"-37.81333081, 144.96675571"
621120231118,62,2023-11-18,11,166,133,299,Lat224_T,"-37.80996494, 144.96216521"
562020241119,56,2024-11-19,20,242,321,563,Lon364_T,"-37.81234775, 144.96153311"
861720240209,86,2024-02-09,17,38,48,86,574Qub_T,"-37.80309992, 144.94908064"
242120240510,24,2024-05-10,21,374,544,918,Col620_T,"-37.81887963, 144.95449198"
561820250709,56,2025-07-09,18,433,489,922,Lon364_T,"-37.81234775, 144.96153311"
22020250121,2,2025-01-21,20,137,193,330,Bou283_T,"-37.81380668, 144.96516718"
91620250422,9,2025-04-22,16,1445,123,1568,Col700_T,"-37.81982992, 144.95102555"
23520240721,23,2024-07-21,5,9,23,32,Col623_T,"-37.81909256, 144.95452748"
23820231231,23,2023-12-31,8,49,71,120,Col623_T,"-37.81909256, 144.95452748"
491220241219,49,2024-12-19,12,443,566,1009,Eli501_T,"-37.80730068, 144.95956055"
25220250927,25,2025-09-27,2,7,38,45,MCEC_T,"-37.82401776, 144.95604426"
481320240926,48,2024-09-26,13,417,251,668,QVMQ_T,"-37.80631581, 144.95866697"
172320250403,17,2025-04-03,23,41,47,88,Col15_T,"-37.81362543, 144.97323591"
182320241126,18,2024-11-26,23,8,11,19,Col12_T,"-37.81344862, 144.97305353"
671820240108,67,2024-01-08,18,128,235,363,FLDegS_T,"-37.81688755, 144.96562569"
62720250421,62,2025-04-21,7,19,28,47,Lat224_T,"-37.80996494, 144.96216521"
562320250223,56,2025-02-23,23,86,105,191,Lon364_T,"-37.81234775, 144.96153311"
12120231123,12,2023-11-23,1,3,8,11,NewQ_T,"-37.81457988, 144.94292398"
721920240503,72,2024-05-03,19,281,357,638,ACMI_T,"-37.81726338, 144.96872809"
581320240108,58,2024-01-08,13,439,252,691,Bou688_T,"-37.81686075, 144.95358075"
791620240821,79,2024-08-21,16,436,575,1011,FliSS_T,"-37.81794046, 144.96616678"
79520240320,79,2024-03-20,5,43,29,72,FliSS_T,"-37.81794046, 144.96616678"
53020240823,53,2024-08-23,0,16,19,35,Col254_T,"-37.81564191, 144.965499"
46520240921,46,2024-09-21,5,0,1,1,Pel147_T,"-37.80240719, 144.9615673"
20020250831,20,2025-08-31,0,176,318,494,LtB170_T,"-37.81172914, 144.9682466"
481920250118,48,2025-01-18,19,120,191,311,QVMQ_T,"-37.80631581, 144.95866697"
521520250226,52,2025-02-26,15,294,276,570,Eli263_T,"-37.81252157, 144.9619401"
1412120240204,141,2024-02-04,21,70,106,176,474Fl_T,"-37.81997273, 144.95834911"
1361320250107,136,2025-01-07,13,103,150,253,BirFed1120_T,"-37.8184141, 144.97357915"
1362120240303,136,2024-03-03,21,1,0,1,BirFed1120_T,"-37.8184141, 144.97357915"
1421620251002,142,2025-10-02,16,185,184,369,Hammer1584_T,"-37.81970749, 144.96795734"
142020241021,142,2024-10-21,0,1,0,1,Hammer1584_T,"-37.81970749, 144.96795734"
142020241129,142,2024-11-29,0,0,1,1,Hammer1584_T,"-37.81970749, 144.96795734"
692120240704,69,2024-07-04,21,30,19,49,FLDegC_T,"-37.81687226, 144.96559144"
691920250522,69,2025-05-22,19,30,22,52,FLDegC_T,"-37.81687226, 144.96559144"
61320240229,6,2024-02-29,13,813,844,1657,FliS_T,"-37.81911705, 144.96558255"
84320241012,84,2024-10-12,3,44,70,114,ElFi_T,"-37.81798049, 144.96503383"
702320240206,70,2024-02-06,23,11,8,19,Errol20_T,"-37.80456984, 144.94946228"
31320250319,3,2025-03-19,13,1109,1072,2181,Swa295_T,"-37.81101524, 144.96429485"
39420231211,39,2023-12-11,4,0,1,1,AlfPl_T,"-37.81379749, 144.96995745"
391420250204,39,2025-02-04,14,95,77,172,AlfPl_T,"-37.81379749, 144.96995745"
8920240924,8,2024-09-24,9,202,138,340,WebBN_T,"-37.82293543, 144.9471751"
422220240713,42,2024-07-13,22,13,19,32,UM1_T,"-37.80008566, 144.96386412"
711920240908,71,2024-09-08,19,5,11,16,WestWP_T,"-37.81235775, 144.97136962"
59420250109,59,2025-01-09,4,11,16,27,RMIT_T,"-37.80825648, 144.96304859"
421020250428,42,2025-04-28,10,310,218,528,UM1_T,"-37.80008566, 144.96386412"
54020240417,54,2024-04-17,0,35,45,80,Swa607_T,"-37.804024, 144.96308399"
281820240216,28,2024-02-16,18,496,921,1417,VAC_T,"-37.82129925, 144.96879309"
28620240326,28,2024-03-26,6,165,52,217,VAC_T,"-37.82129925, 144.96879309"
40920240208,40,2024-02-08,9,201,266,467,Spr201_T,"-37.80999341, 144.97227587"
40520240531,40,2024-05-31,5,11,11,22,Spr201_T,"-37.80999341, 144.97227587"
1381720250829,138,2025-08-29,17,8,2,10,EntPark1671_T,"-37.81996544, 144.95981454"
1091820241202,109,2024-12-02,18,197,84,281,LatWill_T,"-37.81193681, 144.95621105"
691420241209,69,2024-12-09,14,211,265,476,FLDegC_T,"-37.81687226, 144.96559144"
6020240113,6,2024-01-13,0,527,240,767,FliS_T,"-37.81911705, 144.96558255"
6920240904,6,2024-09-04,9,586,1018,1604,FliS_T,"-37.81911705, 144.96558255"
3920250923,3,2025-09-23,9,357,347,704,Swa295_T,"-37.81101524, 144.96429485"
32020240519,3,2024-05-19,20,827,610,1437,Swa295_T,"-37.81101524, 144.96429485"
3920240608,3,2024-06-08,9,201,221,422,Swa295_T,"-37.81101524, 144.96429485"
141820250408,14,2025-04-08,18,546,165,711,SanBri_T,"-37.82011242, 144.96291897"
71920250217,71,2025-02-17,9,18,21,39,WestWP_T,"-37.81235775, 144.97136962"
712320250916,71,2025-09-16,23,2,0,2,WestWP_T,"-37.81235775, 144.97136962"
591920240903,59,2024-09-03,19,641,442,1083,RMIT_T,"-37.80825648, 144.96304859"
59320231102,59,2023-11-02,3,15,7,22,RMIT_T,"-37.80825648, 144.96304859"
591820240119,59,2024-01-19,18,530,491,1021,RMIT_T,"-37.80825648, 144.96304859"
59020240213,59,2024-02-13,0,78,27,105,RMIT_T,"-37.80825648, 144.96304859"
47120240308,47,2024-03-08,1,67,60,127,Eli250_T,"-37.81258467, 144.9625775"
401920231105,40,2023-11-05,19,82,106,188,Spr201_T,"-37.80999341, 144.97227587"
36520240930,36,2024-09-30,5,14,5,19,Que85_T,"-37.81652527, 144.96121062"
37720240406,37,2024-04-06,7,14,4,18,Lyg260_T,"-37.80107122, 144.96704554"
371620240513,37,2024-05-13,16,89,121,210,Lyg260_T,"-37.80107122, 144.96704554"
47820250917,47,2025-09-17,8,267,673,940,Eli250_T,"-37.81258467, 144.9625775"
452020240326,45,2024-03-26,20,216,496,712,Swa148_T,"-37.81414075, 144.96609379"
441620240706,44,2024-07-06,16,85,54,139,UM3_T,"-37.79698741, 144.96441306"
211020240129,21,2024-01-29,10,138,167,305,Bourke155_T,"-37.81267313, 144.96788288"
21720240608,21,2024-06-08,7,26,31,57,Bourke155_T,"-37.81267313, 144.96788288"
133420231225,133,2023-12-25,4,19,35,54,Spen229_T,"-37.81531435, 144.95227769"
1241220250317,124,2025-03-17,12,8,14,22,BirBridge_T,"-37.81757416, 144.97329934"
612020250222,61,2025-02-22,20,460,476,936,RMIT14_T,"-37.80767455, 144.96309114"
61520231206,61,2023-12-06,5,11,33,44,RMIT14_T,"-37.80767455, 144.96309114"
441520241117,44,2024-11-17,15,26,14,40,UM3_T,"-37.79698741, 144.96441306"
184720250926,184,2025-09-26,7,52,66,118,Eli124_T,"-37.81512416, 144.96371988"
167020250605,167,2025-06-05,0,1,4,5,Lat526_T,"-37.81304149, 144.95155955"
132420240724,132,2024-07-24,4,2,4,6,King335_T,"-37.81267639, 144.95386444"
672020250629,67,2025-06-29,20,111,112,223,FLDegS_T,"-37.81688755, 144.96562569"
171220240416,17,2024-04-16,12,860,841,1701,Col15_T,"-37.81362543, 144.97323591"
671820231122,67,2023-11-22,18,323,474,797,FLDegS_T,"-37.81688755, 144.96562569"
67220250327,67,2025-03-27,2,4,3,7,FLDegS_T,"-37.81688755, 144.96562569"
631920250921,63,2025-09-21,19,107,185,292,Bou231_T,"-37.81333081, 144.96675571"
862320240506,86,2024-05-06,23,1,4,5,574Qub_T,"-37.80309992, 144.94908064"
241820241117,24,2024-11-17,18,421,641,1062,Col620_T,"-37.81887963, 144.95449198"
242120241212,24,2024-12-12,21,231,600,831,Col620_T,"-37.81887963, 144.95449198"
561820250910,56,2025-09-10,18,371,403,774,Lon364_T,"-37.81234775, 144.96153311"
721120231127,72,2023-11-27,11,196,274,470,ACMI_T,"-37.81726338, 144.96872809"
761320241228,76,2024-12-28,13,27,33,60,KenMac_T,"-37.79453803, 144.93036194"
721220250804,72,2025-08-04,12,144,272,416,ACMI_T,"-37.81726338, 144.96872809"
21320240721,2,2024-07-21,13,717,840,1557,Bou283_T,"-37.81380668, 144.96516718"
9520241230,9,2024-12-30,5,10,7,17,Col700_T,"-37.81982992, 144.95102555"
27620240814,27,2024-08-14,6,19,13,32,Vic_T,"-37.80606888, 144.95644692"
792120250309,79,2025-03-09,21,536,1070,1606,FliSS_T,"-37.81794046, 144.96616678"
532220240109,53,2024-01-09,22,57,127,184,Col254_T,"-37.81564191, 144.965499"
30220250120,30,2025-01-20,2,27,55,82,Lon189_T,"-37.8112185, 144.96656806"
511620250305,51,2025-03-05,16,100,106,206,Fra118_T,"-37.80841815, 144.95906316"
511120240327,51,2024-03-27,11,99,68,167,Fra118_T,"-37.80841815, 144.95906316"
191220250613,19,2025-06-13,12,503,384,887,LtB210_T,"-37.81237202, 144.96550671"
19020250810,19,2025-08-10,0,221,206,427,LtB210_T,"-37.81237202, 144.96550671"
1412220250425,141,2025-04-25,22,63,117,180,474Fl_T,"-37.81997273, 144.95834911"
1391320240326,139,2024-03-26,13,77,99,176,Signal1647_T,"-37.81959923, 144.9632832"
1391920250108,139,2025-01-08,19,52,37,89,Signal1647_T,"-37.81959923, 144.9632832"
139520250223,139,2025-02-23,5,0,1,1,Signal1647_T,"-37.81959923, 144.9632832"
142020250323,142,2025-03-23,0,17,10,27,Hammer1584_T,"-37.81970749, 144.96795734"
138920240410,138,2024-04-10,9,6,8,14,EntPark1671_T,"-37.81996544, 144.95981454"
1171020250427,117,2025-04-27,10,74,121,195,Fli114F_T,"-37.81629332, 144.97090877"
1091820241215,109,2024-12-15,18,48,76,124,LatWill_T,"-37.81193681, 144.95621105"
661420250606,66,2025-06-06,14,990,964,1954,QVN_T,"-37.81057846, 144.96444294"
691220250313,69,2025-03-13,12,477,384,861,FLDegC_T,"-37.81687226, 144.96559144"
3020240225,3,2024-02-25,0,651,629,1280,Swa295_T,"-37.81101524, 144.96429485"
41420240108,4,2024-01-08,14,1641,1079,2720,Swa123_T,"-37.81487988, 144.9660878"
70620231026,70,2023-10-26,6,10,4,14,Errol20_T,"-37.80456984, 144.94946228"
32120240502,3,2024-05-02,21,839,723,1562,Swa295_T,"-37.81101524, 144.96429485"
392220240912,39,2024-09-12,22,2,1,3,AlfPl_T,"-37.81379749, 144.96995745"
82220250212,8,2025-02-12,22,22,12,34,WebBN_T,"-37.82293543, 144.9471751"
41020240717,41,2024-07-17,0,27,28,55,Swa31,"-37.81668634, 144.96689733"
421320240929,42,2024-09-29,13,78,85,163,UM1_T,"-37.80008566, 144.96386412"
422020241216,42,2024-12-16,20,33,37,70,UM1_T,"-37.80008566, 144.96386412"
77520231205,77,2023-12-05,5,14,10,24,HarEsP_T,"-37.81441438, 144.94433026"
781020241215,78,2024-12-15,10,65,75,140,HarEsB_T,"-37.81471642, 144.9446508"
782220240613,78,2024-06-13,22,1,3,4,HarEsB_T,"-37.81471642, 144.9446508"
591520240409,59,2024-04-09,15,1199,1321,2520,RMIT_T,"-37.80825648, 144.96304859"
141420241019,14,2024-10-19,14,488,204,692,SanBri_T,"-37.82011242, 144.96291897"
28720240717,28,2024-07-17,7,257,135,392,VAC_T,"-37.82129925, 144.96879309"
281720240801,28,2024-08-01,17,494,939,1433,VAC_T,"-37.82129925, 144.96879309"
472220240628,47,2024-06-28,22,394,413,807,Eli250_T,"-37.81258467, 144.9625775"
31020250228,31,2025-02-28,0,22,15,37,Lyg161_T,"-37.80169681, 144.96658911"
21420240302,21,2024-03-02,4,33,37,70,Bourke155_T,"-37.81267313, 144.96788288"
372320240206,37,2024-02-06,23,13,36,49,Lyg260_T,"-37.80107122, 144.96704554"
371020250322,37,2025-03-22,10,76,63,139,Lyg260_T,"-37.80107122, 144.96704554"
44020240803,44,2024-08-03,0,8,6,14,UM3_T,"-37.79698741, 144.96441306"
45120231108,45,2023-11-08,1,15,39,54,Swa148_T,"-37.81414075, 144.96609379"
1081420250311,108,2025-03-11,14,511,280,791,261Will_T,"-37.81295822, 144.95678789"
1321320250522,132,2025-05-22,13,231,165,396,King335_T,"-37.81267639, 144.95386444"
1072020250926,107,2025-09-26,20,63,79,142,280Will_T,"-37.81246271, 144.95690188"
1341220240126,134,2024-01-26,12,329,334,663,Spen201_T,"-37.81694221, 144.95303935"
1081020250823,108,2025-08-23,10,126,97,223,261Will_T,"-37.81295822, 144.95678789"
182220250418,182,2025-04-18,2,45,89,134,King163_T,"-37.81627451, 144.95550503"
1851320250815,185,2025-08-15,13,815,892,1707,Eli197_T,"-37.81374643, 144.96276183"
179820250504,179,2025-05-04,8,25,10,35,Pow61_T,"-37.82392385, 144.96299677"
131620241008,131,2024-10-08,6,24,16,40,King2_T,"-37.82009057, 144.95758725"
162120241004,162,2024-10-04,1,63,44,107,Eli489_T,"-37.80740397, 144.95987909"
1401320250606,140,2025-06-06,13,86,49,135,Boyd2837_T,"-37.82590962, 144.96185972"
132820250218,132,2025-02-18,8,166,117,283,King335_T,"-37.81267639, 144.95386444"
681220240106,68,2024-01-06,12,257,142,399,FLDegN_T,"-37.8168479, 144.96559789"
17720231224,17,2023-12-24,7,37,23,60,Col15_T,"-37.81362543, 144.97323591"
17720240108,17,2024-01-08,7,189,61,250,Col15_T,"-37.81362543, 144.97323591"
672220231224,67,2023-12-24,22,14,22,36,FLDegS_T,"-37.81688755, 144.96562569"
67620241113,67,2024-11-13,6,107,53,160,FLDegS_T,"-37.81688755, 144.96562569"
68620240120,68,2024-01-20,6,11,7,18,FLDegN_T,"-37.8168479, 144.96559789"
18420250321,18,2025-03-21,4,3,2,5,Col12_T,"-37.81344862, 144.97305353"
861920240215,86,2024-02-15,19,72,61,133,574Qub_T,"-37.80309992, 144.94908064"
541320250603,54,2025-06-03,13,128,108,236,Swa607_T,"-37.804024, 144.96308399"
54220240918,54,2024-09-18,2,17,3,20,Swa607_T,"-37.804024, 144.96308399"
37420240823,37,2024-08-23,4,2,5,7,Lyg260_T,"-37.80107122, 144.96704554"
372120231122,37,2023-11-22,21,41,41,82,Lyg260_T,"-37.80107122, 144.96704554"
471720240106,47,2024-01-06,17,721,673,1394,Eli250_T,"-37.81258467, 144.9625775"
45120250623,45,2025-06-23,1,6,0,6,Swa148_T,"-37.81414075, 144.96609379"
51320240706,5,2024-07-06,13,1258,2083,3341,PriNW_T,"-37.81874249, 144.96787656"
1822020251002,182,2025-10-02,20,227,249,476,King163_T,"-37.81627451, 144.95550503"
167520250514,167,2025-05-14,5,1,3,4,Lat526_T,"-37.81304149, 144.95155955"
1312220231227,131,2023-12-27,22,153,88,241,King2_T,"-37.82009057, 144.95758725"
134120250924,134,2025-09-24,1,15,23,38,Spen201_T,"-37.81694221, 144.95303935"
1071720240819,107,2024-08-19,17,188,144,332,280Will_T,"-37.81246271, 144.95690188"
1071920250819,107,2025-08-19,19,79,76,155,280Will_T,"-37.81246271, 144.95690188"
66220240102,66,2024-01-02,2,14,9,23,QVN_T,"-37.81057846, 144.96444294"
701020240226,70,2024-02-26,10,81,90,171,Errol20_T,"-37.80456984, 144.94946228"
3720250901,3,2025-09-01,7,65,123,188,Swa295_T,"-37.81101524, 144.96429485"
771720250129,77,2025-01-29,17,292,131,423,HarEsP_T,"-37.81441438, 144.94433026"
422020240629,42,2024-06-29,20,20,25,45,UM1_T,"-37.80008566, 144.96386412"
771420240116,77,2024-01-16,14,87,55,142,HarEsP_T,"-37.81441438, 144.94433026"
421520250302,42,2025-03-02,15,87,75,162,UM1_T,"-37.80008566, 144.96386412"
591620231215,59,2023-12-15,16,828,534,1362,RMIT_T,"-37.80825648, 144.96304859"
651520240904,65,2024-09-04,15,788,664,1452,SwaCs_T,"-37.81569416, 144.9668064"
36320240617,36,2024-06-17,3,10,7,17,Que85_T,"-37.81652527, 144.96121062"
431620250704,43,2025-07-04,16,145,151,296,UM2_T,"-37.79844526, 144.96411782"
51220240426,5,2024-04-26,12,841,1078,1919,PriNW_T,"-37.81874249, 144.96787656"
1331220240518,133,2024-05-18,12,424,424,848,Spen229_T,"-37.81531435, 144.95227769"
133320241105,133,2024-11-05,3,16,24,40,Spen229_T,"-37.81531435, 144.95227769"
1181620250829,118,2025-08-29,16,25,30,55,Fli114C_T,"-37.81632783, 144.97090512"
1241220240117,124,2024-01-17,12,0,1,1,BirBridge_T,"-37.81757416, 144.97329934"
1182320240503,118,2024-05-03,23,52,13,65,Fli114C_T,"-37.81632783, 144.97090512"
612120241228,61,2024-12-28,21,140,139,279,RMIT14_T,"-37.80767455, 144.96309114"
87220241229,87,2024-12-29,2,3,0,3,Errol23_T,"-37.80454949, 144.94921863"
611920240419,61,2024-04-19,19,361,417,778,RMIT14_T,"-37.80767455, 144.96309114"
501320241029,50,2024-10-29,13,183,175,358,Lyg309_T,"-37.79808192, 144.96721013"
179920250804,179,2025-08-04,9,56,42,98,Pow61_T,"-37.82392385, 144.96299677"
1671420240922,167,2024-09-22,14,45,51,96,Lat526_T,"-37.81304149, 144.95155955"
1432220250701,143,2025-07-01,22,62,59,121,Spencer_T,"-37.821728, 144.95557015"
143420251013,143,2025-10-13,4,26,4,30,Spencer_T,"-37.821728, 144.95557015"
48820231216,48,2023-12-16,8,107,127,234,QVMQ_T,"-37.80631581, 144.95866697"
20120250311,20,2025-03-11,1,17,19,36,LtB170_T,"-37.81172914, 144.9682466"
201120240520,20,2024-05-20,11,138,116,254,LtB170_T,"-37.81172914, 144.9682466"
1411520250307,141,2025-03-07,15,185,178,363,474Fl_T,"-37.81997273, 144.95834911"
141520231125,141,2023-11-25,5,13,13,26,474Fl_T,"-37.81997273, 144.95834911"
137520250420,137,2025-04-20,5,0,1,1,BouHbr2353_T,"-37.81894815, 144.94612292"
139520240807,139,2024-08-07,5,1,2,3,Signal1647_T,"-37.81959923, 144.9632832"
1361220241208,136,2024-12-08,12,200,127,327,BirFed1120_T,"-37.8184141, 144.97357915"
130720240806,130,2024-08-06,7,1,1,2,Bou892T,"-37.8204637, 144.94126826"
1642120241022,164,2024-10-22,21,40,82,122,Lat526_T,"-37.813005, 144.95160411"
491820250529,49,2025-05-29,18,315,303,618,Eli501_T,"-37.80730068, 144.95956055"
109320231114,109,2023-11-14,3,1,11,12,LatWill_T,"-37.81193681, 144.95621105"
66220250802,66,2025-08-02,2,55,43,98,QVN_T,"-37.81057846, 144.96444294"
84620250613,84,2025-06-13,6,236,85,321,ElFi_T,"-37.81798049, 144.96503383"
4520240329,4,2024-03-29,5,36,24,60,Swa123_T,"-37.81487988, 144.9660878"
41420240819,4,2024-08-19,14,1143,1089,2232,Swa123_T,"-37.81487988, 144.9660878"
702020240610,70,2024-06-10,20,60,65,125,Errol20_T,"-37.80456984, 144.94946228"
39120231115,39,2023-11-15,1,1,5,6,AlfPl_T,"-37.81379749, 144.96995745"
39720250410,39,2025-04-10,7,44,37,81,AlfPl_T,"-37.81379749, 144.96995745"
41920240713,41,2024-07-13,9,114,204,318,Swa31,"-37.81668634, 144.96689733"
411220231028,41,2023-10-28,12,1840,1209,3049,Swa31,"-37.81668634, 144.96689733"
78720240620,78,2024-06-20,7,9,2,11,HarEsB_T,"-37.81471642, 144.9446508"
291220240906,29,2024-09-06,12,265,316,581,AG_T,"-37.8199817, 144.96872865"
141820240711,14,2024-07-11,18,563,180,743,SanBri_T,"-37.82011242, 144.96291897"
591220241022,59,2024-10-22,12,505,653,1158,RMIT_T,"-37.80825648, 144.96304859"
47220240713,47,2024-07-13,2,76,64,140,Eli250_T,"-37.81258467, 144.9625775"
471220231126,47,2023-11-26,12,915,1002,1917,Eli250_T,"-37.81258467, 144.9625775"
36120241203,36,2024-12-03,1,7,10,17,Que85_T,"-37.81652527, 144.96121062"
451620240208,45,2024-02-08,16,504,681,1185,Swa148_T,"-37.81414075, 144.96609379"
133620231207,133,2023-12-07,6,409,247,656,Spen229_T,"-37.81531435, 144.95227769"
133320231213,133,2023-12-13,3,18,20,38,Spen229_T,"-37.81531435, 144.95227769"
132120250708,132,2025-07-08,1,8,7,15,King335_T,"-37.81267639, 144.95386444"
108220240106,108,2024-01-06,2,29,16,45,261Will_T,"-37.81295822, 144.95678789"
611320240511,61,2024-05-11,13,334,540,874,RMIT14_T,"-37.80767455, 144.96309114"
50220250414,50,2025-04-14,2,6,1,7,Lyg309_T,"-37.79808192, 144.96721013"
167620250301,167,2025-03-01,6,3,19,22,Lat526_T,"-37.81304149, 144.95155955"
1661420241103,166,2024-11-03,14,59,44,103,Spen484_T,"-37.80896733, 144.94931703"
132520240127,132,2024-01-27,5,7,2,9,King335_T,"-37.81267639, 144.95386444"
1341920240129,134,2024-01-29,19,290,249,539,Spen201_T,"-37.81694221, 144.95303935"
6920240924,6,2024-09-24,9,557,927,1484,FliS_T,"-37.81911705, 144.96558255"
61520241013,6,2024-10-13,15,1184,973,2157,FliS_T,"-37.81911705, 144.96558255"
4420240619,4,2024-06-19,4,6,14,20,Swa123_T,"-37.81487988, 144.9660878"
42020240626,4,2024-06-26,20,360,342,702,Swa123_T,"-37.81487988, 144.9660878"
70720240318,70,2024-03-18,7,28,29,57,Errol20_T,"-37.80456984, 144.94946228"
70120240418,70,2024-04-18,1,1,2,3,Errol20_T,"-37.80456984, 144.94946228"
70820250818,70,2025-08-18,8,96,80,176,Errol20_T,"-37.80456984, 144.94946228"
70520250911,70,2025-09-11,5,0,3,3,Errol20_T,"-37.80456984, 144.94946228"
31820250810,3,2025-08-10,18,1193,1437,2630,Swa295_T,"-37.81101524, 144.96429485"
31320240815,3,2024-08-15,13,1009,1131,2140,Swa295_T,"-37.81101524, 144.96429485"
31020241012,3,2024-10-12,10,378,389,767,Swa295_T,"-37.81101524, 144.96429485"
32020241101,3,2024-11-01,20,1114,985,2099,Swa295_T,"-37.81101524, 144.96429485"
751620241221,75,2024-12-21,16,32,42,74,SprFli_T,"-37.81515276, 144.97467661"
3320250228,3,2025-02-28,3,73,19,92,Swa295_T,"-37.81101524, 144.96429485"
132120240711,132,2024-07-11,1,13,9,22,King335_T,"-37.81267639, 144.95386444"
85820250113,85,2025-01-13,8,99,46,145,488Mac_T,"-37.79432415, 144.92973378"
852120250423,85,2025-04-23,21,5,6,11,488Mac_T,"-37.79432415, 144.92973378"
85020250908,85,2025-09-08,0,0,1,1,488Mac_T,"-37.79432415, 144.92973378"
85520250531,85,2025-05-31,5,3,0,3,488Mac_T,"-37.79432415, 144.92973378"
1320231227,1,2023-12-27,3,45,41,86,Bou292_T,"-37.81349441, 144.96515323"
1620241007,1,2024-10-07,6,22,42,64,Bou292_T,"-37.81349441, 144.96515323"
62720240204,62,2024-02-04,7,14,31,45,Lat224_T,"-37.80996494, 144.96216521"
621020241025,62,2024-10-25,10,171,208,379,Lat224_T,"-37.80996494, 144.96216521"
562220241112,56,2024-11-12,22,130,141,271,Lon364_T,"-37.81234775, 144.96153311"
86820240424,86,2024-04-24,8,51,40,91,574Qub_T,"-37.80309992, 144.94908064"
122020240722,12,2024-07-22,20,158,124,282,NewQ_T,"-37.81457988, 144.94292398"
86120240922,86,2024-09-22,1,0,2,2,574Qub_T,"-37.80309992, 144.94908064"
10020241215,10,2024-12-15,0,31,6,37,BouHbr_T,"-37.81876474, 144.94710545"
102020250404,10,2025-04-04,20,49,38,87,BouHbr_T,"-37.81876474, 144.94710545"
581620240421,58,2024-04-21,16,487,312,799,Bou688_T,"-37.81686075, 144.95358075"
231520240713,23,2024-07-13,15,181,397,578,Col623_T,"-37.81909256, 144.95452748"
521620240801,52,2024-08-01,16,388,309,697,Eli263_T,"-37.81252157, 144.9619401"
52620240922,52,2024-09-22,6,9,14,23,Eli263_T,"-37.81252157, 144.9619401"
481820251006,48,2025-10-06,18,127,141,268,QVMQ_T,"-37.80631581, 144.95866697"
201320240604,20,2024-06-04,13,195,239,434,LtB170_T,"-37.81172914, 144.9682466"
1412120250421,141,2025-04-21,21,42,82,124,474Fl_T,"-37.81997273, 144.95834911"
137120250316,137,2025-03-16,1,1,0,1,BouHbr2353_T,"-37.81894815, 144.94612292"
139820250711,139,2025-07-11,8,34,316,350,Signal1647_T,"-37.81959923, 144.9632832"
142720251010,142,2025-10-10,7,241,213,454,Hammer1584_T,"-37.81970749, 144.96795734"
142820240622,142,2024-06-22,8,224,119,343,Hammer1584_T,"-37.81970749, 144.96795734"
49020241223,49,2024-12-23,0,27,32,59,Eli501_T,"-37.80730068, 144.95956055"
492020250105,49,2025-01-05,20,157,88,245,Eli501_T,"-37.80730068, 144.95956055"
117120240905,117,2024-09-05,1,8,10,18,Fli114F_T,"-37.81629332, 144.97090877"
1171120231115,117,2023-11-15,11,129,144,273,Fli114F_T,"-37.81629332, 144.97090877"
1171720240222,117,2024-02-22,17,186,473,659,Fli114F_T,"-37.81629332, 144.97090877"
109320250527,109,2025-05-27,3,0,2,2,LatWill_T,"-37.81193681, 144.95621105"
691920240408,69,2024-04-08,19,12,9,21,FLDegC_T,"-37.81687226, 144.96559144"
6120250801,6,2025-08-01,1,19,37,56,FliS_T,"-37.81911705, 144.96558255"
6220251017,6,2025-10-17,2,5,18,23,FliS_T,"-37.81911705, 144.96558255"
841620250323,84,2025-03-23,16,888,1398,2286,ElFi_T,"-37.81798049, 144.96503383"
41320231020,4,2023-10-20,13,1640,1419,3059,Swa123_T,"-37.81487988, 144.9660878"
661520231213,66,2023-12-13,15,998,933,1931,QVN_T,"-37.81057846, 144.96444294"
4920240904,4,2024-09-04,9,338,310,648,Swa123_T,"-37.81487988, 144.9660878"
42220250921,4,2025-09-21,22,231,724,955,Swa123_T,"-37.81487988, 144.9660878"
39520241107,39,2024-11-07,5,0,1,1,AlfPl_T,"-37.81379749, 144.96995745"
411320240803,41,2024-08-03,13,452,484,936,Swa31,"-37.81668634, 144.96689733"
42120250415,42,2025-04-15,1,3,7,10,UM1_T,"-37.80008566, 144.96386412"
422120250724,42,2025-07-24,21,42,33,75,UM1_T,"-37.80008566, 144.96386412"
291220250501,29,2025-05-01,12,205,401,606,AG_T,"-37.8199817, 144.96872865"
47320250105,47,2025-01-05,3,41,46,87,Eli250_T,"-37.81258467, 144.9625775"
47220241020,47,2024-10-20,2,101,90,191,Eli250_T,"-37.81258467, 144.9625775"
40520240702,40,2024-07-02,5,10,6,16,Spr201_T,"-37.80999341, 144.97227587"
371320250520,37,2025-05-20,13,135,108,243,Lyg260_T,"-37.80107122, 144.96704554"
37520250721,37,2025-07-21,5,0,1,1,Lyg260_T,"-37.80107122, 144.96704554"
81820231109,8,2023-11-09,18,176,242,418,WebBN_T,"-37.82293543, 144.9471751"
81520240131,8,2024-01-31,15,148,230,378,WebBN_T,"-37.82293543, 144.9471751"
772020240513,77,2024-05-13,20,19,16,35,HarEsP_T,"-37.81441438, 144.94433026"
782120250109,78,2025-01-09,21,7,13,20,HarEsB_T,"-37.81471642, 144.9446508"
71120250417,71,2025-04-17,1,3,2,5,WestWP_T,"-37.81235775, 144.97136962"
711720250717,71,2025-07-17,17,48,30,78,WestWP_T,"-37.81235775, 144.97136962"
712220250807,71,2025-08-07,22,7,2,9,WestWP_T,"-37.81235775, 144.97136962"
591320240822,59,2024-08-22,13,1424,1363,2787,RMIT_T,"-37.80825648, 144.96304859"
59120240124,59,2024-01-24,1,65,21,86,RMIT_T,"-37.80825648, 144.96304859"
282320241122,28,2024-11-22,23,269,1254,1523,VAC_T,"-37.82129925, 144.96879309"
31020250421,31,2025-04-21,0,14,40,54,Lyg161_T,"-37.80169681, 144.96658911"
311420250517,31,2025-05-17,14,124,130,254,Lyg161_T,"-37.80169681, 144.96658911"
312120250811,31,2025-08-11,21,102,138,240,Lyg161_T,"-37.80169681, 144.96658911"
311220250910,31,2025-09-10,12,188,153,341,Lyg161_T,"-37.80169681, 144.96658911"
312220251014,31,2025-10-14,22,63,99,162,Lyg161_T,"-37.80169681, 144.96658911"
311320240513,31,2024-05-13,13,183,176,359,Lyg161_T,"-37.80169681, 144.96658911"
361020240403,36,2024-04-03,10,142,152,294,Que85_T,"-37.81652527, 144.96121062"
471420250523,47,2025-05-23,14,863,861,1724,Eli250_T,"-37.81258467, 144.9625775"
21920250513,21,2025-05-13,9,88,63,151,Bourke155_T,"-37.81267313, 144.96788288"
51320231203,5,2023-12-03,13,2184,2048,4232,PriNW_T,"-37.81874249, 144.96787656"
133720241109,133,2024-11-09,7,144,209,353,Spen229_T,"-37.81531435, 144.95227769"
1321320250405,132,2025-04-05,13,165,104,269,King335_T,"-37.81267639, 144.95386444"
871720240713,87,2024-07-13,17,86,90,176,Errol23_T,"-37.80454949, 144.94921863"
872120240913,87,2024-09-13,21,26,39,65,Errol23_T,"-37.80454949, 144.94921863"
611620240508,61,2024-05-08,16,634,700,1334,RMIT14_T,"-37.80767455, 144.96309114"
611820240511,61,2024-05-11,18,324,364,688,RMIT14_T,"-37.80767455, 144.96309114"
61720240401,61,2024-04-01,7,10,43,53,RMIT14_T,"-37.80767455, 144.96309114"
1672020250930,167,2025-09-30,20,7,22,29,Lat526_T,"-37.81304149, 144.95155955"
132820241228,132,2024-12-28,8,61,48,109,King335_T,"-37.81267639, 144.95386444"
1341320240826,134,2024-08-26,13,375,349,724,Spen201_T,"-37.81694221, 144.95303935"
1342020231105,134,2023-11-05,20,252,302,554,Spen201_T,"-37.81694221, 144.95303935"
135820240803,135,2024-08-03,8,128,176,304,Spen161_T,"-37.8172861, 144.95319102"
851420241007,85,2024-10-07,14,48,58,106,488Mac_T,"-37.79432415, 144.92973378"
12020250715,1,2025-07-15,20,239,315,554,Bou292_T,"-37.81349441, 144.96515323"
67520240828,67,2024-08-28,5,17,8,25,FLDegS_T,"-37.81688755, 144.96562569"
182020240327,18,2024-03-27,20,15,15,30,Col12_T,"-37.81344862, 144.97305353"
63120241001,63,2024-10-01,1,1,13,14,Bou231_T,"-37.81333081, 144.96675571"
681320231126,68,2023-11-26,13,285,197,482,FLDegN_T,"-37.8168479, 144.96559789"
861520251012,86,2025-10-12,15,55,103,158,574Qub_T,"-37.80309992, 144.94908064"
111920250811,11,2025-08-11,19,77,80,157,WatCit_T,"-37.81564989, 144.93970694"
10920250205,10,2025-02-05,9,59,136,195,BouHbr_T,"-37.81876474, 144.94710545"
581720240830,58,2024-08-30,17,792,826,1618,Bou688_T,"-37.81686075, 144.95358075"
76620231105,76,2023-11-05,6,3,3,6,KenMac_T,"-37.79453803, 144.93036194"
30320240429,30,2024-04-29,3,23,39,62,Lon189_T,"-37.8112185, 144.96656806"
91520250715,9,2025-07-15,15,864,177,1041,Col700_T,"-37.81982992, 144.95102555"
53120240505,53,2024-05-05,1,21,29,50,Col254_T,"-37.81564191, 144.965499"
791920250518,79,2025-05-18,19,189,271,460,FliSS_T,"-37.81794046, 144.96616678"
231320240524,23,2024-05-24,13,250,447,697,Col623_T,"-37.81909256, 144.95452748"
231820231209,23,2023-12-09,18,122,146,268,Col623_T,"-37.81909256, 144.95452748"
20620251012,20,2025-10-12,6,22,18,40,LtB170_T,"-37.81172914, 144.9682466"
521520250901,52,2025-09-01,15,345,184,529,Eli263_T,"-37.81252157, 144.9619401"
1411620240830,141,2024-08-30,16,132,137,269,474Fl_T,"-37.81997273, 144.95834911"
141220240707,141,2024-07-07,2,46,49,95,474Fl_T,"-37.81997273, 144.95834911"
139420250412,139,2025-04-12,4,6,1,7,Signal1647_T,"-37.81959923, 144.9632832"
136520241004,136,2024-10-04,5,4,3,7,BirFed1120_T,"-37.8184141, 144.97357915"
1172320250705,117,2025-07-05,23,262,85,347,Fli114F_T,"-37.81629332, 144.97090877"
123820250912,123,2025-09-12,8,52,20,72,BirBridge_T,"-37.81753741, 144.97329734"
138420250818,138,2025-08-18,4,0,1,1,EntPark1671_T,"-37.81996544, 144.95981454"
41520240304,4,2024-03-04,15,1558,1385,2943,Swa123_T,"-37.81487988, 144.9660878"
8620250625,8,2025-06-25,6,2,2,4,WebBN_T,"-37.82293543, 144.9471751"
421420250120,42,2025-01-20,14,77,82,159,UM1_T,"-37.80008566, 144.96386412"
77120240521,77,2024-05-21,1,0,1,1,HarEsP_T,"-37.81441438, 144.94433026"
771820250817,77,2025-08-17,18,184,135,319,HarEsP_T,"-37.81441438, 144.94433026"
772120240213,77,2024-02-13,21,120,131,251,HarEsP_T,"-37.81441438, 144.94433026"
711520241006,71,2024-10-06,15,12,9,21,WestWP_T,"-37.81235775, 144.97136962"
591420240713,59,2024-07-13,14,525,547,1072,RMIT_T,"-37.80825648, 144.96304859"
28020241011,28,2024-10-11,0,28,7,35,VAC_T,"-37.82129925, 144.96879309"
29420250201,29,2025-02-01,4,7,9,16,AG_T,"-37.8199817, 144.96872865"
471620241002,47,2024-10-02,16,1130,878,2008,Eli250_T,"-37.81258467, 144.9625775"
361420240206,36,2024-02-06,14,191,256,447,Que85_T,"-37.81652527, 144.96121062"
371620250724,37,2025-07-24,16,124,85,209,Lyg260_T,"-37.80107122, 144.96704554"
52120240827,5,2024-08-27,21,366,257,623,PriNW_T,"-37.81874249, 144.96787656"
211820231124,21,2023-11-24,18,518,423,941,Bourke155_T,"-37.81267313, 144.96788288"
1081620250303,108,2025-03-03,16,1004,300,1304,261Will_T,"-37.81295822, 144.95678789"
871720251015,87,2025-10-15,17,106,125,231,Errol23_T,"-37.80454949, 144.94921863"
1082120240717,108,2024-07-17,21,42,79,121,261Will_T,"-37.81295822, 144.95678789"
61620241118,61,2024-11-18,6,33,54,87,RMIT14_T,"-37.80767455, 144.96309114"
50220231208,50,2023-12-08,2,2,2,4,Lyg309_T,"-37.79808192, 144.96721013"
431120241213,43,2024-12-13,11,77,95,172,UM2_T,"-37.79844526, 144.96411782"
1661420250704,166,2025-07-04,14,60,56,116,Spen484_T,"-37.80896733, 144.94931703"
179120250313,179,2025-03-13,1,3,2,5,Pow61_T,"-37.82392385, 144.96299677"
1791020250506,179,2025-05-06,10,55,36,91,Pow61_T,"-37.82392385, 144.96299677"
165120240901,165,2024-09-01,1,2,0,2,Spen475_T,"-37.80953359, 144.94939004"
131620240306,131,2024-03-06,6,14,22,36,King2_T,"-37.82009057, 144.95758725"
1621420250723,162,2025-07-23,14,276,336,612,Eli489_T,"-37.80740397, 144.95987909"
1071020231112,107,2023-11-12,10,63,77,140,280Will_T,"-37.81246271, 144.95690188"
1321420240410,132,2024-04-10,14,170,137,307,King335_T,"-37.81267639, 144.95386444"
134620241205,134,2024-12-05,6,156,162,318,Spen201_T,"-37.81694221, 144.95303935"
1351720240918,135,2024-09-18,17,546,485,1031,Spen161_T,"-37.8172861, 144.95319102"
17820240208,17,2024-02-08,8,1486,240,1726,Col15_T,"-37.81362543, 144.97323591"
172020240830,17,2024-08-30,20,97,117,214,Col15_T,"-37.81362543, 144.97323591"
171620250327,17,2025-03-27,16,274,419,693,Col15_T,"-37.81362543, 144.97323591"
181820241212,18,2024-12-12,18,371,105,476,Col12_T,"-37.81344862, 144.97305353"
631020250302,63,2025-03-02,10,159,257,416,Bou231_T,"-37.81333081, 144.96675571"
86020240102,86,2024-01-02,0,2,1,3,574Qub_T,"-37.80309992, 144.94908064"
44120240802,44,2024-08-02,1,1,1,2,UM3_T,"-37.79698741, 144.96441306"
441220250217,44,2025-02-17,12,55,74,129,UM3_T,"-37.79698741, 144.96441306"
442120250620,44,2025-06-20,21,18,13,31,UM3_T,"-37.79698741, 144.96441306"
1181220250406,118,2025-04-06,12,23,22,45,Fli114C_T,"-37.81632783, 144.97090512"
1241820231020,124,2023-10-20,18,1,5,6,BirBridge_T,"-37.81757416, 144.97329934"
108020231028,108,2023-10-28,0,64,46,110,261Will_T,"-37.81295822, 144.95678789"
871720250326,87,2025-03-26,17,152,125,277,Errol23_T,"-37.80454949, 144.94921863"
50320250529,50,2025-05-29,3,1,0,1,Lyg309_T,"-37.79808192, 144.96721013"
50620240717,50,2024-07-17,6,5,5,10,Lyg309_T,"-37.79808192, 144.96721013"
43220250223,43,2025-02-23,2,2,0,2,UM2_T,"-37.79844526, 144.96411782"
1821120250419,182,2025-04-19,11,240,194,434,King163_T,"-37.81627451, 144.95550503"
1842120250926,184,2025-09-26,21,252,488,740,Eli124_T,"-37.81512416, 144.96371988"
140720241006,140,2024-10-06,7,28,8,36,Boyd2837_T,"-37.82590962, 144.96185972"
134420250613,134,2025-06-13,4,12,17,29,Spen201_T,"-37.81694221, 144.95303935"
1352120250128,135,2025-01-28,21,143,204,347,Spen161_T,"-37.8172861, 144.95319102"
671720240919,67,2024-09-19,17,426,747,1173,FLDegS_T,"-37.81688755, 144.96562569"
852220231025,85,2023-10-25,22,4,8,12,488Mac_T,"-37.79432415, 144.92973378"
851320241028,85,2024-10-28,13,61,73,134,488Mac_T,"-37.79432415, 144.92973378"
11320241107,1,2024-11-07,13,1450,1245,2695,Bou292_T,"-37.81349441, 144.96515323"
1320241114,1,2024-11-14,3,7,12,19,Bou292_T,"-37.81349441, 144.96515323"
68120250803,68,2025-08-03,1,4,4,8,FLDegN_T,"-37.8168479, 144.96559789"
181520240728,18,2024-07-28,15,84,28,112,Col12_T,"-37.81344862, 144.97305353"
67420250501,67,2025-05-01,4,0,3,3,FLDegS_T,"-37.81688755, 144.96562569"
621120241006,62,2024-10-06,11,128,138,266,Lat224_T,"-37.80996494, 144.96216521"
56920240317,56,2024-03-17,9,159,66,225,Lon364_T,"-37.81234775, 144.96153311"
561120240511,56,2024-05-11,11,237,185,422,Lon364_T,"-37.81234775, 144.96153311"
86020240410,86,2024-04-10,0,2,3,5,574Qub_T,"-37.80309992, 144.94908064"
11820240207,11,2024-02-07,8,81,81,162,WatCit_T,"-37.81564989, 144.93970694"
1920250923,1,2025-09-23,9,301,386,687,Bou292_T,"-37.81349441, 144.96515323"
24620250211,24,2025-02-11,6,410,136,546,Col620_T,"-37.81887963, 144.95449198"
72720240331,72,2024-03-31,7,14,23,37,ACMI_T,"-37.81726338, 144.96872809"
351920240820,35,2024-08-20,19,706,727,1433,SouthB_T,"-37.82018685, 144.96508508"
22320240709,2,2024-07-09,23,11,20,31,Bou283_T,"-37.81380668, 144.96516718"
231020241010,23,2024-10-10,10,288,244,532,Col623_T,"-37.81909256, 144.95452748"
79920241201,79,2024-12-01,9,230,152,382,FliSS_T,"-37.81794046, 144.96616678"
52820241122,52,2024-11-22,8,117,215,332,Eli263_T,"-37.81252157, 144.9619401"
46620240830,46,2024-08-30,6,6,1,7,Pel147_T,"-37.80240719, 144.9615673"
301620251003,30,2025-10-03,16,308,409,717,Lon189_T,"-37.8112185, 144.96656806"
141720240114,141,2024-01-14,7,40,11,51,474Fl_T,"-37.81997273, 144.95834911"
130620250716,130,2025-07-16,6,10,1,11,Bou892T,"-37.8204637, 144.94126826"
1642320250717,164,2025-07-17,23,6,21,27,Lat526_T,"-37.813005, 144.95160411"
49520240906,49,2024-09-06,5,25,20,45,Eli501_T,"-37.80730068, 144.95956055"
62220240114,6,2024-01-14,22,457,298,755,FliS_T,"-37.81911705, 144.96558255"
841920240307,84,2024-03-07,19,830,1223,2053,ElFi_T,"-37.81798049, 144.96503383"
4920250107,4,2025-01-07,9,673,457,1130,Swa123_T,"-37.81487988, 144.9660878"
41820250521,4,2025-05-21,18,1066,1223,2289,Swa123_T,"-37.81487988, 144.9660878"
70420250126,70,2025-01-26,4,3,3,6,Errol20_T,"-37.80456984, 144.94946228"
31720250111,3,2025-01-11,17,957,1039,1996,Swa295_T,"-37.81101524, 144.96429485"
392020250718,39,2025-07-18,20,19,10,29,AlfPl_T,"-37.81379749, 144.96995745"
82320250820,8,2025-08-20,23,7,6,13,WebBN_T,"-37.82293543, 144.9471751"
751120250420,75,2025-04-20,11,33,28,61,SprFli_T,"-37.81515276, 144.97467661"
751520240120,75,2024-01-20,15,61,66,127,SprFli_T,"-37.81515276, 144.97467661"
78920250718,78,2025-07-18,9,41,26,67,HarEsB_T,"-37.81471642, 144.9446508"
722220250128,72,2025-01-28,22,77,89,166,ACMI_T,"-37.81726338, 144.96872809"
72920231226,72,2023-12-26,9,165,128,293,ACMI_T,"-37.81726338, 144.96872809"
27820250313,27,2025-03-13,8,71,118,189,Vic_T,"-37.80606888, 144.95644692"
79620240208,79,2024-02-08,6,146,67,213,FliSS_T,"-37.81794046, 144.96616678"
9620250114,9,2025-01-14,6,24,243,267,Col700_T,"-37.81982992, 144.95102555"
531520250801,53,2025-08-01,15,671,475,1146,Col254_T,"-37.81564191, 144.965499"
30920250416,30,2025-04-16,9,95,127,222,Lon189_T,"-37.8112185, 144.96656806"
461620250207,46,2025-02-07,16,53,75,128,Pel147_T,"-37.80240719, 144.9615673"
512120240719,51,2024-07-19,21,43,56,99,Fra118_T,"-37.80841815, 144.95906316"
191620231205,19,2023-12-05,16,402,421,823,LtB210_T,"-37.81237202, 144.96550671"
301220250816,30,2025-08-16,12,302,435,737,Lon189_T,"-37.8112185, 144.96656806"
1412320241113,141,2024-11-13,23,30,121,151,474Fl_T,"-37.81997273, 144.95834911"
1371220240302,137,2024-03-02,12,11,24,35,BouHbr2353_T,"-37.81894815, 144.94612292"
1372220250915,137,2025-09-15,22,0,2,2,BouHbr2353_T,"-37.81894815, 144.94612292"
1171620231027,117,2023-10-27,16,147,216,363,Fli114F_T,"-37.81629332, 144.97090877"
66320250221,66,2025-02-21,3,25,9,34,QVN_T,"-37.81057846, 144.96444294"
661520250713,66,2025-07-13,15,1525,1467,2992,QVN_T,"-37.81057846, 144.96444294"
701220250217,70,2025-02-17,12,181,178,359,Errol20_T,"-37.80456984, 144.94946228"
392020240421,39,2024-04-21,20,25,25,50,AlfPl_T,"-37.81379749, 144.96995745"
75920250108,75,2025-01-08,9,36,42,78,SprFli_T,"-37.81515276, 144.97467661"
75620250201,75,2025-02-01,6,14,8,22,SprFli_T,"-37.81515276, 144.97467661"
781720240401,78,2024-04-01,17,12,43,55,HarEsB_T,"-37.81471642, 144.9446508"
14120240819,14,2024-08-19,1,27,3,30,SanBri_T,"-37.82011242, 144.96291897"
14720250124,14,2025-01-24,7,131,107,238,SanBri_T,"-37.82011242, 144.96291897"
141020240109,14,2024-01-09,10,258,72,330,SanBri_T,"-37.82011242, 144.96291897"
711020241024,71,2024-10-24,10,32,36,68,WestWP_T,"-37.81235775, 144.97136962"
71320250227,71,2025-02-27,3,5,3,8,WestWP_T,"-37.81235775, 144.97136962"
311720240225,31,2024-02-25,17,225,201,426,Lyg161_T,"-37.80169681, 144.96658911"
36820240906,36,2024-09-06,8,169,148,317,Que85_T,"-37.81652527, 144.96121062"
361520241128,36,2024-11-28,15,230,205,435,Que85_T,"-37.81652527, 144.96121062"
47020250113,47,2025-01-13,0,117,89,206,Eli250_T,"-37.81258467, 144.9625775"
452120250511,45,2025-05-11,21,212,369,581,Swa148_T,"-37.81414075, 144.96609379"
451720250218,45,2025-02-18,17,529,797,1326,Swa148_T,"-37.81414075, 144.96609379"
211320250204,21,2025-02-04,13,258,318,576,Bourke155_T,"-37.81267313, 144.96788288"
1181520250316,118,2025-03-16,15,10,25,35,Fli114C_T,"-37.81632783, 144.97090512"
1241220231111,124,2023-11-11,12,0,4,4,BirBridge_T,"-37.81757416, 144.97329934"
87720250203,87,2025-02-03,7,28,27,55,Errol23_T,"-37.80454949, 144.94921863"
1842020250823,184,2025-08-23,20,533,670,1203,Eli124_T,"-37.81512416, 144.96371988"
1791420250719,179,2025-07-19,14,74,68,142,Pow61_T,"-37.82392385, 144.96299677"
1401120250728,140,2025-07-28,11,77,60,137,Boyd2837_T,"-37.82590962, 144.96185972"
1312320250214,131,2025-02-14,23,115,96,211,King2_T,"-37.82009057, 144.95758725"
1311720250809,131,2025-08-09,17,134,76,210,King2_T,"-37.82009057, 144.95758725"
42620250807,42,2025-08-07,6,7,16,23,UM1_T,"-37.80008566, 144.96386412"
29520240203,29,2024-02-03,5,18,13,31,AG_T,"-37.8199817, 144.96872865"
291520240517,29,2024-05-17,15,45,61,106,AG_T,"-37.8199817, 144.96872865"
712020250331,71,2025-03-31,20,50,41,91,WestWP_T,"-37.81235775, 144.97136962"
281620240823,28,2024-08-23,16,305,643,948,VAC_T,"-37.82129925, 144.96879309"
471920250224,47,2025-02-24,19,658,478,1136,Eli250_T,"-37.81258467, 144.9625775"
361820240815,36,2024-08-15,18,246,209,455,Que85_T,"-37.81652527, 144.96121062"
371820250502,37,2025-05-02,18,65,56,121,Lyg260_T,"-37.80107122, 144.96704554"
441520241119,44,2024-11-19,15,38,31,69,UM3_T,"-37.79698741, 144.96441306"
441320250107,44,2025-01-07,13,56,53,109,UM3_T,"-37.79698741, 144.96441306"
5120240130,5,2024-01-30,1,38,28,66,PriNW_T,"-37.81874249, 144.96787656"
5520250330,5,2025-03-30,5,21,26,47,PriNW_T,"-37.81874249, 144.96787656"
1071920240610,107,2024-06-10,19,41,45,86,280Will_T,"-37.81246271, 144.95690188"
1321620250609,132,2025-06-09,16,108,109,217,King335_T,"-37.81267639, 144.95386444"
87620250418,87,2025-04-18,6,5,2,7,Errol23_T,"-37.80454949, 144.94921863"
166620241028,166,2024-10-28,6,6,5,11,Spen484_T,"-37.80896733, 144.94931703"
1651420250317,165,2025-03-17,14,46,31,77,Spen475_T,"-37.80953359, 144.94939004"
1651620250712,165,2025-07-12,16,199,21,220,Spen475_T,"-37.80953359, 144.94939004"
1671620241029,167,2024-10-29,16,16,19,35,Lat526_T,"-37.81304149, 144.95155955"
132020240601,132,2024-06-01,0,58,39,97,King335_T,"-37.81267639, 144.95386444"
1311520240909,131,2024-09-09,15,87,76,163,King2_T,"-37.82009057, 144.95758725"
1351720250119,135,2025-01-19,17,352,388,740,Spen161_T,"-37.8172861, 144.95319102"
72420240515,72,2024-05-15,4,4,5,9,ACMI_T,"-37.81726338, 144.96872809"
761120240626,76,2024-06-26,11,84,53,137,KenMac_T,"-37.79453803, 144.93036194"
582120231215,58,2023-12-15,21,309,357,666,Bou688_T,"-37.81686075, 144.95358075"
22120250430,2,2025-04-30,21,30,91,121,Bou283_T,"-37.81380668, 144.96516718"
352020250831,35,2025-08-31,20,228,299,527,SouthB_T,"-37.82018685, 144.96508508"
76020250909,76,2025-09-09,0,2,0,2,KenMac_T,"-37.79453803, 144.93036194"
27520241016,27,2024-10-16,5,7,7,14,Vic_T,"-37.80606888, 144.95644692"
30020250708,30,2025-07-08,0,43,44,87,Lon189_T,"-37.8112185, 144.96656806"
792020250413,79,2025-04-13,20,268,348,616,FliSS_T,"-37.81794046, 144.96616678"
461020231025,46,2023-10-25,10,62,116,178,Pel147_T,"-37.80240719, 144.9615673"
481720250222,48,2025-02-22,17,132,146,278,QVMQ_T,"-37.80631581, 144.95866697"
202320250201,20,2025-02-01,23,285,440,725,LtB170_T,"-37.81172914, 144.9682466"
1411520240726,141,2024-07-26,15,135,110,245,474Fl_T,"-37.81997273, 144.95834911"
1371920240118,137,2024-01-18,19,22,28,50,BouHbr2353_T,"-37.81894815, 144.94612292"
1392320240409,139,2024-04-09,23,12,5,17,Signal1647_T,"-37.81959923, 144.9632832"
1422320240827,142,2024-08-27,23,13,18,31,Hammer1584_T,"-37.81970749, 144.96795734"
1641820250429,164,2025-04-29,18,111,81,192,Lat526_T,"-37.813005, 144.95160411"
1802120250811,180,2025-08-11,21,2,3,5,Mac330_T,"-37.79497059, 144.93530329"
1231320231110,123,2023-11-10,13,76,36,112,BirBridge_T,"-37.81753741, 144.97329734"
491320250306,49,2025-03-06,13,296,530,826,Eli501_T,"-37.80730068, 144.95956055"
491620250324,49,2025-03-24,16,252,252,504,Eli501_T,"-37.80730068, 144.95956055"
1171320240711,117,2024-07-11,13,236,180,416,Fli114F_T,"-37.81629332, 144.97090877"
1091720240218,109,2024-02-18,17,103,129,232,LatWill_T,"-37.81193681, 144.95621105"
1091020241130,109,2024-11-30,10,32,34,66,LatWill_T,"-37.81193681, 144.95621105"
682320240225,68,2024-02-25,23,11,1,12,FLDegN_T,"-37.8168479, 144.96559789"
171820240202,17,2024-02-02,18,176,254,430,Col15_T,"-37.81362543, 144.97323591"
68120241230,68,2024-12-30,1,3,0,3,FLDegN_T,"-37.8168479, 144.96559789"
68520241005,68,2024-10-05,5,0,1,1,FLDegN_T,"-37.8168479, 144.96559789"
85520240223,85,2024-02-23,5,7,0,7,488Mac_T,"-37.79432415, 144.92973378"
171620240317,17,2024-03-17,16,233,169,402,Col15_T,"-37.81362543, 144.97323591"
11620240318,1,2024-03-18,16,1002,870,1872,Bou292_T,"-37.81349441, 144.96515323"
67520250210,67,2025-02-10,5,6,8,14,FLDegS_T,"-37.81688755, 144.96562569"
631420250911,63,2025-09-11,14,339,441,780,Bou231_T,"-37.81333081, 144.96675571"
561720250513,56,2025-05-13,17,413,446,859,Lon364_T,"-37.81234775, 144.96153311"
11020250930,1,2025-09-30,10,421,569,990,Bou292_T,"-37.81349441, 144.96515323"
762120250115,76,2025-01-15,21,3,12,15,KenMac_T,"-37.79453803, 144.93036194"
53620240331,53,2024-03-31,6,15,13,28,Col254_T,"-37.81564191, 144.965499"
531920240616,53,2024-06-16,19,123,106,229,Col254_T,"-37.81564191, 144.965499"
231920250316,23,2025-03-16,19,205,360,565,Col623_T,"-37.81909256, 144.95452748"
481020240727,48,2024-07-27,10,328,290,618,QVMQ_T,"-37.80631581, 144.95866697"
49520250713,49,2025-07-13,5,17,16,33,Eli501_T,"-37.80730068, 144.95956055"
137620250811,137,2025-08-11,6,8,1,9,BouHbr2353_T,"-37.81894815, 144.94612292"
1391720231218,139,2023-12-18,17,197,41,238,Signal1647_T,"-37.81959923, 144.9632832"
1392120240322,139,2024-03-22,21,35,32,67,Signal1647_T,"-37.81959923, 144.9632832"
1391220240629,139,2024-06-29,12,9,13,22,Signal1647_T,"-37.81959923, 144.9632832"
136620250626,136,2025-06-26,6,2,1,3,BirFed1120_T,"-37.8184141, 144.97357915"
142720250321,142,2025-03-21,7,120,145,265,Hammer1584_T,"-37.81970749, 144.96795734"
1421120241114,142,2024-11-14,11,182,265,447,Hammer1584_T,"-37.81970749, 144.96795734"
130420250406,130,2025-04-06,4,1,2,3,Bou892T,"-37.8204637, 144.94126826"
1642020240916,164,2024-09-16,20,41,52,93,Lat526_T,"-37.813005, 144.95160411"
1641520250102,164,2025-01-02,15,123,75,198,Lat526_T,"-37.813005, 144.95160411"
1231520250820,123,2025-08-20,15,53,17,70,BirBridge_T,"-37.81753741, 144.97329734"
1231120251010,123,2025-10-10,11,33,23,56,BirBridge_T,"-37.81753741, 144.97329734"
49220240505,49,2024-05-05,2,50,43,93,Eli501_T,"-37.80730068, 144.95956055"
109220240902,109,2024-09-02,2,2,0,2,LatWill_T,"-37.81193681, 144.95621105"
692020241016,69,2024-10-16,20,41,39,80,FLDegC_T,"-37.81687226, 144.96559144"
62320251006,6,2025-10-06,23,196,128,324,FliS_T,"-37.81911705, 144.96558255"
411820250122,41,2025-01-22,18,1365,1471,2836,Swa31,"-37.81668634, 144.96689733"
42220250820,42,2025-08-20,2,1,1,2,UM1_T,"-37.80008566, 144.96386412"
77920240518,77,2024-05-18,9,113,92,205,HarEsP_T,"-37.81441438, 144.94433026"
771820250512,77,2025-05-12,18,258,161,419,HarEsP_T,"-37.81441438, 144.94433026"
54820240414,54,2024-04-14,8,22,28,50,Swa607_T,"-37.804024, 144.96308399"
401120250201,40,2025-02-01,11,96,141,237,Spr201_T,"-37.80999341, 144.97227587"
312220240225,31,2024-02-25,22,82,105,187,Lyg161_T,"-37.80169681, 144.96658911"
312320240814,31,2024-08-14,23,25,22,47,Lyg161_T,"-37.80169681, 144.96658911"
361920250225,36,2025-02-25,19,132,167,299,Que85_T,"-37.81652527, 144.96121062"
45020240403,45,2024-04-03,0,19,61,80,Swa148_T,"-37.81414075, 144.96609379"
451720240510,45,2024-05-10,17,599,846,1445,Swa148_T,"-37.81414075, 144.96609379"
1331420231204,133,2023-12-04,14,475,503,978,Spen229_T,"-37.81531435, 144.95227769"
1071820250712,107,2025-07-12,18,94,141,235,280Will_T,"-37.81246271, 144.95690188"
441520250815,44,2025-08-15,15,73,44,117,UM3_T,"-37.79698741, 144.96441306"
1851220250830,185,2025-08-30,12,675,556,1231,Eli197_T,"-37.81374643, 144.96276183"
1792120241226,179,2024-12-26,21,71,71,142,Pow61_T,"-37.82392385, 144.96299677"
1661520241012,166,2024-10-12,15,70,47,117,Spen484_T,"-37.80896733, 144.94931703"
162520250111,162,2025-01-11,5,32,14,46,Eli489_T,"-37.80740397, 144.95987909"
1321820240416,132,2024-04-16,18,159,179,338,King335_T,"-37.81267639, 144.95386444"
1351220240308,135,2024-03-08,12,391,417,808,Spen161_T,"-37.8172861, 144.95319102"
1351720240405,135,2024-04-05,17,568,454,1022,Spen161_T,"-37.8172861, 144.95319102"
85620241031,85,2024-10-31,6,41,30,71,488Mac_T,"-37.79432415, 144.92973378"
852220250507,85,2025-05-07,22,1,8,9,488Mac_T,"-37.79432415, 144.92973378"
171320240215,17,2024-02-15,13,873,735,1608,Col15_T,"-37.81362543, 144.97323591"
63620240307,63,2024-03-07,6,29,43,72,Bou231_T,"-37.81333081, 144.96675571"
672120250714,67,2025-07-14,21,79,192,271,FLDegS_T,"-37.81688755, 144.96562569"
18420250308,18,2025-03-08,4,1,4,5,Col12_T,"-37.81344862, 144.97305353"
62920250211,62,2025-02-11,9,103,130,233,Lat224_T,"-37.80996494, 144.96216521"
241920240803,24,2024-08-03,19,386,421,807,Col620_T,"-37.81887963, 144.95449198"
72620241029,72,2024-10-29,6,75,42,117,ACMI_T,"-37.81726338, 144.96872809"
72320240125,72,2024-01-25,3,2,5,7,ACMI_T,"-37.81726338, 144.96872809"
761620250115,76,2025-01-15,16,49,69,118,KenMac_T,"-37.79453803, 144.93036194"
35120250410,35,2025-04-10,1,20,45,65,SouthB_T,"-37.82018685, 144.96508508"
352120240920,35,2024-09-20,21,605,1034,1639,SouthB_T,"-37.82018685, 144.96508508"
761920231112,76,2023-11-12,19,22,39,61,KenMac_T,"-37.79453803, 144.93036194"
27920240102,27,2024-01-02,9,36,89,125,Vic_T,"-37.80606888, 144.95644692"
23720250612,23,2025-06-12,7,370,212,582,Col623_T,"-37.81909256, 144.95452748"
46820240828,46,2024-08-28,8,141,56,197,Pel147_T,"-37.80240719, 144.9615673"
191920250322,19,2025-03-22,19,968,676,1644,LtB210_T,"-37.81237202, 144.96550671"
25420241005,25,2024-10-05,4,6,10,16,MCEC_T,"-37.82401776, 144.95604426"
482220251010,48,2025-10-10,22,158,236,394,QVMQ_T,"-37.80631581, 144.95866697"
481020241227,48,2024-12-27,10,223,187,410,QVMQ_T,"-37.80631581, 144.95866697"
201220250205,20,2025-02-05,12,347,257,604,LtB170_T,"-37.81172914, 144.9682466"
25220240126,25,2024-01-26,2,5,16,21,MCEC_T,"-37.82401776, 144.95604426"
1641720250326,164,2025-03-26,17,170,133,303,Lat526_T,"-37.813005, 144.95160411"
1421920240827,142,2024-08-27,19,141,96,237,Hammer1584_T,"-37.81970749, 144.96795734"
1301420241222,130,2024-12-22,14,50,19,69,Bou892T,"-37.8204637, 144.94126826"
1642320241001,164,2024-10-01,23,5,32,37,Lat526_T,"-37.813005, 144.95160411"
1172220250324,117,2025-03-24,22,75,42,117,Fli114F_T,"-37.81629332, 144.97090877"
138820250421,138,2025-04-21,8,1,5,6,EntPark1671_T,"-37.81996544, 144.95981454"
1091220251009,109,2025-10-09,12,207,172,379,LatWill_T,"-37.81193681, 144.95621105"
117520240514,117,2024-05-14,5,5,9,14,Fli114F_T,"-37.81629332, 144.97090877"
117320240320,117,2024-03-20,3,1,0,1,Fli114F_T,"-37.81629332, 144.97090877"
1091320240611,109,2024-06-11,13,161,165,326,LatWill_T,"-37.81193681, 144.95621105"
61720250314,6,2025-03-14,17,1851,1452,3303,FliS_T,"-37.81911705, 144.96558255"
4220241129,4,2024-11-29,2,39,25,64,Swa123_T,"-37.81487988, 144.9660878"
701820250610,70,2025-06-10,18,130,197,327,Errol20_T,"-37.80456984, 144.94946228"
75720240706,75,2024-07-06,7,8,16,24,SprFli_T,"-37.81515276, 144.97467661"
3220250303,3,2025-03-03,2,31,19,50,Swa295_T,"-37.81101524, 144.96429485"
3420250409,3,2025-04-09,4,12,7,19,Swa295_T,"-37.81101524, 144.96429485"
751020250723,75,2025-07-23,10,51,51,102,SprFli_T,"-37.81515276, 144.97467661"
41620240423,41,2024-04-23,6,444,217,661,Swa31,"-37.81668634, 144.96689733"
561920240311,56,2024-03-11,19,269,269,538,Lon364_T,"-37.81234775, 144.96153311"
121220231026,12,2023-10-26,12,258,452,710,NewQ_T,"-37.81457988, 144.94292398"
562320251005,56,2025-10-05,23,39,81,120,Lon364_T,"-37.81234775, 144.96153311"
241020240606,24,2024-06-06,10,750,330,1080,Col620_T,"-37.81887963, 144.95449198"
101320240415,10,2024-04-15,13,126,99,225,BouHbr_T,"-37.81876474, 144.94710545"
351620251001,35,2025-10-01,16,1169,1051,2220,SouthB_T,"-37.82018685, 144.96508508"
58220240419,58,2024-04-19,2,13,25,38,Bou688_T,"-37.81686075, 144.95358075"
761520250812,76,2025-08-12,15,55,94,149,KenMac_T,"-37.79453803, 144.93036194"
762320231107,76,2023-11-07,23,2,0,2,KenMac_T,"-37.79453803, 144.93036194"
58820250603,58,2025-06-03,8,1595,137,1732,Bou688_T,"-37.81686075, 144.95358075"
91820240911,9,2024-09-11,18,688,119,807,Col700_T,"-37.81982992, 144.95102555"
30620250206,30,2025-02-06,6,15,27,42,Lon189_T,"-37.8112185, 144.96656806"
79720250606,79,2025-06-06,7,182,105,287,FliSS_T,"-37.81794046, 144.96616678"
482220240221,48,2024-02-21,22,216,115,331,QVMQ_T,"-37.80631581, 144.95866697"
30520250627,30,2025-06-27,5,12,26,38,Lon189_T,"-37.8112185, 144.96656806"
461420240630,46,2024-06-30,14,22,42,64,Pel147_T,"-37.80240719, 144.9615673"
202320240815,20,2024-08-15,23,52,96,148,LtB170_T,"-37.81172914, 144.9682466"
52620240409,52,2024-04-09,6,33,17,50,Eli263_T,"-37.81252157, 144.9619401"
46820240311,46,2024-03-11,8,36,113,149,Pel147_T,"-37.80240719, 144.9615673"
1392220240607,139,2024-06-07,22,19,13,32,Signal1647_T,"-37.81959923, 144.9632832"
1392020241219,139,2024-12-19,20,108,63,171,Signal1647_T,"-37.81959923, 144.9632832"
1391320250611,139,2025-06-11,13,75,88,163,Signal1647_T,"-37.81959923, 144.9632832"
1361120240206,136,2024-02-06,11,67,63,130,BirFed1120_T,"-37.8184141, 144.97357915"
1301720250108,130,2025-01-08,17,59,49,108,Bou892T,"-37.8204637, 144.94126826"
1421320240923,142,2024-09-23,13,470,421,891,Hammer1584_T,"-37.81970749, 144.96795734"
117220241206,117,2024-12-06,2,19,4,23,Fli114F_T,"-37.81629332, 144.97090877"
180620250524,180,2025-05-24,6,1,0,1,Mac330_T,"-37.79497059, 144.93530329"
691820231116,69,2023-11-16,18,88,98,186,FLDegC_T,"-37.81687226, 144.96559144"
69420240902,69,2024-09-02,4,5,4,9,FLDegC_T,"-37.81687226, 144.96559144"
62320250802,6,2025-08-02,23,582,412,994,FliS_T,"-37.81911705, 144.96558255"
6020250808,6,2025-08-08,0,90,79,169,FliS_T,"-37.81911705, 144.96558255"
32320240217,3,2024-02-17,23,1054,790,1844,Swa295_T,"-37.81101524, 144.96429485"
4820240604,4,2024-06-04,8,539,273,812,Swa123_T,"-37.81487988, 144.9660878"
41920240919,4,2024-09-19,19,558,637,1195,Swa123_T,"-37.81487988, 144.9660878"
701020240310,70,2024-03-10,10,96,106,202,Errol20_T,"-37.80456984, 144.94946228"
3820241010,3,2024-10-10,8,166,323,489,Swa295_T,"-37.81101524, 144.96429485"
39420240510,39,2024-05-10,4,27,14,41,AlfPl_T,"-37.81379749, 144.96995745"
41920240609,41,2024-06-09,9,604,317,921,Swa31,"-37.81668634, 144.96689733"
41120231025,41,2023-10-25,1,30,40,70,Swa31,"-37.81668634, 144.96689733"
292020240601,29,2024-06-01,20,76,183,259,AG_T,"-37.8199817, 144.96872865"
71220240124,71,2024-01-24,2,7,9,16,WestWP_T,"-37.81235775, 144.97136962"
54920241213,54,2024-12-13,9,57,26,83,Swa607_T,"-37.804024, 144.96308399"
47920241123,47,2024-11-23,9,282,377,659,Eli250_T,"-37.81258467, 144.9625775"
402220240505,40,2024-05-05,22,42,17,59,Spr201_T,"-37.80999341, 144.97227587"
40520231110,40,2023-11-10,5,10,7,17,Spr201_T,"-37.80999341, 144.97227587"
211420241223,21,2024-12-23,14,349,382,731,Bourke155_T,"-37.81267313, 144.96788288"
37920240928,37,2024-09-28,9,56,53,109,Lyg260_T,"-37.80107122, 144.96704554"
371120250301,37,2025-03-01,11,87,69,156,Lyg260_T,"-37.80107122, 144.96704554"
50820240310,50,2024-03-10,8,17,34,51,Lyg309_T,"-37.79808192, 144.96721013"
50620231110,50,2023-11-10,6,12,8,20,Lyg309_T,"-37.79808192, 144.96721013"
43620231023,43,2023-10-23,6,32,9,41,UM2_T,"-37.79844526, 144.96411782"
45020250509,45,2025-05-09,0,34,73,107,Swa148_T,"-37.81414075, 144.96609379"
45720250617,45,2025-06-17,7,96,117,213,Swa148_T,"-37.81414075, 144.96609379"
1352320241201,135,2024-12-01,23,38,56,94,Spen161_T,"-37.8172861, 144.95319102"
1311620231228,131,2023-12-28,16,195,93,288,King2_T,"-37.82009057, 144.95758725"
1081820250126,108,2025-01-26,18,97,100,197,261Will_T,"-37.81295822, 144.95678789"
63720250924,63,2025-09-24,7,89,92,181,Bou231_T,"-37.81333081, 144.96675571"
621820240315,62,2024-03-15,18,346,230,576,Lat224_T,"-37.80996494, 144.96216521"
622020240928,62,2024-09-28,20,165,113,278,Lat224_T,"-37.80996494, 144.96216521"
56020241003,56,2024-10-03,0,14,31,45,Lon364_T,"-37.81234775, 144.96153311"
11220250920,1,2025-09-20,12,1389,1207,2596,Bou292_T,"-37.81349441, 144.96515323"
101520250121,10,2025-01-21,15,300,37,337,BouHbr_T,"-37.81876474, 144.94710545"
662220250421,66,2025-04-21,22,289,204,493,QVN_T,"-37.81057846, 144.96444294"
66220241002,66,2024-10-02,2,31,9,40,QVN_T,"-37.81057846, 144.96444294"
84420241005,84,2024-10-05,4,32,39,71,ElFi_T,"-37.81798049, 144.96503383"
84920250321,84,2025-03-21,9,906,406,1312,ElFi_T,"-37.81798049, 144.96503383"
4620240223,4,2024-02-23,6,142,57,199,Swa123_T,"-37.81487988, 144.9660878"
41920240904,4,2024-09-04,19,539,644,1183,Swa123_T,"-37.81487988, 144.9660878"
701320241129,70,2024-11-29,13,146,145,291,Errol20_T,"-37.80456984, 144.94946228"
31820250409,3,2025-04-09,18,1026,1320,2346,Swa295_T,"-37.81101524, 144.96429485"
3320240303,3,2024-03-03,3,254,212,466,Swa295_T,"-37.81101524, 144.96429485"
32220240315,3,2024-03-15,22,1151,1063,2214,Swa295_T,"-37.81101524, 144.96429485"
392020231101,39,2023-11-01,20,34,26,60,AlfPl_T,"-37.81379749, 144.96995745"
81520241026,8,2024-10-26,15,194,253,447,WebBN_T,"-37.82293543, 144.9471751"
751120240601,75,2024-06-01,11,37,62,99,SprFli_T,"-37.81515276, 144.97467661"
412320240222,41,2024-02-22,23,323,381,704,Swa31,"-37.81668634, 144.96689733"
77520250514,77,2025-05-14,5,5,15,20,HarEsP_T,"-37.81441438, 144.94433026"
781320240108,78,2024-01-08,13,6,19,25,HarEsB_T,"-37.81471642, 144.9446508"
291620250510,29,2025-05-10,16,456,536,992,AG_T,"-37.8199817, 144.96872865"
711920241017,71,2024-10-17,19,17,21,38,WestWP_T,"-37.81235775, 144.97136962"
59720241219,59,2024-12-19,7,106,70,176,RMIT_T,"-37.80825648, 144.96304859"
54620250606,54,2025-06-06,6,15,13,28,Swa607_T,"-37.804024, 144.96308399"
281920240830,28,2024-08-30,19,885,549,1434,VAC_T,"-37.82129925, 144.96879309"
401020250912,40,2025-09-12,10,169,182,351,Spr201_T,"-37.80999341, 144.97227587"
40320241129,40,2024-11-29,3,7,7,14,Spr201_T,"-37.80999341, 144.97227587"
372220240501,37,2024-05-01,22,54,59,113,Lyg260_T,"-37.80107122, 144.96704554"
43320231111,43,2023-11-11,3,1,3,4,UM2_T,"-37.79844526, 144.96411782"
1332320250730,133,2025-07-30,23,56,44,100,Spen229_T,"-37.81531435, 144.95227769"
133920250312,133,2025-03-12,9,434,446,880,Spen229_T,"-37.81531435, 144.95227769"
132020250420,132,2025-04-20,0,72,75,147,King335_T,"-37.81267639, 144.95386444"
1181420241226,118,2024-12-26,14,15,22,37,Fli114C_T,"-37.81632783, 144.97090512"
61520241108,61,2024-11-08,5,12,23,35,RMIT14_T,"-37.80767455, 144.96309114"
43120241208,43,2024-12-08,1,5,0,5,UM2_T,"-37.79844526, 144.96411782"
70120241120,70,2024-11-20,1,0,1,1,Errol20_T,"-37.80456984, 144.94946228"
1621820241218,162,2024-12-18,18,642,638,1280,Eli489_T,"-37.80740397, 144.95987909"
179120250506,179,2025-05-06,1,4,0,4,Pow61_T,"-37.82392385, 144.96299677"
1651220250221,165,2025-02-21,12,65,84,149,Spen475_T,"-37.80953359, 144.94939004"
1401120250327,140,2025-03-27,11,131,67,198,Boyd2837_T,"-37.82590962, 144.96185972"
1341320240322,134,2024-03-22,13,439,545,984,Spen201_T,"-37.81694221, 144.95303935"
672020241208,67,2024-12-08,20,165,275,440,FLDegS_T,"-37.81688755, 144.96562569"
851020231126,85,2023-11-26,10,125,82,207,488Mac_T,"-37.79432415, 144.92973378"
85920240321,85,2024-03-21,9,110,90,200,488Mac_T,"-37.79432415, 144.92973378"
851120250501,85,2025-05-01,11,84,62,146,488Mac_T,"-37.79432415, 144.92973378"
172220240118,17,2024-01-18,22,91,117,208,Col15_T,"-37.81362543, 144.97323591"
17720250719,17,2025-07-19,7,39,18,57,Col15_T,"-37.81362543, 144.97323591"
11820241113,1,2024-11-13,18,1499,773,2272,Bou292_T,"-37.81349441, 144.96515323"
681220231224,68,2023-12-24,12,211,168,379,FLDegN_T,"-37.8168479, 144.96559789"
63020240106,63,2024-01-06,0,102,162,264,Bou231_T,"-37.81333081, 144.96675571"
56520240829,56,2024-08-29,5,8,4,12,Lon364_T,"-37.81234775, 144.96153311"
24320240126,24,2024-01-26,3,21,20,41,Col620_T,"-37.81887963, 144.95449198"
121620241105,12,2024-11-05,16,171,168,339,NewQ_T,"-37.81457988, 144.94292398"
11920250923,1,2025-09-23,19,564,427,991,Bou292_T,"-37.81349441, 144.96515323"
121220250725,12,2025-07-25,12,160,205,365,NewQ_T,"-37.81457988, 144.94292398"
1341120240616,134,2024-06-16,11,364,332,696,Spen201_T,"-37.81694221, 144.95303935"
1081220240625,108,2024-06-25,12,156,326,482,261Will_T,"-37.81295822, 144.95678789"
108120240627,108,2024-06-27,1,2,8,10,261Will_T,"-37.81295822, 144.95678789"
87620250501,87,2025-05-01,6,6,8,14,Errol23_T,"-37.80454949, 144.94921863"
181520251007,181,2025-10-07,5,35,63,98,Eli368_T,"-37.81009465, 144.96143149"
1792120250730,179,2025-07-30,21,40,42,82,Pow61_T,"-37.82392385, 144.96299677"
165320250311,165,2025-03-11,3,0,1,1,Spen475_T,"-37.80953359, 144.94939004"
165620250721,165,2025-07-21,6,0,7,7,Spen475_T,"-37.80953359, 144.94939004"
1671820250111,167,2025-01-11,18,53,81,134,Lat526_T,"-37.81304149, 144.95155955"
17320240813,17,2024-08-13,3,5,6,11,Col15_T,"-37.81362543, 144.97323591"
11220240510,1,2024-05-10,12,1171,1036,2207,Bou292_T,"-37.81349441, 144.96515323"
631120240114,63,2024-01-14,11,214,216,430,Bou231_T,"-37.81333081, 144.96675571"
18120250518,18,2025-05-18,1,5,4,9,Col12_T,"-37.81344862, 144.97305353"
18320240407,18,2024-04-07,3,0,1,1,Col12_T,"-37.81344862, 144.97305353"
861620250418,86,2025-04-18,16,54,52,106,574Qub_T,"-37.80309992, 144.94908064"
12920250310,12,2025-03-10,9,103,105,208,NewQ_T,"-37.81457988, 144.94292398"
68120241018,68,2024-10-18,1,2,0,2,FLDegN_T,"-37.8168479, 144.96559789"
101420250324,10,2025-03-24,14,118,61,179,BouHbr_T,"-37.81876474, 144.94710545"
24420240306,24,2024-03-06,4,17,17,34,Col620_T,"-37.81887963, 144.95449198"
27220250425,27,2025-04-25,2,26,3,29,Vic_T,"-37.80606888, 144.95644692"
532020231228,53,2023-12-28,20,232,249,481,Col254_T,"-37.81564191, 144.965499"
30520240118,30,2024-01-18,5,10,39,49,Lon189_T,"-37.8112185, 144.96656806"
791620240705,79,2024-07-05,16,662,450,1112,FliSS_T,"-37.81794046, 144.96616678"
51820250516,51,2025-05-16,8,60,57,117,Fra118_T,"-37.80841815, 144.95906316"
79620250901,79,2025-09-01,6,68,45,113,FliSS_T,"-37.81794046, 144.96616678"
51220231025,51,2023-10-25,2,5,10,15,Fra118_T,"-37.80841815, 144.95906316"
252220231103,25,2023-11-03,22,248,189,437,MCEC_T,"-37.82401776, 144.95604426"
251720240312,25,2024-03-12,17,1149,526,1675,MCEC_T,"-37.82401776, 144.95604426"
522320240829,52,2024-08-29,23,52,57,109,Eli263_T,"-37.81252157, 144.9619401"
139920250807,139,2025-08-07,9,15,188,203,Signal1647_T,"-37.81959923, 144.9632832"
1362320240726,136,2024-07-26,23,1,3,4,BirFed1120_T,"-37.8184141, 144.97357915"
1611820250923,161,2025-09-23,18,127,88,215,BirArt1109_T,"-37.81851276, 144.97131336"
1641820240904,164,2024-09-04,18,73,100,173,Lat526_T,"-37.813005, 144.95160411"
164120250716,164,2025-07-16,1,2,7,9,Lat526_T,"-37.813005, 144.95160411"
1232320250214,123,2025-02-14,23,2,0,2,BirBridge_T,"-37.81753741, 144.97329734"
1411820240430,141,2024-04-30,18,121,99,220,474Fl_T,"-37.81997273, 144.95834911"
117520231230,117,2023-12-30,5,6,2,8,Fli114F_T,"-37.81629332, 144.97090877"
109120250902,109,2025-09-02,1,7,15,22,LatWill_T,"-37.81193681, 144.95621105"
1371920250627,137,2025-06-27,19,5,16,21,BouHbr2353_T,"-37.81894815, 144.94612292"
691620241001,69,2024-10-01,16,164,237,401,FLDegC_T,"-37.81687226, 144.96559144"
62320240223,6,2024-02-23,23,671,506,1177,FliS_T,"-37.81911705, 144.96558255"
3520240216,3,2024-02-16,5,34,54,88,Swa295_T,"-37.81101524, 144.96429485"
701620240526,70,2024-05-26,16,128,145,273,Errol20_T,"-37.80456984, 144.94946228"
81820250117,8,2025-01-17,18,153,221,374,WebBN_T,"-37.82293543, 144.9471751"
81420250213,8,2025-02-13,14,131,196,327,WebBN_T,"-37.82293543, 144.9471751"
41120250403,41,2025-04-03,1,51,82,133,Swa31,"-37.81668634, 144.96689733"
78220240303,78,2024-03-03,2,1,3,4,HarEsB_T,"-37.81471642, 144.9446508"
421720250702,42,2025-07-02,17,65,96,161,UM1_T,"-37.80008566, 144.96386412"
772020250917,77,2025-09-17,20,131,111,242,HarEsP_T,"-37.81441438, 144.94433026"
421420240820,42,2024-08-20,14,326,327,653,UM1_T,"-37.80008566, 144.96386412"
29820231226,29,2023-12-26,8,84,71,155,AG_T,"-37.8199817, 144.96872865"
29820240129,29,2024-01-29,8,151,147,298,AG_T,"-37.8199817, 144.96872865"
592120250725,59,2025-07-25,21,422,332,754,RMIT_T,"-37.80825648, 144.96304859"
59420250819,59,2025-08-19,4,6,13,19,RMIT_T,"-37.80825648, 144.96304859"
591620240514,59,2024-05-14,16,1092,1601,2693,RMIT_T,"-37.80825648, 144.96304859"
28920241218,28,2024-12-18,9,598,177,775,VAC_T,"-37.82129925, 144.96879309"
282220231109,28,2023-11-09,22,223,365,588,VAC_T,"-37.82129925, 144.96879309"
40620240829,40,2024-08-29,6,40,50,90,Spr201_T,"-37.80999341, 144.97227587"
311820231128,31,2023-11-28,18,209,134,343,Lyg161_T,"-37.80169681, 144.96658911"
37020231120,37,2023-11-20,0,35,8,43,Lyg260_T,"-37.80107122, 144.96704554"
441820240709,44,2024-07-09,18,15,8,23,UM3_T,"-37.79698741, 144.96441306"
5220240620,5,2024-06-20,2,2,5,7,PriNW_T,"-37.81874249, 144.96787656"
5820250219,5,2025-02-19,8,341,824,1165,PriNW_T,"-37.81874249, 144.96787656"
52020240219,5,2024-02-19,20,808,677,1485,PriNW_T,"-37.81874249, 144.96787656"
1241920250106,124,2025-01-06,19,5,3,8,BirBridge_T,"-37.81757416, 144.97329934"
441320250223,44,2025-02-23,13,22,53,75,UM3_T,"-37.79698741, 144.96441306"
442020250401,44,2025-04-01,20,26,27,53,UM3_T,"-37.79698741, 144.96441306"
1791920250403,179,2025-04-03,19,70,86,156,Pow61_T,"-37.82392385, 144.96299677"
1401320250415,140,2025-04-15,13,101,46,147,Boyd2837_T,"-37.82590962, 144.96185972"
140820250506,140,2025-05-06,8,208,46,254,Boyd2837_T,"-37.82590962, 144.96185972"
134520250617,134,2025-06-17,5,26,38,64,Spen201_T,"-37.81694221, 144.95303935"
85020250217,85,2025-02-17,0,0,1,1,488Mac_T,"-37.79432415, 144.92973378"
17620240428,17,2024-04-28,6,9,10,19,Col15_T,"-37.81362543, 144.97323591"
171420240711,17,2024-07-11,14,283,280,563,Col15_T,"-37.81362543, 144.97323591"
632120240229,63,2024-02-29,21,159,278,437,Bou231_T,"-37.81333081, 144.96675571"
18320250601,18,2025-06-01,3,1,0,1,Col12_T,"-37.81344862, 144.97305353"
621720240811,62,2024-08-11,17,294,171,465,Lat224_T,"-37.80996494, 144.96216521"
56020241126,56,2024-11-26,0,18,27,45,Lon364_T,"-37.81234775, 144.96153311"
241820231108,24,2023-11-08,18,412,1124,1536,Col620_T,"-37.81887963, 144.95449198"
12920231224,12,2023-12-24,9,102,83,185,NewQ_T,"-37.81457988, 144.94292398"
86020250918,86,2025-09-18,0,0,1,1,574Qub_T,"-37.80309992, 144.94908064"
76720240605,76,2024-06-05,7,30,12,42,KenMac_T,"-37.79453803, 144.93036194"
11220250123,11,2025-01-23,2,2,2,4,WatCit_T,"-37.81564989, 144.93970694"
351320250913,35,2025-09-13,13,879,1192,2071,SouthB_T,"-37.82018685, 144.96508508"
22120250218,2,2025-02-18,21,99,171,270,Bou283_T,"-37.81380668, 144.96516718"
22020250309,2,2025-03-09,20,240,239,479,Bou283_T,"-37.81380668, 144.96516718"
56420250725,56,2025-07-25,4,0,9,9,Lon364_T,"-37.81234775, 144.96153311"
271620250217,27,2025-02-17,16,101,77,178,Vic_T,"-37.80606888, 144.95644692"
271420240102,27,2024-01-02,14,211,124,335,Vic_T,"-37.80606888, 144.95644692"
302320231218,30,2023-12-18,23,114,115,229,Lon189_T,"-37.8112185, 144.96656806"
531220250329,53,2025-03-29,12,796,527,1323,Col254_T,"-37.81564191, 144.965499"
53720240718,53,2024-07-18,7,130,98,228,Col254_T,"-37.81564191, 144.965499"
53320240317,53,2024-03-17,3,35,28,63,Col254_T,"-37.81564191, 144.965499"
231420250528,23,2025-05-28,14,195,356,551,Col623_T,"-37.81909256, 144.95452748"
232220250810,23,2025-08-10,22,25,71,96,Col623_T,"-37.81909256, 144.95452748"
192220250329,19,2025-03-29,22,508,607,1115,LtB210_T,"-37.81237202, 144.96550671"
481220231221,48,2023-12-21,12,379,347,726,QVMQ_T,"-37.80631581, 144.95866697"
101520240213,10,2024-02-13,15,137,25,162,BouHbr_T,"-37.81876474, 144.94710545"
352220250112,35,2025-01-12,22,499,946,1445,SouthB_T,"-37.82018685, 144.96508508"
35920250126,35,2025-01-26,9,764,530,1294,SouthB_T,"-37.82018685, 144.96508508"
58220251012,58,2025-10-12,2,38,80,118,Bou688_T,"-37.81686075, 144.95358075"
21720231125,2,2023-11-25,17,1286,1021,2307,Bou283_T,"-37.81380668, 144.96516718"
272220240717,27,2024-07-17,22,56,74,130,Vic_T,"-37.80606888, 144.95644692"
9620241208,9,2024-12-08,6,8,15,23,Col700_T,"-37.81982992, 144.95102555"
30020250719,30,2025-07-19,0,212,267,479,Lon189_T,"-37.8112185, 144.96656806"
301420240914,30,2024-09-14,14,313,410,723,Lon189_T,"-37.8112185, 144.96656806"
301620250102,30,2025-01-02,16,331,336,667,Lon189_T,"-37.8112185, 144.96656806"
521120250418,52,2025-04-18,11,188,219,407,Eli263_T,"-37.81252157, 144.9619401"
19920241108,19,2024-11-08,9,133,129,262,LtB210_T,"-37.81237202, 144.96550671"
19620241202,19,2024-12-02,6,21,9,30,LtB210_T,"-37.81237202, 144.96550671"
20820250912,20,2025-09-12,8,50,60,110,LtB170_T,"-37.81172914, 144.9682466"
202320250926,20,2025-09-26,23,154,263,417,LtB170_T,"-37.81172914, 144.9682466"
141220241021,141,2024-10-21,2,11,19,30,474Fl_T,"-37.81997273, 144.95834911"
1391120250802,139,2025-08-02,11,57,27,84,Signal1647_T,"-37.81959923, 144.9632832"
1361720241011,136,2024-10-11,17,182,171,353,BirFed1120_T,"-37.8184141, 144.97357915"
142820250511,142,2025-05-11,8,890,673,1563,Hammer1584_T,"-37.81970749, 144.96795734"
142720250705,142,2025-07-05,7,94,63,157,Hammer1584_T,"-37.81970749, 144.96795734"
142920250811,142,2025-08-11,9,182,143,325,Hammer1584_T,"-37.81970749, 144.96795734"
1301620250109,130,2025-01-09,16,37,41,78,Bou892T,"-37.8204637, 144.94126826"
1801220250423,180,2025-04-23,12,45,22,67,Mac330_T,"-37.79497059, 144.93530329"
1231120250421,123,2025-04-21,11,65,46,111,BirBridge_T,"-37.81753741, 144.97329734"
4020241010,4,2024-10-10,0,65,32,97,Swa123_T,"-37.81487988, 144.9660878"
701520250213,70,2025-02-13,15,127,92,219,Errol20_T,"-37.80456984, 144.94946228"
391420241002,39,2024-10-02,14,93,125,218,AlfPl_T,"-37.81379749, 144.96995745"
81120240614,8,2024-06-14,11,104,150,254,WebBN_T,"-37.82293543, 144.9471751"
751520231101,75,2023-11-01,15,55,65,120,SprFli_T,"-37.81515276, 144.97467661"
411720240426,41,2024-04-26,17,1812,1700,3512,Swa31,"-37.81668634, 144.96689733"
712120240929,71,2024-09-29,21,2,4,6,WestWP_T,"-37.81235775, 144.97136962"
59720240131,59,2024-01-31,7,158,104,262,RMIT_T,"-37.80825648, 144.96304859"
54620240819,54,2024-08-19,6,13,9,22,Swa607_T,"-37.804024, 144.96308399"
28920240720,28,2024-07-20,9,224,126,350,VAC_T,"-37.82129925, 144.96879309"
282120231206,28,2023-12-06,21,286,404,690,VAC_T,"-37.82129925, 144.96879309"
211020240114,21,2024-01-14,10,143,187,330,Bourke155_T,"-37.81267313, 144.96788288"
362020231028,36,2023-10-28,20,137,181,318,Que85_T,"-37.81652527, 144.96121062"
432120240209,43,2024-02-09,21,19,25,44,UM2_T,"-37.79844526, 144.96411782"
5720241219,5,2024-12-19,7,152,345,497,PriNW_T,"-37.81874249, 144.96787656"
11220231209,1,2023-12-09,12,1469,1356,2825,Bou292_T,"-37.81349441, 144.96515323"
181320250804,18,2025-08-04,13,203,202,405,Col12_T,"-37.81344862, 144.97305353"
62620240503,62,2024-05-03,6,63,35,98,Lat224_T,"-37.80996494, 144.96216521"
62120250516,62,2025-05-16,1,25,30,55,Lat224_T,"-37.80996494, 144.96216521"
122020241222,12,2024-12-22,20,107,131,238,NewQ_T,"-37.81457988, 144.94292398"
11820251002,1,2025-10-02,18,1209,867,2076,Bou292_T,"-37.81349441, 144.96515323"
24620240325,24,2024-03-25,6,244,141,385,Col620_T,"-37.81887963, 144.95449198"
1801020250426,180,2025-04-26,10,42,26,68,Mac330_T,"-37.79497059, 144.93530329"
1392020250127,139,2025-01-27,20,54,36,90,Signal1647_T,"-37.81959923, 144.9632832"
1421320240802,142,2024-08-02,13,474,364,838,Hammer1584_T,"-37.81970749, 144.96795734"
142820240823,142,2024-08-23,8,144,168,312,Hammer1584_T,"-37.81970749, 144.96795734"
1421220241015,142,2024-10-15,12,610,459,1069,Hammer1584_T,"-37.81970749, 144.96795734"
164120241204,164,2024-12-04,1,5,5,10,Lat526_T,"-37.813005, 144.95160411"
1231920250514,123,2025-05-14,19,1,0,1,BirBridge_T,"-37.81753741, 144.97329734"
6620240303,6,2024-03-03,6,50,84,134,FliS_T,"-37.81911705, 144.96558255"
3720240122,3,2024-01-22,7,60,130,190,Swa295_T,"-37.81101524, 144.96429485"
392120250516,39,2025-05-16,21,53,20,73,AlfPl_T,"-37.81379749, 144.96995745"
81220240915,8,2024-09-15,12,119,222,341,WebBN_T,"-37.82293543, 144.9471751"
781420250420,78,2025-04-20,14,33,54,87,HarEsB_T,"-37.81471642, 144.9446508"
14920250116,14,2025-01-16,9,278,274,552,SanBri_T,"-37.82011242, 144.96291897"
29820240630,29,2024-06-30,8,47,103,150,AG_T,"-37.8199817, 144.96872865"
59720250103,59,2025-01-03,7,42,28,70,RMIT_T,"-37.80825648, 144.96304859"
54620250331,54,2025-03-31,6,18,9,27,Swa607_T,"-37.804024, 144.96308399"
29520250331,29,2025-03-31,5,10,11,21,AG_T,"-37.8199817, 144.96872865"
40620240419,40,2024-04-19,6,25,54,79,Spr201_T,"-37.80999341, 144.97227587"
361820241004,36,2024-10-04,18,260,231,491,Que85_T,"-37.81652527, 144.96121062"
451920240911,45,2024-09-11,19,259,396,655,Swa148_T,"-37.81414075, 144.96609379"
1071320250704,107,2025-07-04,13,190,179,369,280Will_T,"-37.81246271, 144.95690188"
1181520231123,118,2023-11-23,15,26,30,56,Fli114C_T,"-37.81632783, 144.97090512"
1082120231110,108,2023-11-10,21,166,156,322,261Will_T,"-37.81295822, 144.95678789"
431920250525,43,2025-05-25,19,37,48,85,UM2_T,"-37.79844526, 144.96411782"
1842020250926,184,2025-09-26,20,370,621,991,Eli124_T,"-37.81512416, 144.96371988"
1652120250828,165,2025-08-28,21,37,8,45,Spen475_T,"-37.80953359, 144.94939004"
1311420240816,131,2024-08-16,14,148,116,264,King2_T,"-37.82009057, 144.95758725"
135220250804,135,2025-08-04,2,15,6,21,Spen161_T,"-37.8172861, 144.95319102"
135120240619,135,2024-06-19,1,13,2,15,Spen161_T,"-37.8172861, 144.95319102"
671920240330,67,2024-03-30,19,379,516,895,FLDegS_T,"-37.81688755, 144.96562569"
181920241203,18,2024-12-03,19,120,31,151,Col12_T,"-37.81344862, 144.97305353"
631920250824,63,2025-08-24,19,38,140,178,Bou231_T,"-37.81333081, 144.96675571"
86420240121,86,2024-01-21,4,2,1,3,574Qub_T,"-37.80309992, 144.94908064"
861520250525,86,2025-05-25,15,50,56,106,574Qub_T,"-37.80309992, 144.94908064"
12620240130,12,2024-01-30,6,57,44,101,NewQ_T,"-37.81457988, 144.94292398"
12920240504,12,2024-05-04,9,130,136,266,NewQ_T,"-37.81457988, 144.94292398"
242120250604,24,2025-06-04,21,227,351,578,Col620_T,"-37.81887963, 144.95449198"
35020250205,35,2025-02-05,0,63,101,164,SouthB_T,"-37.82018685, 144.96508508"
351220231115,35,2023-11-15,12,1257,1285,2542,SouthB_T,"-37.82018685, 144.96508508"
721620251004,72,2025-10-04,16,233,481,714,ACMI_T,"-37.81726338, 144.96872809"
24720250711,24,2025-07-11,7,727,215,942,Col620_T,"-37.81887963, 144.95449198"
24020250916,24,2025-09-16,0,27,41,68,Col620_T,"-37.81887963, 144.95449198"
76720250128,76,2025-01-28,7,41,22,63,KenMac_T,"-37.79453803, 144.93036194"
58020240121,58,2024-01-21,0,152,168,320,Bou688_T,"-37.81686075, 144.95358075"
27920241125,27,2024-11-25,9,64,88,152,Vic_T,"-37.80606888, 144.95644692"
27720240622,27,2024-06-22,7,25,25,50,Vic_T,"-37.80606888, 144.95644692"
53920231109,53,2023-11-09,9,428,358,786,Col254_T,"-37.81564191, 144.965499"
231420250904,23,2025-09-04,14,180,312,492,Col623_T,"-37.81909256, 144.95452748"
52220250504,52,2025-05-04,2,103,77,180,Eli263_T,"-37.81252157, 144.9619401"
461220250425,46,2025-04-25,12,42,37,79,Pel147_T,"-37.80240719, 144.9615673"
511620241207,51,2024-12-07,16,142,45,187,Fra118_T,"-37.80841815, 144.95906316"
51820231021,51,2023-10-21,8,39,46,85,Fra118_T,"-37.80841815, 144.95906316"
49920250404,49,2025-04-04,9,140,223,363,Eli501_T,"-37.80730068, 144.95956055"
19320250510,19,2025-05-10,3,39,35,74,LtB210_T,"-37.81237202, 144.96550671"
141420240915,141,2024-09-15,4,50,20,70,474Fl_T,"-37.81997273, 144.95834911"
1421120241218,142,2024-12-18,11,353,370,723,Hammer1584_T,"-37.81970749, 144.96795734"
142620240825,142,2024-08-25,6,33,5,38,Hammer1584_T,"-37.81970749, 144.96795734"
1641320250908,164,2025-09-08,13,124,82,206,Lat526_T,"-37.813005, 144.95160411"
1801720250802,180,2025-08-02,17,42,49,91,Mac330_T,"-37.79497059, 144.93530329"
1802220250323,180,2025-03-23,22,0,8,8,Mac330_T,"-37.79497059, 144.93530329"
1171420250905,117,2025-09-05,14,185,181,366,Fli114F_T,"-37.81629332, 144.97090877"
123820251014,123,2025-10-14,8,83,13,96,BirBridge_T,"-37.81753741, 144.97329734"
1381320240507,138,2024-05-07,13,12,8,20,EntPark1671_T,"-37.81996544, 144.95981454"
1171020240831,117,2024-08-31,10,97,114,211,Fli114F_T,"-37.81629332, 144.97090877"
1091620240124,109,2024-01-24,16,352,143,495,LatWill_T,"-37.81193681, 144.95621105"
1092220240529,109,2024-05-29,22,43,59,102,LatWill_T,"-37.81193681, 144.95621105"
1331820250910,133,2025-09-10,18,651,498,1149,Spen229_T,"-37.81531435, 144.95227769"
108420250306,108,2025-03-06,4,12,5,17,261Will_T,"-37.81295822, 144.95678789"
1081620240531,108,2024-05-31,16,242,154,396,261Will_T,"-37.81295822, 144.95678789"
162220241029,162,2024-10-29,2,32,14,46,Eli489_T,"-37.80740397, 144.95987909"
1651820241222,165,2024-12-22,18,46,30,76,Spen475_T,"-37.80953359, 144.94939004"
140820250305,140,2025-03-05,8,248,50,298,Boyd2837_T,"-37.82590962, 144.96185972"
1622020240717,162,2024-07-17,20,277,706,983,Eli489_T,"-37.80740397, 144.95987909"
132920240829,132,2024-08-29,9,127,87,214,King335_T,"-37.81267639, 144.95386444"
135720240414,135,2024-04-14,7,99,71,170,Spen161_T,"-37.8172861, 144.95319102"
1351320240918,135,2024-09-18,13,413,501,914,Spen161_T,"-37.8172861, 144.95319102"
1351320241207,135,2024-12-07,13,467,550,1017,Spen161_T,"-37.8172861, 144.95319102"
85620241220,85,2024-12-20,6,22,6,28,488Mac_T,"-37.79432415, 144.92973378"
18620250409,18,2025-04-09,6,35,119,154,Col12_T,"-37.81344862, 144.97305353"
62320251015,62,2025-10-15,3,9,11,20,Lat224_T,"-37.80996494, 144.96216521"
621720231218,62,2023-12-18,17,214,177,391,Lat224_T,"-37.80996494, 144.96216521"
56720240711,56,2024-07-11,7,54,48,102,Lon364_T,"-37.81234775, 144.96153311"
56820240805,56,2024-08-05,8,124,180,304,Lon364_T,"-37.81234775, 144.96153311"
101120241011,10,2024-10-11,11,72,55,127,BouHbr_T,"-37.81876474, 144.94710545"
101420240101,10,2024-01-01,14,40,29,69,BouHbr_T,"-37.81876474, 144.94710545"
722120241110,72,2024-11-10,21,51,82,133,ACMI_T,"-37.81726338, 144.96872809"
76720250115,76,2025-01-15,7,38,26,64,KenMac_T,"-37.79453803, 144.93036194"
21820250109,2,2025-01-09,18,484,354,838,Bou283_T,"-37.81380668, 144.96516718"
271720250424,27,2025-04-24,17,121,102,223,Vic_T,"-37.80606888, 144.95644692"
9520250502,9,2025-05-02,5,14,32,46,Col700_T,"-37.81982992, 144.95102555"
531020250131,53,2025-01-31,10,486,330,816,Col254_T,"-37.81564191, 144.965499"
791820241015,79,2024-10-15,18,16,20,36,FliSS_T,"-37.81794046, 144.96616678"
30220240822,30,2024-08-22,2,23,47,70,Lon189_T,"-37.8112185, 144.96656806"
521820250331,52,2025-03-31,18,278,353,631,Eli263_T,"-37.81252157, 144.9619401"
14320250414,14,2025-04-14,3,10,4,14,SanBri_T,"-37.82011242, 144.96291897"
14520240825,14,2024-08-25,5,21,30,51,SanBri_T,"-37.82011242, 144.96291897"
59120250927,59,2025-09-27,1,58,22,80,RMIT_T,"-37.80825648, 144.96304859"
71120240704,71,2024-07-04,1,5,2,7,WestWP_T,"-37.81235775, 144.97136962"
711420240927,71,2024-09-27,14,11,3,14,WestWP_T,"-37.81235775, 144.97136962"
712020241207,71,2024-12-07,20,1,9,10,WestWP_T,"-37.81235775, 144.97136962"
311520240825,31,2024-08-25,15,226,261,487,Lyg161_T,"-37.80169681, 144.96658911"
54220250928,54,2025-09-28,2,22,10,32,Swa607_T,"-37.804024, 144.96308399"
401820240827,40,2024-08-27,18,170,264,434,Spr201_T,"-37.80999341, 144.97227587"
40020241122,40,2024-11-22,0,26,13,39,Spr201_T,"-37.80999341, 144.97227587"
31820231220,31,2023-12-20,8,63,65,128,Lyg161_T,"-37.80169681, 144.96658911"
31120250206,31,2025-02-06,1,3,2,5,Lyg161_T,"-37.80169681, 144.96658911"
431420250721,43,2025-07-21,14,135,293,428,UM2_T,"-37.79844526, 144.96411782"
45520240810,45,2024-08-10,5,19,38,57,Swa148_T,"-37.81414075, 144.96609379"
44120240315,44,2024-03-15,1,1,0,1,UM3_T,"-37.79698741, 144.96441306"
451820250515,45,2025-05-15,18,651,917,1568,Swa148_T,"-37.81414075, 144.96609379"
451520240130,45,2024-01-30,15,360,634,994,Swa148_T,"-37.81414075, 144.96609379"
1082020250521,108,2025-05-21,20,165,110,275,261Will_T,"-37.81295822, 144.95678789"
1182320240516,118,2024-05-16,23,0,2,2,Fli114C_T,"-37.81632783, 144.97090512"
118420241026,118,2024-10-26,4,0,1,1,Fli114C_T,"-37.81632783, 144.97090512"
1241320231027,124,2023-10-27,13,2,3,5,BirBridge_T,"-37.81757416, 144.97329934"
1071820231225,107,2023-12-25,18,63,88,151,280Will_T,"-37.81246271, 144.95690188"
1071120231024,107,2023-10-24,11,116,126,242,280Will_T,"-37.81246271, 144.95690188"
61220251001,61,2025-10-01,2,15,6,21,RMIT14_T,"-37.80767455, 144.96309114"
1821320250729,182,2025-07-29,13,321,341,662,King163_T,"-37.81627451, 144.95550503"
131120241103,131,2024-11-03,1,100,178,278,King2_T,"-37.82009057, 144.95758725"
162920250623,162,2025-06-23,9,158,158,316,Eli489_T,"-37.80740397, 144.95987909"
1401120250314,140,2025-03-14,11,143,51,194,Boyd2837_T,"-37.82590962, 144.96185972"
1311420240120,131,2024-01-20,14,152,157,309,King2_T,"-37.82009057, 144.95758725"
11920240913,1,2024-09-13,19,837,640,1477,Bou292_T,"-37.81349441, 144.96515323"
68720231107,68,2023-11-07,7,33,28,61,FLDegN_T,"-37.8168479, 144.96559789"
86020240910,86,2024-09-10,0,0,2,2,574Qub_T,"-37.80309992, 144.94908064"
62120240908,62,2024-09-08,1,42,22,64,Lat224_T,"-37.80996494, 144.96216521"
121620241023,12,2024-10-23,16,257,293,550,NewQ_T,"-37.81457988, 144.94292398"
101620240125,10,2024-01-25,16,162,33,195,BouHbr_T,"-37.81876474, 144.94710545"
101820240506,10,2024-05-06,18,61,44,105,BouHbr_T,"-37.81876474, 144.94710545"
721020231115,72,2023-11-15,10,397,195,592,ACMI_T,"-37.81726338, 144.96872809"
722220240117,72,2024-01-17,22,174,254,428,ACMI_T,"-37.81726338, 144.96872809"
722120240208,72,2024-02-08,21,108,121,229,ACMI_T,"-37.81726338, 144.96872809"
721620250710,72,2025-07-10,16,139,678,817,ACMI_T,"-37.81726338, 144.96872809"
22120240907,2,2024-09-07,21,142,219,361,Bou283_T,"-37.81380668, 144.96516718"
91420241008,9,2024-10-08,14,583,227,810,Col700_T,"-37.81982992, 144.95102555"
30320240205,30,2024-02-05,3,27,71,98,Lon189_T,"-37.8112185, 144.96656806"
25120250118,25,2025-01-18,1,31,79,110,MCEC_T,"-37.82401776, 144.95604426"
251920240410,25,2024-04-10,19,316,393,709,MCEC_T,"-37.82401776, 144.95604426"
139720251006,139,2025-10-06,7,16,135,151,Signal1647_T,"-37.81959923, 144.9632832"
1612020250314,161,2025-03-14,20,15,12,27,BirArt1109_T,"-37.81851276, 144.97131336"
1172220240228,117,2024-02-28,22,146,67,213,Fli114F_T,"-37.81629332, 144.97090877"
491520250807,49,2025-08-07,15,236,396,632,Eli501_T,"-37.80730068, 144.95956055"
19920250328,19,2025-03-28,9,107,92,199,LtB210_T,"-37.81237202, 144.96550671"
19220250410,19,2025-04-10,2,26,34,60,LtB210_T,"-37.81237202, 144.96550671"
1802220250823,180,2025-08-23,22,3,1,4,Mac330_T,"-37.79497059, 144.93530329"
461120250729,46,2025-07-29,11,115,97,212,Pel147_T,"-37.80240719, 144.9615673"
251120240422,25,2024-04-22,11,273,518,791,MCEC_T,"-37.82401776, 144.95604426"
252220250330,25,2025-03-30,22,119,141,260,MCEC_T,"-37.82401776, 144.95604426"
252220250912,25,2025-09-12,22,413,303,716,MCEC_T,"-37.82401776, 144.95604426"
48920250221,48,2025-02-21,9,187,152,339,QVMQ_T,"-37.80631581, 144.95866697"
461220240606,46,2024-06-06,12,154,203,357,Pel147_T,"-37.80240719, 144.9615673"
46020240715,46,2024-07-15,0,3,6,9,Pel147_T,"-37.80240719, 144.9615673"
1372320240305,137,2024-03-05,23,1,1,2,BouHbr2353_T,"-37.81894815, 144.94612292"
1421520250330,142,2025-03-30,15,607,550,1157,Hammer1584_T,"-37.81970749, 144.96795734"
1172020250522,117,2025-05-22,20,100,88,188,Fli114F_T,"-37.81629332, 144.97090877"
138320240330,138,2024-03-30,3,0,1,1,EntPark1671_T,"-37.81996544, 144.95981454"
1172120240216,117,2024-02-16,21,274,228,502,Fli114F_T,"-37.81629332, 144.97090877"
117920240221,117,2024-02-21,9,212,126,338,Fli114F_T,"-37.81629332, 144.97090877"
1092020250907,109,2025-09-07,20,55,72,127,LatWill_T,"-37.81193681, 144.95621105"
6820250404,6,2025-04-04,8,784,1400,2184,FliS_T,"-37.81911705, 144.96558255"
8820240722,8,2024-07-22,8,237,185,422,WebBN_T,"-37.82293543, 144.9471751"
75320240719,75,2024-07-19,3,0,1,1,SprFli_T,"-37.81515276, 144.97467661"
29820250708,29,2025-07-08,8,168,98,266,AG_T,"-37.8199817, 144.96872865"
71620241127,71,2024-11-27,6,17,20,37,WestWP_T,"-37.81235775, 144.97136962"
591820250819,59,2025-08-19,18,1003,1493,2496,RMIT_T,"-37.80825648, 144.96304859"
592120250114,59,2025-01-14,21,255,194,449,RMIT_T,"-37.80825648, 144.96304859"
54920241128,54,2024-11-28,9,74,28,102,Swa607_T,"-37.804024, 144.96308399"
54020240109,54,2024-01-09,0,27,17,44,Swa607_T,"-37.804024, 144.96308399"
281620240903,28,2024-09-03,16,360,1410,1770,VAC_T,"-37.82129925, 144.96879309"
471820250119,47,2025-01-19,18,578,508,1086,Eli250_T,"-37.81258467, 144.9625775"
401520240121,40,2024-01-21,15,211,127,338,Spr201_T,"-37.80999341, 144.97227587"
372120231224,37,2023-12-24,21,16,29,45,Lyg260_T,"-37.80107122, 144.96704554"
441320250626,44,2025-06-26,13,69,77,146,UM3_T,"-37.79698741, 144.96441306"
501820240101,50,2024-01-01,18,187,193,380,Lyg309_T,"-37.79808192, 144.96721013"
5820250810,5,2025-08-10,8,138,147,285,PriNW_T,"-37.81874249, 144.96787656"
107920250219,107,2025-02-19,9,61,208,269,280Will_T,"-37.81246271, 144.95690188"
107420250222,107,2025-02-22,4,1,6,7,280Will_T,"-37.81246271, 144.95690188"
118820231216,118,2023-12-16,8,5,10,15,Fli114C_T,"-37.81632783, 144.97090512"
118520240415,118,2024-04-15,5,1,2,3,Fli114C_T,"-37.81632783, 144.97090512"
611120250519,61,2025-05-19,11,388,518,906,RMIT14_T,"-37.80767455, 144.96309114"
1662020250422,166,2025-04-22,20,9,13,22,Spen484_T,"-37.80896733, 144.94931703"
1661620250709,166,2025-07-09,16,72,70,142,Spen484_T,"-37.80896733, 144.94931703"
143020240806,143,2024-08-06,0,31,10,41,Spencer_T,"-37.821728, 144.95557015"
131720240715,131,2024-07-15,7,51,23,74,King2_T,"-37.82009057, 144.95758725"
131020240228,131,2024-02-28,0,22,22,44,King2_T,"-37.82009057, 144.95758725"
851420240415,85,2024-04-15,14,71,58,129,488Mac_T,"-37.79432415, 144.92973378"
851420241123,85,2024-11-23,14,79,85,164,488Mac_T,"-37.79432415, 144.92973378"
17820250908,17,2025-09-08,8,1140,175,1315,Col15_T,"-37.81362543, 144.97323591"
631020240619,63,2024-06-19,10,180,219,399,Bou231_T,"-37.81333081, 144.96675571"
681320231228,68,2023-12-28,13,316,199,515,FLDegN_T,"-37.8168479, 144.96559789"
18520250609,18,2025-06-09,5,0,1,1,Col12_T,"-37.81344862, 144.97305353"
62920251013,62,2025-10-13,9,150,94,244,Lat224_T,"-37.80996494, 144.96216521"
63920250912,63,2025-09-12,9,176,214,390,Bou231_T,"-37.81333081, 144.96675571"
671320241125,67,2024-11-25,13,475,650,1125,FLDegS_T,"-37.81688755, 144.96562569"
62620240110,62,2024-01-10,6,118,61,179,Lat224_T,"-37.80996494, 144.96216521"
62420250722,62,2025-07-22,4,5,7,12,Lat224_T,"-37.80996494, 144.96216521"
86820240907,86,2024-09-07,8,32,30,62,574Qub_T,"-37.80309992, 144.94908064"
861720241222,86,2024-12-22,17,31,40,71,574Qub_T,"-37.80309992, 144.94908064"
101720231225,10,2023-12-25,17,27,16,43,BouHbr_T,"-37.81876474, 144.94710545"
10620240317,10,2024-03-17,6,6,30,36,BouHbr_T,"-37.81876474, 144.94710545"
242120240408,24,2024-04-08,21,231,375,606,Col620_T,"-37.81887963, 144.95449198"
241420240729,24,2024-07-29,14,385,780,1165,Col620_T,"-37.81887963, 144.95449198"
72220240512,72,2024-05-12,2,3,34,37,ACMI_T,"-37.81726338, 144.96872809"
10320250402,10,2025-04-02,3,2,0,2,BouHbr_T,"-37.81876474, 144.94710545"
84920250819,84,2025-08-19,9,1187,416,1603,ElFi_T,"-37.81798049, 144.96503383"
661520240427,66,2024-04-27,15,1659,1572,3231,QVN_T,"-37.81057846, 144.96444294"
82120241017,8,2024-10-17,21,44,52,96,WebBN_T,"-37.82293543, 144.9471751"
77220250225,77,2025-02-25,2,8,4,12,HarEsP_T,"-37.81441438, 144.94433026"
78820250904,78,2025-09-04,8,86,32,118,HarEsB_T,"-37.81471642, 144.9446508"
781420250405,78,2025-04-05,14,52,89,141,HarEsB_T,"-37.81471642, 144.9446508"
592020240922,59,2024-09-22,20,269,207,476,RMIT_T,"-37.80825648, 144.96304859"
65620240114,65,2024-01-14,6,24,38,62,SwaCs_T,"-37.81569416, 144.9668064"
29420250823,29,2025-08-23,4,1,7,8,AG_T,"-37.8199817, 144.96872865"
542220240716,54,2024-07-16,22,45,130,175,Swa607_T,"-37.804024, 144.96308399"
471220240629,47,2024-06-29,12,565,629,1194,Eli250_T,"-37.81258467, 144.9625775"
47220250320,47,2025-03-20,2,35,25,60,Eli250_T,"-37.81258467, 144.9625775"
40720240501,40,2024-05-01,7,95,127,222,Spr201_T,"-37.80999341, 144.97227587"
40320240629,40,2024-06-29,3,14,4,18,Spr201_T,"-37.80999341, 144.97227587"
312320250220,31,2025-02-20,23,36,73,109,Lyg161_T,"-37.80169681, 144.96658911"
361420240909,36,2024-09-09,14,197,235,432,Que85_T,"-37.81652527, 144.96121062"
501320240611,50,2024-06-11,13,161,138,299,Lyg309_T,"-37.79808192, 144.96721013"
441520241106,44,2024-11-06,15,74,45,119,UM3_T,"-37.79698741, 144.96441306"
451020241202,45,2024-12-02,10,276,345,621,Swa148_T,"-37.81414075, 144.96609379"
51220240926,5,2024-09-26,12,835,933,1768,PriNW_T,"-37.81874249, 144.96787656"
1351320251013,135,2025-10-13,13,414,402,816,Spen161_T,"-37.8172861, 144.95319102"
135120240702,135,2024-07-02,1,10,8,18,Spen161_T,"-37.8172861, 144.95319102"
135120241102,135,2024-11-02,1,16,64,80,Spen161_T,"-37.8172861, 144.95319102"
108620250325,108,2025-03-25,6,41,322,363,261Will_T,"-37.81295822, 144.95678789"
871320240606,87,2024-06-06,13,155,121,276,Errol23_T,"-37.80454949, 144.94921863"
87820240822,87,2024-08-22,8,94,42,136,Errol23_T,"-37.80454949, 144.94921863"
1311920250201,131,2025-02-01,19,138,134,272,King2_T,"-37.82009057, 144.95758725"
1432020250104,143,2025-01-04,20,178,174,352,Spencer_T,"-37.821728, 144.95557015"
1401320240112,140,2024-01-12,13,56,46,102,Boyd2837_T,"-37.82590962, 144.96185972"
1401120241025,140,2024-10-25,11,130,64,194,Boyd2837_T,"-37.82590962, 144.96185972"
134020250729,134,2025-07-29,0,39,37,76,Spen201_T,"-37.81694221, 144.95303935"
67120250726,67,2025-07-26,1,33,55,88,FLDegS_T,"-37.81688755, 144.96562569"
171420250413,17,2025-04-13,14,156,85,241,Col15_T,"-37.81362543, 144.97323591"
1620241026,1,2024-10-26,6,19,15,34,Bou292_T,"-37.81349441, 144.96515323"
67120250225,67,2025-02-25,1,11,7,18,FLDegS_T,"-37.81688755, 144.96562569"
18720240118,18,2024-01-18,7,34,352,386,Col12_T,"-37.81344862, 144.97305353"
11220240217,11,2024-02-17,2,3,7,10,WatCit_T,"-37.81564989, 144.93970694"
62320250207,62,2025-02-07,3,9,5,14,Lat224_T,"-37.80996494, 144.96216521"
101920250212,10,2025-02-12,19,37,45,82,BouHbr_T,"-37.81876474, 144.94710545"
10220250329,10,2025-03-29,2,3,18,21,BouHbr_T,"-37.81876474, 144.94710545"
582020250303,58,2025-03-03,20,222,213,435,Bou688_T,"-37.81686075, 144.95358075"
21620250606,2,2025-06-06,16,537,401,938,Bou283_T,"-37.81380668, 144.96516718"
9720250102,9,2025-01-02,7,35,145,180,Col700_T,"-37.81982992, 144.95102555"
301220240909,30,2024-09-09,12,243,396,639,Lon189_T,"-37.8112185, 144.96656806"
23020240109,23,2024-01-09,0,20,32,52,Col623_T,"-37.81909256, 144.95452748"
51920241209,51,2024-12-09,9,68,63,131,Fra118_T,"-37.80841815, 144.95906316"
582120250630,58,2025-06-30,21,154,119,273,Bou688_T,"-37.81686075, 144.95358075"
91720240203,9,2024-02-03,17,125,94,219,Col700_T,"-37.81982992, 144.95102555"
92220231202,9,2023-12-02,22,25,28,53,Col700_T,"-37.81982992, 144.95102555"
30020240129,30,2024-01-29,0,155,149,304,Lon189_T,"-37.8112185, 144.96656806"
531220241109,53,2024-11-09,12,753,528,1281,Col254_T,"-37.81564191, 144.965499"
232320240116,23,2024-01-16,23,23,60,83,Col623_T,"-37.81909256, 144.95452748"
481920240214,48,2024-02-14,19,714,826,1540,QVMQ_T,"-37.80631581, 144.95866697"
1421620231123,142,2023-11-23,16,496,383,879,Hammer1584_T,"-37.81970749, 144.96795734"
1301320240914,130,2024-09-14,13,39,20,59,Bou892T,"-37.8204637, 144.94126826"
692320240510,69,2024-05-10,23,20,15,35,FLDegC_T,"-37.81687226, 144.96559144"
4320241023,4,2024-10-23,3,19,4,23,Swa123_T,"-37.81487988, 144.9660878"
4920250518,4,2025-05-18,9,411,257,668,Swa123_T,"-37.81487988, 144.9660878"
70920240129,70,2024-01-29,9,76,80,156,Errol20_T,"-37.80456984, 144.94946228"
8320240602,8,2024-06-02,3,4,3,7,WebBN_T,"-37.82293543, 144.9471751"
412220250622,41,2025-06-22,22,244,546,790,Swa31,"-37.81668634, 144.96689733"
412020250820,41,2025-08-20,20,540,1254,1794,Swa31,"-37.81668634, 144.96689733"
421420250210,42,2025-02-10,14,83,77,160,UM1_T,"-37.80008566, 144.96386412"
42820250426,42,2025-04-26,8,19,16,35,UM1_T,"-37.80008566, 144.96386412"
42220241221,42,2024-12-21,2,1,0,1,UM1_T,"-37.80008566, 144.96386412"
782120240504,78,2024-05-04,21,10,3,13,HarEsB_T,"-37.81471642, 144.9446508"
292020231124,29,2023-11-24,20,122,778,900,AG_T,"-37.8199817, 144.96872865"
65320231201,65,2023-12-01,3,0,4,4,SwaCs_T,"-37.81569416, 144.9668064"
312120250506,31,2025-05-06,21,107,107,214,Lyg161_T,"-37.80169681, 144.96658911"
36420250131,36,2025-01-31,4,4,3,7,Que85_T,"-37.81652527, 144.96121062"
361920250331,36,2025-03-31,19,96,89,185,Que85_T,"-37.81652527, 144.96121062"
471120250911,47,2025-09-11,11,504,530,1034,Eli250_T,"-37.81258467, 144.9625775"
671820250501,67,2025-05-01,18,358,433,791,FLDegS_T,"-37.81688755, 144.96562569"
171020240517,17,2024-05-17,10,328,214,542,Col15_T,"-37.81362543, 144.97323591"
62020250901,62,2025-09-01,0,37,26,63,Lat224_T,"-37.80996494, 144.96216521"
862120250119,86,2025-01-19,21,10,23,33,574Qub_T,"-37.80309992, 144.94908064"
101520240125,10,2024-01-25,15,138,47,185,BouHbr_T,"-37.81876474, 144.94710545"
12420240608,12,2024-06-08,4,14,7,21,NewQ_T,"-37.81457988, 144.94292398"
721220240606,72,2024-06-06,12,245,301,546,ACMI_T,"-37.81726338, 144.96872809"
721320250313,72,2025-03-13,13,322,464,786,ACMI_T,"-37.81726338, 144.96872809"
351620250124,35,2025-01-24,16,1418,1604,3022,SouthB_T,"-37.82018685, 144.96508508"
352120231211,35,2023-12-11,21,1607,1932,3539,SouthB_T,"-37.82018685, 144.96508508"
352120240317,35,2024-03-17,21,640,894,1534,SouthB_T,"-37.82018685, 144.96508508"
22220240727,2,2024-07-27,22,57,133,190,Bou283_T,"-37.81380668, 144.96516718"
23120250726,23,2025-07-26,1,9,41,50,Col623_T,"-37.81909256, 144.95452748"
52520240929,52,2024-09-29,5,17,22,39,Eli263_T,"-37.81252157, 144.9619401"
25620240917,25,2024-09-17,6,97,153,250,MCEC_T,"-37.82401776, 144.95604426"
49420231207,49,2023-12-07,4,14,18,32,Eli501_T,"-37.80730068, 144.95956055"
76820250423,76,2025-04-23,8,94,46,140,KenMac_T,"-37.79453803, 144.93036194"
76920250724,76,2025-07-24,9,63,45,108,KenMac_T,"-37.79453803, 144.93036194"
72620250801,72,2025-08-01,6,49,25,74,ACMI_T,"-37.81726338, 144.96872809"
58720240607,58,2024-06-07,7,529,104,633,Bou688_T,"-37.81686075, 144.95358075"
58620250605,58,2025-06-05,6,220,49,269,Bou688_T,"-37.81686075, 144.95358075"
21320250521,2,2025-05-21,13,659,721,1380,Bou283_T,"-37.81380668, 144.96516718"
271120250426,27,2025-04-26,11,348,289,637,Vic_T,"-37.80606888, 144.95644692"
27420240713,27,2024-07-13,4,12,3,15,Vic_T,"-37.80606888, 144.95644692"
30720240319,30,2024-03-19,7,26,68,94,Lon189_T,"-37.8112185, 144.96656806"
532120250314,53,2025-03-14,21,210,328,538,Col254_T,"-37.81564191, 144.965499"
532220250809,53,2025-08-09,22,118,230,348,Col254_T,"-37.81564191, 144.965499"
531720250816,53,2025-08-16,17,567,363,930,Col254_T,"-37.81564191, 144.965499"
531320240116,53,2024-01-16,13,943,804,1747,Col254_T,"-37.81564191, 144.965499"
30520241020,30,2024-10-20,5,49,82,131,Lon189_T,"-37.8112185, 144.96656806"
20020240323,20,2024-03-23,0,100,222,322,LtB170_T,"-37.81172914, 144.9682466"
20720240516,20,2024-05-16,7,43,31,74,LtB170_T,"-37.81172914, 144.9682466"
141920240722,141,2024-07-22,9,129,78,207,474Fl_T,"-37.81997273, 144.95834911"
137620240211,137,2024-02-11,6,0,1,1,BouHbr2353_T,"-37.81894815, 144.94612292"
139420240506,139,2024-05-06,4,0,1,1,Signal1647_T,"-37.81959923, 144.9632832"
1421520250412,142,2025-04-12,15,665,525,1190,Hammer1584_T,"-37.81970749, 144.96795734"
142020240727,142,2024-07-27,0,29,33,62,Hammer1584_T,"-37.81970749, 144.96795734"
1802220250905,180,2025-09-05,22,0,4,4,Mac330_T,"-37.79497059, 144.93530329"
1231020250306,123,2025-03-06,10,18,7,25,BirBridge_T,"-37.81753741, 144.97329734"
1381120240615,138,2024-06-15,11,5,6,11,EntPark1671_T,"-37.81996544, 144.95981454"
1172120250104,117,2025-01-04,21,120,107,227,Fli114F_T,"-37.81629332, 144.97090877"
661020240124,66,2024-01-24,10,418,434,852,QVN_T,"-37.81057846, 144.96444294"
661420250121,66,2025-01-21,14,796,888,1684,QVN_T,"-37.81057846, 144.96444294"
62320240307,6,2024-03-07,23,393,186,579,FliS_T,"-37.81911705, 144.96558255"
6920250202,6,2025-02-02,9,392,351,743,FliS_T,"-37.81911705, 144.96558255"
841120240314,84,2024-03-14,11,771,723,1494,ElFi_T,"-37.81798049, 144.96503383"
41820231123,4,2023-11-23,18,1892,1361,3253,Swa123_T,"-37.81487988, 144.9660878"
41220240123,4,2024-01-23,12,2071,1356,3427,Swa123_T,"-37.81487988, 144.9660878"
32320240719,3,2024-07-19,23,660,579,1239,Swa295_T,"-37.81101524, 144.96429485"
32120231201,3,2023-12-01,21,1190,1018,2208,Swa295_T,"-37.81101524, 144.96429485"
31420231229,3,2023-12-29,14,1186,1397,2583,Swa295_T,"-37.81101524, 144.96429485"
751420250313,75,2025-03-13,14,115,73,188,SprFli_T,"-37.81515276, 144.97467661"
752320240316,75,2024-03-16,23,1,1,2,SprFli_T,"-37.81515276, 144.97467661"
411520250209,41,2025-02-09,15,1678,1919,3597,Swa31,"-37.81668634, 144.96689733"
781320250117,78,2025-01-17,13,40,44,84,HarEsB_T,"-37.81471642, 144.9446508"
65220231223,65,2023-12-23,2,18,94,112,SwaCs_T,"-37.81569416, 144.9668064"
421120250717,42,2025-07-17,11,150,261,411,UM1_T,"-37.80008566, 144.96386412"
291120240813,29,2024-08-13,11,166,278,444,AG_T,"-37.8199817, 144.96872865"
142020240410,14,2024-04-10,20,259,93,352,SanBri_T,"-37.82011242, 144.96291897"
712220250116,71,2025-01-16,22,6,3,9,WestWP_T,"-37.81235775, 144.97136962"
59520240902,59,2024-09-02,5,12,27,39,RMIT_T,"-37.80825648, 144.96304859"
652320240926,65,2024-09-26,23,216,199,415,SwaCs_T,"-37.81569416, 144.9668064"
54120250527,54,2025-05-27,1,14,17,31,Swa607_T,"-37.804024, 144.96308399"
28620250227,28,2025-02-27,6,204,92,296,VAC_T,"-37.82129925, 144.96879309"
21520240830,21,2024-08-30,5,5,7,12,Bourke155_T,"-37.81267313, 144.96788288"
212020250219,21,2025-02-19,20,243,241,484,Bourke155_T,"-37.81267313, 144.96788288"
36820241010,36,2024-10-10,8,261,184,445,Que85_T,"-37.81652527, 144.96121062"
371420240906,37,2024-09-06,14,96,106,202,Lyg260_T,"-37.80107122, 144.96704554"
44620240624,44,2024-06-24,6,3,2,5,UM3_T,"-37.79698741, 144.96441306"
441120241103,44,2024-11-03,11,33,38,71,UM3_T,"-37.79698741, 144.96441306"
431120250311,43,2025-03-11,11,241,255,496,UM2_T,"-37.79844526, 144.96411782"
431320250515,43,2025-05-15,13,263,427,690,UM2_T,"-37.79844526, 144.96411782"
452020250924,45,2025-09-24,20,211,524,735,Swa148_T,"-37.81414075, 144.96609379"
5220240121,5,2024-01-21,2,131,124,255,PriNW_T,"-37.81874249, 144.96787656"
51320240502,5,2024-05-02,13,1266,880,2146,PriNW_T,"-37.81874249, 144.96787656"
1071420240611,107,2024-06-11,14,114,125,239,280Will_T,"-37.81246271, 144.95690188"
1181320250811,118,2025-08-11,13,14,8,22,Fli114C_T,"-37.81632783, 144.97090512"
871620250327,87,2025-03-27,16,98,97,195,Errol23_T,"-37.80454949, 144.94921863"
1081720240625,108,2024-06-25,17,344,211,555,261Will_T,"-37.81295822, 144.95678789"
201820250403,20,2025-04-03,18,504,386,890,LtB170_T,"-37.81172914, 144.9682466"
202320240418,20,2024-04-18,23,142,180,322,LtB170_T,"-37.81172914, 144.9682466"
1371220250312,137,2025-03-12,12,47,116,163,BouHbr2353_T,"-37.81894815, 144.94612292"
1372120250609,137,2025-06-09,21,0,3,3,BouHbr2353_T,"-37.81894815, 144.94612292"
1361620240101,136,2024-01-01,16,50,47,97,BirFed1120_T,"-37.8184141, 144.97357915"
1641120241026,164,2024-10-26,11,106,28,134,Lat526_T,"-37.813005, 144.95160411"
1171920250609,117,2025-06-09,19,116,133,249,Fli114F_T,"-37.81629332, 144.97090877"
1171320250610,117,2025-06-10,13,173,174,347,Fli114F_T,"-37.81629332, 144.97090877"
117820240511,117,2024-05-11,8,46,57,103,Fli114F_T,"-37.81629332, 144.97090877"
44820240813,44,2024-08-13,8,64,83,147,UM3_T,"-37.79698741, 144.96441306"
118720250616,118,2025-06-16,7,4,9,13,Fli114C_T,"-37.81632783, 144.97090512"
108520240214,108,2024-02-14,5,12,60,72,261Will_T,"-37.81295822, 144.95678789"
87620250624,87,2025-06-24,6,12,8,20,Errol23_T,"-37.80454949, 144.94921863"
612120250719,61,2025-07-19,21,185,109,294,RMIT14_T,"-37.80767455, 144.96309114"
611220250421,61,2025-04-21,12,331,395,726,RMIT14_T,"-37.80767455, 144.96309114"
611920240605,61,2024-06-05,19,334,673,1007,RMIT14_T,"-37.80767455, 144.96309114"
50820250108,50,2025-01-08,8,57,63,120,Lyg309_T,"-37.79808192, 144.96721013"
1661420250531,166,2025-05-31,14,43,47,90,Spen484_T,"-37.80896733, 144.94931703"
1791620250409,179,2025-04-09,16,54,59,113,Pow61_T,"-37.82392385, 144.96299677"
162120250817,162,2025-08-17,1,67,51,118,Eli489_T,"-37.80740397, 144.95987909"
143020250715,143,2025-07-15,0,45,14,59,Spencer_T,"-37.821728, 144.95557015"
1431720250717,143,2025-07-17,17,253,343,596,Spencer_T,"-37.821728, 144.95557015"
1351520231105,135,2023-11-05,15,352,383,735,Spen161_T,"-37.8172861, 144.95319102"
681920240124,68,2024-01-24,19,158,80,238,FLDegN_T,"-37.8168479, 144.96559789"
171520240514,17,2024-05-14,15,330,382,712,Col15_T,"-37.81362543, 144.97323591"
1820241217,1,2024-12-17,8,250,305,555,Bou292_T,"-37.81349441, 144.96515323"
181520240107,18,2024-01-07,15,22,21,43,Col12_T,"-37.81344862, 144.97305353"
631720250728,63,2025-07-28,17,187,273,460,Bou231_T,"-37.81333081, 144.96675571"
861420241205,86,2024-12-05,14,33,53,86,574Qub_T,"-37.80309992, 144.94908064"
101520231228,10,2023-12-28,15,49,42,91,BouHbr_T,"-37.81876474, 144.94710545"
241720240102,24,2024-01-02,17,473,1031,1504,Col620_T,"-37.81887963, 144.95449198"
761220240927,76,2024-09-27,12,57,43,100,KenMac_T,"-37.79453803, 144.93036194"
581520250827,58,2025-08-27,15,548,567,1115,Bou688_T,"-37.81686075, 144.95358075"
21720240615,2,2024-06-15,17,660,594,1254,Bou283_T,"-37.81380668, 144.96516718"
9420240929,9,2024-09-29,4,3,10,13,Col700_T,"-37.81982992, 144.95102555"
79420240219,79,2024-02-19,4,10,17,27,FliSS_T,"-37.81794046, 144.96616678"
302220241028,30,2024-10-28,22,96,163,259,Lon189_T,"-37.8112185, 144.96656806"
25920240914,25,2024-09-14,9,90,229,319,MCEC_T,"-37.82401776, 144.95604426"
491520231114,49,2023-11-14,15,222,338,560,Eli501_T,"-37.80730068, 144.95956055"
30620250918,30,2025-09-18,6,22,19,41,Lon189_T,"-37.8112185, 144.96656806"
201720250528,20,2025-05-28,17,346,232,578,LtB170_T,"-37.81172914, 144.9682466"
201420240514,20,2024-05-14,14,137,219,356,LtB170_T,"-37.81172914, 144.9682466"
20620240912,20,2024-09-12,6,8,13,21,LtB170_T,"-37.81172914, 144.9682466"
1801120250611,180,2025-06-11,11,27,23,50,Mac330_T,"-37.79497059, 144.93530329"
136120240212,136,2024-02-12,1,2,1,3,BirFed1120_T,"-37.8184141, 144.97357915"
1422120251010,142,2025-10-10,21,5,7,12,Hammer1584_T,"-37.81970749, 144.96795734"
491420241223,49,2024-12-23,14,333,533,866,Eli501_T,"-37.80730068, 144.95956055"
1091920250612,109,2025-06-12,19,90,111,201,LatWill_T,"-37.81193681, 144.95621105"
66020241102,66,2024-11-02,0,182,189,371,QVN_T,"-37.81057846, 144.96444294"
842220250322,84,2025-03-22,22,523,744,1267,ElFi_T,"-37.81798049, 144.96503383"
841420250818,84,2025-08-18,14,669,979,1648,ElFi_T,"-37.81798049, 144.96503383"
41320231108,4,2023-11-08,13,1708,1537,3245,Swa123_T,"-37.81487988, 144.9660878"
701720250817,70,2025-08-17,17,113,142,255,Errol20_T,"-37.80456984, 144.94946228"
3820231104,3,2023-11-04,8,97,141,238,Swa295_T,"-37.81101524, 144.96429485"
39920240323,39,2024-03-23,9,112,91,203,AlfPl_T,"-37.81379749, 144.96995745"
51820250830,51,2025-08-30,8,41,40,81,Fra118_T,"-37.80841815, 144.95906316"
511720241106,51,2024-11-06,17,108,102,210,Fra118_T,"-37.80841815, 144.95906316"
521520250414,52,2025-04-14,15,457,275,732,Eli263_T,"-37.81252157, 144.9619401"
522320250521,52,2025-05-21,23,40,18,58,Eli263_T,"-37.81252157, 144.9619401"
1422020250512,142,2025-05-12,20,20,17,37,Hammer1584_T,"-37.81970749, 144.96795734"
1362120241007,136,2024-10-07,21,1,1,2,BirFed1120_T,"-37.8184141, 144.97357915"
1381120241102,138,2024-11-02,11,4,11,15,EntPark1671_T,"-37.81996544, 144.95981454"
1381520250225,138,2025-02-25,15,10,6,16,EntPark1671_T,"-37.81996544, 144.95981454"
161520241102,161,2024-11-02,5,0,3,3,BirArt1109_T,"-37.81851276, 144.97131336"
161620250304,161,2025-03-04,6,19,31,50,BirArt1109_T,"-37.81851276, 144.97131336"
1301920231210,130,2023-12-10,19,14,17,31,Bou892T,"-37.8204637, 144.94126826"
1381220240125,138,2024-01-25,12,14,8,22,EntPark1671_T,"-37.81996544, 144.95981454"
49620250409,49,2025-04-09,6,52,51,103,Eli501_T,"-37.80730068, 144.95956055"
117720240203,117,2024-02-03,7,21,46,67,Fli114F_T,"-37.81629332, 144.97090877"
1171120241207,117,2024-12-07,11,134,141,275,Fli114F_T,"-37.81629332, 144.97090877"
123320240112,123,2024-01-12,3,1,0,1,BirBridge_T,"-37.81753741, 144.97329734"
49620240405,49,2024-04-05,6,47,52,99,Eli501_T,"-37.80730068, 144.95956055"
109020240727,109,2024-07-27,0,25,35,60,LatWill_T,"-37.81193681, 144.95621105"
19520240418,19,2024-04-18,5,6,7,13,LtB210_T,"-37.81237202, 144.96550671"
1802120250824,180,2025-08-24,21,0,2,2,Mac330_T,"-37.79497059, 144.93530329"
69620241107,69,2024-11-07,6,13,14,27,FLDegC_T,"-37.81687226, 144.96559144"
61220240205,6,2024-02-05,12,593,495,1088,FliS_T,"-37.81911705, 144.96558255"
41720231215,4,2023-12-15,17,2548,2040,4588,Swa123_T,"-37.81487988, 144.9660878"
31720231220,3,2023-12-20,17,1324,1368,2692,Swa295_T,"-37.81101524, 144.96429485"
4120250627,4,2025-06-27,1,66,81,147,Swa123_T,"-37.81487988, 144.9660878"
70320250412,70,2025-04-12,3,1,2,3,Errol20_T,"-37.80456984, 144.94946228"
81120240530,8,2024-05-30,11,94,173,267,WebBN_T,"-37.82293543, 144.9471751"
75320240801,75,2024-08-01,3,1,2,3,SprFli_T,"-37.81515276, 144.97467661"
41720250618,41,2025-06-18,7,801,340,1141,Swa31,"-37.81668634, 144.96689733"
422320241210,42,2024-12-10,23,12,9,21,UM1_T,"-37.80008566, 144.96386412"
781520241129,78,2024-11-29,15,47,88,135,HarEsB_T,"-37.81471642, 144.9446508"
781020240409,78,2024-04-09,10,17,30,47,HarEsB_T,"-37.81471642, 144.9446508"
59820231203,59,2023-12-03,8,65,93,158,RMIT_T,"-37.80825648, 144.96304859"
291120250113,29,2025-01-13,11,436,315,751,AG_T,"-37.8199817, 144.96872865"
401920240428,40,2024-04-28,19,56,68,124,Spr201_T,"-37.80999341, 144.97227587"
67620250721,67,2025-07-21,6,38,31,69,FLDegS_T,"-37.81688755, 144.96562569"
85420241015,85,2024-10-15,4,1,0,1,488Mac_T,"-37.79432415, 144.92973378"
682120240925,68,2024-09-25,21,58,22,80,FLDegN_T,"-37.8168479, 144.96559789"
682220250612,68,2025-06-12,22,33,27,60,FLDegN_T,"-37.8168479, 144.96559789"
861320250803,86,2025-08-03,13,62,49,111,574Qub_T,"-37.80309992, 144.94908064"
12620250416,12,2025-04-16,6,53,47,100,NewQ_T,"-37.81457988, 144.94292398"
56720250721,56,2025-07-21,7,47,55,102,Lon364_T,"-37.81234775, 144.96153311"
35320241021,35,2024-10-21,3,14,17,31,SouthB_T,"-37.82018685, 144.96508508"
21920240508,2,2024-05-08,19,142,192,334,Bou283_T,"-37.81380668, 144.96516718"
791220240715,79,2024-07-15,12,338,271,609,FliSS_T,"-37.81794046, 144.96616678"
791020231203,79,2023-12-03,10,422,268,690,FliSS_T,"-37.81794046, 144.96616678"
791420240713,79,2024-07-13,14,824,539,1363,FliSS_T,"-37.81794046, 144.96616678"
532320250518,53,2025-05-18,23,16,16,32,Col254_T,"-37.81564191, 144.965499"
30020250706,30,2025-07-06,0,308,332,640,Lon189_T,"-37.8112185, 144.96656806"
142020250914,142,2025-09-14,0,2,0,2,Hammer1584_T,"-37.81970749, 144.96795734"
136020250506,136,2025-05-06,0,1,0,1,BirFed1120_T,"-37.8184141, 144.97357915"
1231720250419,123,2025-04-19,17,70,28,98,BirBridge_T,"-37.81753741, 144.97329734"
130620240124,130,2024-01-24,6,1,2,3,Bou892T,"-37.8204637, 144.94126826"
117220240316,117,2024-03-16,2,26,13,39,Fli114F_T,"-37.81629332, 144.97090877"
117920241225,117,2024-12-25,9,34,57,91,Fli114F_T,"-37.81629332, 144.97090877"
109220240303,109,2024-03-03,2,23,21,44,LatWill_T,"-37.81193681, 144.95621105"
191520241114,19,2024-11-14,15,415,430,845,LtB210_T,"-37.81237202, 144.96550671"
481720250708,48,2025-07-08,17,130,158,288,QVMQ_T,"-37.80631581, 144.95866697"
211720240227,21,2024-02-27,17,445,459,904,Bourke155_T,"-37.81267313, 144.96788288"
37320240223,37,2024-02-23,3,5,8,13,Lyg260_T,"-37.80107122, 144.96704554"
50820240726,50,2024-07-26,8,48,81,129,Lyg309_T,"-37.79808192, 144.96721013"
135520250331,135,2025-03-31,5,40,22,62,Spen161_T,"-37.8172861, 144.95319102"
1341120241019,134,2024-10-19,11,466,492,958,Spen201_T,"-37.81694221, 144.95303935"
1071420240624,107,2024-06-24,14,92,111,203,280Will_T,"-37.81246271, 144.95690188"
1072020231029,107,2023-10-29,20,71,63,134,280Will_T,"-37.81246271, 144.95690188"
87820250109,87,2025-01-09,8,43,39,82,Errol23_T,"-37.80454949, 144.94921863"
1811720250810,181,2025-08-10,17,978,970,1948,Eli368_T,"-37.81009465, 144.96143149"
1661620241006,166,2024-10-06,16,61,72,133,Spen484_T,"-37.80896733, 144.94931703"
167120250821,167,2025-08-21,1,0,2,2,Lat526_T,"-37.81304149, 144.95155955"
1431720250303,143,2025-03-03,17,267,322,589,Spencer_T,"-37.821728, 144.95557015"
1322020240716,132,2024-07-16,20,74,104,178,King335_T,"-37.81267639, 144.95386444"
85820250505,85,2025-05-05,8,124,65,189,488Mac_T,"-37.79432415, 144.92973378"
17320240729,17,2024-07-29,3,1,1,2,Col15_T,"-37.81362543, 144.97323591"
17520241230,17,2024-12-30,5,13,5,18,Col15_T,"-37.81362543, 144.97323591"
1820240116,1,2024-01-16,8,189,259,448,Bou292_T,"-37.81349441, 144.96515323"
1920240816,1,2024-08-16,9,292,363,655,Bou292_T,"-37.81349441, 144.96515323"
631020250629,63,2025-06-29,10,129,189,318,Bou231_T,"-37.81333081, 144.96675571"
621720231101,62,2023-11-01,17,272,172,444,Lat224_T,"-37.80996494, 144.96216521"
111720250611,11,2025-06-11,17,108,102,210,WatCit_T,"-37.81564989, 144.93970694"
27520250205,27,2025-02-05,5,2,1,3,Vic_T,"-37.80606888, 144.95644692"
27920231116,27,2023-11-16,9,50,92,142,Vic_T,"-37.80606888, 144.95644692"
30920250518,30,2025-05-18,9,45,139,184,Lon189_T,"-37.8112185, 144.96656806"
202220250716,20,2025-07-16,22,89,183,272,LtB170_T,"-37.81172914, 144.9682466"
461320250519,46,2025-05-19,13,194,158,352,Pel147_T,"-37.80240719, 144.9615673"
1391120250302,139,2025-03-02,11,37,35,72,Signal1647_T,"-37.81959923, 144.9632832"
142020250514,142,2025-05-14,0,1,2,3,Hammer1584_T,"-37.81970749, 144.96795734"
138720250119,138,2025-01-19,7,6,2,8,EntPark1671_T,"-37.81996544, 144.95981454"
1231820250817,123,2025-08-17,18,7,0,7,BirBridge_T,"-37.81753741, 144.97329734"
1091420250405,109,2025-04-05,14,86,90,176,LatWill_T,"-37.81193681, 144.95621105"
109820231026,109,2023-10-26,8,83,744,827,LatWill_T,"-37.81193681, 144.95621105"
1091920240623,109,2024-06-23,19,52,63,115,LatWill_T,"-37.81193681, 144.95621105"
19520240503,19,2024-05-03,5,7,2,9,LtB210_T,"-37.81237202, 144.96550671"
191520240714,19,2024-07-14,15,644,622,1266,LtB210_T,"-37.81237202, 144.96550671"
192120231027,19,2023-10-27,21,688,699,1387,LtB210_T,"-37.81237202, 144.96550671"
19320231201,19,2023-12-01,3,13,32,45,LtB210_T,"-37.81237202, 144.96550671"
192320231231,19,2023-12-31,23,271,470,741,LtB210_T,"-37.81237202, 144.96550671"
87420241110,87,2024-11-10,4,3,0,3,Errol23_T,"-37.80454949, 144.94921863"
61320240119,61,2024-01-19,3,13,2,15,RMIT14_T,"-37.80767455, 144.96309114"
162320250307,162,2025-03-07,3,10,6,16,Eli489_T,"-37.80740397, 144.95987909"
1852320251013,185,2025-10-13,23,120,73,193,Eli197_T,"-37.81374643, 144.96276183"
134820240609,134,2024-06-09,8,94,91,185,Spen201_T,"-37.81694221, 144.95303935"
135720240108,135,2024-01-08,7,127,70,197,Spen161_T,"-37.8172861, 144.95319102"
1351820250616,135,2025-06-16,18,176,180,356,Spen161_T,"-37.8172861, 144.95319102"
122220240513,12,2024-05-13,22,33,41,74,NewQ_T,"-37.81457988, 144.94292398"
24520240903,24,2024-09-03,5,102,59,161,Col620_T,"-37.81887963, 144.95449198"
721520240101,72,2024-01-01,15,175,343,518,ACMI_T,"-37.81726338, 144.96872809"
58720250426,58,2025-04-26,7,83,69,152,Bou688_T,"-37.81686075, 144.95358075"
58020251007,58,2025-10-07,0,54,55,109,Bou688_T,"-37.81686075, 144.95358075"
2320250130,2,2025-01-30,3,3,10,13,Bou283_T,"-37.81380668, 144.96516718"
582220250502,58,2025-05-02,22,1095,262,1357,Bou688_T,"-37.81686075, 144.95358075"
27120250517,27,2025-05-17,1,23,10,33,Vic_T,"-37.80606888, 144.95644692"
792320231113,79,2023-11-13,23,85,85,170,FliSS_T,"-37.81794046, 144.96616678"
9620240625,9,2024-06-25,6,23,386,409,Col700_T,"-37.81982992, 144.95102555"
532020231215,53,2023-12-15,20,383,315,698,Col254_T,"-37.81564191, 144.965499"
23220240802,23,2024-08-02,2,8,8,16,Col623_T,"-37.81909256, 144.95452748"
23620231222,23,2023-12-22,6,49,40,89,Col623_T,"-37.81909256, 144.95452748"
231620240422,23,2024-04-22,16,173,509,682,Col623_T,"-37.81909256, 144.95452748"
301820250815,30,2025-08-15,18,412,555,967,Lon189_T,"-37.8112185, 144.96656806"
30020240628,30,2024-06-28,0,123,98,221,Lon189_T,"-37.8112185, 144.96656806"
521620250328,52,2025-03-28,16,421,306,727,Eli263_T,"-37.81252157, 144.9619401"
521420240708,52,2024-07-08,14,385,318,703,Eli263_T,"-37.81252157, 144.9619401"
231320250618,23,2025-06-18,13,310,511,821,Col623_T,"-37.81909256, 144.95452748"
482220240219,48,2024-02-19,22,34,71,105,QVMQ_T,"-37.80631581, 144.95866697"
46120240225,46,2024-02-25,1,2,9,11,Pel147_T,"-37.80240719, 144.9615673"
491920250814,49,2025-08-14,19,231,266,497,Eli501_T,"-37.80730068, 144.95956055"
141020240827,141,2024-08-27,0,8,11,19,474Fl_T,"-37.81997273, 144.95834911"
1411820251014,141,2025-10-14,18,151,91,242,474Fl_T,"-37.81997273, 144.95834911"
1361820240322,136,2024-03-22,18,117,48,165,BirFed1120_T,"-37.8184141, 144.97357915"
1421720250219,142,2025-02-19,17,566,462,1028,Hammer1584_T,"-37.81970749, 144.96795734"
164120250729,164,2025-07-29,1,0,6,6,Lat526_T,"-37.813005, 144.95160411"
161720240806,161,2024-08-06,7,96,160,256,BirArt1109_T,"-37.81851276, 144.97131336"
1231720251006,123,2025-10-06,17,43,43,86,BirBridge_T,"-37.81753741, 144.97329734"
1092020241231,109,2024-12-31,20,190,329,519,LatWill_T,"-37.81193681, 144.95621105"
672020240625,67,2024-06-25,20,182,359,541,FLDegS_T,"-37.81688755, 144.96562569"
671020240722,67,2024-07-22,10,308,437,745,FLDegS_T,"-37.81688755, 144.96562569"
17120240413,17,2024-04-13,1,20,21,41,Col15_T,"-37.81362543, 144.97323591"
631520240921,63,2024-09-21,15,454,486,940,Bou231_T,"-37.81333081, 144.96675571"
18220240222,18,2024-02-22,2,0,3,3,Col12_T,"-37.81344862, 144.97305353"
63420231020,63,2023-10-20,4,4,11,15,Bou231_T,"-37.81333081, 144.96675571"
561120250116,56,2025-01-16,11,249,173,422,Lon364_T,"-37.81234775, 144.96153311"
86920240708,86,2024-07-08,9,37,20,57,574Qub_T,"-37.80309992, 144.94908064"
111520240513,11,2024-05-13,15,81,71,152,WatCit_T,"-37.81564989, 144.93970694"
66220250527,66,2025-05-27,2,13,5,18,QVN_T,"-37.81057846, 144.96444294"
662120250106,66,2025-01-06,21,588,359,947,QVN_T,"-37.81057846, 144.96444294"
691520250119,69,2025-01-19,15,266,323,589,FLDegC_T,"-37.81687226, 144.96559144"
84020241222,84,2024-12-22,0,339,326,665,ElFi_T,"-37.81798049, 144.96503383"
4320240519,4,2024-05-19,3,78,99,177,Swa123_T,"-37.81487988, 144.9660878"
391520240513,39,2024-05-13,15,71,71,142,AlfPl_T,"-37.81379749, 144.96995745"
391520240528,39,2024-05-28,15,59,72,131,AlfPl_T,"-37.81379749, 144.96995745"
391920251011,39,2025-10-11,19,34,23,57,AlfPl_T,"-37.81379749, 144.96995745"
411420250616,41,2025-06-16,14,1148,1218,2366,Swa31,"-37.81668634, 144.96689733"
771620250331,77,2025-03-31,16,142,104,246,HarEsP_T,"-37.81441438, 144.94433026"
772320250511,77,2025-05-11,23,26,22,48,HarEsP_T,"-37.81441438, 144.94433026"
842320240512,84,2024-05-12,23,198,151,349,ElFi_T,"-37.81798049, 144.96503383"
3020250806,3,2025-08-06,0,70,61,131,Swa295_T,"-37.81101524, 144.96429485"
8020231105,8,2023-11-05,0,10,14,24,WebBN_T,"-37.82293543, 144.9471751"
8920241022,8,2024-10-22,9,228,123,351,WebBN_T,"-37.82293543, 144.9471751"
41320250316,41,2025-03-16,3,127,306,433,Swa31,"-37.81668634, 144.96689733"
29020240603,29,2024-06-03,0,3,6,9,AG_T,"-37.8199817, 144.96872865"
291220250115,29,2025-01-15,12,441,381,822,AG_T,"-37.8199817, 144.96872865"
14420250305,14,2025-03-05,4,19,0,19,SanBri_T,"-37.82011242, 144.96291897"
711020231103,71,2023-11-03,10,34,29,63,WestWP_T,"-37.81235775, 144.97136962"
541820250312,54,2025-03-12,18,160,498,658,Swa607_T,"-37.804024, 144.96308399"
281020250628,28,2025-06-28,10,677,222,899,VAC_T,"-37.82129925, 144.96879309"
281720241204,28,2024-12-04,17,487,813,1300,VAC_T,"-37.82129925, 144.96879309"
40820240217,40,2024-02-17,8,34,48,82,Spr201_T,"-37.80999341, 144.97227587"
361620240518,36,2024-05-18,16,130,102,232,Que85_T,"-37.81652527, 144.96121062"
501920240708,50,2024-07-08,19,142,143,285,Lyg309_T,"-37.79808192, 144.96721013"
442020240719,44,2024-07-19,20,8,18,26,UM3_T,"-37.79698741, 144.96441306"
431620240624,43,2024-06-24,16,113,187,300,UM2_T,"-37.79844526, 144.96411782"
451420240705,45,2024-07-05,14,783,889,1672,Swa148_T,"-37.81414075, 144.96609379"
133320240618,133,2024-06-18,3,7,7,14,Spen229_T,"-37.81531435, 144.95227769"
118520240831,118,2024-08-31,5,0,2,2,Fli114C_T,"-37.81632783, 144.97090512"
1241820250411,124,2025-04-11,18,1,1,2,BirBridge_T,"-37.81757416, 144.97329934"
1671720240911,167,2024-09-11,17,49,67,116,Lat526_T,"-37.81304149, 144.95155955"
1401620240212,140,2024-02-12,16,89,89,178,Boyd2837_T,"-37.82590962, 144.96185972"
134320250811,134,2025-08-11,3,10,9,19,Spen201_T,"-37.81694221, 144.95303935"
1342020250414,134,2025-04-14,20,324,271,595,Spen201_T,"-37.81694221, 144.95303935"
1120240602,1,2024-06-02,1,41,81,122,Bou292_T,"-37.81349441, 144.96515323"
632320241103,63,2024-11-03,23,101,72,173,Bou231_T,"-37.81333081, 144.96675571"
671820241201,67,2024-12-01,18,203,257,460,FLDegS_T,"-37.81688755, 144.96562569"
18620250909,18,2025-09-09,6,10,40,50,Col12_T,"-37.81344862, 144.97305353"
112020231107,11,2023-11-07,20,126,104,230,WatCit_T,"-37.81564989, 144.93970694"
121120250809,12,2025-08-09,11,190,198,388,NewQ_T,"-37.81457988, 144.94292398"
72620250814,72,2025-08-14,6,66,35,101,ACMI_T,"-37.81726338, 144.96872809"
241620250901,24,2025-09-01,16,462,1769,2231,Col620_T,"-37.81887963, 144.95449198"
351420250621,35,2025-06-21,14,1275,1501,2776,SouthB_T,"-37.82018685, 144.96508508"
35620250302,35,2025-03-02,6,70,125,195,SouthB_T,"-37.82018685, 144.96508508"
351520240927,35,2024-09-27,15,1690,2439,4129,SouthB_T,"-37.82018685, 144.96508508"
271520250115,27,2025-01-15,15,125,83,208,Vic_T,"-37.80606888, 144.95644692"
271420250905,27,2025-09-05,14,179,142,321,Vic_T,"-37.80606888, 144.95644692"
79020250430,79,2025-04-30,0,17,33,50,FliSS_T,"-37.81794046, 144.96616678"
79920241118,79,2024-11-18,9,411,208,619,FliSS_T,"-37.81794046, 144.96616678"
51820240322,51,2024-03-22,8,72,64,136,Fra118_T,"-37.80841815, 144.95906316"
511820241019,51,2024-10-19,18,125,112,237,Fra118_T,"-37.80841815, 144.95906316"
1391620250307,139,2025-03-07,16,110,57,167,Signal1647_T,"-37.81959923, 144.9632832"
1421220241030,142,2024-10-30,12,534,469,1003,Hammer1584_T,"-37.81970749, 144.96795734"
411620240131,41,2024-01-31,16,1358,1743,3101,Swa31,"-37.81668634, 144.96689733"
78320240926,78,2024-09-26,3,0,1,1,HarEsB_T,"-37.81471642, 144.9446508"
59120240917,59,2024-09-17,1,32,8,40,RMIT_T,"-37.80825648, 144.96304859"
541920240412,54,2024-04-12,19,117,229,346,Swa607_T,"-37.804024, 144.96308399"
401420250126,40,2025-01-26,14,225,184,409,Spr201_T,"-37.80999341, 144.97227587"
472120240223,47,2024-02-23,21,579,454,1033,Eli250_T,"-37.81258467, 144.9625775"
401720250909,40,2025-09-09,17,166,276,442,Spr201_T,"-37.80999341, 144.97227587"
311620241204,31,2024-12-04,16,113,137,250,Lyg161_T,"-37.80169681, 144.96658911"
371020250402,37,2025-04-02,10,48,51,99,Lyg260_T,"-37.80107122, 144.96704554"
43920231031,43,2023-10-31,9,128,84,212,UM2_T,"-37.79844526, 144.96411782"
45720251009,45,2025-10-09,7,97,163,260,Swa148_T,"-37.81414075, 144.96609379"
441220241110,44,2024-11-10,12,30,51,81,UM3_T,"-37.79698741, 144.96441306"
21820250331,21,2025-03-31,8,51,68,119,Bourke155_T,"-37.81267313, 144.96788288"
21220250621,21,2025-06-21,2,35,48,83,Bourke155_T,"-37.81267313, 144.96788288"
1182220250711,118,2025-07-11,22,11,11,22,Fli114C_T,"-37.81632783, 144.97090512"
107820250112,107,2025-01-12,8,49,39,88,280Will_T,"-37.81246271, 144.95690188"
108020240909,108,2024-09-09,0,7,15,22,261Will_T,"-37.81295822, 144.95678789"
611820231210,61,2023-12-10,18,304,354,658,RMIT14_T,"-37.80767455, 144.96309114"
611220240209,61,2024-02-09,12,305,414,719,RMIT14_T,"-37.80767455, 144.96309114"
501720241203,50,2024-12-03,17,217,194,411,Lyg309_T,"-37.79808192, 144.96721013"
501520250505,50,2025-05-05,15,182,147,329,Lyg309_T,"-37.79808192, 144.96721013"
1842220250729,184,2025-07-29,22,153,194,347,Eli124_T,"-37.81512416, 144.96371988"
1851420250915,185,2025-09-15,14,602,646,1248,Eli197_T,"-37.81374643, 144.96276183"
1401420250722,140,2025-07-22,14,61,49,110,Boyd2837_T,"-37.82590962, 144.96185972"
143520250915,143,2025-09-15,5,28,17,45,Spencer_T,"-37.821728, 144.95557015"
132620240413,132,2024-04-13,6,15,11,26,King335_T,"-37.81267639, 144.95386444"
134120241025,134,2024-10-25,1,26,44,70,Spen201_T,"-37.81694221, 144.95303935"
1341220241214,134,2024-12-14,12,374,401,775,Spen201_T,"-37.81694221, 144.95303935"
63820241226,63,2024-12-26,8,52,117,169,Bou231_T,"-37.81333081, 144.96675571"
111920231119,11,2023-11-19,19,157,177,334,WatCit_T,"-37.81564989, 144.93970694"
24420250608,24,2025-06-08,4,12,35,47,Col620_T,"-37.81887963, 144.95449198"
581320241228,58,2024-12-28,13,606,230,836,Bou688_T,"-37.81686075, 144.95358075"
21020250217,2,2025-02-17,10,299,393,692,Bou283_T,"-37.81380668, 144.96516718"
231420240122,23,2024-01-22,14,175,307,482,Col623_T,"-37.81909256, 144.95452748"
511720251008,51,2025-10-08,17,139,146,285,Fra118_T,"-37.80841815, 144.95906316"
202220241121,20,2024-11-21,22,200,373,573,LtB170_T,"-37.81172914, 144.9682466"
251120231030,25,2023-10-30,11,319,492,811,MCEC_T,"-37.82401776, 144.95604426"
137920240520,137,2024-05-20,9,52,23,75,BouHbr2353_T,"-37.81894815, 144.94612292"
1371820240525,137,2024-05-25,18,1,5,6,BouHbr2353_T,"-37.81894815, 144.94612292"
1371820250930,137,2025-09-30,18,10,50,60,BouHbr2353_T,"-37.81894815, 144.94612292"
1361020250409,136,2025-04-09,10,76,73,149,BirFed1120_T,"-37.8184141, 144.97357915"
1611920240706,161,2024-07-06,19,0,1,1,BirArt1109_T,"-37.81851276, 144.97131336"
491720240519,49,2024-05-19,17,185,195,380,Eli501_T,"-37.80730068, 144.95956055"
164920250617,164,2025-06-17,9,65,50,115,Lat526_T,"-37.813005, 144.95160411"
1382220250213,138,2025-02-13,22,0,1,1,EntPark1671_T,"-37.81996544, 144.95981454"
491520250410,49,2025-04-10,15,272,378,650,Eli501_T,"-37.80730068, 144.95956055"
117920241123,117,2024-11-23,9,43,73,116,Fli114F_T,"-37.81629332, 144.97090877"
492320240424,49,2024-04-24,23,124,108,232,Eli501_T,"-37.80730068, 144.95956055"
491920231020,49,2023-10-20,19,181,165,346,Eli501_T,"-37.80730068, 144.95956055"
692120250528,69,2025-05-28,21,16,18,34,FLDegC_T,"-37.81687226, 144.96559144"
6120240207,6,2024-02-07,1,18,20,38,FliS_T,"-37.81911705, 144.96558255"
81820231213,8,2023-12-13,18,174,263,437,WebBN_T,"-37.82293543, 144.9471751"
41820250321,41,2025-03-21,8,1553,525,2078,Swa31,"-37.81668634, 144.96689733"
781820250207,78,2025-02-07,18,71,144,215,HarEsB_T,"-37.81471642, 144.9446508"
65020241002,65,2024-10-02,0,32,21,53,SwaCs_T,"-37.81569416, 144.9668064"
291520250508,29,2025-05-08,15,193,200,393,AG_T,"-37.8199817, 144.96872865"
711120250706,71,2025-07-06,11,30,35,65,WestWP_T,"-37.81235775, 144.97136962"
711020240322,71,2024-03-22,10,42,25,67,WestWP_T,"-37.81235775, 144.97136962"
28220241216,28,2024-12-16,2,17,8,25,VAC_T,"-37.82129925, 144.96879309"
312120250120,31,2025-01-20,21,176,185,361,Lyg161_T,"-37.80169681, 144.96658911"
361920250922,36,2025-09-22,19,91,78,169,Que85_T,"-37.81652527, 144.96121062"
361020250728,36,2025-07-28,10,159,137,296,Que85_T,"-37.81652527, 144.96121062"
47820250816,47,2025-08-16,8,108,169,277,Eli250_T,"-37.81258467, 144.9625775"
118720240215,118,2024-02-15,7,19,14,33,Fli114C_T,"-37.81632783, 144.97090512"
118720250307,118,2025-03-07,7,12,3,15,Fli114C_T,"-37.81632783, 144.97090512"
118120231201,118,2023-12-01,1,1,0,1,Fli114C_T,"-37.81632783, 144.97090512"
872120240327,87,2024-03-27,21,43,25,68,Errol23_T,"-37.80454949, 144.94921863"
1622120250114,162,2025-01-14,21,195,104,299,Eli489_T,"-37.80740397, 144.95987909"
140520231115,140,2023-11-15,5,2,0,2,Boyd2837_T,"-37.82590962, 144.96185972"
851520231125,85,2023-11-25,15,110,104,214,488Mac_T,"-37.79432415, 144.92973378"
851620241217,85,2024-12-17,16,73,81,154,488Mac_T,"-37.79432415, 144.92973378"
851420250826,85,2025-08-26,14,42,44,86,488Mac_T,"-37.79432415, 144.92973378"
63620240926,63,2024-09-26,6,31,32,63,Bou231_T,"-37.81333081, 144.96675571"
111420240701,11,2024-07-01,14,67,88,155,WatCit_T,"-37.81564989, 144.93970694"
111220250310,11,2025-03-10,12,55,29,84,WatCit_T,"-37.81564989, 144.93970694"
671620240105,67,2024-01-05,16,313,533,846,FLDegS_T,"-37.81688755, 144.96562569"
621320250401,62,2025-04-01,13,265,226,491,Lat224_T,"-37.80996494, 144.96216521"
561620250424,56,2025-04-24,16,377,359,736,Lon364_T,"-37.81234775, 144.96153311"
861420250420,86,2025-04-20,14,22,49,71,574Qub_T,"-37.80309992, 144.94908064"
12820250815,12,2025-08-15,8,123,81,204,NewQ_T,"-37.81457988, 144.94292398"
24220231125,24,2023-11-25,2,43,50,93,Col620_T,"-37.81887963, 144.95449198"
1720250420,1,2025-04-20,7,34,20,54,Bou292_T,"-37.81349441, 144.96515323"
11920250716,11,2025-07-16,9,45,46,91,WatCit_T,"-37.81564989, 144.93970694"
61320241201,6,2024-12-01,13,841,836,1677,FliS_T,"-37.81911705, 144.96558255"
84220250217,84,2025-02-17,2,11,20,31,ElFi_T,"-37.81798049, 144.96503383"
3520231107,3,2023-11-07,5,28,39,67,Swa295_T,"-37.81101524, 144.96429485"
781920231127,78,2023-11-27,19,37,80,117,HarEsB_T,"-37.81471642, 144.9446508"
411220250107,41,2025-01-07,12,2038,1355,3393,Swa31,"-37.81668634, 144.96689733"
77820250707,77,2025-07-07,8,86,117,203,HarEsP_T,"-37.81441438, 144.94433026"
781120250329,78,2025-03-29,11,36,60,96,HarEsB_T,"-37.81471642, 144.9446508"
142320240805,14,2024-08-05,23,114,15,129,SanBri_T,"-37.82011242, 144.96291897"
651820240907,65,2024-09-07,18,945,710,1655,SwaCs_T,"-37.81569416, 144.9668064"
472120240828,47,2024-08-28,21,296,357,653,Eli250_T,"-37.81258467, 144.9625775"
311520250425,31,2025-04-25,15,114,183,297,Lyg161_T,"-37.80169681, 144.96658911"
311020250907,31,2025-09-07,10,157,143,300,Lyg161_T,"-37.80169681, 144.96658911"
311520251008,31,2025-10-08,15,132,128,260,Lyg161_T,"-37.80169681, 144.96658911"
451720251013,45,2025-10-13,17,589,830,1419,Swa148_T,"-37.81414075, 144.96609379"
5320231108,5,2023-11-08,3,15,10,25,PriNW_T,"-37.81874249, 144.96787656"
51020240130,5,2024-01-30,10,600,741,1341,PriNW_T,"-37.81874249, 144.96787656"
1332220240612,133,2024-06-12,22,155,133,288,Spen229_T,"-37.81531435, 144.95227769"
1182220241013,118,2024-10-13,22,18,9,27,Fli114C_T,"-37.81632783, 144.97090512"
107020250513,107,2025-05-13,0,11,13,24,280Will_T,"-37.81246271, 144.95690188"
871520250911,87,2025-09-11,15,81,91,172,Errol23_T,"-37.80454949, 144.94921863"
108620240828,108,2024-08-28,6,14,195,209,261Will_T,"-37.81295822, 144.95678789"
611220241106,61,2024-11-06,12,631,618,1249,RMIT14_T,"-37.80767455, 144.96309114"
611320231210,61,2023-12-10,13,366,568,934,RMIT14_T,"-37.80767455, 144.96309114"
442120250916,44,2025-09-16,21,31,19,50,UM3_T,"-37.79698741, 144.96441306"
1811720251016,181,2025-10-16,17,1118,1505,2623,Eli368_T,"-37.81009465, 144.96143149"
1401320250928,140,2025-09-28,13,90,92,182,Boyd2837_T,"-37.82590962, 144.96185972"
1311120250929,131,2025-09-29,11,72,113,185,King2_T,"-37.82009057, 144.95758725"
1311120240801,131,2024-08-01,11,79,111,190,King2_T,"-37.82009057, 144.95758725"
162320250926,162,2025-09-26,3,37,34,71,Eli489_T,"-37.80740397, 144.95987909"
132220231114,132,2023-11-14,2,11,1,12,King335_T,"-37.81267639, 144.95386444"
1341120240910,134,2024-09-10,11,331,314,645,Spen201_T,"-37.81694221, 144.95303935"
1341920240108,134,2024-01-08,19,192,226,418,Spen201_T,"-37.81694221, 144.95303935"
181920241113,18,2024-11-13,19,105,34,139,Col12_T,"-37.81344862, 144.97305353"
18020250302,18,2025-03-02,0,13,17,30,Col12_T,"-37.81344862, 144.97305353"
681020240708,68,2024-07-08,10,163,141,304,FLDegN_T,"-37.8168479, 144.96559789"
62920240314,62,2024-03-14,9,135,131,266,Lat224_T,"-37.80996494, 144.96216521"
561520240802,56,2024-08-02,15,256,254,510,Lon364_T,"-37.81234775, 144.96153311"
10020231030,10,2023-10-30,0,1,3,4,BouHbr_T,"-37.81876474, 144.94710545"
10720240316,10,2024-03-16,7,12,16,28,BouHbr_T,"-37.81876474, 144.94710545"
101820240425,10,2024-04-25,18,30,24,54,BouHbr_T,"-37.81876474, 144.94710545"
122220250105,12,2025-01-05,22,189,174,363,NewQ_T,"-37.81457988, 144.94292398"
722220241225,72,2024-12-25,22,489,382,871,ACMI_T,"-37.81726338, 144.96872809"
581520231031,58,2023-10-31,15,440,523,963,Bou688_T,"-37.81686075, 144.95358075"
21220241018,2,2024-10-18,12,525,570,1095,Bou283_T,"-37.81380668, 144.96516718"
21520241115,2,2024-11-15,15,674,700,1374,Bou283_T,"-37.81380668, 144.96516718"
79620240313,79,2024-03-13,6,118,73,191,FliSS_T,"-37.81794046, 144.96616678"
531620250522,53,2025-05-22,16,612,436,1048,Col254_T,"-37.81564191, 144.965499"
53520240127,53,2024-01-27,5,4,5,9,Col254_T,"-37.81564191, 144.965499"
79920251007,79,2025-10-07,9,311,195,506,FliSS_T,"-37.81794046, 144.96616678"
231920231027,23,2023-10-27,19,125,170,295,Col623_T,"-37.81909256, 144.95452748"
461320250120,46,2025-01-20,13,77,80,157,Pel147_T,"-37.80240719, 144.9615673"
51520241009,51,2024-10-09,5,2,8,10,Fra118_T,"-37.80841815, 144.95906316"
252120240806,25,2024-08-06,21,314,131,445,MCEC_T,"-37.82401776, 144.95604426"
19220240507,19,2024-05-07,2,18,20,38,LtB210_T,"-37.81237202, 144.96550671"
481320240509,48,2024-05-09,13,412,309,721,QVMQ_T,"-37.80631581, 144.95866697"
20220240622,20,2024-06-22,2,40,61,101,LtB170_T,"-37.81172914, 144.9682466"
78620250824,78,2025-08-24,6,4,5,9,HarEsB_T,"-37.81471642, 144.9446508"
77820240212,77,2024-02-12,8,193,142,335,HarEsP_T,"-37.81441438, 144.94433026"
651320240227,65,2024-02-27,13,447,525,972,SwaCs_T,"-37.81569416, 144.9668064"
14120250502,14,2025-05-02,1,15,3,18,SanBri_T,"-37.82011242, 144.96291897"
141720231224,14,2023-12-24,17,696,180,876,SanBri_T,"-37.82011242, 144.96291897"
591620231104,59,2023-11-04,16,569,683,1252,RMIT_T,"-37.80825648, 144.96304859"
361220241015,36,2024-10-15,12,481,421,902,Que85_T,"-37.81652527, 144.96121062"
37020250308,37,2025-03-08,0,63,60,123,Lyg260_T,"-37.80107122, 144.96704554"
51820240727,5,2024-07-27,18,321,485,806,PriNW_T,"-37.81874249, 144.96787656"
1331820250410,133,2025-04-10,18,581,483,1064,Spen229_T,"-37.81531435, 144.95227769"
108420241017,108,2024-10-17,4,6,7,13,261Will_T,"-37.81295822, 144.95678789"
108320241113,108,2024-11-13,3,1,1,2,261Will_T,"-37.81295822, 144.95678789"
166120250625,166,2025-06-25,1,1,1,2,Spen484_T,"-37.80896733, 144.94931703"
131520250319,131,2025-03-19,5,5,6,11,King2_T,"-37.82009057, 144.95758725"
131420250609,131,2025-06-09,4,14,44,58,King2_T,"-37.82009057, 144.95758725"
1321120240205,132,2024-02-05,11,50,34,84,King335_T,"-37.81267639, 144.95386444"
1311720240109,131,2024-01-09,17,140,131,271,King2_T,"-37.82009057, 144.95758725"
135920240629,135,2024-06-29,9,189,174,363,Spen161_T,"-37.8172861, 144.95319102"
1351820240728,135,2024-07-28,18,132,145,277,Spen161_T,"-37.8172861, 144.95319102"
135520231024,135,2023-10-24,5,21,12,33,Spen161_T,"-37.8172861, 144.95319102"
672220251005,67,2025-10-05,22,35,86,121,FLDegS_T,"-37.81688755, 144.96562569"
852320241226,85,2024-12-26,23,0,6,6,488Mac_T,"-37.79432415, 144.92973378"
17820250425,17,2025-04-25,8,101,57,158,Col15_T,"-37.81362543, 144.97323591"
12020250407,1,2025-04-07,20,255,244,499,Bou292_T,"-37.81349441, 144.96515323"
111420240111,11,2024-01-11,14,100,123,223,WatCit_T,"-37.81564989, 144.93970694"
11420240828,11,2024-08-28,4,0,1,1,WatCit_T,"-37.81564989, 144.93970694"
862320251014,86,2025-10-14,23,1,5,6,574Qub_T,"-37.80309992, 144.94908064"
101120250330,10,2025-03-30,11,56,32,88,BouHbr_T,"-37.81876474, 144.94710545"
11920250727,11,2025-07-27,9,47,63,110,WatCit_T,"-37.81564989, 144.93970694"
72820250321,72,2025-03-21,8,429,79,508,ACMI_T,"-37.81726338, 144.96872809"
722120240524,72,2024-05-24,21,127,187,314,ACMI_T,"-37.81726338, 144.96872809"
21520231213,2,2023-12-13,15,748,846,1594,Bou283_T,"-37.81380668, 144.96516718"
79720240110,79,2024-01-10,7,233,98,331,FliSS_T,"-37.81794046, 144.96616678"
531720250719,53,2025-07-19,17,461,365,826,Col254_T,"-37.81564191, 144.965499"
532220241108,53,2024-11-08,22,146,244,390,Col254_T,"-37.81564191, 144.965499"
301120250515,30,2025-05-15,11,167,210,377,Lon189_T,"-37.8112185, 144.96656806"
52520231222,52,2023-12-22,5,11,12,23,Eli263_T,"-37.81252157, 144.9619401"
522120241214,52,2024-12-14,21,325,298,623,Eli263_T,"-37.81252157, 144.9619401"
461220250324,46,2025-03-24,12,188,178,366,Pel147_T,"-37.80240719, 144.9615673"
511620240711,51,2024-07-11,16,85,68,153,Fra118_T,"-37.80841815, 144.95906316"
251520231031,25,2023-10-31,15,602,521,1123,MCEC_T,"-37.82401776, 144.95604426"
25920250808,25,2025-08-08,9,171,361,532,MCEC_T,"-37.82401776, 144.95604426"
192220240222,19,2024-02-22,22,212,330,542,LtB210_T,"-37.81237202, 144.96550671"
20820240406,20,2024-04-06,8,41,39,80,LtB170_T,"-37.81172914, 144.9682466"
1392220240216,139,2024-02-16,22,27,53,80,Signal1647_T,"-37.81959923, 144.9632832"
1362220250306,136,2025-03-06,22,25,2,27,BirFed1120_T,"-37.8184141, 144.97357915"
142020231120,142,2023-11-20,0,15,13,28,Hammer1584_T,"-37.81970749, 144.96795734"
1611020241028,161,2024-10-28,10,129,122,251,BirArt1109_T,"-37.81851276, 144.97131336"
161720241209,161,2024-12-09,7,79,120,199,BirArt1109_T,"-37.81851276, 144.97131336"
1231520240306,123,2024-03-06,15,42,20,62,BirBridge_T,"-37.81753741, 144.97329734"
1091520250707,109,2025-07-07,15,200,130,330,LatWill_T,"-37.81193681, 144.95621105"
69920240207,69,2024-02-07,9,162,103,265,FLDegC_T,"-37.81687226, 144.96559144"
692120250612,69,2025-06-12,21,35,39,74,FLDegC_T,"-37.81687226, 144.96559144"
761220241012,76,2024-10-12,12,58,75,133,KenMac_T,"-37.79453803, 144.93036194"
351920240902,35,2024-09-02,19,425,506,931,SouthB_T,"-37.82018685, 144.96508508"
21520240501,2,2024-05-01,15,486,609,1095,Bou283_T,"-37.81380668, 144.96516718"
271720241209,27,2024-12-09,17,120,70,190,Vic_T,"-37.80606888, 144.95644692"
271320240205,27,2024-02-05,13,76,103,179,Vic_T,"-37.80606888, 144.95644692"
531320241018,53,2024-10-18,13,772,635,1407,Col254_T,"-37.81564191, 144.965499"
791720250727,79,2025-07-27,17,386,644,1030,FliSS_T,"-37.81794046, 144.96616678"
53720250715,53,2025-07-15,7,119,86,205,Col254_T,"-37.81564191, 144.965499"
511320250701,51,2025-07-01,13,91,108,199,Fra118_T,"-37.80841815, 144.95906316"
48320240414,48,2024-04-14,3,6,22,28,QVMQ_T,"-37.80631581, 144.95866697"
46920240308,46,2024-03-08,9,54,178,232,Pel147_T,"-37.80240719, 144.9615673"
1391820250130,139,2025-01-30,18,162,58,220,Signal1647_T,"-37.81959923, 144.9632832"
139520250414,139,2025-04-14,5,3,4,7,Signal1647_T,"-37.81959923, 144.9632832"
142220250809,142,2025-08-09,2,1,0,1,Hammer1584_T,"-37.81970749, 144.96795734"
142320231127,142,2023-11-27,3,2,1,3,Hammer1584_T,"-37.81970749, 144.96795734"
1611820250406,161,2025-04-06,18,8,24,32,BirArt1109_T,"-37.81851276, 144.97131336"
1411820240519,141,2024-05-19,18,99,85,184,474Fl_T,"-37.81997273, 144.95834911"
1171220250913,117,2025-09-13,12,209,108,317,Fli114F_T,"-37.81629332, 144.97090877"
1371820251013,137,2025-10-13,18,20,78,98,BouHbr2353_T,"-37.81894815, 144.94612292"
69720241228,69,2024-12-28,7,38,31,69,FLDegC_T,"-37.81687226, 144.96559144"
4720240401,4,2024-04-01,7,42,28,70,Swa123_T,"-37.81487988, 144.9660878"
41720250524,4,2025-05-24,17,1910,1479,3389,Swa123_T,"-37.81487988, 144.9660878"
391420250705,39,2025-07-05,14,49,48,97,AlfPl_T,"-37.81379749, 144.96995745"
39620241031,39,2024-10-31,6,7,6,13,AlfPl_T,"-37.81379749, 144.96995745"
391320250514,39,2025-05-14,13,178,216,394,AlfPl_T,"-37.81379749, 144.96995745"
75020250830,75,2025-08-30,0,2,2,4,SprFli_T,"-37.81515276, 144.97467661"
41020240314,41,2024-03-14,0,167,149,316,Swa31,"-37.81668634, 144.96689733"
781820240920,78,2024-09-20,18,3,9,12,HarEsB_T,"-37.81471642, 144.9446508"
291220250514,29,2025-05-14,12,313,298,611,AG_T,"-37.8199817, 144.96872865"
31420240725,31,2024-07-25,4,5,10,15,Lyg161_T,"-37.80169681, 144.96658911"
282020250222,28,2025-02-22,20,324,668,992,VAC_T,"-37.82129925, 144.96879309"
282220250916,28,2025-09-16,22,113,59,172,VAC_T,"-37.82129925, 144.96879309"
471620250718,47,2025-07-18,16,1299,1174,2473,Eli250_T,"-37.81258467, 144.9625775"
311120251010,31,2025-10-10,11,119,112,231,Lyg161_T,"-37.80169681, 144.96658911"
44620240707,44,2024-07-07,6,2,0,2,UM3_T,"-37.79698741, 144.96441306"
5720231125,5,2023-11-25,7,119,183,302,PriNW_T,"-37.81874249, 144.96787656"
1351920240911,135,2024-09-11,19,101,100,201,Spen161_T,"-37.8172861, 144.95319102"
1332220240515,133,2024-05-15,22,198,148,346,Spen229_T,"-37.81531435, 144.95227769"
1181220250923,118,2025-09-23,12,26,24,50,Fli114C_T,"-37.81632783, 144.97090512"
1182020251015,118,2025-10-15,20,9,8,17,Fli114C_T,"-37.81632783, 144.97090512"
871720250826,87,2025-08-26,17,65,61,126,Errol23_T,"-37.80454949, 144.94921863"
871420241213,87,2024-12-13,14,119,82,201,Errol23_T,"-37.80454949, 144.94921863"
61220240423,61,2024-04-23,2,10,4,14,RMIT14_T,"-37.80767455, 144.96309114"
1791120250915,179,2025-09-15,11,38,24,62,Pow61_T,"-37.82392385, 144.96299677"
1651020241126,165,2024-11-26,10,37,54,91,Spen475_T,"-37.80953359, 144.94939004"
1312220250126,131,2025-01-26,22,199,48,247,King2_T,"-37.82009057, 144.95758725"
167720240825,167,2024-08-25,7,3,26,29,Lat526_T,"-37.81304149, 144.95155955"
1311120240530,131,2024-05-30,11,61,63,124,King2_T,"-37.82009057, 144.95758725"
681620250206,68,2025-02-06,16,258,219,477,FLDegN_T,"-37.8168479, 144.96559789"
17220250401,17,2025-04-01,2,5,4,9,Col15_T,"-37.81362543, 144.97323591"
671220240513,67,2024-05-13,12,421,605,1026,FLDegS_T,"-37.81688755, 144.96562569"
18120241127,18,2024-11-27,1,1,1,2,Col12_T,"-37.81344862, 144.97305353"
86920241208,86,2024-12-08,9,45,50,95,574Qub_T,"-37.80309992, 144.94908064"
11620250406,11,2025-04-06,6,24,27,51,WatCit_T,"-37.81564989, 144.93970694"
67320241031,67,2024-10-31,3,3,13,16,FLDegS_T,"-37.81688755, 144.96562569"
241920240316,24,2024-03-16,19,376,507,883,Col620_T,"-37.81887963, 144.95449198"
24920250421,24,2025-04-21,9,306,274,580,Col620_T,"-37.81887963, 144.95449198"
352120250623,35,2025-06-23,21,107,148,255,SouthB_T,"-37.82018685, 144.96508508"
581120250530,58,2025-05-30,11,659,219,878,Bou688_T,"-37.81686075, 144.95358075"
581420251009,58,2025-10-09,14,597,484,1081,Bou688_T,"-37.81686075, 144.95358075"
51520250103,51,2025-01-03,5,5,6,11,Fra118_T,"-37.80841815, 144.95906316"
511220240715,51,2024-07-15,12,84,63,147,Fra118_T,"-37.80841815, 144.95906316"
251120250517,25,2025-05-17,11,398,622,1020,MCEC_T,"-37.82401776, 144.95604426"
25820250523,25,2025-05-23,8,182,315,497,MCEC_T,"-37.82401776, 144.95604426"
142720250202,142,2025-02-02,7,217,148,365,Hammer1584_T,"-37.81970749, 144.96795734"
142320240415,142,2024-04-15,3,1,2,3,Hammer1584_T,"-37.81970749, 144.96795734"
1231920231124,123,2023-11-24,19,14,58,72,BirBridge_T,"-37.81753741, 144.97329734"
391620240507,39,2024-05-07,16,112,91,203,AlfPl_T,"-37.81379749, 144.96995745"
42020250416,42,2025-04-16,0,2,3,5,UM1_T,"-37.80008566, 144.96386412"
47220250723,47,2025-07-23,2,27,19,46,Eli250_T,"-37.81258467, 144.9625775"
40420250612,40,2025-06-12,4,1,1,2,Spr201_T,"-37.80999341, 144.97227587"
402220240507,40,2024-05-07,22,44,34,78,Spr201_T,"-37.80999341, 144.97227587"
312220250905,31,2025-09-05,22,155,183,338,Lyg161_T,"-37.80169681, 144.96658911"
211920250404,21,2025-04-04,19,545,576,1121,Bourke155_T,"-37.81267313, 144.96788288"
1082320250502,108,2025-05-02,23,74,84,158,261Will_T,"-37.81295822, 144.95678789"
133020240611,133,2024-06-11,0,25,11,36,Spen229_T,"-37.81531435, 144.95227769"
1241620250908,124,2025-09-08,16,3,4,7,BirBridge_T,"-37.81757416, 144.97329934"
1072320231025,107,2023-10-25,23,15,11,26,280Will_T,"-37.81246271, 144.95690188"
612020240630,61,2024-06-30,20,156,167,323,RMIT14_T,"-37.80767455, 144.96309114"
611920241212,61,2024-12-12,19,441,571,1012,RMIT14_T,"-37.80767455, 144.96309114"
1791520250808,179,2025-08-08,15,70,58,128,Pow61_T,"-37.82392385, 144.96299677"
1651120250713,165,2025-07-13,11,33,51,84,Spen475_T,"-37.80953359, 144.94939004"
1321020240314,132,2024-03-14,10,196,111,307,King335_T,"-37.81267639, 144.95386444"
851420250425,85,2025-04-25,14,76,88,164,488Mac_T,"-37.79432415, 144.92973378"
12320240629,1,2024-06-29,23,111,102,213,Bou292_T,"-37.81349441, 144.96515323"
63620241011,63,2024-10-11,6,20,24,44,Bou231_T,"-37.81333081, 144.96675571"
621920250123,62,2025-01-23,19,246,188,434,Lat224_T,"-37.80996494, 144.96216521"
561320241106,56,2024-11-06,13,327,369,696,Lon364_T,"-37.81234775, 144.96153311"
761320250203,76,2025-02-03,13,38,45,83,KenMac_T,"-37.79453803, 144.93036194"
76620250414,76,2025-04-14,6,16,9,25,KenMac_T,"-37.79453803, 144.93036194"
351420240510,35,2024-05-10,14,793,950,1743,SouthB_T,"-37.82018685, 144.96508508"
271520240727,27,2024-07-27,15,187,184,371,Vic_T,"-37.80606888, 144.95644692"
53020231230,53,2023-12-30,0,38,42,80,Col254_T,"-37.81564191, 144.965499"
91120250301,9,2025-03-01,11,94,146,240,Col700_T,"-37.81982992, 144.95102555"
30420241202,30,2024-12-02,4,12,28,40,Lon189_T,"-37.8112185, 144.96656806"
301720241213,30,2024-12-13,17,439,478,917,Lon189_T,"-37.8112185, 144.96656806"
53620250512,53,2025-05-12,6,16,30,46,Col254_T,"-37.81564191, 144.965499"
231620241228,23,2024-12-28,16,83,188,271,Col623_T,"-37.81909256, 144.95452748"
481720241102,48,2024-11-02,17,158,140,298,QVMQ_T,"-37.80631581, 144.95866697"
201420250430,20,2025-04-30,14,164,208,372,LtB170_T,"-37.81172914, 144.9682466"
139620241107,139,2024-11-07,6,5,28,33,Signal1647_T,"-37.81959923, 144.9632832"
139020250425,139,2025-04-25,0,2,13,15,Signal1647_T,"-37.81959923, 144.9632832"
130620250701,130,2025-07-01,6,5,0,5,Bou892T,"-37.8204637, 144.94126826"
481220250822,48,2025-08-22,12,408,322,730,QVMQ_T,"-37.80631581, 144.95866697"
491120241125,49,2024-11-25,11,156,233,389,Eli501_T,"-37.80730068, 144.95956055"
492320251002,49,2025-10-02,23,78,73,151,Eli501_T,"-37.80730068, 144.95956055"
1372320240320,137,2024-03-20,23,7,5,12,BouHbr2353_T,"-37.81894815, 144.94612292"
1081120240712,108,2024-07-12,11,103,217,320,261Will_T,"-37.81295822, 144.95678789"
872120250904,87,2025-09-04,21,20,30,50,Errol23_T,"-37.80454949, 144.94921863"
611320241115,61,2024-11-15,13,490,682,1172,RMIT14_T,"-37.80767455, 144.96309114"
611820250828,61,2025-08-28,18,457,528,985,RMIT14_T,"-37.80767455, 144.96309114"
70220240114,70,2024-01-14,2,0,4,4,Errol20_T,"-37.80456984, 144.94946228"
166220250618,166,2025-06-18,2,0,1,1,Spen484_T,"-37.80896733, 144.94931703"
1811820250706,181,2025-07-06,18,769,879,1648,Eli368_T,"-37.81009465, 144.96143149"
1621220250720,162,2025-07-20,12,643,1019,1662,Eli489_T,"-37.80740397, 144.95987909"
1432020250102,143,2025-01-02,20,170,201,371,Spencer_T,"-37.821728, 144.95557015"
132320240608,132,2024-06-08,3,5,9,14,King335_T,"-37.81267639, 144.95386444"
132620241018,132,2024-10-18,6,20,19,39,King335_T,"-37.81267639, 144.95386444"
1342120250620,134,2025-06-20,21,300,243,543,Spen201_T,"-37.81694221, 144.95303935"
1311520240922,131,2024-09-22,15,229,112,341,King2_T,"-37.82009057, 144.95758725"
6520240622,6,2024-06-22,5,25,60,85,FliS_T,"-37.81911705, 144.96558255"
841320241003,84,2024-10-03,13,1319,1602,2921,ElFi_T,"-37.81798049, 144.96503383"
70920240922,70,2024-09-22,9,70,64,134,Errol20_T,"-37.80456984, 144.94946228"
39820240222,39,2024-02-22,8,157,174,331,AlfPl_T,"-37.81379749, 144.96995745"
391320250429,39,2025-04-29,13,201,235,436,AlfPl_T,"-37.81379749, 144.96995745"
411620240529,41,2024-05-29,16,1270,1820,3090,Swa31,"-37.81668634, 144.96689733"
412020250910,41,2025-09-10,20,543,840,1383,Swa31,"-37.81668634, 144.96689733"
772120240131,77,2024-01-31,21,146,149,295,HarEsP_T,"-37.81441438, 144.94433026"
78820231108,78,2023-11-08,8,104,68,172,HarEsB_T,"-37.81471642, 144.9446508"
651420240504,65,2024-05-04,14,708,792,1500,SwaCs_T,"-37.81569416, 144.9668064"
421420240618,42,2024-06-18,14,158,175,333,UM1_T,"-37.80008566, 144.96386412"
42620250320,42,2025-03-20,6,15,42,57,UM1_T,"-37.80008566, 144.96386412"
59420250813,59,2025-08-13,4,3,7,10,RMIT_T,"-37.80825648, 144.96304859"
541720241108,54,2024-11-08,17,195,235,430,Swa607_T,"-37.804024, 144.96308399"
282120250116,28,2025-01-16,21,1090,642,1732,VAC_T,"-37.82129925, 144.96879309"
471220231025,47,2023-10-25,12,595,734,1329,Eli250_T,"-37.81258467, 144.9625775"
472320231214,47,2023-12-14,23,227,196,423,Eli250_T,"-37.81258467, 144.9625775"
471920240114,47,2024-01-14,19,590,550,1140,Eli250_T,"-37.81258467, 144.9625775"
36820250312,36,2025-03-12,8,239,158,397,Que85_T,"-37.81652527, 144.96121062"
501220241209,50,2024-12-09,12,205,229,434,Lyg309_T,"-37.79808192, 144.96721013"
441220240627,44,2024-06-27,12,83,52,135,UM3_T,"-37.79698741, 144.96441306"
44320250908,44,2025-09-08,3,0,1,1,UM3_T,"-37.79698741, 144.96441306"
452020250507,45,2025-05-07,20,163,560,723,Swa148_T,"-37.81414075, 144.96609379"
1331820240816,133,2024-08-16,18,504,499,1003,Spen229_T,"-37.81531435, 144.95227769"
132020250319,132,2025-03-19,0,19,27,46,King335_T,"-37.81267639, 144.95386444"
1341620240101,134,2024-01-01,16,441,410,851,Spen201_T,"-37.81694221, 144.95303935"
1341920250117,134,2025-01-17,19,487,349,836,Spen201_T,"-37.81694221, 144.95303935"
1181420241213,118,2024-12-13,14,24,31,55,Fli114C_T,"-37.81632783, 144.97090512"
1182020250614,118,2025-06-14,20,12,2,14,Fli114C_T,"-37.81632783, 144.97090512"
1072320240727,107,2024-07-27,23,28,52,80,280Will_T,"-37.81246271, 144.95690188"
11620240519,1,2024-05-19,16,1502,950,2452,Bou292_T,"-37.81349441, 144.96515323"
63220250118,63,2025-01-18,2,2,29,31,Bou231_T,"-37.81333081, 144.96675571"
621720241227,62,2024-12-27,17,242,142,384,Lat224_T,"-37.80996494, 144.96216521"
121220240630,12,2024-06-30,12,290,137,427,NewQ_T,"-37.81457988, 144.94292398"
68320250724,68,2025-07-24,3,0,1,1,FLDegN_T,"-37.8168479, 144.96559789"
102120240623,10,2024-06-23,21,11,8,19,BouHbr_T,"-37.81876474, 144.94710545"
12320241203,12,2024-12-03,3,1,0,1,NewQ_T,"-37.81457988, 144.94292398"
58120240823,58,2024-08-23,1,28,44,72,Bou688_T,"-37.81686075, 144.95358075"
58020240929,58,2024-09-29,0,93,109,202,Bou688_T,"-37.81686075, 144.95358075"
581020240511,58,2024-05-11,10,528,169,697,Bou688_T,"-37.81686075, 144.95358075"
27920241208,27,2024-12-08,9,116,146,262,Vic_T,"-37.80606888, 144.95644692"
53620240504,53,2024-05-04,6,27,12,39,Col254_T,"-37.81564191, 144.965499"
9720231211,9,2023-12-11,7,42,782,824,Col700_T,"-37.81982992, 144.95102555"
9720251005,9,2025-10-05,7,23,13,36,Col700_T,"-37.81982992, 144.95102555"
791120231024,79,2023-10-24,11,386,296,682,FliSS_T,"-37.81794046, 144.96616678"
232220250418,23,2025-04-18,22,56,148,204,Col623_T,"-37.81909256, 144.95452748"
23320250612,23,2025-06-12,3,2,11,13,Col623_T,"-37.81909256, 144.95452748"
201620240724,20,2024-07-24,16,212,251,463,LtB170_T,"-37.81172914, 144.9682466"
20020240823,20,2024-08-23,0,48,74,122,LtB170_T,"-37.81172914, 144.9682466"
25620240404,25,2024-04-04,6,45,72,117,MCEC_T,"-37.82401776, 144.95604426"
252220240805,25,2024-08-05,22,80,75,155,MCEC_T,"-37.82401776, 144.95604426"
462020250101,46,2025-01-01,20,31,10,41,Pel147_T,"-37.80240719, 144.9615673"
123920250922,123,2025-09-22,9,27,6,33,BirBridge_T,"-37.81753741, 144.97329734"
1231020241006,123,2024-10-06,10,3,1,4,BirBridge_T,"-37.81753741, 144.97329734"
1411120241208,141,2024-12-08,11,165,81,246,474Fl_T,"-37.81997273, 144.95834911"
1172220240314,117,2024-03-14,22,157,1014,1171,Fli114F_T,"-37.81629332, 144.97090877"
117720240622,117,2024-06-22,7,30,26,56,Fli114F_T,"-37.81629332, 144.97090877"
19020241229,19,2024-12-29,0,170,202,372,LtB210_T,"-37.81237202, 144.96550671"
48220241114,48,2024-11-14,2,3,5,8,QVMQ_T,"-37.80631581, 144.95866697"
137720240102,137,2024-01-02,7,25,4,29,BouHbr2353_T,"-37.81894815, 144.94612292"
1371520240122,137,2024-01-22,15,15,130,145,BouHbr2353_T,"-37.81894815, 144.94612292"
1371720241008,137,2024-10-08,17,10,107,117,BouHbr2353_T,"-37.81894815, 144.94612292"
681120240529,68,2024-05-29,11,194,130,324,FLDegN_T,"-37.8168479, 144.96559789"
851420240402,85,2024-04-02,14,83,65,148,488Mac_T,"-37.79432415, 144.92973378"
85920250415,85,2025-04-15,9,84,78,162,488Mac_T,"-37.79432415, 144.92973378"
17020250911,17,2025-09-11,0,8,7,15,Col15_T,"-37.81362543, 144.97323591"
84620250510,84,2025-05-10,6,78,39,117,ElFi_T,"-37.81798049, 144.96503383"
42220240911,4,2024-09-11,22,261,196,457,Swa123_T,"-37.81487988, 144.9660878"
4720250911,4,2025-09-11,7,317,188,505,Swa123_T,"-37.81487988, 144.9660878"
701720240908,70,2024-09-08,17,91,108,199,Errol20_T,"-37.80456984, 144.94946228"
3420241229,3,2024-12-29,4,77,48,125,Swa295_T,"-37.81101524, 144.96429485"
391220241019,39,2024-10-19,12,53,47,100,AlfPl_T,"-37.81379749, 144.96995745"
82120250306,8,2025-03-06,21,14,21,35,WebBN_T,"-37.82293543, 144.9471751"
1412220240421,141,2024-04-21,22,39,64,103,474Fl_T,"-37.81997273, 144.95834911"
139720240307,139,2024-03-07,7,39,117,156,Signal1647_T,"-37.81959923, 144.9632832"
1392020250802,139,2025-08-02,20,15,25,40,Signal1647_T,"-37.81959923, 144.9632832"
136620250730,136,2025-07-30,6,8,7,15,BirFed1120_T,"-37.8184141, 144.97357915"
1301920250506,130,2025-05-06,19,17,13,30,Bou892T,"-37.8204637, 144.94126826"
109720240919,109,2024-09-19,7,43,232,275,LatWill_T,"-37.81193681, 144.95621105"
661620240102,66,2024-01-02,16,485,380,865,QVN_T,"-37.81057846, 144.96444294"
6420250713,6,2025-07-13,4,55,41,96,FliS_T,"-37.81911705, 144.96558255"
6720250810,6,2025-08-10,7,132,111,243,FliS_T,"-37.81911705, 144.96558255"
42120250102,4,2025-01-02,21,665,815,1480,Swa123_T,"-37.81487988, 144.9660878"
82320250226,8,2025-02-26,23,7,1,8,WebBN_T,"-37.82293543, 144.9471751"
411420250923,41,2025-09-23,14,1425,1833,3258,Swa31,"-37.81668634, 144.96689733"
772120240922,77,2024-09-22,21,97,77,174,HarEsP_T,"-37.81441438, 144.94433026"
781920241226,78,2024-12-26,19,30,37,67,HarEsB_T,"-37.81471642, 144.9446508"
142020240914,14,2024-09-14,20,234,91,325,SanBri_T,"-37.82011242, 144.96291897"
712120240218,71,2024-02-18,21,5,5,10,WestWP_T,"-37.81235775, 144.97136962"
651420240811,65,2024-08-11,14,1588,1426,3014,SwaCs_T,"-37.81569416, 144.9668064"
592120231019,59,2023-10-19,21,464,270,734,RMIT_T,"-37.80825648, 144.96304859"
591920231207,59,2023-12-07,19,533,511,1044,RMIT_T,"-37.80825648, 144.96304859"
40320240322,40,2024-03-22,3,6,4,10,Spr201_T,"-37.80999341, 144.97227587"
362120250107,36,2025-01-07,21,75,68,143,Que85_T,"-37.81652527, 144.96121062"
441020240726,44,2024-07-26,10,66,110,176,UM3_T,"-37.79698741, 144.96441306"
132020250728,132,2025-07-28,0,15,18,33,King335_T,"-37.81267639, 144.95386444"
1071920250806,107,2025-08-06,19,73,102,175,280Will_T,"-37.81246271, 144.95690188"
43920250827,43,2025-08-27,9,338,108,446,UM2_T,"-37.79844526, 144.96411782"
131720240331,131,2024-03-31,7,10,32,42,King2_T,"-37.82009057, 144.95758725"
131420240406,131,2024-04-06,4,23,68,91,King2_T,"-37.82009057, 144.95758725"
143220250228,143,2025-02-28,2,25,31,56,Spencer_T,"-37.821728, 144.95557015"
140820231202,140,2023-12-02,8,20,10,30,Boyd2837_T,"-37.82590962, 144.96185972"
1321820240929,132,2024-09-29,18,120,141,261,King335_T,"-37.81267639, 144.95386444"
1431020240524,143,2024-05-24,10,151,338,489,Spencer_T,"-37.821728, 144.95557015"
63020240716,63,2024-07-16,0,14,20,34,Bou231_T,"-37.81333081, 144.96675571"
631220240808,63,2024-08-08,12,443,574,1017,Bou231_T,"-37.81333081, 144.96675571"
68920250611,68,2025-06-11,9,214,160,374,FLDegN_T,"-37.8168479, 144.96559789"
622120250313,62,2025-03-13,21,264,237,501,Lat224_T,"-37.80996494, 144.96216521"
62220250322,62,2025-03-22,2,55,42,97,Lat224_T,"-37.80996494, 144.96216521"
56720231130,56,2023-11-30,7,56,53,109,Lon364_T,"-37.81234775, 144.96153311"
562020240314,56,2024-03-14,20,278,329,607,Lon364_T,"-37.81234775, 144.96153311"
111020241001,11,2024-10-01,10,49,41,90,WatCit_T,"-37.81564989, 144.93970694"
761320240401,76,2024-04-01,13,31,32,63,KenMac_T,"-37.79453803, 144.93036194"
351820241104,35,2024-11-04,18,1299,950,2249,SouthB_T,"-37.82018685, 144.96508508"
761520240212,76,2024-02-12,15,48,91,139,KenMac_T,"-37.79453803, 144.93036194"
751120250319,75,2025-03-19,11,51,35,86,SprFli_T,"-37.81515276, 144.97467661"
411820240421,41,2024-04-21,18,1249,1322,2571,Swa31,"-37.81668634, 144.96689733"
41320250803,41,2025-08-03,3,86,198,284,Swa31,"-37.81668634, 144.96689733"
772020250504,77,2025-05-04,20,116,132,248,HarEsP_T,"-37.81441438, 144.94433026"
42920250211,42,2025-02-11,9,163,91,254,UM1_T,"-37.80008566, 144.96386412"
78220250307,78,2025-03-07,2,4,5,9,HarEsB_T,"-37.81471642, 144.9446508"
29420241120,29,2024-11-20,4,5,7,12,AG_T,"-37.8199817, 144.96872865"
291920250917,29,2025-09-17,19,8,9,17,AG_T,"-37.8199817, 144.96872865"
541020251005,54,2025-10-05,10,43,37,80,Swa607_T,"-37.804024, 144.96308399"
282220240408,28,2024-04-08,22,13,4,17,VAC_T,"-37.82129925, 144.96879309"
311320231107,31,2023-11-07,13,189,166,355,Lyg161_T,"-37.80169681, 144.96658911"
21020240417,21,2024-04-17,0,73,48,121,Bourke155_T,"-37.81267313, 144.96788288"
21620250428,21,2025-04-28,6,12,12,24,Bourke155_T,"-37.81267313, 144.96788288"
371420241008,37,2024-10-08,14,72,111,183,Lyg260_T,"-37.80107122, 144.96704554"
50720241008,50,2024-10-08,7,13,20,33,Lyg309_T,"-37.79808192, 144.96721013"
442020250914,44,2025-09-14,20,18,51,69,UM3_T,"-37.79698741, 144.96441306"
44220241029,44,2024-10-29,2,1,0,1,UM3_T,"-37.79698741, 144.96441306"
441520240204,44,2024-02-04,15,34,21,55,UM3_T,"-37.79698741, 144.96441306"
451220250818,45,2025-08-18,12,644,679,1323,Swa148_T,"-37.81414075, 144.96609379"
5220250128,5,2025-01-28,2,10,16,26,PriNW_T,"-37.81874249, 144.96787656"
5720250506,5,2025-05-06,7,200,537,737,PriNW_T,"-37.81874249, 144.96787656"
135220240122,135,2024-01-22,2,9,6,15,Spen161_T,"-37.8172861, 144.95319102"
1331120250224,133,2025-02-24,11,390,444,834,Spen229_T,"-37.81531435, 144.95227769"
1072220250313,107,2025-03-13,22,72,82,154,280Will_T,"-37.81246271, 144.95690188"
1341620240621,134,2024-06-21,16,439,434,873,Spen201_T,"-37.81694221, 144.95303935"
1071720240514,107,2024-05-14,17,236,118,354,280Will_T,"-37.81246271, 144.95690188"
871920250907,87,2025-09-07,19,60,73,133,Errol23_T,"-37.80454949, 144.94921863"
108520231122,108,2023-11-22,5,19,62,81,261Will_T,"-37.81295822, 144.95678789"
61520240206,61,2024-02-06,5,14,37,51,RMIT14_T,"-37.80767455, 144.96309114"
182920250522,182,2025-05-22,9,86,128,214,King163_T,"-37.81627451, 144.95550503"
1851820250808,185,2025-08-08,18,929,736,1665,Eli197_T,"-37.81374643, 144.96276183"
1621520250211,162,2025-02-11,15,252,504,756,Eli489_T,"-37.80740397, 144.95987909"
1622320250320,162,2025-03-20,23,127,74,201,Eli489_T,"-37.80740397, 144.95987909"
1401220240709,140,2024-07-09,12,28,35,63,Boyd2837_T,"-37.82590962, 144.96185972"
1322220240401,132,2024-04-01,22,6,18,24,King335_T,"-37.81267639, 144.95386444"
171920250806,17,2025-08-06,19,73,109,182,Col15_T,"-37.81362543, 144.97323591"
671520231221,67,2023-12-21,15,413,657,1070,FLDegS_T,"-37.81688755, 144.96562569"
112320231030,11,2023-10-30,23,4,22,26,WatCit_T,"-37.81564989, 144.93970694"
101520250203,10,2025-02-03,15,109,31,140,BouHbr_T,"-37.81876474, 144.94710545"
241520240723,24,2024-07-23,15,455,1198,1653,Col620_T,"-37.81887963, 144.95449198"
2020240613,2,2024-06-13,0,10,26,36,Bou283_T,"-37.81380668, 144.96516718"
53420241018,53,2024-10-18,4,2,6,8,Col254_T,"-37.81564191, 144.965499"
92320240712,9,2024-07-12,23,39,57,96,Col700_T,"-37.81982992, 144.95102555"
302220241219,30,2024-12-19,22,254,394,648,Lon189_T,"-37.8112185, 144.96656806"
231120250427,23,2025-04-27,11,135,131,266,Col623_T,"-37.81909256, 144.95452748"
232120240314,23,2024-03-14,21,48,153,201,Col623_T,"-37.81909256, 144.95452748"
201920240629,20,2024-06-29,19,447,525,972,LtB170_T,"-37.81172914, 144.9682466"
46620231025,46,2023-10-25,6,4,29,33,Pel147_T,"-37.80240719, 144.9615673"
1391520240604,139,2024-06-04,15,59,23,82,Signal1647_T,"-37.81959923, 144.9632832"
1391420240621,139,2024-06-21,14,23,58,81,Signal1647_T,"-37.81959923, 144.9632832"
1421020241224,142,2024-12-24,10,329,248,577,Hammer1584_T,"-37.81970749, 144.96795734"
1611720250513,161,2025-05-13,17,192,80,272,BirArt1109_T,"-37.81851276, 144.97131336"
1231120250523,123,2025-05-23,11,18,10,28,BirBridge_T,"-37.81753741, 144.97329734"
1231120250919,123,2025-09-19,11,37,11,48,BirBridge_T,"-37.81753741, 144.97329734"
1231120240915,123,2024-09-15,11,6,1,7,BirBridge_T,"-37.81753741, 144.97329734"
1411720240606,141,2024-06-06,17,148,142,290,474Fl_T,"-37.81997273, 144.95834911"
1412220250304,141,2025-03-04,22,49,162,211,474Fl_T,"-37.81997273, 144.95834911"
191620241110,19,2024-11-10,16,576,507,1083,LtB210_T,"-37.81237202, 144.96550671"
482020250121,48,2025-01-21,20,89,112,201,QVMQ_T,"-37.80631581, 144.95866697"
661920240820,66,2024-08-20,19,926,860,1786,QVN_T,"-37.81057846, 144.96444294"
691020240614,69,2024-06-14,10,175,69,244,FLDegC_T,"-37.81687226, 144.96559144"
62120240921,6,2024-09-21,21,758,734,1492,FliS_T,"-37.81911705, 144.96558255"
61420241002,6,2024-10-02,14,944,806,1750,FliS_T,"-37.81911705, 144.96558255"
4520240628,4,2024-06-28,5,40,13,53,Swa123_T,"-37.81487988, 144.9660878"
41020250802,4,2025-08-02,10,1140,626,1766,Swa123_T,"-37.81487988, 144.9660878"
701020250820,70,2025-08-20,10,72,84,156,Errol20_T,"-37.80456984, 144.94946228"
411820250929,41,2025-09-29,18,1012,1295,2307,Swa31,"-37.81668634, 144.96689733"
29320241013,29,2024-10-13,3,6,3,9,AG_T,"-37.8199817, 144.96872865"
292220240405,29,2024-04-05,22,107,215,322,AG_T,"-37.8199817, 144.96872865"
311220241004,31,2024-10-04,12,167,155,322,Lyg161_T,"-37.80169681, 144.96658911"
31320240131,31,2024-01-31,3,2,0,2,Lyg161_T,"-37.80169681, 144.96658911"
212220250310,21,2025-03-10,22,150,151,301,Bourke155_T,"-37.81267313, 144.96788288"
37720250916,37,2025-09-16,7,10,15,25,Lyg260_T,"-37.80107122, 144.96704554"
44420240605,44,2024-06-05,4,1,0,1,UM3_T,"-37.79698741, 144.96441306"
43020250413,43,2025-04-13,0,35,8,43,UM2_T,"-37.79844526, 144.96411782"
451620250724,45,2025-07-24,16,615,833,1448,Swa148_T,"-37.81414075, 144.96609379"
1182220250401,118,2025-04-01,22,4,2,6,Fli114C_T,"-37.81632783, 144.97090512"
1241420250527,124,2025-05-27,14,1,2,3,BirBridge_T,"-37.81757416, 144.97329934"
1081520241104,108,2024-11-04,15,206,145,351,261Will_T,"-37.81295822, 144.95678789"
871020250210,87,2025-02-10,10,71,87,158,Errol23_T,"-37.80454949, 144.94921863"
611920250531,61,2025-05-31,19,317,229,546,RMIT14_T,"-37.80767455, 144.96309114"
1841220251011,184,2025-10-11,12,1173,1054,2227,Eli124_T,"-37.81512416, 144.96371988"
1661720250117,166,2025-01-17,17,68,57,125,Spen484_T,"-37.80896733, 144.94931703"
1661720250201,166,2025-02-01,17,44,33,77,Spen484_T,"-37.80896733, 144.94931703"
1621420251015,162,2025-10-15,14,462,504,966,Eli489_T,"-37.80740397, 144.95987909"
131620250225,131,2025-02-25,6,16,17,33,King2_T,"-37.82009057, 144.95758725"
1431520241207,143,2024-12-07,15,292,316,608,Spencer_T,"-37.821728, 144.95557015"
67320240602,67,2024-06-02,3,13,25,38,FLDegS_T,"-37.81688755, 144.96562569"
851520241204,85,2024-12-04,15,94,125,219,488Mac_T,"-37.79432415, 144.92973378"
171320240918,17,2024-09-18,13,648,622,1270,Col15_T,"-37.81362543, 144.97323591"
172120241126,17,2024-11-26,21,91,134,225,Col15_T,"-37.81362543, 144.97323591"
671520250530,67,2025-05-30,15,359,595,954,FLDegS_T,"-37.81688755, 144.96562569"
181020240815,18,2024-08-15,10,184,278,462,Col12_T,"-37.81344862, 144.97305353"
56620231222,56,2023-12-22,6,30,37,67,Lon364_T,"-37.81234775, 144.96153311"
27220240517,27,2024-05-17,2,1,5,6,Vic_T,"-37.80606888, 144.95644692"
231720250217,23,2025-02-17,17,276,715,991,Col623_T,"-37.81909256, 144.95452748"
522220240425,52,2024-04-25,22,128,137,265,Eli263_T,"-37.81252157, 144.9619401"
19420231022,19,2023-10-22,4,21,21,42,LtB210_T,"-37.81237202, 144.96550671"
46520240128,46,2024-01-28,5,1,5,6,Pel147_T,"-37.80240719, 144.9615673"
462220250215,46,2025-02-15,22,1,0,1,Pel147_T,"-37.80240719, 144.9615673"
1371720240830,137,2024-08-30,17,27,65,92,BouHbr2353_T,"-37.81894815, 144.94612292"
139020231201,139,2023-12-01,0,3,2,5,Signal1647_T,"-37.81959923, 144.9632832"
139020240606,139,2024-06-06,0,6,4,10,Signal1647_T,"-37.81959923, 144.9632832"
1421020250404,142,2025-04-04,10,317,203,520,Hammer1584_T,"-37.81970749, 144.96795734"
142520240123,142,2024-01-23,5,12,4,16,Hammer1584_T,"-37.81970749, 144.96795734"
1231220250723,123,2025-07-23,12,98,76,174,BirBridge_T,"-37.81753741, 144.97329734"
109420240925,109,2024-09-25,4,4,8,12,LatWill_T,"-37.81193681, 144.95621105"
69820231122,69,2023-11-22,8,150,50,200,FLDegC_T,"-37.81687226, 144.96559144"
61420240208,6,2024-02-08,14,882,705,1587,FliS_T,"-37.81911705, 144.96558255"
61320250808,6,2025-08-08,13,765,799,1564,FliS_T,"-37.81911705, 144.96558255"
701520240217,70,2024-02-17,15,122,139,261,Errol20_T,"-37.80456984, 144.94946228"
392320231024,39,2023-10-24,23,11,15,26,AlfPl_T,"-37.81379749, 144.96995745"
592320241102,59,2024-11-02,23,134,161,295,RMIT_T,"-37.80825648, 144.96304859"
651020240529,65,2024-05-29,10,258,193,451,SwaCs_T,"-37.81569416, 144.9668064"
541920240209,54,2024-02-09,19,147,187,334,Swa607_T,"-37.804024, 144.96308399"
471920240926,47,2024-09-26,19,796,670,1466,Eli250_T,"-37.81258467, 144.9625775"
372320240706,37,2024-07-06,23,89,149,238,Lyg260_T,"-37.80107122, 144.96704554"
45320240425,45,2024-04-25,3,20,72,92,Swa148_T,"-37.81414075, 144.96609379"
44520240906,44,2024-09-06,5,0,2,2,UM3_T,"-37.79698741, 144.96441306"
451520241212,45,2024-12-12,15,531,778,1309,Swa148_T,"-37.81414075, 144.96609379"
132520250928,132,2025-09-28,5,11,9,20,King335_T,"-37.81267639, 144.95386444"
107020251013,107,2025-10-13,0,10,8,18,280Will_T,"-37.81246271, 144.95690188"
612220250525,61,2025-05-25,22,152,57,209,RMIT14_T,"-37.80767455, 144.96309114"
50520250612,50,2025-06-12,5,3,3,6,Lyg309_T,"-37.79808192, 144.96721013"
1841820250813,184,2025-08-13,18,815,887,1702,Eli124_T,"-37.81512416, 144.96371988"
1621520250915,162,2025-09-15,15,261,298,559,Eli489_T,"-37.80740397, 144.95987909"
1322020241112,132,2024-11-12,20,129,131,260,King335_T,"-37.81267639, 144.95386444"
1431420240806,143,2024-08-06,14,218,222,440,Spencer_T,"-37.821728, 144.95557015"
242020240923,24,2024-09-23,20,308,547,855,Col620_T,"-37.81887963, 144.95449198"
241720241120,24,2024-11-20,17,644,2546,3190,Col620_T,"-37.81887963, 144.95449198"
24320250204,24,2025-02-04,3,14,15,29,Col620_T,"-37.81887963, 144.95449198"
111320251003,11,2025-10-03,13,70,48,118,WatCit_T,"-37.81564989, 144.93970694"
721020240720,72,2024-07-20,10,106,110,216,ACMI_T,"-37.81726338, 144.96872809"
21920240406,2,2024-04-06,19,336,359,695,Bou283_T,"-37.81380668, 144.96516718"
761720250619,76,2025-06-19,17,66,72,138,KenMac_T,"-37.79453803, 144.93036194"
271020240526,27,2024-05-26,10,225,235,460,Vic_T,"-37.80606888, 144.95644692"
531620231111,53,2023-11-11,16,683,609,1292,Col254_T,"-37.81564191, 144.965499"
92220250612,9,2025-06-12,22,68,34,102,Col700_T,"-37.81982992, 144.95102555"
791020240809,79,2024-08-09,10,346,221,567,FliSS_T,"-37.81794046, 144.96616678"
232320240819,23,2024-08-19,23,7,42,49,Col623_T,"-37.81909256, 144.95452748"
51220240227,51,2024-02-27,2,3,7,10,Fra118_T,"-37.80841815, 144.95906316"
251020250221,25,2025-02-21,10,253,538,791,MCEC_T,"-37.82401776, 144.95604426"
201020231203,20,2023-12-03,10,160,89,249,LtB170_T,"-37.81172914, 144.9682466"
521120231109,52,2023-11-09,11,326,272,598,Eli263_T,"-37.81252157, 144.9619401"
164520250324,164,2025-03-24,5,6,9,15,Lat526_T,"-37.813005, 144.95160411"
1231320240303,123,2024-03-03,13,24,15,39,BirBridge_T,"-37.81753741, 144.97329734"
492220241107,49,2024-11-07,22,108,68,176,Eli501_T,"-37.80730068, 144.95956055"
1092320250813,109,2025-08-13,23,29,32,61,LatWill_T,"-37.81193681, 144.95621105"
1642220251008,164,2025-10-08,22,43,70,113,Lat526_T,"-37.813005, 144.95160411"
180520251012,180,2025-10-12,5,9,0,9,Mac330_T,"-37.79497059, 144.93530329"
691520240110,69,2024-01-10,15,198,225,423,FLDegC_T,"-37.81687226, 144.96559144"
6820241016,6,2024-10-16,8,1038,2369,3407,FliS_T,"-37.81911705, 144.96558255"
841820250213,84,2025-02-13,18,881,1340,2221,ElFi_T,"-37.81798049, 144.96503383"
841220250417,84,2025-04-17,12,1207,1247,2454,ElFi_T,"-37.81798049, 144.96503383"
4020241126,4,2024-11-26,0,57,40,97,Swa123_T,"-37.81487988, 144.9660878"
3920250616,3,2025-06-16,9,156,221,377,Swa295_T,"-37.81101524, 144.96429485"
8820240203,8,2024-02-03,8,75,90,165,WebBN_T,"-37.82293543, 144.9471751"
8020250414,8,2025-04-14,0,1,1,2,WebBN_T,"-37.82293543, 144.9471751"
751120241019,75,2024-10-19,11,38,43,81,SprFli_T,"-37.81515276, 144.97467661"
781720241006,78,2024-10-06,17,53,71,124,HarEsB_T,"-37.81471642, 144.9446508"
65920240509,65,2024-05-09,9,478,207,685,SwaCs_T,"-37.81569416, 144.9668064"
65320240122,65,2024-01-22,3,1,11,12,SwaCs_T,"-37.81569416, 144.9668064"
281320250412,28,2025-04-12,13,1260,1145,2405,VAC_T,"-37.82129925, 144.96879309"
361720240415,36,2024-04-15,17,287,318,605,Que85_T,"-37.81652527, 144.96121062"
361620250629,36,2025-06-29,16,92,102,194,Que85_T,"-37.81652527, 144.96121062"
502320231218,50,2023-12-18,23,22,13,35,Lyg309_T,"-37.79808192, 144.96721013"
431320250616,43,2025-06-16,13,104,133,237,UM2_T,"-37.79844526, 144.96411782"
5320240630,5,2024-06-30,3,21,31,52,PriNW_T,"-37.81874249, 144.96787656"
132720250518,132,2025-05-18,7,36,16,52,King335_T,"-37.81267639, 144.95386444"
165420250109,165,2025-01-09,4,2,0,2,Spen475_T,"-37.80953359, 144.94939004"
143720240527,143,2024-05-27,7,87,152,239,Spencer_T,"-37.821728, 144.95557015"
1311320240316,131,2024-03-16,13,134,127,261,King2_T,"-37.82009057, 144.95758725"
1311420240522,131,2024-05-22,14,28,30,58,King2_T,"-37.82009057, 144.95758725"
852120231116,85,2023-11-16,21,4,14,18,488Mac_T,"-37.79432415, 144.92973378"
69120250707,69,2025-07-07,1,4,1,5,FLDegC_T,"-37.81687226, 144.96559144"
6320250317,6,2025-03-17,3,12,9,21,FliS_T,"-37.81911705, 144.96558255"
84820250521,84,2025-05-21,8,1608,363,1971,ElFi_T,"-37.81798049, 144.96503383"
41520250312,4,2025-03-12,15,1621,1309,2930,Swa123_T,"-37.81487988, 144.9660878"
41620250626,4,2025-06-26,16,1795,1305,3100,Swa123_T,"-37.81487988, 144.9660878"
70020240324,70,2024-03-24,0,8,7,15,Errol20_T,"-37.80456984, 144.94946228"
701620250228,70,2025-02-28,16,134,138,272,Errol20_T,"-37.80456984, 144.94946228"
3120250310,3,2025-03-10,1,134,116,250,Swa295_T,"-37.81101524, 144.96429485"
392120240612,39,2024-06-12,21,22,17,39,AlfPl_T,"-37.81379749, 144.96995745"
75720250605,75,2025-06-05,7,30,31,61,SprFli_T,"-37.81515276, 144.97467661"
75720231216,75,2023-12-16,7,20,13,33,SprFli_T,"-37.81515276, 144.97467661"
412020250322,41,2025-03-22,20,1160,1579,2739,Swa31,"-37.81668634, 144.96689733"
771620241029,77,2024-10-29,16,236,143,379,HarEsP_T,"-37.81441438, 144.94433026"
29920240314,29,2024-03-14,9,91,173,264,AG_T,"-37.8199817, 144.96872865"
291520240402,29,2024-04-02,15,202,331,533,AG_T,"-37.8199817, 144.96872865"
592120250910,59,2025-09-10,21,353,282,635,RMIT_T,"-37.80825648, 144.96304859"
591220231129,59,2023-11-29,12,373,343,716,RMIT_T,"-37.80825648, 144.96304859"
591420241130,59,2024-11-30,14,113,123,236,RMIT_T,"-37.80825648, 144.96304859"
312220240815,31,2024-08-15,22,82,105,187,Lyg161_T,"-37.80169681, 144.96658911"
28220241231,28,2024-12-31,2,10,8,18,VAC_T,"-37.82129925, 144.96879309"
28020240524,28,2024-05-24,0,20,6,26,VAC_T,"-37.82129925, 144.96879309"
47220250807,47,2025-08-07,2,29,28,57,Eli250_T,"-37.81258467, 144.9625775"
47420241025,47,2024-10-25,4,17,21,38,Eli250_T,"-37.81258467, 144.9625775"
502220231108,50,2023-11-08,22,62,33,95,Lyg309_T,"-37.79808192, 144.96721013"
43820241030,43,2024-10-30,8,121,85,206,UM2_T,"-37.79844526, 144.96411782"
5920241016,5,2024-10-16,9,363,758,1121,PriNW_T,"-37.81874249, 144.96787656"
211220231025,21,2023-10-25,12,460,394,854,Bourke155_T,"-37.81267313, 144.96788288"
1071720241031,107,2024-10-31,17,220,177,397,280Will_T,"-37.81246271, 144.95690188"
1071220250816,107,2025-08-16,12,128,187,315,280Will_T,"-37.81246271, 144.95690188"
133820241015,133,2024-10-15,8,555,533,1088,Spen229_T,"-37.81531435, 144.95227769"
1081020250924,108,2025-09-24,10,209,358,567,261Will_T,"-37.81295822, 144.95678789"
501120250314,50,2025-03-14,11,123,163,286,Lyg309_T,"-37.79808192, 144.96721013"
501820240619,50,2024-06-19,18,125,196,321,Lyg309_T,"-37.79808192, 144.96721013"
1651820240916,165,2024-09-16,18,49,24,73,Spen475_T,"-37.80953359, 144.94939004"
140920250414,140,2025-04-14,9,6,1,7,Boyd2837_T,"-37.82590962, 144.96185972"
1622220240826,162,2024-08-26,22,106,64,170,Eli489_T,"-37.80740397, 144.95987909"
1321120250214,132,2025-02-14,11,147,93,240,King335_T,"-37.81267639, 144.95386444"
134120240607,134,2024-06-07,1,28,29,57,Spen201_T,"-37.81694221, 144.95303935"
134320240630,134,2024-06-30,3,27,17,44,Spen201_T,"-37.81694221, 144.95303935"
1311220240915,131,2024-09-15,12,107,123,230,King2_T,"-37.82009057, 144.95758725"
621520250508,62,2025-05-08,15,260,131,391,Lat224_T,"-37.80996494, 144.96216521"
56420241022,56,2024-10-22,4,7,6,13,Lon364_T,"-37.81234775, 144.96153311"
861320240622,86,2024-06-22,13,36,21,57,574Qub_T,"-37.80309992, 144.94908064"
861620240710,86,2024-07-10,16,53,55,108,574Qub_T,"-37.80309992, 144.94908064"
241820241001,24,2024-10-01,18,409,1321,1730,Col620_T,"-37.81887963, 144.95449198"
24720240716,24,2024-07-16,7,1082,215,1297,Col620_T,"-37.81887963, 144.95449198"
721920240611,72,2024-06-11,19,132,146,278,ACMI_T,"-37.81726338, 144.96872809"
761320250528,76,2025-05-28,13,54,58,112,KenMac_T,"-37.79453803, 144.93036194"
58820250521,58,2025-05-21,8,1700,198,1898,Bou688_T,"-37.81686075, 144.95358075"
58320250611,58,2025-06-11,3,5,6,11,Bou688_T,"-37.81686075, 144.95358075"
21020240618,2,2024-06-18,10,184,231,415,Bou283_T,"-37.81380668, 144.96516718"
271920250105,27,2025-01-05,19,61,31,92,Vic_T,"-37.80606888, 144.95644692"
851320240528,85,2024-05-28,13,87,79,166,488Mac_T,"-37.79432415, 144.92973378"
85220250831,85,2025-08-31,2,0,1,1,488Mac_T,"-37.79432415, 144.92973378"
172020240503,17,2024-05-03,20,122,121,243,Col15_T,"-37.81362543, 144.97323591"
1920241002,1,2024-10-02,9,706,469,1175,Bou292_T,"-37.81349441, 144.96515323"
631520240423,63,2024-04-23,15,251,355,606,Bou231_T,"-37.81333081, 144.96675571"
63920240902,63,2024-09-02,9,120,133,253,Bou231_T,"-37.81333081, 144.96675571"
67420250516,67,2025-05-16,4,2,4,6,FLDegS_T,"-37.81688755, 144.96562569"
67020250802,67,2025-08-02,0,42,53,95,FLDegS_T,"-37.81688755, 144.96562569"
681620250208,68,2025-02-08,16,289,230,519,FLDegN_T,"-37.8168479, 144.96559789"
861920250828,86,2025-08-28,19,38,54,92,574Qub_T,"-37.80309992, 144.94908064"
111220250325,11,2025-03-25,12,152,170,322,WatCit_T,"-37.81564989, 144.93970694"
621520250114,62,2025-01-14,15,214,189,403,Lat224_T,"-37.80996494, 144.96216521"
24220231110,24,2023-11-10,2,15,31,46,Col620_T,"-37.81887963, 144.95449198"
121920240601,12,2024-06-01,19,127,150,277,NewQ_T,"-37.81457988, 144.94292398"
72020240805,72,2024-08-05,0,4,3,7,ACMI_T,"-37.81726338, 144.96872809"
351520250214,35,2025-02-14,15,1139,1248,2387,SouthB_T,"-37.82018685, 144.96508508"
352320250308,35,2025-03-08,23,856,1563,2419,SouthB_T,"-37.82018685, 144.96508508"
352220240829,35,2024-08-29,22,307,615,922,SouthB_T,"-37.82018685, 144.96508508"
21820241208,2,2024-12-08,18,532,383,915,Bou283_T,"-37.81380668, 144.96516718"
27220251012,27,2025-10-12,2,66,24,90,Vic_T,"-37.80606888, 144.95644692"
9820240129,9,2024-01-29,8,87,2366,2453,Col700_T,"-37.81982992, 144.95102555"
30320240607,30,2024-06-07,3,13,42,55,Lon189_T,"-37.8112185, 144.96656806"
511220241219,51,2024-12-19,12,84,86,170,Fra118_T,"-37.80841815, 144.95906316"
48620240723,48,2024-07-23,6,21,31,52,QVMQ_T,"-37.80631581, 144.95866697"
251520250409,25,2025-04-09,15,732,586,1318,MCEC_T,"-37.82401776, 144.95604426"
521920250807,52,2025-08-07,19,414,279,693,Eli263_T,"-37.81252157, 144.9619401"
201120250908,20,2025-09-08,11,122,102,224,LtB170_T,"-37.81172914, 144.9682466"
136920250212,136,2025-02-12,9,38,71,109,BirFed1120_T,"-37.8184141, 144.97357915"
1301620250210,130,2025-02-10,16,28,24,52,Bou892T,"-37.8204637, 144.94126826"
130520250723,130,2025-07-23,5,3,0,3,Bou892T,"-37.8204637, 144.94126826"
117520240905,117,2024-09-05,5,12,7,19,Fli114F_T,"-37.81629332, 144.97090877"
49820240716,49,2024-07-16,8,119,188,307,Eli501_T,"-37.80730068, 144.95956055"
691320250923,69,2025-09-23,13,307,308,615,FLDegC_T,"-37.81687226, 144.96559144"
6320240204,6,2024-02-04,3,79,84,163,FliS_T,"-37.81911705, 144.96558255"
41420250617,4,2025-06-17,14,1422,1123,2545,Swa123_T,"-37.81487988, 144.9660878"
31020241115,3,2024-11-15,10,359,397,756,Swa295_T,"-37.81101524, 144.96429485"
392320241102,39,2024-11-02,23,8,7,15,AlfPl_T,"-37.81379749, 144.96995745"
39120240220,39,2024-02-20,1,0,2,2,AlfPl_T,"-37.81379749, 144.96995745"
751220250806,75,2025-08-06,12,82,55,137,SprFli_T,"-37.81515276, 144.97467661"
81320240423,8,2024-04-23,13,334,313,647,WebBN_T,"-37.82293543, 144.9471751"
8720240818,8,2024-08-18,7,98,89,187,WebBN_T,"-37.82293543, 144.9471751"
81520250209,8,2025-02-09,15,208,222,430,WebBN_T,"-37.82293543, 144.9471751"
751620240202,75,2024-02-02,16,49,44,93,SprFli_T,"-37.81515276, 144.97467661"
77920240224,77,2024-02-24,9,140,120,260,HarEsP_T,"-37.81441438, 144.94433026"
29220250129,29,2025-01-29,2,8,12,20,AG_T,"-37.8199817, 144.96872865"
712120240512,71,2024-05-12,21,1,0,1,WestWP_T,"-37.81235775, 144.97136962"
541520250101,54,2025-01-01,15,34,54,88,Swa607_T,"-37.804024, 144.96308399"
54320250110,54,2025-01-10,3,5,1,6,Swa607_T,"-37.804024, 144.96308399"
1341120250802,134,2025-08-02,11,417,418,835,Spen201_T,"-37.81694221, 144.95303935"
135720240729,135,2024-07-29,7,65,46,111,Spen161_T,"-37.8172861, 144.95319102"
68920250521,68,2025-05-21,9,216,223,439,FLDegN_T,"-37.8168479, 144.96559789"
681920240730,68,2024-07-30,19,96,15,111,FLDegN_T,"-37.8168479, 144.96559789"
17120240226,17,2024-02-26,1,5,3,8,Col15_T,"-37.81362543, 144.97323591"
11320231027,1,2023-10-27,13,1600,1334,2934,Bou292_T,"-37.81349441, 144.96515323"
11620250529,1,2025-05-29,16,1093,969,2062,Bou292_T,"-37.81349441, 144.96515323"
632320240515,63,2024-05-15,23,33,72,105,Bou231_T,"-37.81333081, 144.96675571"
63520240604,63,2024-06-04,5,10,11,21,Bou231_T,"-37.81333081, 144.96675571"
861420250227,86,2025-02-27,14,48,70,118,574Qub_T,"-37.80309992, 144.94908064"
11020250210,11,2025-02-10,0,11,9,20,WatCit_T,"-37.81564989, 144.93970694"
722120250217,72,2025-02-17,21,55,77,132,ACMI_T,"-37.81726338, 144.96872809"
72720231101,72,2023-11-01,7,241,49,290,ACMI_T,"-37.81726338, 144.96872809"
351920240526,35,2024-05-26,19,596,885,1481,SouthB_T,"-37.82018685, 144.96508508"
2520241210,2,2024-12-10,5,3,10,13,Bou283_T,"-37.81380668, 144.96516718"
2720250309,2,2025-03-09,7,21,34,55,Bou283_T,"-37.81380668, 144.96516718"
2220240601,2,2024-06-01,2,7,41,48,Bou283_T,"-37.81380668, 144.96516718"
91820240331,9,2024-03-31,18,93,74,167,Col700_T,"-37.81982992, 144.95102555"
9120231208,9,2023-12-08,1,14,16,30,Col700_T,"-37.81982992, 144.95102555"
302220240702,30,2024-07-02,22,115,203,318,Lon189_T,"-37.8112185, 144.96656806"
301920240708,30,2024-07-08,19,240,367,607,Lon189_T,"-37.8112185, 144.96656806"
52320240417,52,2024-04-17,3,3,5,8,Eli263_T,"-37.81252157, 144.9619401"
51120250206,51,2025-02-06,1,16,19,35,Fra118_T,"-37.80841815, 144.95906316"
251620240229,25,2024-02-29,16,612,476,1088,MCEC_T,"-37.82401776, 144.95604426"
191720251003,19,2025-10-03,17,783,459,1242,LtB210_T,"-37.81237202, 144.96550671"
136820250427,136,2025-04-27,8,104,80,184,BirFed1120_T,"-37.8184141, 144.97357915"
1421220250304,142,2025-03-04,12,585,502,1087,Hammer1584_T,"-37.81970749, 144.96795734"
1301620240106,130,2024-01-06,16,19,22,41,Bou892T,"-37.8204637, 144.94126826"
492120250401,49,2025-04-01,21,177,140,317,Eli501_T,"-37.80730068, 144.95956055"
1171820240211,117,2024-02-11,18,159,169,328,Fli114F_T,"-37.81629332, 144.97090877"
109520250130,109,2025-01-30,5,10,16,26,LatWill_T,"-37.81193681, 144.95621105"
1092020250722,109,2025-07-22,20,55,43,98,LatWill_T,"-37.81193681, 144.95621105"
5020241020,5,2024-10-20,0,152,154,306,PriNW_T,"-37.81874249, 144.96787656"
211920250301,21,2025-03-01,19,536,592,1128,Bourke155_T,"-37.81267313, 144.96788288"
21920250101,21,2025-01-01,9,48,31,79,Bourke155_T,"-37.81267313, 144.96788288"
1322220250528,132,2025-05-28,22,34,48,82,King335_T,"-37.81267639, 144.95386444"
1071320250222,107,2025-02-22,13,89,139,228,280Will_T,"-37.81246271, 144.95690188"
107520251013,107,2025-10-13,5,5,10,15,280Will_T,"-37.81246271, 144.95690188"
871220250612,87,2025-06-12,12,150,144,294,Errol23_T,"-37.80454949, 144.94921863"
501820250714,50,2025-07-14,18,173,218,391,Lyg309_T,"-37.79808192, 144.96721013"
50320241229,50,2024-12-29,3,4,2,6,Lyg309_T,"-37.79808192, 144.96721013"
501720250106,50,2025-01-06,17,242,293,535,Lyg309_T,"-37.79808192, 144.96721013"
1792020250526,179,2025-05-26,20,31,44,75,Pow61_T,"-37.82392385, 144.96299677"
179320250819,179,2025-08-19,3,1,2,3,Pow61_T,"-37.82392385, 144.96299677"
1341720240811,134,2024-08-11,17,524,404,928,Spen201_T,"-37.81694221, 144.95303935"
311320250416,31,2025-04-16,13,194,183,377,Lyg161_T,"-37.80169681, 144.96658911"
212220250329,21,2025-03-29,22,426,526,952,Bourke155_T,"-37.81267313, 144.96788288"
211620240228,21,2024-02-28,16,383,382,765,Bourke155_T,"-37.81267313, 144.96788288"
43720240416,43,2024-04-16,7,95,37,132,UM2_T,"-37.79844526, 144.96411782"
135620250330,135,2025-03-30,6,71,50,121,Spen161_T,"-37.8172861, 144.95319102"
1341720240519,134,2024-05-19,17,307,274,581,Spen201_T,"-37.81694221, 144.95303935"
1181620240321,118,2024-03-21,16,20,58,78,Fli114C_T,"-37.81632783, 144.97090512"
1181520250816,118,2025-08-16,15,66,58,124,Fli114C_T,"-37.81632783, 144.97090512"
108820240731,108,2024-07-31,8,65,1938,2003,261Will_T,"-37.81295822, 144.95678789"
87120250527,87,2025-05-27,1,1,1,2,Errol23_T,"-37.80454949, 144.94921863"
871420240812,87,2024-08-12,14,88,100,188,Errol23_T,"-37.80454949, 144.94921863"
165820241111,165,2024-11-11,8,30,65,95,Spen475_T,"-37.80953359, 144.94939004"
181320250624,181,2025-06-24,3,19,24,43,Eli368_T,"-37.81009465, 144.96143149"
1311820250501,131,2025-05-01,18,113,82,195,King2_T,"-37.82009057, 144.95758725"
1621320240820,162,2024-08-20,13,571,635,1206,Eli489_T,"-37.80740397, 144.95987909"
140820241031,140,2024-10-31,8,201,19,220,Boyd2837_T,"-37.82590962, 144.96185972"
1612120250623,161,2025-06-23,21,2,0,2,BirArt1109_T,"-37.81851276, 144.97131336"
164120250226,164,2025-02-26,1,2,7,9,Lat526_T,"-37.813005, 144.95160411"
117720250713,117,2025-07-13,7,85,206,291,Fli114F_T,"-37.81629332, 144.97090877"
1091220240620,109,2024-06-20,12,221,171,392,LatWill_T,"-37.81193681, 144.95621105"
49020250523,49,2025-05-23,0,79,78,157,Eli501_T,"-37.80730068, 144.95956055"
191720240201,19,2024-02-01,17,516,419,935,LtB210_T,"-37.81237202, 144.96550671"
481520250728,48,2025-07-28,15,123,160,283,QVMQ_T,"-37.80631581, 144.95866697"
1371420241015,137,2024-10-15,14,15,56,71,BouHbr2353_T,"-37.81894815, 144.94612292"
291520240415,29,2024-04-15,15,173,335,508,AG_T,"-37.8199817, 144.96872865"
291720250821,29,2025-08-21,17,420,384,804,AG_T,"-37.8199817, 144.96872865"
142120240218,14,2024-02-18,21,309,100,409,SanBri_T,"-37.82011242, 144.96291897"
14820240628,14,2024-06-28,8,229,275,504,SanBri_T,"-37.82011242, 144.96291897"
71220241002,71,2024-10-02,2,2,1,3,WestWP_T,"-37.81235775, 144.97136962"
311920250104,31,2025-01-04,19,384,242,626,Lyg161_T,"-37.80169681, 144.96658911"
281620250106,28,2025-01-06,16,522,1058,1580,VAC_T,"-37.82129925, 144.96879309"
361820241229,36,2024-12-29,18,120,84,204,Que85_T,"-37.81652527, 144.96121062"
361320250510,36,2025-05-10,13,162,87,249,Que85_T,"-37.81652527, 144.96121062"
47120250829,47,2025-08-29,1,65,43,108,Eli250_T,"-37.81258467, 144.9625775"
501520241114,50,2024-11-14,15,152,168,320,Lyg309_T,"-37.79808192, 144.96721013"
43920250221,43,2025-02-21,9,227,79,306,UM2_T,"-37.79844526, 144.96411782"
441220240208,44,2024-02-08,12,51,50,101,UM3_T,"-37.79698741, 144.96441306"
1071220250303,107,2025-03-03,12,180,202,382,280Will_T,"-37.81246271, 144.95690188"
1081220241026,108,2024-10-26,12,110,112,222,261Will_T,"-37.81295822, 144.95678789"
872020240522,87,2024-05-22,20,80,50,130,Errol23_T,"-37.80454949, 144.94921863"
165720250105,165,2025-01-05,7,1,11,12,Spen475_T,"-37.80953359, 144.94939004"
1651520250127,165,2025-01-27,15,19,22,41,Spen475_T,"-37.80953359, 144.94939004"
143920250821,143,2025-08-21,9,93,179,272,Spencer_T,"-37.821728, 144.95557015"
137620250411,137,2025-04-11,6,8,1,9,BouHbr2353_T,"-37.81894815, 144.94612292"
1391020240129,139,2024-01-29,10,28,49,77,Signal1647_T,"-37.81959923, 144.9632832"
1361120240616,136,2024-06-16,11,73,85,158,BirFed1120_T,"-37.8184141, 144.97357915"
1421920240331,142,2024-03-31,19,445,695,1140,Hammer1584_T,"-37.81970749, 144.96795734"
1301720240327,130,2024-03-27,17,18,32,50,Bou892T,"-37.8204637, 144.94126826"
1381720240719,138,2024-07-19,17,3,1,4,EntPark1671_T,"-37.81996544, 144.95981454"
117420241023,117,2024-10-23,4,11,10,21,Fli114F_T,"-37.81629332, 144.97090877"
123720240512,123,2024-05-12,7,11,6,17,BirBridge_T,"-37.81753741, 144.97329734"
1171720240312,117,2024-03-12,17,186,488,674,Fli114F_T,"-37.81629332, 144.97090877"
49720240101,49,2024-01-01,7,23,35,58,Eli501_T,"-37.80730068, 144.95956055"
191620250602,19,2025-06-02,16,384,349,733,LtB210_T,"-37.81237202, 144.96550671"
19320240828,19,2024-08-28,3,15,8,23,LtB210_T,"-37.81237202, 144.96550671"
85720231204,85,2023-12-04,7,63,17,80,488Mac_T,"-37.79432415, 144.92973378"
11620240606,1,2024-06-06,16,1033,913,1946,Bou292_T,"-37.81349441, 144.96515323"
631920250806,63,2025-08-06,19,129,239,368,Bou231_T,"-37.81333081, 144.96675571"
62120231103,62,2023-11-03,1,31,23,54,Lat224_T,"-37.80996494, 144.96216521"
24420240810,24,2024-08-10,4,22,48,70,Col620_T,"-37.81887963, 144.95449198"
722120241213,72,2024-12-13,21,354,543,897,ACMI_T,"-37.81726338, 144.96872809"
24220240706,24,2024-07-06,2,60,65,125,Col620_T,"-37.81887963, 144.95449198"
72720240803,72,2024-08-03,7,28,40,68,ACMI_T,"-37.81726338, 144.96872809"
10720250824,10,2025-08-24,7,8,4,12,BouHbr_T,"-37.81876474, 144.94710545"
10920250827,10,2025-08-27,9,58,78,136,BouHbr_T,"-37.81876474, 144.94710545"
58120231110,58,2023-11-10,1,30,57,87,Bou688_T,"-37.81686075, 144.95358075"
2620240824,2,2024-08-24,6,16,18,34,Bou283_T,"-37.81380668, 144.96516718"
2320240313,2,2024-03-13,3,2,13,15,Bou283_T,"-37.81380668, 144.96516718"
791520250625,79,2025-06-25,15,359,418,777,FliSS_T,"-37.81794046, 144.96616678"
511020240128,51,2024-01-28,10,94,140,234,Fra118_T,"-37.80841815, 144.95906316"
23220241111,23,2024-11-11,2,2,5,7,Col623_T,"-37.81909256, 144.95452748"
252220240511,25,2024-05-11,22,402,414,816,MCEC_T,"-37.82401776, 144.95604426"
20520240805,20,2024-08-05,5,9,14,23,LtB170_T,"-37.81172914, 144.9682466"
202320240302,20,2024-03-02,23,509,685,1194,LtB170_T,"-37.81172914, 144.9682466"
201920250830,20,2025-08-30,19,579,595,1174,LtB170_T,"-37.81172914, 144.9682466"
512220250912,51,2025-09-12,22,52,31,83,Fra118_T,"-37.80841815, 144.95906316"
51520250501,51,2025-05-01,5,13,14,27,Fra118_T,"-37.80841815, 144.95906316"
1301620240221,130,2024-02-21,16,21,30,51,Bou892T,"-37.8204637, 144.94126826"
1301720240728,130,2024-07-28,17,2,7,9,Bou892T,"-37.8204637, 144.94126826"
1411120250616,141,2025-06-16,11,78,77,155,474Fl_T,"-37.81997273, 144.95834911"
109420250327,109,2025-03-27,4,3,1,4,LatWill_T,"-37.81193681, 144.95621105"
492020240621,49,2024-06-21,20,203,147,350,Eli501_T,"-37.80730068, 144.95956055"
19720250821,19,2025-08-21,7,32,26,58,LtB210_T,"-37.81237202, 144.96550671"
164520250616,164,2025-06-16,5,2,4,6,Lat526_T,"-37.813005, 144.95160411"
1371220251001,137,2025-10-01,12,43,97,140,BouHbr2353_T,"-37.81894815, 144.94612292"
1371920241219,137,2024-12-19,19,16,17,33,BouHbr2353_T,"-37.81894815, 144.94612292"
1391620240310,139,2024-03-10,16,39,32,71,Signal1647_T,"-37.81959923, 144.9632832"
139220240815,139,2024-08-15,2,1,1,2,Signal1647_T,"-37.81959923, 144.9632832"
1391220250221,139,2025-02-21,12,89,57,146,Signal1647_T,"-37.81959923, 144.9632832"
672020231129,67,2023-11-29,20,180,241,421,FLDegS_T,"-37.81688755, 144.96562569"
851120240612,85,2024-06-12,11,71,74,145,488Mac_T,"-37.79432415, 144.92973378"
632020240714,63,2024-07-14,20,80,175,255,Bou231_T,"-37.81333081, 144.96675571"
181620250112,18,2025-01-12,16,21,10,31,Col12_T,"-37.81344862, 144.97305353"
181520250629,18,2025-06-29,15,69,39,108,Col12_T,"-37.81344862, 144.97305353"
18520250418,18,2025-04-18,5,0,3,3,Col12_T,"-37.81344862, 144.97305353"
622020250830,62,2025-08-30,20,282,269,551,Lat224_T,"-37.80996494, 144.96216521"
121420231215,12,2023-12-15,14,204,192,396,NewQ_T,"-37.81457988, 144.94292398"
56020240316,56,2024-03-16,0,69,155,224,Lon364_T,"-37.81234775, 144.96153311"
66020241205,66,2024-12-05,0,90,63,153,QVN_T,"-37.81057846, 144.96444294"
662220250324,66,2025-03-24,22,490,208,698,QVN_T,"-37.81057846, 144.96444294"
692220240305,69,2024-03-05,22,8,9,17,FLDegC_T,"-37.81687226, 144.96559144"
69720241003,69,2024-10-03,7,90,37,127,FLDegC_T,"-37.81687226, 144.96559144"
69820250103,69,2025-01-03,8,92,47,139,FLDegC_T,"-37.81687226, 144.96559144"
6620241113,6,2024-11-13,6,228,398,626,FliS_T,"-37.81911705, 144.96558255"
661920231124,66,2023-11-24,19,1311,1250,2561,QVN_T,"-37.81057846, 144.96444294"
66420231215,66,2023-12-15,4,27,23,50,QVN_T,"-37.81057846, 144.96444294"
661820240221,66,2024-02-21,18,1256,1133,2389,QVN_T,"-37.81057846, 144.96444294"
81220240104,8,2024-01-04,12,120,281,401,WebBN_T,"-37.82293543, 144.9471751"
8120241225,8,2024-12-25,1,1,1,2,WebBN_T,"-37.82293543, 144.9471751"
81520231229,8,2023-12-29,15,203,291,494,WebBN_T,"-37.82293543, 144.9471751"
41420250918,41,2025-09-18,4,21,55,76,Swa31,"-37.81668634, 144.96689733"
411720250429,41,2025-04-29,17,1162,2214,3376,Swa31,"-37.81668634, 144.96689733"
781020250712,78,2025-07-12,10,74,87,161,HarEsB_T,"-37.81471642, 144.9446508"
71520240911,71,2024-09-11,5,10,13,23,WestWP_T,"-37.81235775, 144.97136962"
371420250604,37,2025-06-04,14,87,79,166,Lyg260_T,"-37.80107122, 144.96704554"
51520250116,5,2025-01-16,15,1251,1277,2528,PriNW_T,"-37.81874249, 144.96787656"
451620231203,45,2023-12-03,16,736,1254,1990,Swa148_T,"-37.81414075, 144.96609379"
36520240408,36,2024-04-08,5,25,8,33,Que85_T,"-37.81652527, 144.96121062"
87620240530,87,2024-05-30,6,16,10,26,Errol23_T,"-37.80454949, 144.94921863"
87420250707,87,2025-07-07,4,3,1,4,Errol23_T,"-37.80454949, 144.94921863"
50920250208,50,2025-02-08,9,90,126,216,Lyg309_T,"-37.79808192, 144.96721013"
431620240815,43,2024-08-15,16,265,519,784,UM2_T,"-37.79844526, 144.96411782"
58920240830,58,2024-08-30,9,962,146,1108,Bou688_T,"-37.81686075, 144.95358075"
35920241221,35,2024-12-21,9,574,383,957,SouthB_T,"-37.82018685, 144.96508508"
271420241030,27,2024-10-30,14,115,128,243,Vic_T,"-37.80606888, 144.95644692"
9820250217,9,2025-02-17,8,105,2748,2853,Col700_T,"-37.81982992, 144.95102555"
791920250116,79,2025-01-16,19,416,451,867,FliSS_T,"-37.81794046, 144.96616678"
791720240219,79,2024-02-19,17,816,601,1417,FliSS_T,"-37.81794046, 144.96616678"
51620250427,51,2025-04-27,6,1,5,6,Fra118_T,"-37.80841815, 144.95906316"
511820240830,51,2024-08-30,18,117,96,213,Fra118_T,"-37.80841815, 144.95906316"
481620250415,48,2025-04-15,16,155,159,314,QVMQ_T,"-37.80631581, 144.95866697"
25520240808,25,2024-08-08,5,13,19,32,MCEC_T,"-37.82401776, 144.95604426"
25620241108,25,2024-11-08,6,88,149,237,MCEC_T,"-37.82401776, 144.95604426"
841820250321,84,2025-03-21,18,1158,1747,2905,ElFi_T,"-37.81798049, 144.96503383"
70020250520,70,2025-05-20,0,0,3,3,Errol20_T,"-37.80456984, 144.94946228"
3420250926,3,2025-09-26,4,50,31,81,Swa295_T,"-37.81101524, 144.96429485"
39520240418,39,2024-04-18,5,5,6,11,AlfPl_T,"-37.81379749, 144.96995745"
8220250825,8,2025-08-25,2,1,0,1,WebBN_T,"-37.82293543, 144.9471751"
751120251009,75,2025-10-09,11,50,40,90,SprFli_T,"-37.81515276, 144.97467661"
78920240713,78,2024-07-13,9,22,67,89,HarEsB_T,"-37.81471642, 144.9446508"
59820250925,59,2025-09-25,8,1018,203,1221,RMIT_T,"-37.80825648, 144.96304859"
65120240825,65,2024-08-25,1,147,152,299,SwaCs_T,"-37.81569416, 144.9668064"
77020250609,77,2025-06-09,0,21,6,27,HarEsP_T,"-37.81441438, 144.94433026"
291920250104,29,2025-01-04,19,190,184,374,AG_T,"-37.8199817, 144.96872865"
28420250503,28,2025-05-03,4,9,9,18,VAC_T,"-37.82129925, 144.96879309"
291220240819,29,2024-08-19,12,281,359,640,AG_T,"-37.8199817, 144.96872865"
29620240123,29,2024-01-23,6,61,96,157,AG_T,"-37.8199817, 144.96872865"
31720250625,31,2025-06-25,7,25,28,53,Lyg161_T,"-37.80169681, 144.96658911"
311420240615,31,2024-06-15,14,189,158,347,Lyg161_T,"-37.80169681, 144.96658911"
311320240912,31,2024-09-12,13,199,191,390,Lyg161_T,"-37.80169681, 144.96658911"
54720251013,54,2025-10-13,7,45,18,63,Swa607_T,"-37.804024, 144.96308399"
37020231020,37,2023-10-20,0,31,14,45,Lyg260_T,"-37.80107122, 144.96704554"
471620231205,47,2023-12-05,16,1142,828,1970,Eli250_T,"-37.81258467, 144.9625775"
40120250912,40,2025-09-12,1,4,0,4,Spr201_T,"-37.80999341, 144.97227587"
501020240223,50,2024-02-23,10,110,123,233,Lyg309_T,"-37.79808192, 144.96721013"
431920240414,43,2024-04-14,19,66,48,114,UM2_T,"-37.79844526, 144.96411782"
211620250219,21,2025-02-19,16,293,318,611,Bourke155_T,"-37.81267313, 144.96788288"
143820240712,143,2024-07-12,8,145,230,375,Spencer_T,"-37.821728, 144.95557015"
143320240903,143,2024-09-03,3,11,3,14,Spencer_T,"-37.821728, 144.95557015"
1401820231212,140,2023-12-12,18,91,110,201,Boyd2837_T,"-37.82590962, 144.96185972"
134320240403,134,2024-04-03,3,25,20,45,Spen201_T,"-37.81694221, 144.95303935"
1351820240611,135,2024-06-11,18,139,199,338,Spen161_T,"-37.8172861, 144.95319102"
1331920250213,133,2025-02-13,19,504,423,927,Spen229_T,"-37.81531435, 144.95227769"
1332120250129,133,2025-01-29,21,410,243,653,Spen229_T,"-37.81531435, 144.95227769"
133920240404,133,2024-04-04,9,432,399,831,Spen229_T,"-37.81531435, 144.95227769"
133620240511,133,2024-05-11,6,91,121,212,Spen229_T,"-37.81531435, 144.95227769"
1241720250411,124,2025-04-11,17,2,4,6,BirBridge_T,"-37.81757416, 144.97329934"
87320240618,87,2024-06-18,3,0,1,1,Errol23_T,"-37.80454949, 144.94921863"
1651920241218,165,2024-12-18,19,56,40,96,Spen475_T,"-37.80953359, 144.94939004"
1312120251012,131,2025-10-12,21,37,39,76,King2_T,"-37.82009057, 144.95758725"
1621520250329,162,2025-03-29,15,533,980,1513,Eli489_T,"-37.80740397, 144.95987909"
85720241004,85,2024-10-04,7,52,23,75,488Mac_T,"-37.79432415, 144.92973378"
172120240229,17,2024-02-29,21,86,115,201,Col15_T,"-37.81362543, 144.97323591"
17520250215,17,2025-02-15,5,32,21,53,Col15_T,"-37.81362543, 144.97323591"
63420240510,63,2024-05-10,4,0,7,7,Bou231_T,"-37.81333081, 144.96675571"
681820250731,68,2025-07-31,18,164,83,247,FLDegN_T,"-37.8168479, 144.96559789"
631220250627,63,2025-06-27,12,465,531,996,Bou231_T,"-37.81333081, 144.96675571"
621620231201,62,2023-12-01,16,265,144,409,Lat224_T,"-37.80996494, 144.96216521"
672120241106,67,2024-11-06,21,90,217,307,FLDegS_T,"-37.81688755, 144.96562569"
85220240110,85,2024-01-10,2,1,0,1,488Mac_T,"-37.79432415, 144.92973378"
1020240828,1,2024-08-28,0,17,20,37,Bou292_T,"-37.81349441, 144.96515323"
68320240904,68,2024-09-04,3,1,1,2,FLDegN_T,"-37.8168479, 144.96559789"
681520240328,68,2024-03-28,15,183,120,303,FLDegN_T,"-37.8168479, 144.96559789"
63020251013,63,2025-10-13,0,24,47,71,Bou231_T,"-37.81333081, 144.96675571"
11920250815,1,2025-08-15,19,693,609,1302,Bou292_T,"-37.81349441, 144.96515323"
68020240112,68,2024-01-12,0,1,0,1,FLDegN_T,"-37.8168479, 144.96559789"
622120231107,62,2023-11-07,21,117,62,179,Lat224_T,"-37.80996494, 144.96216521"
621020240716,62,2024-07-16,10,154,126,280,Lat224_T,"-37.80996494, 144.96216521"
562020240222,56,2024-02-22,20,247,235,482,Lon364_T,"-37.81234775, 144.96153311"
561620240611,56,2024-06-11,16,237,265,502,Lon364_T,"-37.81234775, 144.96153311"
241920241026,24,2024-10-26,19,465,426,891,Col620_T,"-37.81887963, 144.95449198"
22320240518,2,2024-05-18,23,44,106,150,Bou283_T,"-37.81380668, 144.96516718"
231520250222,23,2025-02-22,15,124,219,343,Col623_T,"-37.81909256, 144.95452748"
30420250123,30,2025-01-23,4,18,42,60,Lon189_T,"-37.8112185, 144.96656806"
46220231228,46,2023-12-28,2,6,5,11,Pel147_T,"-37.80240719, 144.9615673"
191920250114,19,2025-01-14,19,528,528,1056,LtB210_T,"-37.81237202, 144.96550671"
191320240401,19,2024-04-01,13,609,522,1131,LtB210_T,"-37.81237202, 144.96550671"
202220240902,20,2024-09-02,22,74,119,193,LtB170_T,"-37.81172914, 144.9682466"
201320231125,20,2023-11-25,13,381,347,728,LtB170_T,"-37.81172914, 144.9682466"
25620240629,25,2024-06-29,6,29,89,118,MCEC_T,"-37.82401776, 144.95604426"
52320250714,52,2025-07-14,3,4,9,13,Eli263_T,"-37.81252157, 144.9619401"
52520241211,52,2024-12-11,5,7,10,17,Eli263_T,"-37.81252157, 144.9619401"
1411520231113,141,2023-11-13,15,105,102,207,474Fl_T,"-37.81997273, 144.95834911"
139220240328,139,2024-03-28,2,0,1,1,Signal1647_T,"-37.81959923, 144.9632832"
1372020240515,137,2024-05-15,20,3,4,7,BouHbr2353_T,"-37.81894815, 144.94612292"
1421320250102,142,2025-01-02,13,828,732,1560,Hammer1584_T,"-37.81970749, 144.96795734"
1231420240110,123,2024-01-10,14,17,23,40,BirBridge_T,"-37.81753741, 144.97329734"
1301720240119,130,2024-01-19,17,18,38,56,Bou892T,"-37.8204637, 144.94126826"
1172220251013,117,2025-10-13,22,183,45,228,Fli114F_T,"-37.81629332, 144.97090877"
117320240526,117,2024-05-26,3,12,10,22,Fli114F_T,"-37.81629332, 144.97090877"
491820240731,49,2024-07-31,18,614,559,1173,Eli501_T,"-37.80730068, 144.95956055"
1091920240814,109,2024-08-14,19,98,142,240,LatWill_T,"-37.81193681, 144.95621105"
66220250815,66,2025-08-15,2,23,10,33,QVN_T,"-37.81057846, 144.96444294"
84020240121,84,2024-01-21,0,469,386,855,ElFi_T,"-37.81798049, 144.96503383"
841420240512,84,2024-05-12,14,935,1279,2214,ElFi_T,"-37.81798049, 144.96503383"
412320240202,41,2024-02-02,23,605,690,1295,Swa31,"-37.81668634, 144.96689733"
291920250729,29,2025-07-29,19,6,1,7,AG_T,"-37.8199817, 144.96872865"
29820241113,29,2024-11-13,8,122,74,196,AG_T,"-37.8199817, 144.96872865"
71720240224,71,2024-02-24,7,9,12,21,WestWP_T,"-37.81235775, 144.97136962"
40320250105,40,2025-01-05,3,4,3,7,Spr201_T,"-37.80999341, 144.97227587"
211920240503,21,2024-05-03,19,522,586,1108,Bourke155_T,"-37.81267313, 144.96788288"
371020250108,37,2025-01-08,10,61,46,107,Lyg260_T,"-37.80107122, 144.96704554"
872120241022,87,2024-10-22,21,14,36,50,Errol23_T,"-37.80454949, 144.94921863"
61420250108,61,2025-01-08,4,7,6,13,RMIT14_T,"-37.80767455, 144.96309114"
61320250405,61,2025-04-05,3,53,7,60,RMIT14_T,"-37.80767455, 144.96309114"
61420240118,61,2024-01-18,4,4,12,16,RMIT14_T,"-37.80767455, 144.96309114"
242120250413,24,2025-04-13,21,254,278,532,Col620_T,"-37.81887963, 144.95449198"
761420250305,76,2025-03-05,14,47,42,89,KenMac_T,"-37.79453803, 144.93036194"
2920250624,2,2025-06-24,9,155,182,337,Bou283_T,"-37.81380668, 144.96516718"
35020240702,35,2024-07-02,0,35,41,76,SouthB_T,"-37.82018685, 144.96508508"
92120231107,9,2023-11-07,21,23,28,51,Col700_T,"-37.81982992, 144.95102555"
79620250716,79,2025-07-16,6,34,52,86,FliSS_T,"-37.81794046, 144.96616678"
791620250916,79,2025-09-16,16,348,397,745,FliSS_T,"-37.81794046, 144.96616678"
301920241121,30,2024-11-21,19,269,473,742,Lon189_T,"-37.8112185, 144.96656806"
301120240319,30,2024-03-19,11,156,255,411,Lon189_T,"-37.8112185, 144.96656806"
791420240215,79,2024-02-15,14,686,529,1215,FliSS_T,"-37.81794046, 144.96616678"
23020231118,23,2023-11-18,0,27,55,82,Col623_T,"-37.81909256, 144.95452748"
23120240218,23,2024-02-18,1,22,27,49,Col623_T,"-37.81909256, 144.95452748"
482320240502,48,2024-05-02,23,42,49,91,QVMQ_T,"-37.80631581, 144.95866697"
52320240225,52,2024-02-25,3,70,63,133,Eli263_T,"-37.81252157, 144.9619401"
139520240304,139,2024-03-04,5,0,2,2,Signal1647_T,"-37.81959923, 144.9632832"
1362120240111,136,2024-01-11,21,20,862,882,BirFed1120_T,"-37.8184141, 144.97357915"
130720250109,130,2025-01-09,7,11,7,18,Bou892T,"-37.8204637, 144.94126826"
1611820240712,161,2024-07-12,18,319,0,319,BirArt1109_T,"-37.81851276, 144.97131336"
1172120241115,117,2024-11-15,21,174,133,307,Fli114F_T,"-37.81629332, 144.97090877"
117220250405,117,2025-04-05,2,22,23,45,Fli114F_T,"-37.81629332, 144.97090877"
1092020250216,109,2025-02-16,20,56,83,139,LatWill_T,"-37.81193681, 144.95621105"
109020241111,109,2024-11-11,0,19,24,43,LatWill_T,"-37.81193681, 144.95621105"
164120250626,164,2025-06-26,1,0,2,2,Lat526_T,"-37.813005, 144.95160411"
69320240512,69,2024-05-12,3,1,2,3,FLDegC_T,"-37.81687226, 144.96559144"
841920250828,84,2025-08-28,19,628,918,1546,ElFi_T,"-37.81798049, 144.96503383"
41720240705,4,2024-07-05,17,1483,810,2293,Swa123_T,"-37.81487988, 144.9660878"
31920250904,3,2025-09-04,19,917,942,1859,Swa295_T,"-37.81101524, 144.96429485"
39120250321,39,2025-03-21,1,0,2,2,AlfPl_T,"-37.81379749, 144.96995745"
8720240301,8,2024-03-01,7,110,99,209,WebBN_T,"-37.82293543, 144.9471751"
81420241125,8,2024-11-25,14,127,207,334,WebBN_T,"-37.82293543, 144.9471751"
782020250525,78,2025-05-25,20,4,13,17,HarEsB_T,"-37.81471642, 144.9446508"
78620250605,78,2025-06-05,6,1,1,2,HarEsB_T,"-37.81471642, 144.9446508"
141820250114,14,2025-01-14,18,486,161,647,SanBri_T,"-37.82011242, 144.96291897"
421220250806,42,2025-08-06,12,369,437,806,UM1_T,"-37.80008566, 144.96386412"
28720250205,28,2025-02-05,7,260,176,436,VAC_T,"-37.82129925, 144.96879309"
29520250413,29,2025-04-13,5,9,9,18,AG_T,"-37.8199817, 144.96872865"
401920231023,40,2023-10-23,19,98,73,171,Spr201_T,"-37.80999341, 144.97227587"
311820240707,31,2024-07-07,18,383,254,637,Lyg161_T,"-37.80169681, 144.96658911"
31720241217,31,2024-12-17,7,32,36,68,Lyg161_T,"-37.80169681, 144.96658911"
311020250325,31,2025-03-25,10,80,79,159,Lyg161_T,"-37.80169681, 144.96658911"
542220250901,54,2025-09-01,22,77,103,180,Swa607_T,"-37.804024, 144.96308399"
54020250925,54,2025-09-25,0,32,33,65,Swa607_T,"-37.804024, 144.96308399"
36720250112,36,2025-01-12,7,17,14,31,Que85_T,"-37.81652527, 144.96121062"
37620240805,37,2024-08-05,6,8,3,11,Lyg260_T,"-37.80107122, 144.96704554"
47820250123,47,2025-01-23,8,251,672,923,Eli250_T,"-37.81258467, 144.9625775"
471220231105,47,2023-11-05,12,1115,1760,2875,Eli250_T,"-37.81258467, 144.9625775"
21220240418,21,2024-04-18,2,29,8,37,Bourke155_T,"-37.81267313, 144.96788288"
5020250718,5,2025-07-18,0,30,70,100,PriNW_T,"-37.81874249, 144.96787656"
21020250516,21,2025-05-16,0,47,42,89,Bourke155_T,"-37.81267313, 144.96788288"
108820250312,108,2025-03-12,8,239,2716,2955,261Will_T,"-37.81295822, 144.95678789"
611320241213,61,2024-12-13,13,476,577,1053,RMIT14_T,"-37.80767455, 144.96309114"
501220240313,50,2024-03-13,12,198,194,392,Lyg309_T,"-37.79808192, 144.96721013"
50320240625,50,2024-06-25,3,1,3,4,Lyg309_T,"-37.79808192, 144.96721013"
50820240105,50,2024-01-05,8,28,42,70,Lyg309_T,"-37.79808192, 144.96721013"
1822120250721,182,2025-07-21,21,156,192,348,King163_T,"-37.81627451, 144.95550503"
442120240305,44,2024-03-05,21,10,6,16,UM3_T,"-37.79698741, 144.96441306"
1671120250406,167,2025-04-06,11,59,87,146,Lat526_T,"-37.81304149, 144.95155955"
134020250709,134,2025-07-09,0,46,84,130,Spen201_T,"-37.81694221, 144.95303935"
1071920250613,107,2025-06-13,19,107,111,218,280Will_T,"-37.81246271, 144.95690188"
1071920240621,107,2024-06-21,19,75,93,168,280Will_T,"-37.81246271, 144.95690188"
172020250706,17,2025-07-06,20,58,51,109,Col15_T,"-37.81362543, 144.97323591"
171320250807,17,2025-08-07,13,681,672,1353,Col15_T,"-37.81362543, 144.97323591"
1320240309,1,2024-03-09,3,31,16,47,Bou292_T,"-37.81349441, 144.96515323"
631320240613,63,2024-06-13,13,343,446,789,Bou231_T,"-37.81333081, 144.96675571"
121420231202,12,2023-12-02,14,43,29,72,NewQ_T,"-37.81457988, 144.94292398"
862320240608,86,2024-06-08,23,5,22,27,574Qub_T,"-37.80309992, 144.94908064"
11920250525,11,2025-05-25,9,122,68,190,WatCit_T,"-37.81564989, 144.93970694"
11620240204,11,2024-02-04,6,12,14,26,WatCit_T,"-37.81564989, 144.93970694"
56720250509,56,2025-05-09,7,70,46,116,Lon364_T,"-37.81234775, 144.96153311"
10220231209,10,2023-12-09,2,3,2,5,BouHbr_T,"-37.81876474, 144.94710545"
10120240413,10,2024-04-13,1,2,5,7,BouHbr_T,"-37.81876474, 144.94710545"
72020250519,72,2025-05-19,0,2,6,8,ACMI_T,"-37.81726338, 144.96872809"
721920240726,72,2024-07-26,19,178,301,479,ACMI_T,"-37.81726338, 144.96872809"
10920250930,10,2025-09-30,9,62,112,174,BouHbr_T,"-37.81876474, 144.94710545"
24020250522,24,2025-05-22,0,27,43,70,Col620_T,"-37.81887963, 144.95449198"
352320240311,35,2024-03-11,23,261,339,600,SouthB_T,"-37.82018685, 144.96508508"
27920240913,27,2024-09-13,9,111,101,212,Vic_T,"-37.80606888, 144.95644692"
27620241007,27,2024-10-07,6,13,13,26,Vic_T,"-37.80606888, 144.95644692"
22020231223,2,2023-12-23,20,2411,1083,3494,Bou283_T,"-37.81380668, 144.96516718"
21220240329,2,2024-03-29,12,247,372,619,Bou283_T,"-37.81380668, 144.96516718"
2220240718,2,2024-07-18,2,4,14,18,Bou283_T,"-37.81380668, 144.96516718"
791320240630,79,2024-06-30,13,575,375,950,FliSS_T,"-37.81794046, 144.96616678"
791320240308,79,2024-03-08,13,581,412,993,FliSS_T,"-37.81794046, 144.96616678"
23320250331,23,2025-03-31,3,6,14,20,Col623_T,"-37.81909256, 144.95452748"
25620240815,25,2024-08-15,6,82,111,193,MCEC_T,"-37.82401776, 144.95604426"
25320240821,25,2024-08-21,3,4,1,5,MCEC_T,"-37.82401776, 144.95604426"
1301120250110,130,2025-01-10,11,33,16,49,Bou892T,"-37.8204637, 144.94126826"
1411120250720,141,2025-07-20,11,169,176,345,474Fl_T,"-37.81997273, 144.95834911"
117920240124,117,2024-01-24,9,255,139,394,Fli114F_T,"-37.81629332, 144.97090877"
1171220251003,117,2025-10-03,12,187,194,381,Fli114F_T,"-37.81629332, 144.97090877"
1372020240502,137,2024-05-02,20,6,7,13,BouHbr2353_T,"-37.81894815, 144.94612292"
1421620240109,142,2024-01-09,16,509,330,839,Hammer1584_T,"-37.81970749, 144.96795734"
1421020240619,142,2024-06-19,10,188,113,301,Hammer1584_T,"-37.81970749, 144.96795734"
1611420250801,161,2025-08-01,14,118,154,272,BirArt1109_T,"-37.81851276, 144.97131336"
391920241122,39,2024-11-22,19,96,81,177,AlfPl_T,"-37.81379749, 144.96995745"
752020251006,75,2025-10-06,20,10,10,20,SprFli_T,"-37.81515276, 144.97467661"
182020250913,182,2025-09-13,0,137,149,286,King163_T,"-37.81627451, 144.95550503"
182920250829,182,2025-08-29,9,74,137,211,King163_T,"-37.81627451, 144.95550503"
185020250902,185,2025-09-02,0,79,53,132,Eli197_T,"-37.81374643, 144.96276183"
167020250313,167,2025-03-13,0,3,8,11,Lat526_T,"-37.81304149, 144.95155955"
1401220240209,140,2024-02-09,12,89,61,150,Boyd2837_T,"-37.82590962, 144.96185972"
1432320240504,143,2024-05-04,23,278,173,451,Spencer_T,"-37.821728, 144.95557015"
1431120241222,143,2024-12-22,11,102,209,311,Spencer_T,"-37.821728, 144.95557015"
1321220240406,132,2024-04-06,12,190,143,333,King335_T,"-37.81267639, 144.95386444"
1321720250924,132,2025-09-24,17,189,183,372,King335_T,"-37.81267639, 144.95386444"
1341120250505,134,2025-05-05,11,409,387,796,Spen201_T,"-37.81694221, 144.95303935"
134820240123,134,2024-01-23,8,329,351,680,Spen201_T,"-37.81694221, 144.95303935"
134020241011,134,2024-10-11,0,85,108,193,Spen201_T,"-37.81694221, 144.95303935"
133620250503,133,2025-05-03,6,105,104,209,Spen229_T,"-37.81531435, 144.95227769"
133620241201,133,2024-12-01,6,93,195,288,Spen229_T,"-37.81531435, 144.95227769"
107620240511,107,2024-05-11,6,4,18,22,280Will_T,"-37.81246271, 144.95690188"
67320250331,67,2025-03-31,3,3,7,10,FLDegS_T,"-37.81688755, 144.96562569"
171820231227,17,2023-12-27,18,214,158,372,Col15_T,"-37.81362543, 144.97323591"
171120240613,17,2024-06-13,11,310,237,547,Col15_T,"-37.81362543, 144.97323591"
17020250218,17,2025-02-18,0,19,5,24,Col15_T,"-37.81362543, 144.97323591"
181520240831,18,2024-08-31,15,76,48,124,Col12_T,"-37.81344862, 144.97305353"
862220250112,86,2025-01-12,22,5,21,26,574Qub_T,"-37.80309992, 144.94908064"
86120250329,86,2025-03-29,1,5,15,20,574Qub_T,"-37.80309992, 144.94908064"
112320250906,11,2025-09-06,23,25,32,57,WatCit_T,"-37.81564989, 144.93970694"
11620251006,11,2025-10-06,6,10,8,18,WatCit_T,"-37.81564989, 144.93970694"
10920250102,10,2025-01-02,9,30,30,60,BouHbr_T,"-37.81876474, 144.94710545"
24120250325,24,2025-03-25,1,22,23,45,Col620_T,"-37.81887963, 144.95449198"
72620250318,72,2025-03-18,6,78,38,116,ACMI_T,"-37.81726338, 144.96872809"
27120240306,27,2024-03-06,1,19,6,25,Vic_T,"-37.80606888, 144.95644692"
53520240114,53,2024-01-14,5,1,4,5,Col254_T,"-37.81564191, 144.965499"
9020250121,9,2025-01-21,0,6,20,26,Col700_T,"-37.81982992, 144.95102555"
271820240816,27,2024-08-16,18,124,108,232,Vic_T,"-37.80606888, 144.95644692"
232220250707,23,2025-07-07,22,22,100,122,Col623_T,"-37.81909256, 144.95452748"
51120240217,51,2024-02-17,1,15,20,35,Fra118_T,"-37.80841815, 144.95906316"
231220240131,23,2024-01-31,12,488,586,1074,Col623_T,"-37.81909256, 144.95452748"
191420240126,19,2024-01-26,14,619,723,1342,LtB210_T,"-37.81237202, 144.96550671"
192120240622,19,2024-06-22,21,466,664,1130,LtB210_T,"-37.81237202, 144.96550671"
481120231210,48,2023-12-10,11,526,437,963,QVMQ_T,"-37.80631581, 144.95866697"
201520231219,20,2023-12-19,15,210,260,470,LtB170_T,"-37.81172914, 144.9682466"
1411520250201,141,2025-02-01,15,163,152,315,474Fl_T,"-37.81997273, 144.95834911"
1371220250227,137,2025-02-27,12,50,162,212,BouHbr2353_T,"-37.81894815, 144.94612292"
139820250104,139,2025-01-04,8,11,14,25,Signal1647_T,"-37.81959923, 144.9632832"
1361720250904,136,2025-09-04,17,232,77,309,BirFed1120_T,"-37.8184141, 144.97357915"
142820231217,142,2023-12-17,8,208,170,378,Hammer1584_T,"-37.81970749, 144.96795734"
1641120241013,164,2024-10-13,11,109,65,174,Lat526_T,"-37.813005, 144.95160411"
1382220250523,138,2025-05-23,22,0,1,1,EntPark1671_T,"-37.81996544, 144.95981454"
117020231215,117,2023-12-15,0,56,14,70,Fli114F_T,"-37.81629332, 144.97090877"
1171520240317,117,2024-03-17,15,140,185,325,Fli114F_T,"-37.81629332, 144.97090877"
69320240808,69,2024-08-08,3,1,1,2,FLDegC_T,"-37.81687226, 144.96559144"
61320231205,6,2023-12-05,13,923,865,1788,FliS_T,"-37.81911705, 144.96558255"
62020250217,6,2025-02-17,20,611,446,1057,FliS_T,"-37.81911705, 144.96558255"
4320240328,4,2024-03-28,3,14,7,21,Swa123_T,"-37.81487988, 144.9660878"
4220241116,4,2024-11-16,2,50,55,105,Swa123_T,"-37.81487988, 144.9660878"
70620240327,70,2024-03-27,6,8,7,15,Errol20_T,"-37.80456984, 144.94946228"
3320240630,3,2024-06-30,3,226,255,481,Swa295_T,"-37.81101524, 144.96429485"
31920240724,3,2024-07-24,19,925,1066,1991,Swa295_T,"-37.81101524, 144.96429485"
391920250704,39,2025-07-04,19,13,15,28,AlfPl_T,"-37.81379749, 144.96995745"
184020250812,184,2025-08-12,0,19,23,42,Eli124_T,"-37.81512416, 144.96371988"
165820250909,165,2025-09-09,8,10,46,56,Spen475_T,"-37.80953359, 144.94939004"
181320250503,181,2025-05-03,3,77,44,121,Eli368_T,"-37.81009465, 144.96143149"
131620250418,131,2025-04-18,6,7,13,20,King2_T,"-37.82009057, 144.95758725"
143720241222,143,2024-12-22,7,44,54,98,Spencer_T,"-37.821728, 144.95557015"
1081220240816,108,2024-08-16,12,179,256,435,261Will_T,"-37.81295822, 144.95678789"
682320250927,68,2025-09-27,23,58,31,89,FLDegN_T,"-37.8168479, 144.96559789"
172020241111,17,2024-11-11,20,87,79,166,Col15_T,"-37.81362543, 144.97323591"
172220250818,17,2025-08-18,22,52,96,148,Col15_T,"-37.81362543, 144.97323591"
112020231229,11,2023-12-29,20,214,248,462,WatCit_T,"-37.81564989, 144.93970694"
111620250421,11,2025-04-21,16,154,117,271,WatCit_T,"-37.81564989, 144.93970694"
11820250511,11,2025-05-11,8,59,53,112,WatCit_T,"-37.81564989, 144.93970694"
352120231102,35,2023-11-02,21,483,631,1114,SouthB_T,"-37.82018685, 144.96508508"
76420250417,76,2025-04-17,4,1,0,1,KenMac_T,"-37.79453803, 144.93036194"
91620240307,9,2024-03-07,16,3148,203,3351,Col700_T,"-37.81982992, 144.95102555"
9920240828,9,2024-08-28,9,195,1770,1965,Col700_T,"-37.81982992, 144.95102555"
92320241008,9,2024-10-08,23,18,7,25,Col700_T,"-37.81982992, 144.95102555"
271620250323,27,2025-03-23,16,202,137,339,Vic_T,"-37.80606888, 144.95644692"
23620250206,23,2025-02-06,6,66,67,133,Col623_T,"-37.81909256, 144.95452748"
792320251014,79,2025-10-14,23,53,63,116,FliSS_T,"-37.81794046, 144.96616678"
23920250706,23,2025-07-06,9,120,135,255,Col623_T,"-37.81909256, 144.95452748"
51320241025,51,2024-10-25,3,10,4,14,Fra118_T,"-37.80841815, 144.95906316"
511020240210,51,2024-02-10,10,148,126,274,Fra118_T,"-37.80841815, 144.95906316"
49020240225,49,2024-02-25,0,82,101,183,Eli501_T,"-37.80730068, 144.95956055"
481920251016,48,2025-10-16,19,135,257,392,QVMQ_T,"-37.80631581, 144.95866697"
52620250708,52,2025-07-08,6,18,26,44,Eli263_T,"-37.81252157, 144.9619401"
52120250717,52,2025-07-17,1,9,12,21,Eli263_T,"-37.81252157, 144.9619401"
202020231024,20,2023-10-24,20,202,293,495,LtB170_T,"-37.81172914, 144.9682466"
139520231214,139,2023-12-14,5,0,1,1,Signal1647_T,"-37.81959923, 144.9632832"
1642320240828,164,2024-08-28,23,3,18,21,Lat526_T,"-37.813005, 144.95160411"
1382020250307,138,2025-03-07,20,0,2,2,EntPark1671_T,"-37.81996544, 144.95981454"
1612320250916,161,2025-09-16,23,0,3,3,BirArt1109_T,"-37.81851276, 144.97131336"
49320250328,49,2025-03-28,3,27,32,59,Eli501_T,"-37.80730068, 144.95956055"
109020241008,109,2024-10-08,0,15,18,33,LatWill_T,"-37.81193681, 144.95621105"
1092120231205,109,2023-12-05,21,112,113,225,LatWill_T,"-37.81193681, 144.95621105"
66220250315,66,2025-03-15,2,98,85,183,QVN_T,"-37.81057846, 144.96444294"
66720240910,66,2024-09-10,7,102,257,359,QVN_T,"-37.81057846, 144.96444294"
69220240225,69,2024-02-25,2,1,2,3,FLDegC_T,"-37.81687226, 144.96559144"
69820240320,69,2024-03-20,8,180,48,228,FLDegC_T,"-37.81687226, 144.96559144"
6020240506,6,2024-05-06,0,50,27,77,FliS_T,"-37.81911705, 144.96558255"
84920240119,84,2024-01-19,9,923,552,1475,ElFi_T,"-37.81798049, 144.96503383"
31020240718,3,2024-07-18,10,329,454,783,Swa295_T,"-37.81101524, 144.96429485"
4820250508,4,2025-05-08,8,728,419,1147,Swa123_T,"-37.81487988, 144.9660878"
702320250114,70,2025-01-14,23,13,13,26,Errol20_T,"-37.80456984, 144.94946228"
772220231201,77,2023-12-01,22,77,54,131,HarEsP_T,"-37.81441438, 144.94433026"
711620231205,71,2023-12-05,16,11,12,23,WestWP_T,"-37.81235775, 144.97136962"
59620231213,59,2023-12-13,6,72,49,121,RMIT_T,"-37.80825648, 144.96304859"
541920240119,54,2024-01-19,19,111,89,200,Swa607_T,"-37.804024, 144.96308399"
282220250302,28,2025-03-02,22,97,108,205,VAC_T,"-37.82129925, 144.96879309"
291820250704,29,2025-07-04,18,423,311,734,AG_T,"-37.8199817, 144.96872865"
541020241201,54,2024-12-01,10,32,32,64,Swa607_T,"-37.804024, 144.96308399"
371220240501,37,2024-05-01,12,134,99,233,Lyg260_T,"-37.80107122, 144.96704554"
21520240225,21,2024-02-25,5,33,43,76,Bourke155_T,"-37.81267313, 144.96788288"
5620250706,5,2025-07-06,6,39,38,77,PriNW_T,"-37.81874249, 144.96787656"
5420250326,5,2025-03-26,4,21,10,31,PriNW_T,"-37.81874249, 144.96787656"
51720250616,5,2025-06-16,17,870,678,1548,PriNW_T,"-37.81874249, 144.96787656"
211920240825,21,2024-08-25,19,184,225,409,Bourke155_T,"-37.81267313, 144.96788288"
871920231031,87,2023-10-31,19,143,95,238,Errol23_T,"-37.80454949, 144.94921863"
441620250213,44,2025-02-13,16,58,28,86,UM3_T,"-37.79698741, 144.96441306"
166920250823,166,2025-08-23,9,35,34,69,Spen484_T,"-37.80896733, 144.94931703"
1401720250331,140,2025-03-31,17,113,143,256,Boyd2837_T,"-37.82590962, 144.96185972"
1621920240903,162,2024-09-03,19,214,231,445,Eli489_T,"-37.80740397, 144.95987909"
131920241010,131,2024-10-10,9,132,103,235,King2_T,"-37.82009057, 144.95758725"
1312020241110,131,2024-11-10,20,61,73,134,King2_T,"-37.82009057, 144.95758725"
1311320241212,131,2024-12-12,13,172,224,396,King2_T,"-37.82009057, 144.95758725"
131320240325,131,2024-03-25,3,10,15,25,King2_T,"-37.82009057, 144.95758725"
134220250801,134,2025-08-01,2,18,18,36,Spen201_T,"-37.81694221, 144.95303935"
1321520231025,132,2023-10-25,15,104,115,219,King335_T,"-37.81267639, 144.95386444"
1341520240325,134,2024-03-25,15,469,457,926,Spen201_T,"-37.81694221, 144.95303935"
1332220250209,133,2025-02-09,22,244,187,431,Spen229_T,"-37.81531435, 144.95227769"
1071520240806,107,2024-08-06,15,123,97,220,280Will_T,"-37.81246271, 144.95690188"
631820240531,63,2024-05-31,18,316,387,703,Bou231_T,"-37.81333081, 144.96675571"
671420240430,67,2024-04-30,14,337,435,772,FLDegS_T,"-37.81688755, 144.96562569"
621320241208,62,2024-12-08,13,202,181,383,Lat224_T,"-37.80996494, 144.96216521"
56620241231,56,2024-12-31,6,14,16,30,Lon364_T,"-37.81234775, 144.96153311"
10720240329,10,2024-03-29,7,4,4,8,BouHbr_T,"-37.81876474, 144.94710545"
351220250112,35,2025-01-12,12,471,658,1129,SouthB_T,"-37.82018685, 144.96508508"
761220240323,76,2024-03-23,12,74,66,140,KenMac_T,"-37.79453803, 144.93036194"
581420250111,58,2025-01-11,14,483,231,714,Bou688_T,"-37.81686075, 144.95358075"
92020250608,9,2025-06-08,20,31,30,61,Col700_T,"-37.81982992, 144.95102555"
91320250710,9,2025-07-10,13,475,454,929,Col700_T,"-37.81982992, 144.95102555"
91120250730,9,2025-07-30,11,306,351,657,Col700_T,"-37.81982992, 144.95102555"
92020240130,9,2024-01-30,20,87,45,132,Col700_T,"-37.81982992, 144.95102555"
301720240715,30,2024-07-15,17,203,313,516,Lon189_T,"-37.8112185, 144.96656806"
531520241021,53,2024-10-21,15,625,572,1197,Col254_T,"-37.81564191, 144.965499"
232220250728,23,2025-07-28,22,29,80,109,Col623_T,"-37.81909256, 144.95452748"
23320240827,23,2024-08-27,3,5,6,11,Col623_T,"-37.81909256, 144.95452748"
52120240828,52,2024-08-28,1,17,19,36,Eli263_T,"-37.81252157, 144.9619401"
521620250120,52,2025-01-20,16,257,259,516,Eli263_T,"-37.81252157, 144.9619401"
491320231220,49,2023-12-20,13,227,272,499,Eli501_T,"-37.80730068, 144.95956055"
49820240115,49,2024-01-15,8,53,102,155,Eli501_T,"-37.80730068, 144.95956055"
1372320240202,137,2024-02-02,23,0,1,1,BouHbr2353_T,"-37.81894815, 144.94612292"
1372120240223,137,2024-02-23,21,6,4,10,BouHbr2353_T,"-37.81894815, 144.94612292"
1391120231205,139,2023-12-05,11,33,46,79,Signal1647_T,"-37.81959923, 144.9632832"
139220240707,139,2024-07-07,2,4,0,4,Signal1647_T,"-37.81959923, 144.9632832"
1422120240605,142,2024-06-05,21,59,41,100,Hammer1584_T,"-37.81970749, 144.96795734"
28520231028,28,2023-10-28,5,10,16,26,VAC_T,"-37.82129925, 144.96879309"
29120240229,29,2024-02-29,1,10,5,15,AG_T,"-37.8199817, 144.96872865"
311020241226,31,2024-12-26,10,26,26,52,Lyg161_T,"-37.80169681, 144.96658911"
311020231029,31,2023-10-29,10,83,80,163,Lyg161_T,"-37.80169681, 144.96658911"
311620240219,31,2024-02-19,16,189,143,332,Lyg161_T,"-37.80169681, 144.96658911"
312120240324,31,2024-03-24,21,346,410,756,Lyg161_T,"-37.80169681, 144.96658911"
54520250228,54,2025-02-28,5,32,1,33,Swa607_T,"-37.804024, 144.96308399"
54120250405,54,2025-04-05,1,24,23,47,Swa607_T,"-37.804024, 144.96308399"
542020250807,54,2025-08-07,20,133,175,308,Swa607_T,"-37.804024, 144.96308399"
37220240129,37,2024-01-29,2,14,12,26,Lyg260_T,"-37.80107122, 144.96704554"
472220250515,47,2025-05-15,22,328,222,550,Eli250_T,"-37.81258467, 144.9625775"
47520250208,47,2025-02-08,5,17,29,46,Eli250_T,"-37.81258467, 144.9625775"
51020240125,5,2024-01-25,10,574,959,1533,PriNW_T,"-37.81874249, 144.96787656"
17420250419,17,2025-04-19,4,14,7,21,Col15_T,"-37.81362543, 144.97323591"
17920251003,17,2025-10-03,9,462,186,648,Col15_T,"-37.81362543, 144.97323591"
12020240929,1,2024-09-29,20,234,248,482,Bou292_T,"-37.81349441, 144.96515323"
1320250126,1,2025-01-26,3,32,30,62,Bou292_T,"-37.81349441, 144.96515323"
181220240924,18,2024-09-24,12,296,232,528,Col12_T,"-37.81344862, 144.97305353"
111320241205,11,2024-12-05,13,68,55,123,WatCit_T,"-37.81564989, 144.93970694"
621920240531,62,2024-05-31,19,205,140,345,Lat224_T,"-37.80996494, 144.96216521"
621820240828,62,2024-08-28,18,424,736,1160,Lat224_T,"-37.80996494, 144.96216521"
561920231218,56,2023-12-18,19,256,288,544,Lon364_T,"-37.81234775, 144.96153311"
101120231123,10,2023-11-23,11,100,75,175,BouHbr_T,"-37.81876474, 144.94710545"
24720231120,24,2023-11-20,7,730,182,912,Col620_T,"-37.81887963, 144.95449198"
12120240907,12,2024-09-07,1,6,12,18,NewQ_T,"-37.81457988, 144.94292398"
24120241109,24,2024-11-09,1,56,88,144,Col620_T,"-37.81887963, 144.95449198"
58620241026,58,2024-10-26,6,56,40,96,Bou688_T,"-37.81686075, 144.95358075"
58920250321,58,2025-03-21,9,823,155,978,Bou688_T,"-37.81686075, 144.95358075"
9120250926,9,2025-09-26,1,3,11,14,Col700_T,"-37.81982992, 144.95102555"
791020250213,79,2025-02-13,10,412,328,740,FliSS_T,"-37.81794046, 144.96616678"
532220250618,53,2025-06-18,22,70,72,142,Col254_T,"-37.81564191, 144.965499"
511120241228,51,2024-12-28,11,130,122,252,Fra118_T,"-37.80841815, 144.95906316"
482220231114,48,2023-11-14,22,49,67,116,QVMQ_T,"-37.80631581, 144.95866697"
251020240425,25,2024-04-25,10,286,348,634,MCEC_T,"-37.82401776, 144.95604426"
202220231201,20,2023-12-01,22,367,697,1064,LtB170_T,"-37.81172914, 144.9682466"
201220240112,20,2024-01-12,12,217,180,397,LtB170_T,"-37.81172914, 144.9682466"
1231920240216,123,2024-02-16,19,40,23,63,BirBridge_T,"-37.81753741, 144.97329734"
1231520240427,123,2024-04-27,15,164,32,196,BirBridge_T,"-37.81753741, 144.97329734"
1301120240222,130,2024-02-22,11,35,49,84,Bou892T,"-37.8204637, 144.94126826"
48720250928,48,2025-09-28,7,33,36,69,QVMQ_T,"-37.80631581, 144.95866697"
141020240518,141,2024-05-18,0,57,49,106,474Fl_T,"-37.81997273, 144.95834911"
117620250326,117,2025-03-26,6,39,23,62,Fli114F_T,"-37.81629332, 144.97090877"
139020240309,139,2024-03-09,0,12,22,34,Signal1647_T,"-37.81959923, 144.9632832"
139320250123,139,2025-01-23,3,0,1,1,Signal1647_T,"-37.81959923, 144.9632832"
87920240527,87,2024-05-27,9,54,76,130,Errol23_T,"-37.80454949, 144.94921863"
501220231220,50,2023-12-20,12,337,402,739,Lyg309_T,"-37.79808192, 144.96721013"
43120240413,43,2024-04-13,1,7,8,15,UM2_T,"-37.79844526, 144.96411782"
1822120250708,182,2025-07-08,21,122,158,280,King163_T,"-37.81627451, 144.95550503"
841520240207,84,2024-02-07,15,885,1338,2223,ElFi_T,"-37.81798049, 144.96503383"
42120240525,4,2024-05-25,21,795,659,1454,Swa123_T,"-37.81487988, 144.9660878"
4220241013,4,2024-10-13,2,119,144,263,Swa123_T,"-37.81487988, 144.9660878"
41920250429,4,2025-04-29,19,483,636,1119,Swa123_T,"-37.81487988, 144.9660878"
8020240629,8,2024-06-29,0,10,0,10,WebBN_T,"-37.82293543, 144.9471751"
412120240915,41,2024-09-15,21,40,36,76,Swa31,"-37.81668634, 144.96689733"
41120240605,41,2024-06-05,1,28,53,81,Swa31,"-37.81668634, 144.96689733"
652320240530,65,2024-05-30,23,35,77,112,SwaCs_T,"-37.81569416, 144.9668064"
65720240229,65,2024-02-29,7,260,90,350,SwaCs_T,"-37.81569416, 144.9668064"
65020240313,65,2024-03-13,0,11,38,49,SwaCs_T,"-37.81569416, 144.9668064"
281520250222,28,2025-02-22,15,1037,1154,2191,VAC_T,"-37.82129925, 144.96879309"
28820241002,28,2024-10-02,8,651,257,908,VAC_T,"-37.82129925, 144.96879309"
29320231125,29,2023-11-25,3,1,7,8,AG_T,"-37.8199817, 144.96872865"
401220240114,40,2024-01-14,12,114,152,266,Spr201_T,"-37.80999341, 144.97227587"
401520250514,40,2025-05-14,15,309,214,523,Spr201_T,"-37.80999341, 144.97227587"
312320250908,31,2025-09-08,23,8,23,31,Lyg161_T,"-37.80169681, 144.96658911"
37320231101,37,2023-11-01,3,6,9,15,Lyg260_T,"-37.80107122, 144.96704554"
471520250429,47,2025-04-29,15,792,693,1485,Eli250_T,"-37.81258467, 144.9625775"
51520250303,5,2025-03-03,15,1049,931,1980,PriNW_T,"-37.81874249, 144.96787656"
5920240401,5,2024-04-01,9,267,396,663,PriNW_T,"-37.81874249, 144.96787656"
36320240308,36,2024-03-08,3,22,6,28,Que85_T,"-37.81652527, 144.96121062"
87220240317,87,2024-03-17,2,3,2,5,Errol23_T,"-37.80454949, 144.94921863"
50920240719,50,2024-07-19,9,59,103,162,Lyg309_T,"-37.79808192, 144.96721013"
1791320251011,179,2025-10-11,13,51,63,114,Pow61_T,"-37.82392385, 144.96299677"
162320250629,162,2025-06-29,3,37,16,53,Eli489_T,"-37.80740397, 144.95987909"
1671520250614,167,2025-06-14,15,83,85,168,Lat526_T,"-37.81304149, 144.95155955"
167920250922,167,2025-09-22,9,18,78,96,Lat526_T,"-37.81304149, 144.95155955"
1311520240127,131,2024-01-27,15,183,103,286,King2_T,"-37.82009057, 144.95758725"
134920241202,134,2024-12-02,9,331,324,655,Spen201_T,"-37.81694221, 144.95303935"
133220240820,133,2024-08-20,2,4,4,8,Spen229_T,"-37.81531435, 144.95227769"
124720250529,124,2025-05-29,7,3,3,6,BirBridge_T,"-37.81757416, 144.97329934"
1241620250601,124,2025-06-01,16,4,8,12,BirBridge_T,"-37.81757416, 144.97329934"
172120250411,17,2025-04-11,21,133,111,244,Col15_T,"-37.81362543, 144.97323591"
1220241110,1,2024-11-10,2,34,40,74,Bou292_T,"-37.81349441, 144.96515323"
681920240902,68,2024-09-02,19,40,10,50,FLDegN_T,"-37.8168479, 144.96559789"
622320250811,62,2025-08-11,23,68,62,130,Lat224_T,"-37.80996494, 144.96216521"
631020250127,63,2025-01-27,10,109,196,305,Bou231_T,"-37.81333081, 144.96675571"
621920250102,62,2025-01-02,19,164,120,284,Lat224_T,"-37.80996494, 144.96216521"
56020231206,56,2023-12-06,0,27,29,56,Lon364_T,"-37.81234775, 144.96153311"
862320240423,86,2024-04-23,23,1,0,1,574Qub_T,"-37.80309992, 144.94908064"
86920250527,86,2025-05-27,9,53,27,80,574Qub_T,"-37.80309992, 144.94908064"
10620240921,10,2024-09-21,6,7,3,10,BouHbr_T,"-37.81876474, 144.94710545"
58120231230,58,2023-12-30,1,72,100,172,Bou688_T,"-37.81686075, 144.95358075"
351620250312,35,2025-03-12,16,1357,1136,2493,SouthB_T,"-37.82018685, 144.96508508"
27820250207,27,2025-02-07,8,72,92,164,Vic_T,"-37.80606888, 144.95644692"
91120240220,9,2024-02-20,11,308,430,738,Col700_T,"-37.81982992, 144.95102555"
92120240306,9,2024-03-06,21,90,68,158,Col700_T,"-37.81982992, 144.95102555"
27320240807,27,2024-08-07,3,1,2,3,Vic_T,"-37.80606888, 144.95644692"
791120231022,79,2023-10-22,11,439,327,766,FliSS_T,"-37.81794046, 144.96616678"
53920241015,53,2024-10-15,9,465,334,799,Col254_T,"-37.81564191, 144.965499"
23720240505,23,2024-05-05,7,33,60,93,Col623_T,"-37.81909256, 144.95452748"
461820240703,46,2024-07-03,18,49,38,87,Pel147_T,"-37.80240719, 144.9615673"
1671020250617,167,2025-06-17,10,16,38,54,Lat526_T,"-37.81304149, 144.95155955"
131120240828,131,2024-08-28,1,4,22,26,King2_T,"-37.82009057, 144.95758725"
108220250424,108,2025-04-24,2,14,13,27,261Will_T,"-37.81295822, 144.95678789"
143420250822,143,2025-08-22,4,27,9,36,Spencer_T,"-37.821728, 144.95557015"
132920240415,132,2024-04-15,9,129,114,243,King335_T,"-37.81267639, 144.95386444"
135620240614,135,2024-06-14,6,39,46,85,Spen161_T,"-37.8172861, 144.95319102"
1181420240110,118,2024-01-10,14,30,27,57,Fli114C_T,"-37.81632783, 144.97090512"
17820250211,17,2025-02-11,8,1409,191,1600,Col15_T,"-37.81362543, 144.97323591"
171120250311,17,2025-03-11,11,345,234,579,Col15_T,"-37.81362543, 144.97323591"
1820241031,1,2024-10-31,8,242,281,523,Bou292_T,"-37.81349441, 144.96515323"
63820240617,63,2024-06-17,8,139,142,281,Bou231_T,"-37.81333081, 144.96675571"
181620241222,18,2024-12-22,16,86,90,176,Col12_T,"-37.81344862, 144.97305353"
122320231231,12,2023-12-31,23,2088,3694,5782,NewQ_T,"-37.81457988, 144.94292398"
86920250821,86,2025-08-21,9,47,32,79,574Qub_T,"-37.80309992, 144.94908064"
111620240719,11,2024-07-19,16,64,73,137,WatCit_T,"-37.81564989, 144.93970694"
56620250219,56,2025-02-19,6,44,37,81,Lon364_T,"-37.81234775, 144.96153311"
721620231022,72,2023-10-22,16,193,322,515,ACMI_T,"-37.81726338, 144.96872809"
24820240609,24,2024-06-09,8,246,221,467,Col620_T,"-37.81887963, 144.95449198"
561120251013,56,2025-10-13,11,281,268,549,Lon364_T,"-37.81234775, 144.96153311"
581120250130,58,2025-01-30,11,608,292,900,Bou688_T,"-37.81686075, 144.95358075"
351520231027,35,2023-10-27,15,1214,1283,2497,SouthB_T,"-37.82018685, 144.96508508"
762320250122,76,2025-01-22,23,2,0,2,KenMac_T,"-37.79453803, 144.93036194"
272120250301,27,2025-03-01,21,103,52,155,Vic_T,"-37.80606888, 144.95644692"
27420250614,27,2025-06-14,4,7,2,9,Vic_T,"-37.80606888, 144.95644692"
791220231102,79,2023-11-02,12,411,467,878,FliSS_T,"-37.81794046, 144.96616678"
791820231218,79,2023-12-18,18,491,331,822,FliSS_T,"-37.81794046, 144.96616678"
512320240108,51,2024-01-08,23,19,14,33,Fra118_T,"-37.80841815, 144.95906316"
301720250619,30,2025-06-19,17,334,489,823,Lon189_T,"-37.8112185, 144.96656806"
301520250728,30,2025-07-28,15,174,303,477,Lon189_T,"-37.8112185, 144.96656806"
20820240124,20,2024-01-24,8,60,52,112,LtB170_T,"-37.81172914, 144.9682466"
51120250605,51,2025-06-05,1,5,8,13,Fra118_T,"-37.80841815, 144.95906316"
141020241121,141,2024-11-21,0,22,29,51,474Fl_T,"-37.81997273, 144.95834911"
1172320240126,117,2024-01-26,23,182,141,323,Fli114F_T,"-37.81629332, 144.97090877"
1172120240929,117,2024-09-29,21,69,91,160,Fli114F_T,"-37.81629332, 144.97090877"
117620241106,117,2024-11-06,6,29,18,47,Fli114F_T,"-37.81629332, 144.97090877"
49220250218,49,2025-02-18,2,27,36,63,Eli501_T,"-37.80730068, 144.95956055"
491520240726,49,2024-07-26,15,267,302,569,Eli501_T,"-37.80730068, 144.95956055"
1092320241013,109,2024-10-13,23,29,39,68,LatWill_T,"-37.81193681, 144.95621105"
19720241227,19,2024-12-27,7,11,17,28,LtB210_T,"-37.81237202, 144.96550671"
481520241201,48,2024-12-01,15,487,258,745,QVMQ_T,"-37.80631581, 144.95866697"
1641120241128,164,2024-11-28,11,113,46,159,Lat526_T,"-37.813005, 144.95160411"
161320241112,161,2024-11-12,3,1,0,1,BirArt1109_T,"-37.81851276, 144.97131336"
691920240530,69,2024-05-30,19,8,7,15,FLDegC_T,"-37.81687226, 144.96559144"
41020250527,4,2025-05-27,10,712,482,1194,Swa123_T,"-37.81487988, 144.9660878"
701120240912,70,2024-09-12,11,131,144,275,Errol20_T,"-37.80456984, 144.94946228"
751720231111,75,2023-11-11,17,47,43,90,SprFli_T,"-37.81515276, 144.97467661"
59720250915,59,2025-09-15,7,198,72,270,RMIT_T,"-37.80825648, 144.96304859"
71920240625,71,2024-06-25,9,45,17,62,WestWP_T,"-37.81235775, 144.97136962"
77720250811,77,2025-08-11,7,74,92,166,HarEsP_T,"-37.81441438, 144.94433026"
771920250911,77,2025-09-11,19,69,42,111,HarEsP_T,"-37.81441438, 144.94433026"
291020250530,29,2025-05-30,10,279,398,677,AG_T,"-37.8199817, 144.96872865"
462020250723,46,2025-07-23,20,1,1,2,Pel147_T,"-37.80240719, 144.9615673"
52520240123,52,2024-01-23,5,7,6,13,Eli263_T,"-37.81252157, 144.9619401"
51020250906,51,2025-09-06,0,16,27,43,Fra118_T,"-37.80841815, 144.95906316"
51220240326,51,2024-03-26,2,6,0,6,Fra118_T,"-37.80841815, 144.95906316"
491020250325,49,2025-03-25,10,277,322,599,Eli501_T,"-37.80730068, 144.95956055"
491820250516,49,2025-05-16,18,297,293,590,Eli501_T,"-37.80730068, 144.95956055"
481020250731,48,2025-07-31,10,204,127,331,QVMQ_T,"-37.80631581, 144.95866697"
20220240824,20,2024-08-24,2,25,37,62,LtB170_T,"-37.81172914, 144.9682466"
491320250925,49,2025-09-25,13,373,649,1022,Eli501_T,"-37.80730068, 144.95956055"
141820240320,141,2024-03-20,8,149,120,269,474Fl_T,"-37.81997273, 144.95834911"
1411420250919,141,2025-09-19,14,205,126,331,474Fl_T,"-37.81997273, 144.95834911"
1391920250902,139,2025-09-02,19,20,19,39,Signal1647_T,"-37.81959923, 144.9632832"
1362320240224,136,2024-02-24,23,3,3,6,BirFed1120_T,"-37.8184141, 144.97357915"
1422220240425,142,2024-04-25,22,103,320,423,Hammer1584_T,"-37.81970749, 144.96795734"
117220240814,117,2024-08-14,2,2,3,5,Fli114F_T,"-37.81629332, 144.97090877"
1091720240110,109,2024-01-10,17,427,146,573,LatWill_T,"-37.81193681, 144.95621105"
1091020250108,109,2025-01-08,10,76,86,162,LatWill_T,"-37.81193681, 144.95621105"
66620250821,66,2025-08-21,6,22,71,93,QVN_T,"-37.81057846, 144.96444294"
691620250528,69,2025-05-28,16,144,201,345,FLDegC_T,"-37.81687226, 144.96559144"
3020250306,3,2025-03-06,0,95,54,149,Swa295_T,"-37.81101524, 144.96429485"
81420250219,8,2025-02-19,14,130,243,373,WebBN_T,"-37.82293543, 144.9471751"
78620250515,78,2025-05-15,6,3,2,5,HarEsB_T,"-37.81471642, 144.9446508"
29820240108,29,2024-01-08,8,74,60,134,AG_T,"-37.8199817, 144.96872865"
142020241222,14,2024-12-22,20,867,493,1360,SanBri_T,"-37.82011242, 144.96291897"
651820240817,65,2024-08-17,18,915,524,1439,SwaCs_T,"-37.81569416, 144.9668064"
28620250206,28,2025-02-06,6,255,154,409,VAC_T,"-37.82129925, 144.96879309"
281120240612,28,2024-06-12,11,444,337,781,VAC_T,"-37.82129925, 144.96879309"
54520250113,54,2025-01-13,5,2,3,5,Swa607_T,"-37.804024, 144.96308399"
36220240920,36,2024-09-20,2,23,10,33,Que85_T,"-37.81652527, 144.96121062"
371020240726,37,2024-07-26,10,50,70,120,Lyg260_T,"-37.80107122, 144.96704554"
37020240817,37,2024-08-17,0,29,33,62,Lyg260_T,"-37.80107122, 144.96704554"
362120240502,36,2024-05-02,21,69,152,221,Que85_T,"-37.81652527, 144.96121062"
471220241129,47,2024-11-29,12,901,1044,1945,Eli250_T,"-37.81258467, 144.9625775"
211120240229,21,2024-02-29,11,257,203,460,Bourke155_T,"-37.81267313, 144.96788288"
45520250629,45,2025-06-29,5,12,29,41,Swa148_T,"-37.81414075, 144.96609379"
45820250902,45,2025-09-02,8,286,376,662,Swa148_T,"-37.81414075, 144.96609379"
166120241219,166,2024-12-19,1,0,1,1,Spen484_T,"-37.80896733, 144.94931703"
1671920250329,167,2025-03-29,19,47,61,108,Lat526_T,"-37.81304149, 144.95155955"
131720241226,131,2024-12-26,7,22,27,49,King2_T,"-37.82009057, 144.95758725"
118320241228,118,2024-12-28,3,0,1,1,Fli114C_T,"-37.81632783, 144.97090512"
124720250109,124,2025-01-09,7,2,2,4,BirBridge_T,"-37.81757416, 144.97329934"
171220241222,17,2024-12-22,12,181,129,310,Col15_T,"-37.81362543, 144.97323591"
63920231227,63,2023-12-27,9,90,162,252,Bou231_T,"-37.81333081, 144.96675571"
67620240216,67,2024-02-16,6,75,20,95,FLDegS_T,"-37.81688755, 144.96562569"
181120250319,18,2025-03-19,11,231,262,493,Col12_T,"-37.81344862, 144.97305353"
631420250821,63,2025-08-21,14,396,478,874,Bou231_T,"-37.81333081, 144.96675571"
291220240804,29,2024-08-04,12,320,542,862,AG_T,"-37.8199817, 144.96872865"
401420250121,40,2025-01-21,14,230,179,409,Spr201_T,"-37.80999341, 144.97227587"
311020240916,31,2024-09-16,10,82,81,163,Lyg161_T,"-37.80169681, 144.96658911"
37320250111,37,2025-01-11,3,9,4,13,Lyg260_T,"-37.80107122, 144.96704554"
211620231204,21,2023-12-04,16,376,399,775,Bourke155_T,"-37.81267313, 144.96788288"
362020240928,36,2024-09-28,20,138,131,269,Que85_T,"-37.81652527, 144.96121062"
50220241013,50,2024-10-13,2,2,0,2,Lyg309_T,"-37.79808192, 144.96721013"
442020240616,44,2024-06-16,20,18,5,23,UM3_T,"-37.79698741, 144.96441306"
1621120241204,162,2024-12-04,11,248,331,579,Eli489_T,"-37.80740397, 144.95987909"
1331420240624,133,2024-06-24,14,408,493,901,Spen229_T,"-37.81531435, 144.95227769"
118620240203,118,2024-02-03,6,4,0,4,Fli114C_T,"-37.81632783, 144.97090512"
49520240528,49,2024-05-28,5,28,38,66,Eli501_T,"-37.80730068, 144.95956055"
109020240904,109,2024-09-04,0,3,33,36,LatWill_T,"-37.81193681, 144.95621105"
491020250617,49,2025-06-17,10,232,269,501,Eli501_T,"-37.80730068, 144.95956055"
191320250426,19,2025-04-26,13,701,655,1356,LtB210_T,"-37.81237202, 144.96550671"
482020250201,48,2025-02-01,20,101,99,200,QVMQ_T,"-37.80631581, 144.95866697"
1641420250601,164,2025-06-01,14,121,88,209,Lat526_T,"-37.813005, 144.95160411"
139420250407,139,2025-04-07,4,2,1,3,Signal1647_T,"-37.81959923, 144.9632832"
136820241208,136,2024-12-08,8,110,70,180,BirFed1120_T,"-37.8184141, 144.97357915"
672020240413,67,2024-04-13,20,362,404,766,FLDegS_T,"-37.81688755, 144.96562569"
672320240511,67,2024-05-11,23,126,172,298,FLDegS_T,"-37.81688755, 144.96562569"
182020241119,18,2024-11-19,20,11,12,23,Col12_T,"-37.81344862, 144.97305353"
631620241218,63,2024-12-18,16,415,544,959,Bou231_T,"-37.81333081, 144.96675571"
68920250817,68,2025-08-17,9,184,170,354,FLDegN_T,"-37.8168479, 144.96559789"
56120250330,56,2025-03-30,1,67,124,191,Lon364_T,"-37.81234775, 144.96153311"
56420250618,56,2025-06-18,4,44,21,65,Lon364_T,"-37.81234775, 144.96153311"
122020250822,12,2025-08-22,20,69,54,123,NewQ_T,"-37.81457988, 144.94292398"
58320241101,58,2024-11-01,3,5,13,18,Bou688_T,"-37.81686075, 144.95358075"
76420250814,76,2025-08-14,4,1,0,1,KenMac_T,"-37.79453803, 144.93036194"
76820240323,76,2024-03-23,8,57,24,81,KenMac_T,"-37.79453803, 144.93036194"
11120240731,11,2024-07-31,1,2,0,2,WatCit_T,"-37.81564989, 144.93970694"
92220241126,9,2024-11-26,22,54,40,94,Col700_T,"-37.81982992, 144.95102555"
792020250220,79,2025-02-20,20,247,268,515,FliSS_T,"-37.81794046, 144.96616678"
792220241223,79,2024-12-23,22,656,577,1233,FliSS_T,"-37.81794046, 144.96616678"
51820240212,51,2024-02-12,8,90,61,151,Fra118_T,"-37.80841815, 144.95906316"
20420240226,20,2024-02-26,4,2,2,4,LtB170_T,"-37.81172914, 144.9682466"
511120250612,51,2025-06-12,11,82,71,153,Fra118_T,"-37.80841815, 144.95906316"
1231820240515,123,2024-05-15,18,7,1,8,BirBridge_T,"-37.81753741, 144.97329734"
32320250504,3,2025-05-04,23,176,118,294,Swa295_T,"-37.81101524, 144.96429485"
81120240305,8,2024-03-05,11,123,214,337,WebBN_T,"-37.82293543, 144.9471751"
81720250313,8,2025-03-13,17,236,434,670,WebBN_T,"-37.82293543, 144.9471751"
78220250530,78,2025-05-30,2,0,3,3,HarEsB_T,"-37.81471642, 144.9446508"
65520240916,65,2024-09-16,5,71,54,125,SwaCs_T,"-37.81569416, 144.9668064"
141820240628,14,2024-06-28,18,450,157,607,SanBri_T,"-37.82011242, 144.96291897"
711720240812,71,2024-08-12,17,25,17,42,WestWP_T,"-37.81235775, 144.97136962"
711320250408,71,2025-04-08,13,13,18,31,WestWP_T,"-37.81235775, 144.97136962"
54620231022,54,2023-10-22,6,11,7,18,Swa607_T,"-37.804024, 144.96308399"
471220240910,47,2024-09-10,12,996,951,1947,Eli250_T,"-37.81258467, 144.9625775"
211520250601,21,2025-06-01,15,356,383,739,Bourke155_T,"-37.81267313, 144.96788288"
361120250113,36,2025-01-13,11,156,164,320,Que85_T,"-37.81652527, 144.96121062"
36520250525,36,2025-05-25,5,17,37,54,Que85_T,"-37.81652527, 144.96121062"
50920231229,50,2023-12-29,9,54,88,142,Lyg309_T,"-37.79808192, 144.96721013"
501920250202,50,2025-02-02,19,156,134,290,Lyg309_T,"-37.79808192, 144.96721013"
431720250103,43,2025-01-03,17,71,57,128,UM2_T,"-37.79844526, 144.96411782"
432320250109,43,2025-01-09,23,20,2,22,UM2_T,"-37.79844526, 144.96411782"
451620231224,45,2023-12-24,16,940,1042,1982,Swa148_T,"-37.81414075, 144.96609379"
51320250228,5,2025-02-28,13,947,1165,2112,PriNW_T,"-37.81874249, 144.96787656"
51020231105,5,2023-11-05,10,579,703,1282,PriNW_T,"-37.81874249, 144.96787656"
1651620250320,165,2025-03-20,16,46,41,87,Spen475_T,"-37.80953359, 144.94939004"
1671220250908,167,2025-09-08,12,53,86,139,Lat526_T,"-37.81304149, 144.95155955"
132520250520,132,2025-05-20,5,10,9,19,King335_T,"-37.81267639, 144.95386444"
1322120240629,132,2024-06-29,21,83,89,172,King335_T,"-37.81267639, 144.95386444"
132020240908,132,2024-09-08,0,39,57,96,King335_T,"-37.81267639, 144.95386444"
1342320250528,134,2025-05-28,23,29,24,53,Spen201_T,"-37.81694221, 144.95303935"
134420240225,134,2024-02-25,4,60,28,88,Spen201_T,"-37.81694221, 144.95303935"
681920250811,68,2025-08-11,19,133,74,207,FLDegN_T,"-37.8168479, 144.96559789"
171620240529,17,2024-05-29,16,246,517,763,Col15_T,"-37.81362543, 144.97323591"
171020250209,17,2025-02-09,10,115,102,217,Col15_T,"-37.81362543, 144.97323591"
17720250426,17,2025-04-26,7,39,21,60,Col15_T,"-37.81362543, 144.97323591"
11520241026,1,2024-10-26,15,1722,1691,3413,Bou292_T,"-37.81349441, 144.96515323"
68920250830,68,2025-08-30,9,132,124,256,FLDegN_T,"-37.8168479, 144.96559789"
182020240217,18,2024-02-17,20,22,25,47,Col12_T,"-37.81344862, 144.97305353"
68520240922,68,2024-09-22,5,1,0,1,FLDegN_T,"-37.8168479, 144.96559789"
862220240416,86,2024-04-16,22,4,24,28,574Qub_T,"-37.80309992, 144.94908064"
861520240620,86,2024-06-20,15,13,14,27,574Qub_T,"-37.80309992, 144.94908064"
56620250722,56,2025-07-22,6,24,36,60,Lon364_T,"-37.81234775, 144.96153311"
762320250711,76,2025-07-11,23,2,2,4,KenMac_T,"-37.79453803, 144.93036194"
721220250822,72,2025-08-22,12,263,351,614,ACMI_T,"-37.81726338, 144.96872809"
35120240816,35,2024-08-16,1,9,44,53,SouthB_T,"-37.82018685, 144.96508508"
30120241104,30,2024-11-04,1,75,95,170,Lon189_T,"-37.8112185, 144.96656806"
232220240921,23,2024-09-21,22,106,164,270,Col623_T,"-37.81909256, 144.95452748"
462120231223,46,2023-12-23,21,15,33,48,Pel147_T,"-37.80240719, 144.9615673"
522220240412,52,2024-04-12,22,240,252,492,Eli263_T,"-37.81252157, 144.9619401"
482020241130,48,2024-11-30,20,118,112,230,QVMQ_T,"-37.80631581, 144.95866697"
482320240603,48,2024-06-03,23,19,24,43,QVMQ_T,"-37.80631581, 144.95866697"
672120250317,67,2025-03-17,21,87,234,321,FLDegS_T,"-37.81688755, 144.96562569"
68320241021,68,2024-10-21,3,4,0,4,FLDegN_T,"-37.8168479, 144.96559789"
56020231028,56,2023-10-28,0,87,79,166,Lon364_T,"-37.81234775, 144.96153311"
861920240307,86,2024-03-07,19,39,66,105,574Qub_T,"-37.80309992, 144.94908064"
861520240912,86,2024-09-12,15,47,62,109,574Qub_T,"-37.80309992, 144.94908064"
86620250302,86,2025-03-02,6,2,2,4,574Qub_T,"-37.80309992, 144.94908064"
111420241214,11,2024-12-14,14,124,116,240,WatCit_T,"-37.81564989, 144.93970694"
11820250723,11,2025-07-23,8,59,60,119,WatCit_T,"-37.81564989, 144.93970694"
76420241029,76,2024-10-29,4,1,0,1,KenMac_T,"-37.79453803, 144.93036194"
58020250823,58,2025-08-23,0,137,147,284,Bou688_T,"-37.81686075, 144.95358075"
58220241214,58,2024-12-14,2,70,108,178,Bou688_T,"-37.81686075, 144.95358075"
2120240502,2,2024-05-02,1,2,17,19,Bou283_T,"-37.81380668, 144.96516718"
521420240415,52,2024-04-15,14,377,273,650,Eli263_T,"-37.81252157, 144.9619401"
191120241111,19,2024-11-11,11,344,213,557,LtB210_T,"-37.81237202, 144.96550671"
19720250304,19,2025-03-04,7,31,12,43,LtB210_T,"-37.81237202, 144.96550671"
201820250821,20,2025-08-21,18,491,389,880,LtB170_T,"-37.81172914, 144.9682466"
20920251009,20,2025-10-09,9,70,66,136,LtB170_T,"-37.81172914, 144.9682466"
481320240529,48,2024-05-29,13,198,171,369,QVMQ_T,"-37.80631581, 144.95866697"
48520240610,48,2024-06-10,5,20,9,29,QVMQ_T,"-37.80631581, 144.95866697"
20820241129,20,2024-11-29,8,63,72,135,LtB170_T,"-37.81172914, 144.9682466"
20920250816,20,2025-08-16,9,64,83,147,LtB170_T,"-37.81172914, 144.9682466"
201120240706,20,2024-07-06,11,287,184,471,LtB170_T,"-37.81172914, 144.9682466"
52220250428,52,2025-04-28,2,9,7,16,Eli263_T,"-37.81252157, 144.9619401"
1801120251008,180,2025-10-08,11,40,22,62,Mac330_T,"-37.79497059, 144.93530329"
1392020250815,139,2025-08-15,20,13,18,31,Signal1647_T,"-37.81959923, 144.9632832"
1422120240811,142,2024-08-11,21,87,73,160,Hammer1584_T,"-37.81970749, 144.96795734"
164020250621,164,2025-06-21,0,9,21,30,Lat526_T,"-37.813005, 144.95160411"
1611420250331,161,2025-03-31,14,93,108,201,BirArt1109_T,"-37.81851276, 144.97131336"
117920240206,117,2024-02-06,9,197,129,326,Fli114F_T,"-37.81629332, 144.97090877"
661220240314,66,2024-03-14,12,1066,1240,2306,QVN_T,"-37.81057846, 144.96444294"
661320240924,66,2024-09-24,13,1550,1400,2950,QVN_T,"-37.81057846, 144.96444294"
691020250624,69,2025-06-24,10,205,169,374,FLDegC_T,"-37.81687226, 144.96559144"
61020240202,6,2024-02-02,10,505,424,929,FliS_T,"-37.81911705, 144.96558255"
6720240607,6,2024-06-07,7,355,432,787,FliS_T,"-37.81911705, 144.96558255"
61820250316,6,2025-03-16,18,713,536,1249,FliS_T,"-37.81911705, 144.96558255"
841320240224,84,2024-02-24,13,1188,1573,2761,ElFi_T,"-37.81798049, 144.96503383"
702020250531,70,2025-05-31,20,255,323,578,Errol20_T,"-37.80456984, 144.94946228"
3020241103,3,2024-11-03,0,408,491,899,Swa295_T,"-37.81101524, 144.96429485"
3220240228,3,2024-02-28,2,81,53,134,Swa295_T,"-37.81101524, 144.96429485"
31920240429,3,2024-04-29,19,896,895,1791,Swa295_T,"-37.81101524, 144.96429485"
81320231122,8,2023-11-22,13,309,340,649,WebBN_T,"-37.82293543, 144.9471751"
81920231204,8,2023-12-04,19,98,148,246,WebBN_T,"-37.82293543, 144.9471751"
81920240505,8,2024-05-05,19,38,59,97,WebBN_T,"-37.82293543, 144.9471751"
412320250110,41,2025-01-10,23,1047,624,1671,Swa31,"-37.81668634, 144.96689733"
772020240909,77,2024-09-09,20,106,86,192,HarEsP_T,"-37.81441438, 144.94433026"
771320241011,77,2024-10-11,13,146,134,280,HarEsP_T,"-37.81441438, 144.94433026"
29920231219,29,2023-12-19,9,52,45,97,AG_T,"-37.8199817, 144.96872865"
592020240129,59,2024-01-29,20,335,255,590,RMIT_T,"-37.80825648, 144.96304859"
541520250813,54,2025-08-13,15,231,387,618,Swa607_T,"-37.804024, 144.96308399"
312020240515,31,2024-05-15,20,157,224,381,Lyg161_T,"-37.80169681, 144.96658911"
541720240906,54,2024-09-06,17,176,473,649,Swa607_T,"-37.804024, 144.96308399"
361120240818,36,2024-08-18,11,130,94,224,Que85_T,"-37.81652527, 144.96121062"
371820250121,37,2025-01-21,18,83,91,174,Lyg260_T,"-37.80107122, 144.96704554"
47020250126,47,2025-01-26,0,191,141,332,Eli250_T,"-37.81258467, 144.9625775"
471720240525,47,2024-05-25,17,1184,941,2125,Eli250_T,"-37.81258467, 144.9625775"
21020240109,21,2024-01-09,0,47,77,124,Bourke155_T,"-37.81267313, 144.96788288"
1612020250128,161,2025-01-28,20,38,65,103,BirArt1109_T,"-37.81851276, 144.97131336"
138920250227,138,2025-02-27,9,4,6,10,EntPark1671_T,"-37.81996544, 144.95981454"
171720250222,17,2025-02-22,17,215,128,343,Col15_T,"-37.81362543, 144.97323591"
17220250724,17,2025-07-24,2,4,2,6,Col15_T,"-37.81362543, 144.97323591"
67820240512,67,2024-05-12,8,109,139,248,FLDegS_T,"-37.81688755, 144.96562569"
631320251013,63,2025-10-13,13,571,577,1148,Bou231_T,"-37.81333081, 144.96675571"
681120250505,68,2025-05-05,11,333,282,615,FLDegN_T,"-37.8168479, 144.96559789"
681320240112,68,2024-01-12,13,292,152,444,FLDegN_T,"-37.8168479, 144.96559789"
621920250604,62,2025-06-04,19,189,246,435,Lat224_T,"-37.80996494, 144.96216521"
111320250403,11,2025-04-03,13,136,96,232,WatCit_T,"-37.81564989, 144.93970694"
101420240209,10,2024-02-09,14,70,36,106,BouHbr_T,"-37.81876474, 144.94710545"
721420231204,72,2023-12-04,14,199,247,446,ACMI_T,"-37.81726338, 144.96872809"
761820241215,76,2024-12-15,18,40,44,84,KenMac_T,"-37.79453803, 144.93036194"
35120240211,35,2024-02-11,1,244,374,618,SouthB_T,"-37.82018685, 144.96508508"
762220240721,76,2024-07-21,22,2,8,10,KenMac_T,"-37.79453803, 144.93036194"
761020240723,76,2024-07-23,10,42,41,83,KenMac_T,"-37.79453803, 144.93036194"
9320250622,9,2025-06-22,3,1,2,3,Col700_T,"-37.81982992, 144.95102555"
27920240831,27,2024-08-31,9,118,151,269,Vic_T,"-37.80606888, 144.95644692"
9520251002,9,2025-10-02,5,19,49,68,Col700_T,"-37.81982992, 144.95102555"
79420241018,79,2024-10-18,4,12,15,27,FliSS_T,"-37.81794046, 144.96616678"
51220240429,51,2024-04-29,2,3,5,8,Fra118_T,"-37.80841815, 144.95906316"
51520240926,51,2024-09-26,5,9,10,19,Fra118_T,"-37.80841815, 144.95906316"
231520240405,23,2024-04-05,15,124,294,418,Col623_T,"-37.81909256, 144.95452748"
231120231105,23,2023-11-05,11,148,209,357,Col623_T,"-37.81909256, 144.95452748"
462020241115,46,2024-11-15,20,29,25,54,Pel147_T,"-37.80240719, 144.9615673"
49220250110,49,2025-01-10,2,30,44,74,Eli501_T,"-37.80730068, 144.95956055"
481420250930,48,2025-09-30,14,406,258,664,QVMQ_T,"-37.80631581, 144.95866697"
25120241030,25,2024-10-30,1,11,8,19,MCEC_T,"-37.82401776, 144.95604426"
202220231118,20,2023-11-18,22,395,712,1107,LtB170_T,"-37.81172914, 144.9682466"
141320241025,141,2024-10-25,3,6,11,17,474Fl_T,"-37.81997273, 144.95834911"
1372120250527,137,2025-05-27,21,2,2,4,BouHbr2353_T,"-37.81894815, 144.94612292"
1391820240519,139,2024-05-19,18,4,8,12,Signal1647_T,"-37.81959923, 144.9632832"
142720250718,142,2025-07-18,7,118,108,226,Hammer1584_T,"-37.81970749, 144.96795734"
142720250215,142,2025-02-15,7,127,107,234,Hammer1584_T,"-37.81970749, 144.96795734"
1801320250311,180,2025-03-11,13,30,25,55,Mac330_T,"-37.79497059, 144.93530329"
51920250524,5,2025-05-24,19,469,1582,2051,PriNW_T,"-37.81874249, 144.96787656"
611320231223,61,2023-12-23,13,205,366,571,RMIT14_T,"-37.80767455, 144.96309114"
501520240705,50,2024-07-05,15,165,138,303,Lyg309_T,"-37.79808192, 144.96721013"
432320240429,43,2024-04-29,23,21,21,42,UM2_T,"-37.79844526, 144.96411782"
179520250803,179,2025-08-03,5,5,3,8,Pow61_T,"-37.82392385, 144.96299677"
162920250123,162,2025-01-23,9,290,221,511,Eli489_T,"-37.80740397, 144.95987909"
131520240913,131,2024-09-13,5,6,5,11,King2_T,"-37.82009057, 144.95758725"
1231720240621,123,2024-06-21,17,10,1,11,BirBridge_T,"-37.81753741, 144.97329734"
661920250330,66,2025-03-30,19,1147,1004,2151,QVN_T,"-37.81057846, 144.96444294"
691420240329,69,2024-03-29,14,201,115,316,FLDegC_T,"-37.81687226, 144.96559144"
31920240512,3,2024-05-12,19,875,921,1796,Swa295_T,"-37.81101524, 144.96429485"
3220240812,3,2024-08-12,2,55,22,77,Swa295_T,"-37.81101524, 144.96429485"
81820240405,8,2024-04-05,18,192,219,411,WebBN_T,"-37.82293543, 144.9471751"
751820241107,75,2024-11-07,18,71,45,116,SprFli_T,"-37.81515276, 144.97467661"
411220250919,41,2025-09-19,12,1539,1572,3111,Swa31,"-37.81668634, 144.96689733"
771320240204,77,2024-02-04,13,66,41,107,HarEsP_T,"-37.81441438, 144.94433026"
591620240630,59,2024-06-30,16,594,539,1133,RMIT_T,"-37.80825648, 144.96304859"
711020240212,71,2024-02-12,10,34,37,71,WestWP_T,"-37.81235775, 144.97136962"
71120240926,71,2024-09-26,1,1,0,1,WestWP_T,"-37.81235775, 144.97136962"
772020250226,77,2025-02-26,20,207,166,373,HarEsP_T,"-37.81441438, 144.94433026"
28920250327,28,2025-03-27,9,639,219,858,VAC_T,"-37.82129925, 144.96879309"
292020250817,29,2025-08-17,20,21,62,83,AG_T,"-37.8199817, 144.96872865"
141620250410,14,2025-04-10,16,708,175,883,SanBri_T,"-37.82011242, 144.96291897"
40920250425,40,2025-04-25,9,31,60,91,Spr201_T,"-37.80999341, 144.97227587"
311220241229,31,2024-12-29,12,176,158,334,Lyg161_T,"-37.80169681, 144.96658911"
542120240712,54,2024-07-12,21,101,125,226,Swa607_T,"-37.804024, 144.96308399"
361220240803,36,2024-08-03,12,148,168,316,Que85_T,"-37.81652527, 144.96121062"
372320231216,37,2023-12-16,23,144,187,331,Lyg260_T,"-37.80107122, 144.96704554"
5120231021,5,2023-10-21,1,163,165,328,PriNW_T,"-37.81874249, 144.96787656"
211820231228,21,2023-12-28,18,542,592,1134,Bourke155_T,"-37.81267313, 144.96788288"
21220250201,21,2025-02-01,2,62,76,138,Bourke155_T,"-37.81267313, 144.96788288"
211420251008,21,2025-10-08,14,277,317,594,Bourke155_T,"-37.81267313, 144.96788288"
21220240527,21,2024-05-27,2,14,23,37,Bourke155_T,"-37.81267313, 144.96788288"
611320240821,61,2024-08-21,13,578,518,1096,RMIT14_T,"-37.80767455, 144.96309114"
502220240323,50,2024-03-23,22,278,120,398,Lyg309_T,"-37.79808192, 144.96721013"
50520240713,50,2024-07-13,5,6,0,6,Lyg309_T,"-37.79808192, 144.96721013"
431120250502,43,2025-05-02,11,210,218,428,UM2_T,"-37.79844526, 144.96411782"
1311920240603,131,2024-06-03,19,22,49,71,King2_T,"-37.82009057, 144.95758725"
1311920240707,131,2024-07-07,19,89,76,165,King2_T,"-37.82009057, 144.95758725"
162020250601,162,2025-06-01,0,82,83,165,Eli489_T,"-37.80740397, 144.95987909"
167420241210,167,2024-12-10,4,0,2,2,Lat526_T,"-37.81304149, 144.95155955"
131720250412,131,2025-04-12,7,31,24,55,King2_T,"-37.82009057, 144.95758725"
132220240726,132,2024-07-26,2,7,6,13,King335_T,"-37.81267639, 144.95386444"
1322320240128,132,2024-01-28,23,47,16,63,King335_T,"-37.81267639, 144.95386444"
1342020240526,134,2024-05-26,20,174,186,360,Spen201_T,"-37.81694221, 144.95303935"
1352220240611,135,2024-06-11,22,22,30,52,Spen161_T,"-37.8172861, 144.95319102"
118620241118,118,2024-11-18,6,2,1,3,Fli114C_T,"-37.81632783, 144.97090512"
17720250310,17,2025-03-10,7,33,25,58,Col15_T,"-37.81362543, 144.97323591"
1420240713,1,2024-07-13,4,8,24,32,Bou292_T,"-37.81349441, 144.96515323"
672020240210,67,2024-02-10,20,334,294,628,FLDegS_T,"-37.81688755, 144.96562569"
181820240227,18,2024-02-27,18,425,61,486,Col12_T,"-37.81344862, 144.97305353"
621820240918,62,2024-09-18,18,268,178,446,Lat224_T,"-37.80996494, 144.96216521"
122020241003,12,2024-10-03,20,288,243,531,NewQ_T,"-37.81457988, 144.94292398"
72620240912,72,2024-09-12,6,70,56,126,ACMI_T,"-37.81726338, 144.96872809"
762320250607,76,2025-06-07,23,1,0,1,KenMac_T,"-37.79453803, 144.93036194"
761220241120,76,2024-11-20,12,53,55,108,KenMac_T,"-37.79453803, 144.93036194"
51220240607,51,2024-06-07,2,3,5,8,Fra118_T,"-37.80841815, 144.95906316"
51220241021,51,2024-10-21,2,2,3,5,Fra118_T,"-37.80841815, 144.95906316"
1351820251013,135,2025-10-13,18,421,515,936,Spen161_T,"-37.8172861, 144.95319102"
1072120241213,107,2024-12-13,21,120,109,229,280Will_T,"-37.81246271, 144.95690188"
107320251007,107,2025-10-07,3,1,4,5,280Will_T,"-37.81246271, 144.95690188"
17420240717,17,2024-07-17,4,5,5,10,Col15_T,"-37.81362543, 144.97323591"
171820250414,17,2025-04-14,18,155,265,420,Col15_T,"-37.81362543, 144.97323591"
181920250810,18,2025-08-10,19,11,14,25,Col12_T,"-37.81344862, 144.97305353"
632320231109,63,2023-11-09,23,79,124,203,Bou231_T,"-37.81333081, 144.96675571"
56420240730,56,2024-07-30,4,6,4,10,Lon364_T,"-37.81234775, 144.96153311"
111820240722,11,2024-07-22,18,66,77,143,WatCit_T,"-37.81564989, 144.93970694"
24720241008,24,2024-10-08,7,1053,213,1266,Col620_T,"-37.81887963, 144.95449198"
72220250728,72,2025-07-28,2,2,2,4,ACMI_T,"-37.81726338, 144.96872809"
721120231122,72,2023-11-22,11,261,253,514,ACMI_T,"-37.81726338, 144.96872809"
2220240304,2,2024-03-04,2,5,16,21,Bou283_T,"-37.81380668, 144.96516718"
9520250706,9,2025-07-06,5,4,9,13,Col700_T,"-37.81982992, 144.95102555"
91620240104,9,2024-01-04,16,657,118,775,Col700_T,"-37.81982992, 144.95102555"
9820240628,9,2024-06-28,8,221,1748,1969,Col700_T,"-37.81982992, 144.95102555"
301020240102,30,2024-01-02,10,96,185,281,Lon189_T,"-37.8112185, 144.96656806"
531420250608,53,2025-06-08,14,763,461,1224,Col254_T,"-37.81564191, 144.965499"
532020240821,53,2024-08-21,20,146,151,297,Col254_T,"-37.81564191, 144.965499"
23720250213,23,2025-02-13,7,186,138,324,Col623_T,"-37.81909256, 144.95452748"
511120240430,51,2024-04-30,11,91,82,173,Fra118_T,"-37.80841815, 144.95906316"
791320250708,79,2025-07-08,13,474,400,874,FliSS_T,"-37.81794046, 144.96616678"
30220241231,30,2024-12-31,2,15,32,47,Lon189_T,"-37.8112185, 144.96656806"
521720231229,52,2023-12-29,17,303,358,661,Eli263_T,"-37.81252157, 144.9619401"
192020240817,19,2024-08-17,20,620,860,1480,LtB210_T,"-37.81237202, 144.96550671"
191920250404,19,2025-04-04,19,915,700,1615,LtB210_T,"-37.81237202, 144.96550671"
191920250508,19,2025-05-08,19,600,586,1186,LtB210_T,"-37.81237202, 144.96550671"
191220251009,19,2025-10-09,12,471,378,849,LtB210_T,"-37.81237202, 144.96550671"
1391620250526,139,2025-05-26,16,113,40,153,Signal1647_T,"-37.81959923, 144.9632832"
136020240426,136,2024-04-26,0,2,0,2,BirFed1120_T,"-37.8184141, 144.97357915"
1422220240808,142,2024-08-08,22,39,30,69,Hammer1584_T,"-37.81970749, 144.96795734"
1301720250513,130,2025-05-13,17,63,61,124,Bou892T,"-37.8204637, 144.94126826"
1092320250819,109,2025-08-19,23,22,40,62,LatWill_T,"-37.81193681, 144.95621105"
117520240215,117,2024-02-15,5,10,14,24,Fli114F_T,"-37.81629332, 144.97090877"
66320250704,66,2025-07-04,3,15,3,18,QVN_T,"-37.81057846, 144.96444294"
66020240929,66,2024-09-29,0,164,158,322,QVN_T,"-37.81057846, 144.96444294"
61020240621,6,2024-06-21,10,490,406,896,FliS_T,"-37.81911705, 144.96558255"
841620241124,84,2024-11-24,16,953,1355,2308,ElFi_T,"-37.81798049, 144.96503383"
4520240829,4,2024-08-29,5,32,13,45,Swa123_T,"-37.81487988, 144.9660878"
59220250726,59,2025-07-26,2,85,24,109,RMIT_T,"-37.80825648, 144.96304859"
591020241019,59,2024-10-19,10,92,90,182,RMIT_T,"-37.80825648, 144.96304859"
422120250827,42,2025-08-27,21,35,68,103,UM1_T,"-37.80008566, 144.96386412"
291320250730,29,2025-07-30,13,7,6,13,AG_T,"-37.8199817, 144.96872865"
292020231111,29,2023-11-11,20,194,184,378,AG_T,"-37.8199817, 144.96872865"
31720250120,31,2025-01-20,7,18,25,43,Lyg161_T,"-37.80169681, 144.96658911"
311020231119,31,2023-11-19,10,95,74,169,Lyg161_T,"-37.80169681, 144.96658911"
511320250906,51,2025-09-06,13,150,138,288,Fra118_T,"-37.80841815, 144.95906316"
46420240324,46,2024-03-24,4,0,1,1,Pel147_T,"-37.80240719, 144.9615673"
51320250417,51,2025-04-17,3,8,4,12,Fra118_T,"-37.80841815, 144.95906316"
1381520240429,138,2024-04-29,15,9,2,11,EntPark1671_T,"-37.81996544, 144.95981454"
117720240410,117,2024-04-10,7,127,65,192,Fli114F_T,"-37.81629332, 144.97090877"
123920240620,123,2024-06-20,9,7,0,7,BirBridge_T,"-37.81753741, 144.97329734"
164020250616,164,2025-06-16,0,3,7,10,Lat526_T,"-37.813005, 144.95160411"
1801320251001,180,2025-10-01,13,31,25,56,Mac330_T,"-37.79497059, 144.93530329"
1371620251010,137,2025-10-10,16,20,178,198,BouHbr2353_T,"-37.81894815, 144.94612292"
137820231230,137,2023-12-30,8,2,9,11,BouHbr2353_T,"-37.81894815, 144.94612292"
1422020250202,142,2025-02-02,20,174,174,348,Hammer1584_T,"-37.81970749, 144.96795734"
61520240910,6,2024-09-10,15,1038,660,1698,FliS_T,"-37.81911705, 144.96558255"
6220250826,6,2025-08-26,2,8,7,15,FliS_T,"-37.81911705, 144.96558255"
4520241209,4,2024-12-09,5,50,32,82,Swa123_T,"-37.81487988, 144.9660878"
392120231116,39,2023-11-16,21,39,66,105,AlfPl_T,"-37.81379749, 144.96995745"
751420240411,75,2024-04-11,14,53,57,110,SprFli_T,"-37.81515276, 144.97467661"
411820240218,41,2024-02-18,18,1167,1293,2460,Swa31,"-37.81668634, 144.96689733"
411320240612,41,2024-06-12,13,1326,1186,2512,Swa31,"-37.81668634, 144.96689733"
771620250110,77,2025-01-10,16,148,89,237,HarEsP_T,"-37.81441438, 144.94433026"
542220231231,54,2023-12-31,22,48,54,102,Swa607_T,"-37.804024, 144.96308399"
29020250401,29,2025-04-01,0,6,8,14,AG_T,"-37.8199817, 144.96872865"
311520250322,31,2025-03-22,15,244,261,505,Lyg161_T,"-37.80169681, 144.96658911"
541120250219,54,2025-02-19,11,20,37,57,Swa607_T,"-37.804024, 144.96308399"
542020250320,54,2025-03-20,20,130,168,298,Swa607_T,"-37.804024, 144.96308399"
541220240827,54,2024-08-27,12,425,455,880,Swa607_T,"-37.804024, 144.96308399"
471320250905,47,2025-09-05,13,980,1019,1999,Eli250_T,"-37.81258467, 144.9625775"
21220241009,21,2024-10-09,2,8,3,11,Bourke155_T,"-37.81267313, 144.96788288"
21020241024,21,2024-10-24,0,41,68,109,Bourke155_T,"-37.81267313, 144.96788288"
871720240528,87,2024-05-28,17,141,66,207,Errol23_T,"-37.80454949, 144.94921863"
50520240622,50,2024-06-22,5,4,0,4,Lyg309_T,"-37.79808192, 144.96721013"
431120240109,43,2024-01-09,11,66,51,117,UM2_T,"-37.79844526, 144.96411782"
452320250609,45,2025-06-09,23,30,66,96,Swa148_T,"-37.81414075, 144.96609379"
181620250725,181,2025-07-25,6,89,108,197,Eli368_T,"-37.81009465, 144.96143149"
131320241122,131,2024-11-22,3,13,17,30,King2_T,"-37.82009057, 144.95758725"
1402020251016,140,2025-10-16,20,2,0,2,Boyd2837_T,"-37.82590962, 144.96185972"
1321620240307,132,2024-03-07,16,160,147,307,King335_T,"-37.81267639, 144.95386444"
1321520231030,132,2023-10-30,15,119,103,222,King335_T,"-37.81267639, 144.95386444"
1071320250807,107,2025-08-07,13,259,259,518,280Will_T,"-37.81246271, 144.95690188"
85120250321,85,2025-03-21,1,1,1,2,488Mac_T,"-37.79432415, 144.92973378"
851220251006,85,2025-10-06,12,99,92,191,488Mac_T,"-37.79432415, 144.92973378"
171220250511,17,2025-05-11,12,248,148,396,Col15_T,"-37.81362543, 144.97323591"
11220240130,1,2024-01-30,12,1194,1185,2379,Bou292_T,"-37.81349441, 144.96515323"
11620240313,1,2024-03-13,16,1232,1062,2294,Bou292_T,"-37.81349441, 144.96515323"
311620240329,31,2024-03-29,16,184,183,367,Lyg161_T,"-37.80169681, 144.96658911"
361220240906,36,2024-09-06,12,342,263,605,Que85_T,"-37.81652527, 144.96121062"
1082320240819,108,2024-08-19,23,11,33,44,261Will_T,"-37.81295822, 144.95678789"
61920240802,61,2024-08-02,9,460,356,816,RMIT14_T,"-37.80767455, 144.96309114"
43620231207,43,2023-12-07,6,34,7,41,UM2_T,"-37.79844526, 144.96411782"
43320231213,43,2023-12-13,3,0,3,3,UM2_T,"-37.79844526, 144.96411782"
165820250218,165,2025-02-18,8,18,68,86,Spen475_T,"-37.80953359, 144.94939004"
165420251012,165,2025-10-12,4,4,0,4,Spen475_T,"-37.80953359, 144.94939004"
1661720250617,166,2025-06-17,17,71,73,144,Spen484_T,"-37.80896733, 144.94931703"
167420250129,167,2025-01-29,4,0,3,3,Lat526_T,"-37.81304149, 144.95155955"
1322220250617,132,2025-06-17,22,47,57,104,King335_T,"-37.81267639, 144.95386444"
1341120240117,134,2024-01-17,11,216,342,558,Spen201_T,"-37.81694221, 144.95303935"
107020240815,107,2024-08-15,0,19,7,26,280Will_T,"-37.81246271, 144.95690188"
133620231021,133,2023-10-21,6,116,199,315,Spen229_T,"-37.81531435, 144.95227769"
1241220250920,124,2025-09-20,12,3,7,10,BirBridge_T,"-37.81757416, 144.97329934"
672320231110,67,2023-11-10,23,137,158,295,FLDegS_T,"-37.81688755, 144.96562569"
671120250910,67,2025-09-10,11,373,416,789,FLDegS_T,"-37.81688755, 144.96562569"
12120240622,1,2024-06-22,21,252,271,523,Bou292_T,"-37.81349441, 144.96515323"
11020250226,1,2025-02-26,10,520,542,1062,Bou292_T,"-37.81349441, 144.96515323"
562120241119,56,2024-11-19,21,179,263,442,Lon364_T,"-37.81234775, 144.96153311"
562320250316,56,2025-03-16,23,53,99,152,Lon364_T,"-37.81234775, 144.96153311"
562120250318,56,2025-03-18,21,215,260,475,Lon364_T,"-37.81234775, 144.96153311"
122220241215,12,2024-12-15,22,153,135,288,NewQ_T,"-37.81457988, 144.94292398"
722220240427,72,2024-04-27,22,189,335,524,ACMI_T,"-37.81726338, 144.96872809"
351120241224,35,2024-12-24,11,929,935,1864,SouthB_T,"-37.82018685, 144.96508508"
21120231212,2,2023-12-12,11,739,803,1542,Bou283_T,"-37.81380668, 144.96516718"
53820231208,53,2023-12-08,8,260,240,500,Col254_T,"-37.81564191, 144.965499"
9020240222,9,2024-02-22,0,5,4,9,Col700_T,"-37.81982992, 144.95102555"
792020250117,79,2025-01-17,20,331,502,833,FliSS_T,"-37.81794046, 144.96616678"
79420240721,79,2024-07-21,4,58,45,103,FliSS_T,"-37.81794046, 144.96616678"
52720240831,52,2024-08-31,7,18,11,29,Eli263_T,"-37.81252157, 144.9619401"
521620241007,52,2024-10-07,16,343,292,635,Eli263_T,"-37.81252157, 144.9619401"
491420241202,49,2024-12-02,14,198,162,360,Eli501_T,"-37.80730068, 144.95956055"
19020250529,19,2025-05-29,0,21,59,80,LtB210_T,"-37.81237202, 144.96550671"
481020240809,48,2024-08-09,10,232,162,394,QVMQ_T,"-37.80631581, 144.95866697"
482320241207,48,2024-12-07,23,1,0,1,QVMQ_T,"-37.80631581, 144.95866697"
251720250203,25,2025-02-03,17,607,489,1096,MCEC_T,"-37.82401776, 144.95604426"
1411620241016,141,2024-10-16,16,151,158,309,474Fl_T,"-37.81997273, 144.95834911"
139420240229,139,2024-02-29,4,1,0,1,Signal1647_T,"-37.81959923, 144.9632832"
180820250527,180,2025-05-27,8,116,36,152,Mac330_T,"-37.79497059, 144.93530329"
66820240917,66,2024-09-17,8,237,559,796,QVN_T,"-37.81057846, 144.96444294"
4720250218,4,2025-02-18,7,339,212,551,Swa123_T,"-37.81487988, 144.9660878"
70320250718,70,2025-07-18,3,1,1,2,Errol20_T,"-37.80456984, 144.94946228"
392120240818,39,2024-08-18,21,17,23,40,AlfPl_T,"-37.81379749, 144.96995745"
392220241029,39,2024-10-29,22,1,1,2,AlfPl_T,"-37.81379749, 144.96995745"
411020250711,41,2025-07-11,10,1275,734,2009,Swa31,"-37.81668634, 144.96689733"
41220240529,41,2024-05-29,2,35,25,60,Swa31,"-37.81668634, 144.96689733"
111520241208,11,2024-12-08,15,154,141,295,WatCit_T,"-37.81564989, 144.93970694"
72620250507,72,2025-05-07,6,73,47,120,ACMI_T,"-37.81726338, 144.96872809"
761620240820,76,2024-08-20,16,47,57,104,KenMac_T,"-37.79453803, 144.93036194"
351920240124,35,2024-01-24,19,1321,1427,2748,SouthB_T,"-37.82018685, 144.96508508"
27920241004,27,2024-10-04,9,74,91,165,Vic_T,"-37.80606888, 144.95644692"
2020231018,2,2023-10-18,0,9,14,23,Bou283_T,"-37.81380668, 144.96516718"
271620250715,27,2025-07-15,16,117,91,208,Vic_T,"-37.80606888, 144.95644692"
30220240610,30,2024-06-10,2,92,119,211,Lon189_T,"-37.8112185, 144.96656806"
301620240626,30,2024-06-26,16,244,424,668,Lon189_T,"-37.8112185, 144.96656806"
79020250227,79,2025-02-27,0,54,109,163,FliSS_T,"-37.81794046, 144.96616678"
231420241106,23,2024-11-06,14,215,258,473,Col623_T,"-37.81909256, 144.95452748"
48020240715,48,2024-07-15,0,12,10,22,QVMQ_T,"-37.80631581, 144.95866697"
25120250828,25,2025-08-28,1,20,13,33,MCEC_T,"-37.82401776, 144.95604426"
20420240827,20,2024-08-27,4,0,5,5,LtB170_T,"-37.81172914, 144.9682466"
522320250802,52,2025-08-02,23,248,303,551,Eli263_T,"-37.81252157, 144.9619401"
1231120240219,123,2024-02-19,11,17,7,24,BirBridge_T,"-37.81753741, 144.97329734"
123820241231,123,2024-12-31,8,25,23,48,BirBridge_T,"-37.81753741, 144.97329734"
1301420240321,130,2024-03-21,14,21,27,48,Bou892T,"-37.8204637, 144.94126826"
1301920241009,130,2024-10-09,19,56,40,96,Bou892T,"-37.8204637, 144.94126826"
141320250117,141,2025-01-17,3,7,42,49,474Fl_T,"-37.81997273, 144.95834911"
49420241127,49,2024-11-27,4,16,13,29,Eli501_T,"-37.80730068, 144.95956055"
1092020250321,109,2025-03-21,20,108,150,258,LatWill_T,"-37.81193681, 144.95621105"
49220240815,49,2024-08-15,2,25,19,44,Eli501_T,"-37.80730068, 144.95956055"
191320251013,19,2025-10-13,13,373,447,820,LtB210_T,"-37.81237202, 144.96550671"
191120231224,19,2023-12-24,11,459,249,708,LtB210_T,"-37.81237202, 144.96550671"
1801320250828,180,2025-08-28,13,24,19,43,Mac330_T,"-37.79497059, 144.93530329"
142620240704,142,2024-07-04,6,33,1,34,Hammer1584_T,"-37.81970749, 144.96795734"
701020240619,70,2024-06-19,10,79,91,170,Errol20_T,"-37.80456984, 144.94946228"
70120251009,70,2025-10-09,1,2,5,7,Errol20_T,"-37.80456984, 144.94946228"
31020240507,3,2024-05-07,10,404,484,888,Swa295_T,"-37.81101524, 144.96429485"
39920231208,39,2023-12-08,9,162,133,295,AlfPl_T,"-37.81379749, 144.96995745"
392020250101,39,2025-01-01,20,22,11,33,AlfPl_T,"-37.81379749, 144.96995745"
39920250831,39,2025-08-31,9,54,41,95,AlfPl_T,"-37.81379749, 144.96995745"
71820250917,71,2025-09-17,8,43,34,77,WestWP_T,"-37.81235775, 144.97136962"
71120250118,71,2025-01-18,1,6,4,10,WestWP_T,"-37.81235775, 144.97136962"
59820231113,59,2023-11-13,8,307,156,463,RMIT_T,"-37.80825648, 144.96304859"
771620250612,77,2025-06-12,16,231,127,358,HarEsP_T,"-37.81441438, 144.94433026"
421620250124,42,2025-01-24,16,88,137,225,UM1_T,"-37.80008566, 144.96386412"
28120240809,28,2024-08-09,1,10,2,12,VAC_T,"-37.82129925, 144.96879309"
282120231116,28,2023-11-16,21,150,378,528,VAC_T,"-37.82129925, 144.96879309"
291620241101,29,2024-11-01,16,200,315,515,AG_T,"-37.8199817, 144.96872865"
14620240922,14,2024-09-22,6,33,27,60,SanBri_T,"-37.82011242, 144.96291897"
541120250116,54,2025-01-16,11,44,78,122,Swa607_T,"-37.804024, 144.96308399"
371320240127,37,2024-01-27,13,146,128,274,Lyg260_T,"-37.80107122, 144.96704554"
471920250417,47,2025-04-17,19,926,941,1867,Eli250_T,"-37.81258467, 144.9625775"
36420241004,36,2024-10-04,4,6,4,10,Que85_T,"-37.81652527, 144.96121062"
1081520250616,108,2025-06-16,15,483,173,656,261Will_T,"-37.81295822, 144.95678789"
41820250819,41,2025-08-19,8,1968,420,2388,Swa31,"-37.81668634, 144.96689733"
781720240406,78,2024-04-06,17,42,71,113,HarEsB_T,"-37.81471642, 144.9446508"
14920250129,14,2025-01-29,9,158,238,396,SanBri_T,"-37.82011242, 144.96291897"
712020240121,71,2024-01-21,20,8,6,14,WestWP_T,"-37.81235775, 144.97136962"
401720250212,40,2025-02-12,17,179,338,517,Spr201_T,"-37.80999341, 144.97227587"
542120250802,54,2025-08-02,21,119,126,245,Swa607_T,"-37.804024, 144.96308399"
311920240512,31,2024-05-12,19,387,342,729,Lyg161_T,"-37.80169681, 144.96658911"
361920250318,36,2025-03-18,19,144,144,288,Que85_T,"-37.81652527, 144.96121062"
372220250712,37,2025-07-12,22,101,205,306,Lyg260_T,"-37.80107122, 144.96704554"
212320231129,21,2023-11-29,23,160,139,299,Bourke155_T,"-37.81267313, 144.96788288"
611920250804,61,2025-08-04,19,404,354,758,RMIT14_T,"-37.80767455, 144.96309114"
1822020250911,182,2025-09-11,20,209,204,413,King163_T,"-37.81627451, 144.95550503"
166120250729,166,2025-07-29,1,1,1,2,Spen484_T,"-37.80896733, 144.94931703"
1402020240123,140,2024-01-23,20,58,93,151,Boyd2837_T,"-37.82590962, 144.96185972"
131620240214,131,2024-02-14,6,26,14,40,King2_T,"-37.82009057, 144.95758725"
1312220240515,131,2024-05-15,22,72,26,98,King2_T,"-37.82009057, 144.95758725"
132020240309,132,2024-03-09,0,47,42,89,King335_T,"-37.81267639, 144.95386444"
1322220240108,132,2024-01-08,22,63,56,119,King335_T,"-37.81267639, 144.95386444"
135320240530,135,2024-05-30,3,9,7,16,Spen161_T,"-37.8172861, 144.95319102"
107820250718,107,2025-07-18,8,73,199,272,280Will_T,"-37.81246271, 144.95690188"
67020250304,67,2025-03-04,0,8,8,16,FLDegS_T,"-37.81688755, 144.96562569"
11520240214,1,2024-02-14,15,1260,1377,2637,Bou292_T,"-37.81349441, 144.96515323"
11220240220,1,2024-02-20,12,1487,1197,2684,Bou292_T,"-37.81349441, 144.96515323"
11320241023,1,2024-10-23,13,1278,1177,2455,Bou292_T,"-37.81349441, 144.96515323"
621820251009,62,2025-10-09,18,331,377,708,Lat224_T,"-37.80996494, 144.96216521"
671720240406,67,2024-04-06,17,390,629,1019,FLDegS_T,"-37.81688755, 144.96562569"
62020240324,62,2024-03-24,0,108,73,181,Lat224_T,"-37.80996494, 144.96216521"
562120250408,56,2025-04-08,21,176,247,423,Lon364_T,"-37.81234775, 144.96153311"
122020250610,12,2025-06-10,20,60,36,96,NewQ_T,"-37.81457988, 144.94292398"
122020250904,12,2025-09-04,20,43,25,68,NewQ_T,"-37.81457988, 144.94292398"
111920240821,11,2024-08-21,19,26,23,49,WatCit_T,"-37.81564989, 144.93970694"
72720240228,72,2024-02-28,7,226,58,284,ACMI_T,"-37.81726338, 144.96872809"
22020231228,2,2023-12-28,20,530,452,982,Bou283_T,"-37.81380668, 144.96516718"
232220250204,23,2025-02-04,22,34,86,120,Col623_T,"-37.81909256, 144.95452748"
231520250616,23,2025-06-16,15,149,342,491,Col623_T,"-37.81909256, 144.95452748"
51320250831,51,2025-08-31,3,12,7,19,Fra118_T,"-37.80841815, 144.95906316"
48820240522,48,2024-05-22,8,137,77,214,QVMQ_T,"-37.80631581, 144.95866697"
48020231018,48,2023-10-18,0,10,22,32,QVMQ_T,"-37.80631581, 144.95866697"
141020250303,141,2025-03-03,0,13,41,54,474Fl_T,"-37.81997273, 144.95834911"
1391820240622,139,2024-06-22,18,12,21,33,Signal1647_T,"-37.81959923, 144.9632832"
142020241026,142,2024-10-26,0,4,2,6,Hammer1584_T,"-37.81970749, 144.96795734"
161720250713,161,2025-07-13,7,417,172,589,BirArt1109_T,"-37.81851276, 144.97131336"
1171420240826,117,2024-08-26,14,119,125,244,Fli114F_T,"-37.81629332, 144.97090877"
1092020250424,109,2025-04-24,20,103,137,240,LatWill_T,"-37.81193681, 144.95621105"
1091620241108,109,2024-11-08,16,297,145,442,LatWill_T,"-37.81193681, 144.95621105"
691720240728,69,2024-07-28,17,89,76,165,FLDegC_T,"-37.81687226, 144.96559144"
84920241227,84,2024-12-27,9,705,661,1366,ElFi_T,"-37.81798049, 144.96503383"
39520241006,39,2024-10-06,5,1,0,1,AlfPl_T,"-37.81379749, 144.96995745"
41720250528,41,2025-05-28,7,108,95,203,Swa31,"-37.81668634, 144.96689733"
772320250924,77,2025-09-24,23,34,22,56,HarEsP_T,"-37.81441438, 144.94433026"
14420240628,14,2024-06-28,4,19,0,19,SanBri_T,"-37.82011242, 144.96291897"
71520240516,71,2024-05-16,5,12,5,17,WestWP_T,"-37.81235775, 144.97136962"
711320241124,71,2024-11-24,13,4,4,8,WestWP_T,"-37.81235775, 144.97136962"
40120250313,40,2025-03-13,1,13,3,16,Spr201_T,"-37.80999341, 144.97227587"
402320231105,40,2023-11-05,23,44,1,45,Spr201_T,"-37.80999341, 144.97227587"
541820241012,54,2024-10-12,18,133,165,298,Swa607_T,"-37.804024, 144.96308399"
47820240927,47,2024-09-27,8,129,231,360,Eli250_T,"-37.81258467, 144.9625775"
451220250812,45,2025-08-12,12,528,892,1420,Swa148_T,"-37.81414075, 144.96609379"
451320250515,45,2025-05-15,13,737,899,1636,Swa148_T,"-37.81414075, 144.96609379"
51220250204,5,2025-02-04,12,661,627,1288,PriNW_T,"-37.81874249, 144.96787656"
51120240621,5,2024-06-21,11,479,689,1168,PriNW_T,"-37.81874249, 144.96787656"
611320250116,61,2025-01-16,13,478,411,889,RMIT14_T,"-37.80767455, 144.96309114"
61020240730,61,2024-07-30,0,34,12,46,RMIT14_T,"-37.80767455, 144.96309114"
61320240724,61,2024-07-24,3,23,8,31,RMIT14_T,"-37.80767455, 144.96309114"
501820240613,50,2024-06-13,18,160,232,392,Lyg309_T,"-37.79808192, 144.96721013"
162820241101,162,2024-11-01,8,255,208,463,Eli489_T,"-37.80740397, 144.95987909"
1312220250817,131,2025-08-17,22,55,67,122,King2_T,"-37.82009057, 144.95758725"
1351620250912,135,2025-09-12,16,461,477,938,Spen161_T,"-37.8172861, 144.95319102"
1071320250621,107,2025-06-21,13,91,167,258,280Will_T,"-37.81246271, 144.95690188"
1181420250129,118,2025-01-29,14,13,25,38,Fli114C_T,"-37.81632783, 144.97090512"
1241520250914,124,2025-09-14,15,3,8,11,BirBridge_T,"-37.81757416, 144.97329934"
671720250501,67,2025-05-01,17,396,577,973,FLDegS_T,"-37.81688755, 144.96562569"
11520250310,1,2025-03-10,15,1307,1157,2464,Bou292_T,"-37.81349441, 144.96515323"
11620250516,1,2025-05-16,16,1293,1160,2453,Bou292_T,"-37.81349441, 144.96515323"
671520241108,67,2024-11-08,15,341,601,942,FLDegS_T,"-37.81688755, 144.96562569"
181020240508,18,2024-05-08,10,187,259,446,Col12_T,"-37.81344862, 144.97305353"
67820240618,67,2024-06-18,8,400,294,694,FLDegS_T,"-37.81688755, 144.96562569"
56420240820,56,2024-08-20,4,5,4,9,Lon364_T,"-37.81234775, 144.96153311"
121420240705,12,2024-07-05,14,136,151,287,NewQ_T,"-37.81457988, 144.94292398"
12920240607,12,2024-06-07,9,94,71,165,NewQ_T,"-37.81457988, 144.94292398"
86220240723,86,2024-07-23,2,0,2,2,574Qub_T,"-37.80309992, 144.94908064"
10720240518,10,2024-05-18,7,15,10,25,BouHbr_T,"-37.81876474, 144.94710545"
72520250427,72,2025-04-27,5,5,15,20,ACMI_T,"-37.81726338, 144.96872809"
722120240606,72,2024-06-06,21,84,129,213,ACMI_T,"-37.81726338, 144.96872809"
582320240703,58,2024-07-03,23,93,79,172,Bou688_T,"-37.81686075, 144.95358075"
582120240705,58,2024-07-05,21,325,327,652,Bou688_T,"-37.81686075, 144.95358075"
35220240805,35,2024-08-05,2,13,19,32,SouthB_T,"-37.82018685, 144.96508508"
271720240518,27,2024-05-18,17,161,109,270,Vic_T,"-37.80606888, 144.95644692"
21220241108,2,2024-11-08,12,565,646,1211,Bou283_T,"-37.81380668, 144.96516718"
21320231225,2,2023-12-25,13,119,261,380,Bou283_T,"-37.81380668, 144.96516718"
791520250303,79,2025-03-03,15,521,483,1004,FliSS_T,"-37.81794046, 144.96616678"
791220241106,79,2024-11-06,12,434,404,838,FliSS_T,"-37.81794046, 144.96616678"
1081920250102,108,2025-01-02,19,173,142,315,261Will_T,"-37.81295822, 144.95678789"
872220240113,87,2024-01-13,22,21,24,45,Errol23_T,"-37.80454949, 144.94921863"
611220250719,61,2025-07-19,12,227,356,583,RMIT14_T,"-37.80767455, 144.96309114"
50220240409,50,2024-04-09,2,4,0,4,Lyg309_T,"-37.79808192, 144.96721013"
167220250422,167,2025-04-22,2,1,2,3,Lat526_T,"-37.81304149, 144.95155955"
1851520250721,185,2025-07-21,15,652,617,1269,Eli197_T,"-37.81374643, 144.96276183"
1431520250719,143,2025-07-19,15,230,238,468,Spencer_T,"-37.821728, 144.95557015"
143320240506,143,2024-05-06,3,24,13,37,Spencer_T,"-37.821728, 144.95557015"
1341320250709,134,2025-07-09,13,432,484,916,Spen201_T,"-37.81694221, 144.95303935"
1071920250510,107,2025-05-10,19,129,134,263,280Will_T,"-37.81246271, 144.95690188"
1181720240111,118,2024-01-11,17,28,75,103,Fli114C_T,"-37.81632783, 144.97090512"
107520250110,107,2025-01-10,5,7,20,27,280Will_T,"-37.81246271, 144.95690188"
181720250529,18,2025-05-29,17,404,119,523,Col12_T,"-37.81344862, 144.97305353"
181420250919,18,2025-09-19,14,252,149,401,Col12_T,"-37.81344862, 144.97305353"
631020250921,63,2025-09-21,10,146,252,398,Bou231_T,"-37.81333081, 144.96675571"
101120231227,10,2023-12-27,11,43,40,83,BouHbr_T,"-37.81876474, 144.94710545"
101820250219,10,2025-02-19,18,86,62,148,BouHbr_T,"-37.81876474, 144.94710545"
581220250725,58,2025-07-25,12,766,371,1137,Bou688_T,"-37.81686075, 144.95358075"
761920241227,76,2024-12-27,19,35,37,72,KenMac_T,"-37.79453803, 144.93036194"
762320240930,76,2024-09-30,23,0,2,2,KenMac_T,"-37.79453803, 144.93036194"
76020231224,76,2023-12-24,0,0,1,1,KenMac_T,"-37.79453803, 144.93036194"
271920240204,27,2024-02-04,19,65,47,112,Vic_T,"-37.80606888, 144.95644692"
2720250706,2,2025-07-06,7,12,29,41,Bou283_T,"-37.81380668, 144.96516718"
2220231111,2,2023-11-11,2,20,55,75,Bou283_T,"-37.81380668, 144.96516718"
531920240128,53,2024-01-28,19,114,137,251,Col254_T,"-37.81564191, 144.965499"
791820240824,79,2024-08-24,18,649,639,1288,FliSS_T,"-37.81794046, 144.96616678"
511920241010,51,2024-10-10,19,104,82,186,Fra118_T,"-37.80841815, 144.95906316"
232320240411,23,2024-04-11,23,56,113,169,Col623_T,"-37.81909256, 144.95452748"
23320240724,23,2024-07-24,3,4,6,10,Col623_T,"-37.81909256, 144.95452748"
20720250211,20,2025-02-11,7,22,29,51,LtB170_T,"-37.81172914, 144.9682466"
117220250217,117,2025-02-17,2,4,2,6,Fli114F_T,"-37.81629332, 144.97090877"
49420241231,49,2024-12-31,4,18,15,33,Eli501_T,"-37.80730068, 144.95956055"
109420240201,109,2024-02-01,4,8,4,12,LatWill_T,"-37.81193681, 144.95621105"
191620250726,19,2025-07-26,16,676,457,1133,LtB210_T,"-37.81237202, 144.96550671"
164620240906,164,2024-09-06,6,11,32,43,Lat526_T,"-37.813005, 144.95160411"
1371820240628,137,2024-06-28,18,25,73,98,BouHbr2353_T,"-37.81894815, 144.94612292"
1391320240723,139,2024-07-23,13,51,99,150,Signal1647_T,"-37.81959923, 144.9632832"
1361820240513,136,2024-05-13,18,5,1,6,BirFed1120_T,"-37.8184141, 144.97357915"
1421220241208,142,2024-12-08,12,665,747,1412,Hammer1584_T,"-37.81970749, 144.96795734"
1421320250827,142,2025-08-27,13,368,317,685,Hammer1584_T,"-37.81970749, 144.96795734"
662020240116,66,2024-01-16,20,703,697,1400,QVN_T,"-37.81057846, 144.96444294"
661920240212,66,2024-02-12,19,842,764,1606,QVN_T,"-37.81057846, 144.96444294"
701520240619,70,2024-06-19,15,150,126,276,Errol20_T,"-37.80456984, 144.94946228"
32320250607,3,2025-06-07,23,456,513,969,Swa295_T,"-37.81101524, 144.96429485"
39520250613,39,2025-06-13,5,5,1,6,AlfPl_T,"-37.81379749, 144.96995745"
8920240816,8,2024-08-16,9,170,113,283,WebBN_T,"-37.82293543, 144.9471751"
8420240218,8,2024-02-18,4,2,0,2,WebBN_T,"-37.82293543, 144.9471751"
41620250418,41,2025-04-18,6,46,78,124,Swa31,"-37.81668634, 144.96689733"
41820250107,41,2025-01-07,8,1450,293,1743,Swa31,"-37.81668634, 144.96689733"
14220240816,14,2024-08-16,2,8,3,11,SanBri_T,"-37.82011242, 144.96291897"
481820240805,48,2024-08-05,18,120,164,284,QVMQ_T,"-37.80631581, 144.95866697"
20720240407,20,2024-04-07,7,16,10,26,LtB170_T,"-37.81172914, 144.9682466"
251120240623,25,2024-06-23,11,669,947,1616,MCEC_T,"-37.82401776, 144.95604426"
180120250407,180,2025-04-07,1,1,0,1,Mac330_T,"-37.79497059, 144.93530329"
1411120231204,141,2023-12-04,11,112,130,242,474Fl_T,"-37.81997273, 144.95834911"
139820240421,139,2024-04-21,8,17,16,33,Signal1647_T,"-37.81959923, 144.9632832"
1231320240928,123,2024-09-28,13,6,2,8,BirBridge_T,"-37.81753741, 144.97329734"
161720241031,161,2024-10-31,7,101,186,287,BirArt1109_T,"-37.81851276, 144.97131336"
1091020231228,109,2023-12-28,10,86,86,172,LatWill_T,"-37.81193681, 144.95621105"
691320250802,69,2025-08-02,13,357,299,656,FLDegC_T,"-37.81687226, 144.96559144"
62220250417,6,2025-04-17,22,674,527,1201,FliS_T,"-37.81911705, 144.96558255"
82320240120,8,2024-01-20,23,38,36,74,WebBN_T,"-37.82293543, 144.9471751"
751220240510,75,2024-05-10,12,61,40,101,SprFli_T,"-37.81515276, 144.97467661"
412320240414,41,2024-04-14,23,275,283,558,Swa31,"-37.81668634, 144.96689733"
81720241110,8,2024-11-10,17,278,139,417,WebBN_T,"-37.82293543, 144.9471751"
781920250902,78,2025-09-02,19,10,15,25,HarEsB_T,"-37.81471642, 144.9446508"
591420240112,59,2024-01-12,14,325,376,701,RMIT_T,"-37.80825648, 144.96304859"
771820240330,77,2024-03-30,18,340,170,510,HarEsP_T,"-37.81441438, 144.94433026"
29420250531,29,2025-05-31,4,6,16,22,AG_T,"-37.8199817, 144.96872865"
31520240512,31,2024-05-12,5,1,3,4,Lyg161_T,"-37.80169681, 144.96658911"
362320240909,36,2024-09-09,23,27,24,51,Que85_T,"-37.81652527, 144.96121062"
37820241211,37,2024-12-11,8,22,61,83,Lyg260_T,"-37.80107122, 144.96704554"
872020240816,87,2024-08-16,20,63,58,121,Errol23_T,"-37.80454949, 144.94921863"
5320251017,5,2025-10-17,3,24,15,39,PriNW_T,"-37.81874249, 144.96787656"
5320240802,5,2024-08-02,3,12,7,19,PriNW_T,"-37.81874249, 144.96787656"
1672320241003,167,2024-10-03,23,4,13,17,Lat526_T,"-37.81304149, 144.95155955"
1621920250325,162,2025-03-25,19,311,250,561,Eli489_T,"-37.80740397, 144.95987909"
1311920250306,131,2025-03-06,19,77,97,174,King2_T,"-37.82009057, 144.95758725"
131520240521,131,2024-05-21,5,5,7,12,King2_T,"-37.82009057, 144.95758725"
1311120240719,131,2024-07-19,11,110,141,251,King2_T,"-37.82009057, 144.95758725"
1181720250517,118,2025-05-17,17,31,14,45,Fli114C_T,"-37.81632783, 144.97090512"
1181520231226,118,2023-12-26,15,56,2,58,Fli114C_T,"-37.81632783, 144.97090512"
118620240618,118,2024-06-18,6,2,0,2,Fli114C_T,"-37.81632783, 144.97090512"
851420240524,85,2024-05-24,14,51,77,128,488Mac_T,"-37.79432415, 144.92973378"
11620240208,1,2024-02-08,16,1066,1000,2066,Bou292_T,"-37.81349441, 144.96515323"
671620240715,67,2024-07-15,16,179,435,614,FLDegS_T,"-37.81688755, 144.96562569"
121720241124,12,2024-11-24,17,164,212,376,NewQ_T,"-37.81457988, 144.94292398"
63420250621,63,2025-06-21,4,0,5,5,Bou231_T,"-37.81333081, 144.96675571"
111020240604,11,2024-06-04,10,51,54,105,WatCit_T,"-37.81564989, 144.93970694"
10620240110,10,2024-01-10,6,8,41,49,BouHbr_T,"-37.81876474, 144.94710545"
10620251003,10,2025-10-03,6,8,25,33,BouHbr_T,"-37.81876474, 144.94710545"
21220250721,2,2025-07-21,12,762,722,1484,Bou283_T,"-37.81380668, 144.96516718"
58520250818,58,2025-08-18,5,58,19,77,Bou688_T,"-37.81686075, 144.95358075"
351520240806,35,2024-08-06,15,806,870,1676,SouthB_T,"-37.82018685, 144.96508508"
592120241022,59,2024-10-22,21,174,124,298,RMIT_T,"-37.80825648, 144.96304859"
59220250312,59,2025-03-12,2,14,10,24,RMIT_T,"-37.80825648, 144.96304859"
591220250319,59,2025-03-19,12,1887,1777,3664,RMIT_T,"-37.80825648, 144.96304859"
71720240121,71,2024-01-21,7,0,1,1,WestWP_T,"-37.81235775, 144.97136962"
652220240325,65,2024-03-25,22,98,70,168,SwaCs_T,"-37.81569416, 144.9668064"
47120240427,47,2024-04-27,1,88,119,207,Eli250_T,"-37.81258467, 144.9625775"
51420250318,5,2025-03-18,14,988,1085,2073,PriNW_T,"-37.81874249, 144.96787656"
21820250801,21,2025-08-01,8,51,67,118,Bourke155_T,"-37.81267313, 144.96788288"
50320250823,50,2025-08-23,3,1,4,5,Lyg309_T,"-37.79808192, 144.96721013"
501720250918,50,2025-09-18,17,206,172,378,Lyg309_T,"-37.79808192, 144.96721013"
50720241212,50,2024-12-12,7,22,24,46,Lyg309_T,"-37.79808192, 144.96721013"
50220250226,50,2025-02-26,2,1,0,1,Lyg309_T,"-37.79808192, 144.96721013"
45320241120,45,2024-11-20,3,7,24,31,Swa148_T,"-37.81414075, 144.96609379"
167520250308,167,2025-03-08,5,0,1,1,Lat526_T,"-37.81304149, 144.95155955"
1431020240710,143,2024-07-10,10,147,366,513,Spencer_T,"-37.821728, 144.95557015"
1431520240830,143,2024-08-30,15,168,214,382,Spencer_T,"-37.821728, 144.95557015"
1431420240423,143,2024-04-23,14,258,266,524,Spencer_T,"-37.821728, 144.95557015"
1321120231215,132,2023-12-15,11,149,90,239,King335_T,"-37.81267639, 144.95386444"
1241120250204,124,2025-02-04,11,1,4,5,BirBridge_T,"-37.81757416, 144.97329934"
66120250809,66,2025-08-09,1,119,70,189,QVN_T,"-37.81057846, 144.96444294"
69820240410,69,2024-04-10,8,176,40,216,FLDegC_T,"-37.81687226, 144.96559144"
61120250522,6,2025-05-22,11,535,494,1029,FliS_T,"-37.81911705, 144.96558255"
671420241210,67,2024-12-10,14,328,592,920,FLDegS_T,"-37.81688755, 144.96562569"
17620240614,17,2024-06-14,6,135,34,169,Col15_T,"-37.81362543, 144.97323591"
1620231210,1,2023-12-10,6,27,16,43,Bou292_T,"-37.81349441, 144.96515323"
1520231230,1,2023-12-30,5,13,4,17,Bou292_T,"-37.81349441, 144.96515323"
63520250921,63,2025-09-21,5,1,7,8,Bou231_T,"-37.81333081, 144.96675571"
671320250116,67,2025-01-16,13,639,766,1405,FLDegS_T,"-37.81688755, 144.96562569"
62520250522,62,2025-05-22,5,13,7,20,Lat224_T,"-37.80996494, 144.96216521"
10520231025,10,2023-10-25,5,2,5,7,BouHbr_T,"-37.81876474, 144.94710545"
102220241112,10,2024-11-12,22,13,15,28,BouHbr_T,"-37.81876474, 144.94710545"
12420250218,12,2025-02-18,4,2,8,10,NewQ_T,"-37.81457988, 144.94292398"
35420241014,35,2024-10-14,4,18,12,30,SouthB_T,"-37.82018685, 144.96508508"
35020240112,35,2024-01-12,0,104,136,240,SouthB_T,"-37.82018685, 144.96508508"
23220240521,23,2024-05-21,2,3,7,10,Col623_T,"-37.81909256, 144.95452748"
302220250731,30,2025-07-31,22,184,246,430,Lon189_T,"-37.8112185, 144.96656806"
481920240404,48,2024-04-04,19,92,129,221,QVMQ_T,"-37.80631581, 144.95866697"
252320250106,25,2025-01-06,23,24,49,73,MCEC_T,"-37.82401776, 144.95604426"
201220240918,20,2024-09-18,12,287,278,565,LtB170_T,"-37.81172914, 144.9682466"
79220250624,79,2025-06-24,2,13,9,22,FliSS_T,"-37.81794046, 144.96616678"
232320240129,23,2024-01-29,23,20,51,71,Col623_T,"-37.81909256, 144.95452748"
30620241221,30,2024-12-21,6,31,50,81,Lon189_T,"-37.8112185, 144.96656806"
52520240521,52,2024-05-21,5,11,13,24,Eli263_T,"-37.81252157, 144.9619401"
51920250628,51,2025-06-28,9,84,102,186,Fra118_T,"-37.80841815, 144.95906316"
49120241030,49,2024-10-30,1,64,42,106,Eli501_T,"-37.80730068, 144.95956055"
491420240103,49,2024-01-03,14,166,250,416,Eli501_T,"-37.80730068, 144.95956055"
202120240112,20,2024-01-12,21,318,474,792,LtB170_T,"-37.81172914, 144.9682466"
1361620240429,136,2024-04-29,16,157,63,220,BirFed1120_T,"-37.8184141, 144.97357915"
1641620241113,164,2024-11-13,16,135,118,253,Lat526_T,"-37.813005, 144.95160411"
164320250126,164,2025-01-26,3,2,4,6,Lat526_T,"-37.813005, 144.95160411"
1171320241003,117,2024-10-03,13,262,241,503,Fli114F_T,"-37.81629332, 144.97090877"
1232020250809,123,2025-08-09,20,8,0,8,BirBridge_T,"-37.81753741, 144.97329734"
661020250308,66,2025-03-08,10,436,580,1016,QVN_T,"-37.81057846, 144.96444294"
661020241121,66,2024-11-21,10,378,531,909,QVN_T,"-37.81057846, 144.96444294"
84920240809,84,2024-08-09,9,915,422,1337,ElFi_T,"-37.81798049, 144.96503383"
661220240319,66,2024-03-19,12,1111,1207,2318,QVN_T,"-37.81057846, 144.96444294"
41520250606,4,2025-06-06,15,1574,1220,2794,Swa123_T,"-37.81487988, 144.9660878"
31120250325,3,2025-03-25,11,602,734,1336,Swa295_T,"-37.81101524, 144.96429485"
391720240807,39,2024-08-07,17,116,83,199,AlfPl_T,"-37.81379749, 144.96995745"
75720240719,75,2024-07-19,7,21,27,48,SprFli_T,"-37.81515276, 144.97467661"
771020250201,77,2025-02-01,10,125,138,263,HarEsP_T,"-37.81441438, 144.94433026"
78320250401,78,2025-04-01,3,1,0,1,HarEsB_T,"-37.81471642, 144.9446508"
781020231110,78,2023-11-10,10,20,70,90,HarEsB_T,"-37.81471642, 144.9446508"
141320250715,14,2025-07-15,13,292,103,395,SanBri_T,"-37.82011242, 144.96291897"
65720240506,65,2024-05-06,7,185,74,259,SwaCs_T,"-37.81569416, 144.9668064"
652020240502,65,2024-05-02,20,274,214,488,SwaCs_T,"-37.81569416, 144.9668064"
42220241117,42,2024-11-17,2,5,15,20,UM1_T,"-37.80008566, 144.96386412"
28320250509,28,2025-05-09,3,6,19,25,VAC_T,"-37.82129925, 144.96879309"
54120250628,54,2025-06-28,1,22,24,46,Swa607_T,"-37.804024, 144.96308399"
541420241228,54,2024-12-28,14,42,46,88,Swa607_T,"-37.804024, 144.96308399"
54920240609,54,2024-06-09,9,33,25,58,Swa607_T,"-37.804024, 144.96308399"
541020250316,54,2025-03-16,10,49,61,110,Swa607_T,"-37.804024, 144.96308399"
471420250815,47,2025-08-15,14,823,693,1516,Eli250_T,"-37.81258467, 144.9625775"
471820240525,47,2024-05-25,18,986,822,1808,Eli250_T,"-37.81258467, 144.9625775"
52020250716,5,2025-07-16,20,331,515,846,PriNW_T,"-37.81874249, 144.96787656"
211620231019,21,2023-10-19,16,392,404,796,Bourke155_T,"-37.81267313, 144.96788288"
1081220250514,108,2025-05-14,12,552,532,1084,261Will_T,"-37.81295822, 144.95678789"
871620240905,87,2024-09-05,16,72,77,149,Errol23_T,"-37.80454949, 144.94921863"
1081520240310,108,2024-03-10,15,71,89,160,261Will_T,"-37.81295822, 144.95678789"
108620240501,108,2024-05-01,6,6,243,249,261Will_T,"-37.81295822, 144.95678789"
61020241130,61,2024-11-30,0,168,89,257,RMIT14_T,"-37.80767455, 144.96309114"
61920231023,61,2023-10-23,9,199,339,538,RMIT14_T,"-37.80767455, 144.96309114"
501420240727,50,2024-07-27,14,240,221,461,Lyg309_T,"-37.79808192, 144.96721013"
43220240523,43,2024-05-23,2,4,3,7,UM2_T,"-37.79844526, 144.96411782"
431220250331,43,2025-03-31,12,238,336,574,UM2_T,"-37.79844526, 144.96411782"
1651420250414,165,2025-04-14,14,53,32,85,Spen475_T,"-37.80953359, 144.94939004"
1671220250217,167,2025-02-17,12,37,74,111,Lat526_T,"-37.81304149, 144.95155955"
1672320250911,167,2025-09-11,23,3,6,9,Lat526_T,"-37.81304149, 144.95155955"
143120250603,143,2025-06-03,1,30,12,42,Spencer_T,"-37.821728, 144.95557015"
134420240412,134,2024-04-12,4,15,23,38,Spen201_T,"-37.81694221, 144.95303935"
107120241123,107,2024-11-23,1,32,24,56,280Will_T,"-37.81246271, 144.95690188"
142520231220,142,2023-12-20,5,12,7,19,Hammer1584_T,"-37.81970749, 144.96795734"
1421720240718,142,2024-07-18,17,260,182,442,Hammer1584_T,"-37.81970749, 144.96795734"
1231420240213,123,2024-02-13,14,13,2,15,BirBridge_T,"-37.81753741, 144.97329734"
123720240819,123,2024-08-19,7,8,3,11,BirBridge_T,"-37.81753741, 144.97329734"
1231920241023,123,2024-10-23,19,7,3,10,BirBridge_T,"-37.81753741, 144.97329734"
130720250318,130,2025-03-18,7,13,10,23,Bou892T,"-37.8204637, 144.94126826"
1091820231018,109,2023-10-18,18,250,137,387,LatWill_T,"-37.81193681, 144.95621105"
164020240918,164,2024-09-18,0,2,10,12,Lat526_T,"-37.813005, 144.95160411"
164820241121,164,2024-11-21,8,141,72,213,Lat526_T,"-37.813005, 144.95160411"
164320250108,164,2025-01-08,3,0,1,1,Lat526_T,"-37.813005, 144.95160411"
1391220250118,139,2025-01-18,12,65,39,104,Signal1647_T,"-37.81959923, 144.9632832"
1361420240424,136,2024-04-24,14,95,82,177,BirFed1120_T,"-37.8184141, 144.97357915"
1361320240704,136,2024-07-04,13,225,285,510,BirFed1120_T,"-37.8184141, 144.97357915"
1361820250401,136,2025-04-01,18,232,67,299,BirFed1120_T,"-37.8184141, 144.97357915"
66220241030,66,2024-10-30,2,12,12,24,QVN_T,"-37.81057846, 144.96444294"
691620231219,69,2023-12-19,16,131,135,266,FLDegC_T,"-37.81687226, 144.96559144"
61220240309,6,2024-03-09,12,708,822,1530,FliS_T,"-37.81911705, 144.96558255"
84220240607,84,2024-06-07,2,18,13,31,ElFi_T,"-37.81798049, 144.96503383"
701720250503,70,2025-05-03,17,170,163,333,Errol20_T,"-37.80456984, 144.94946228"
66520231227,66,2023-12-27,5,11,33,44,QVN_T,"-37.81057846, 144.96444294"
81420241208,8,2024-12-08,14,187,277,464,WebBN_T,"-37.82293543, 144.9471751"
41620250522,41,2025-05-22,6,108,78,186,Swa31,"-37.81668634, 144.96689733"
14820240806,14,2024-08-06,8,334,550,884,SanBri_T,"-37.82011242, 144.96291897"
421720240705,42,2024-07-05,17,138,164,302,UM1_T,"-37.80008566, 144.96386412"
42620250114,42,2025-01-14,6,9,25,34,UM1_T,"-37.80008566, 144.96386412"
282120250912,28,2025-09-12,21,587,564,1151,VAC_T,"-37.82129925, 144.96879309"
292120250812,29,2025-08-12,21,16,19,35,AG_T,"-37.8199817, 144.96872865"
40620231218,40,2023-12-18,6,23,48,71,Spr201_T,"-37.80999341, 144.97227587"
311120240122,31,2024-01-22,11,113,81,194,Lyg161_T,"-37.80169681, 144.96658911"
471220250626,47,2025-06-26,12,853,989,1842,Eli250_T,"-37.81258467, 144.9625775"
471920240810,47,2024-08-10,19,989,776,1765,Eli250_T,"-37.81258467, 144.9625775"
45620231227,45,2023-12-27,6,14,34,48,Swa148_T,"-37.81414075, 144.96609379"
612320250424,61,2025-04-24,23,202,95,297,RMIT14_T,"-37.80767455, 144.96309114"
612120241106,61,2024-11-06,21,371,165,536,RMIT14_T,"-37.80767455, 144.96309114"
44620240503,44,2024-05-03,6,10,6,16,UM3_T,"-37.79698741, 144.96441306"
1312220240412,131,2024-04-12,22,128,145,273,King2_T,"-37.82009057, 144.95758725"
134420231029,134,2023-10-29,4,34,32,66,Spen201_T,"-37.81694221, 144.95303935"
1071320240527,107,2024-05-27,13,224,223,447,280Will_T,"-37.81246271, 144.95690188"
721720240324,72,2024-03-24,17,430,414,844,ACMI_T,"-37.81726338, 144.96872809"
242120240419,24,2024-04-19,21,379,546,925,Col620_T,"-37.81887963, 144.95449198"
581420250713,58,2025-07-13,14,616,870,1486,Bou688_T,"-37.81686075, 144.95358075"
35020250505,35,2025-05-05,0,39,86,125,SouthB_T,"-37.82018685, 144.96508508"
791220241024,79,2024-10-24,12,469,379,848,FliSS_T,"-37.81794046, 144.96616678"
48320240121,48,2024-01-21,3,15,34,49,QVMQ_T,"-37.80631581, 144.95866697"
46820240419,46,2024-04-19,8,75,190,265,Pel147_T,"-37.80240719, 144.9615673"
46820250510,46,2025-05-10,8,18,15,33,Pel147_T,"-37.80240719, 144.9615673"
511720250513,51,2025-05-13,17,119,104,223,Fra118_T,"-37.80841815, 144.95906316"
1171020250910,117,2025-09-10,10,84,104,188,Fli114F_T,"-37.81629332, 144.97090877"
1641920240828,164,2024-08-28,19,34,44,78,Lat526_T,"-37.813005, 144.95160411"
164920250606,164,2025-06-06,9,113,47,160,Lat526_T,"-37.813005, 144.95160411"
161720241105,161,2024-11-05,7,53,77,130,BirArt1109_T,"-37.81851276, 144.97131336"
1091020241206,109,2024-12-06,10,77,119,196,LatWill_T,"-37.81193681, 144.95621105"
671520250328,67,2025-03-28,15,366,588,954,FLDegS_T,"-37.81688755, 144.96562569"
17220240513,17,2024-05-13,2,4,6,10,Col15_T,"-37.81362543, 144.97323591"
631620250202,63,2025-02-02,16,228,243,471,Bou231_T,"-37.81333081, 144.96675571"
561020240320,56,2024-03-20,10,244,166,410,Lon364_T,"-37.81234775, 144.96153311"
86720240908,86,2024-09-08,7,14,14,28,574Qub_T,"-37.80309992, 144.94908064"
122120250919,12,2025-09-19,21,37,26,63,NewQ_T,"-37.81457988, 144.94292398"
24820240604,24,2024-06-04,8,1999,306,2305,Col620_T,"-37.81887963, 144.95449198"
561420250719,56,2025-07-19,14,527,430,957,Lon364_T,"-37.81234775, 144.96153311"
30620240526,30,2024-05-26,6,27,72,99,Lon189_T,"-37.8112185, 144.96656806"
30320240916,30,2024-09-16,3,21,45,66,Lon189_T,"-37.8112185, 144.96656806"
53420240522,53,2024-05-22,4,3,2,5,Col254_T,"-37.81564191, 144.965499"
23820250317,23,2025-03-17,8,753,331,1084,Col623_T,"-37.81909256, 144.95452748"
46120240610,46,2024-06-10,1,6,4,10,Pel147_T,"-37.80240719, 144.9615673"
521820251005,52,2025-10-05,18,257,375,632,Eli263_T,"-37.81252157, 144.9619401"
521220231029,52,2023-10-29,12,327,348,675,Eli263_T,"-37.81252157, 144.9619401"
512020250504,51,2025-05-04,20,76,73,149,Fra118_T,"-37.80841815, 144.95906316"
491220241116,49,2024-11-16,12,432,594,1026,Eli501_T,"-37.80730068, 144.95956055"
481220231117,48,2023-11-17,12,293,287,580,QVMQ_T,"-37.80631581, 144.95866697"
251120240628,25,2024-06-28,11,339,639,978,MCEC_T,"-37.82401776, 144.95604426"
521120250827,52,2025-08-27,11,234,168,402,Eli263_T,"-37.81252157, 144.9619401"
1411720241123,141,2024-11-23,17,138,63,201,474Fl_T,"-37.81997273, 144.95834911"
8920250601,8,2025-06-01,9,97,208,305,WebBN_T,"-37.82293543, 144.9471751"
81520250710,8,2025-07-10,15,180,373,553,WebBN_T,"-37.82293543, 144.9471751"
41520250126,41,2025-01-26,5,99,84,183,Swa31,"-37.81668634, 144.96689733"
412020250412,41,2025-04-12,20,1247,1899,3146,Swa31,"-37.81668634, 144.96689733"
771920250829,77,2025-08-29,19,74,60,134,HarEsP_T,"-37.81441438, 144.94433026"
78720241120,78,2024-11-20,7,55,35,90,HarEsB_T,"-37.81471642, 144.9446508"
782120251012,78,2025-10-12,21,10,10,20,HarEsB_T,"-37.81471642, 144.9446508"
712020250803,71,2025-08-03,20,3,7,10,WestWP_T,"-37.81235775, 144.97136962"
71820240404,71,2024-04-04,8,28,38,66,WestWP_T,"-37.81235775, 144.97136962"
28220250913,28,2025-09-13,2,23,14,37,VAC_T,"-37.82129925, 144.96879309"
28320250530,28,2025-05-30,3,5,19,24,VAC_T,"-37.82129925, 144.96879309"
401420240929,40,2024-09-29,14,107,107,214,Spr201_T,"-37.80999341, 144.97227587"
402220250326,40,2025-03-26,22,55,18,73,Spr201_T,"-37.80999341, 144.97227587"
361620231102,36,2023-11-02,16,245,212,457,Que85_T,"-37.81652527, 144.96121062"
1232120250313,123,2025-03-13,21,2,0,2,BirBridge_T,"-37.81753741, 144.97329734"
491320241223,49,2024-12-23,13,395,639,1034,Eli501_T,"-37.80730068, 144.95956055"
1091020250813,109,2025-08-13,10,92,189,281,LatWill_T,"-37.81193681, 144.95621105"
109220250120,109,2025-01-20,2,4,14,18,LatWill_T,"-37.81193681, 144.95621105"
109820240617,109,2024-06-17,8,81,674,755,LatWill_T,"-37.81193681, 144.95621105"
1422120240523,142,2024-05-23,21,141,286,427,Hammer1584_T,"-37.81970749, 144.96795734"
63620250725,63,2025-07-25,6,2,10,12,Bou231_T,"-37.81333081, 144.96675571"
18220240101,18,2024-01-01,2,3,4,7,Col12_T,"-37.81344862, 144.97305353"
181920240514,18,2024-05-14,19,3,2,5,Col12_T,"-37.81344862, 144.97305353"
181220250206,18,2025-02-06,12,256,273,529,Col12_T,"-37.81344862, 144.97305353"
86220240221,86,2024-02-21,2,1,2,3,574Qub_T,"-37.80309992, 144.94908064"
11820240330,11,2024-03-30,8,53,45,98,WatCit_T,"-37.81564989, 144.93970694"
68220250105,68,2025-01-05,2,2,0,2,FLDegN_T,"-37.8168479, 144.96559789"
10020240520,10,2024-05-20,0,1,2,3,BouHbr_T,"-37.81876474, 144.94710545"
692020240204,69,2024-02-04,20,40,43,83,FLDegC_T,"-37.81687226, 144.96559144"
841020231105,84,2023-11-05,10,774,565,1339,ElFi_T,"-37.81798049, 144.96503383"
84420240122,84,2024-01-22,4,18,29,47,ElFi_T,"-37.81798049, 144.96503383"
842220240831,84,2024-08-31,22,695,786,1481,ElFi_T,"-37.81798049, 144.96503383"
4520250112,4,2025-01-12,5,40,48,88,Swa123_T,"-37.81487988, 144.9660878"
42020250621,4,2025-06-21,20,1028,994,2022,Swa123_T,"-37.81487988, 144.9660878"
75820250119,75,2025-01-19,8,20,28,48,SprFli_T,"-37.81515276, 144.97467661"
411420250807,41,2025-08-07,14,1509,1937,3446,Swa31,"-37.81668634, 144.96689733"
77120231225,77,2023-12-25,1,8,5,13,HarEsP_T,"-37.81441438, 144.94433026"
142120240828,14,2024-08-28,21,158,85,243,SanBri_T,"-37.82011242, 144.96291897"
771820250920,77,2025-09-20,18,151,161,312,HarEsP_T,"-37.81441438, 144.94433026"
28720240918,28,2024-09-18,7,354,266,620,VAC_T,"-37.82129925, 144.96879309"
31420250131,31,2025-01-31,4,2,2,4,Lyg161_T,"-37.80169681, 144.96658911"
312120240612,31,2024-06-12,21,119,125,244,Lyg161_T,"-37.80169681, 144.96658911"
54820250225,54,2025-02-25,8,187,40,227,Swa607_T,"-37.804024, 144.96308399"
37520250911,37,2025-09-11,5,5,4,9,Lyg260_T,"-37.80107122, 144.96704554"
361120250912,36,2025-09-12,11,151,137,288,Que85_T,"-37.81652527, 144.96121062"
108720250313,108,2025-03-13,7,91,818,909,261Will_T,"-37.81295822, 144.95678789"
61820241123,61,2024-11-23,8,98,154,252,RMIT14_T,"-37.80767455, 144.96309114"
43320250803,43,2025-08-03,3,1,1,2,UM2_T,"-37.79844526, 144.96411782"
442020241026,44,2024-10-26,20,24,22,46,UM3_T,"-37.79698741, 144.96441306"
131420240509,131,2024-05-09,4,11,8,19,King2_T,"-37.82009057, 144.95758725"
1311520240628,131,2024-06-28,15,119,107,226,King2_T,"-37.82009057, 144.95758725"
1431220240802,143,2024-08-02,12,186,328,514,Spencer_T,"-37.821728, 144.95557015"
1352020250113,135,2025-01-13,20,208,205,413,Spen161_T,"-37.8172861, 144.95319102"
1071320240630,107,2024-06-30,13,68,117,185,280Will_T,"-37.81246271, 144.95690188"
671820251014,67,2025-10-14,18,295,464,759,FLDegS_T,"-37.81688755, 144.96562569"
631520250327,63,2025-03-27,15,325,431,756,Bou231_T,"-37.81333081, 144.96675571"
68020241014,68,2024-10-14,0,1,0,1,FLDegN_T,"-37.8168479, 144.96559789"
861920241009,86,2024-10-09,19,41,61,102,574Qub_T,"-37.80309992, 144.94908064"
582320240410,58,2024-04-10,23,89,100,189,Bou688_T,"-37.81686075, 144.95358075"
352320250128,35,2025-01-28,23,129,256,385,SouthB_T,"-37.82018685, 144.96508508"
21120240310,2,2024-03-10,11,427,524,951,Bou283_T,"-37.81380668, 144.96516718"
30120231127,30,2023-11-27,1,107,97,204,Lon189_T,"-37.8112185, 144.96656806"
511120250131,51,2025-01-31,11,86,87,173,Fra118_T,"-37.80841815, 144.95906316"
51520240307,51,2024-03-07,5,1,18,19,Fra118_T,"-37.80841815, 144.95906316"
46420250906,46,2025-09-06,4,1,0,1,Pel147_T,"-37.80240719, 144.9615673"
202320241107,20,2024-11-07,23,62,108,170,LtB170_T,"-37.81172914, 144.9682466"
1301720241016,130,2024-10-16,17,80,72,152,Bou892T,"-37.8204637, 144.94126826"
491920231128,49,2023-11-28,19,169,131,300,Eli501_T,"-37.80730068, 144.95956055"
491520250718,49,2025-07-18,15,239,422,661,Eli501_T,"-37.80730068, 144.95956055"
1801220250705,180,2025-07-05,12,63,41,104,Mac330_T,"-37.79497059, 144.93530329"
1371420231218,137,2023-12-18,14,19,58,77,BouHbr2353_T,"-37.81894815, 144.94612292"
1361120240430,136,2024-04-30,11,107,48,155,BirFed1120_T,"-37.8184141, 144.97357915"
161620251016,161,2025-10-16,6,73,76,149,BirArt1109_T,"-37.81851276, 144.97131336"
69920231115,69,2023-11-15,9,170,66,236,FLDegC_T,"-37.81687226, 144.96559144"
692220241201,69,2024-12-01,22,2,3,5,FLDegC_T,"-37.81687226, 144.96559144"
842120250524,84,2025-05-24,21,662,808,1470,ElFi_T,"-37.81798049, 144.96503383"
84120250727,84,2025-07-27,1,227,215,442,ElFi_T,"-37.81798049, 144.96503383"
3020240809,3,2024-08-09,0,189,168,357,Swa295_T,"-37.81101524, 144.96429485"
41220240711,4,2024-07-11,12,1718,1281,2999,Swa123_T,"-37.81487988, 144.9660878"
42320250628,4,2025-06-28,23,554,473,1027,Swa123_T,"-37.81487988, 144.9660878"
701720240309,70,2024-03-09,17,98,109,207,Errol20_T,"-37.80456984, 144.94946228"
8720240122,8,2024-01-22,7,132,120,252,WebBN_T,"-37.82293543, 144.9471751"
782120240429,78,2024-04-29,21,3,8,11,HarEsB_T,"-37.81471642, 144.9446508"
78920250101,78,2025-01-01,9,31,33,64,HarEsB_T,"-37.81471642, 144.9446508"
711220250430,71,2025-04-30,12,14,24,38,WestWP_T,"-37.81235775, 144.97136962"
282320250108,28,2025-01-08,23,41,43,84,VAC_T,"-37.82129925, 144.96879309"
28720250131,28,2025-01-31,7,293,188,481,VAC_T,"-37.82129925, 144.96879309"
28920240529,28,2024-05-29,9,472,312,784,VAC_T,"-37.82129925, 144.96879309"
36820240819,36,2024-08-19,8,212,144,356,Que85_T,"-37.81652527, 144.96121062"
51120231028,5,2023-10-28,11,578,933,1511,PriNW_T,"-37.81874249, 144.96787656"
211120240609,21,2024-06-09,11,276,213,489,Bourke155_T,"-37.81267313, 144.96788288"
362320240922,36,2024-09-22,23,15,19,34,Que85_T,"-37.81652527, 144.96121062"
1082020250727,108,2025-07-27,20,39,39,78,261Will_T,"-37.81295822, 144.95678789"
1082120251002,108,2025-10-02,21,124,84,208,261Will_T,"-37.81295822, 144.95678789"
1082120241204,108,2024-12-04,21,141,126,267,261Will_T,"-37.81295822, 144.95678789"
61020240907,61,2024-09-07,0,195,136,331,RMIT14_T,"-37.80767455, 144.96309114"
441920250829,44,2025-08-29,19,20,47,67,UM3_T,"-37.79698741, 144.96441306"
1811420251010,181,2025-10-10,14,755,1158,1913,Eli368_T,"-37.81009465, 144.96143149"
871720241110,87,2024-11-10,17,64,62,126,Errol23_T,"-37.80454949, 144.94921863"
87720240503,87,2024-05-03,7,34,26,60,Errol23_T,"-37.80454949, 144.94921863"
61220241112,61,2024-11-12,2,21,3,24,RMIT14_T,"-37.80767455, 144.96309114"
43120250629,43,2025-06-29,1,4,2,6,UM2_T,"-37.79844526, 144.96411782"
43020231115,43,2023-11-15,0,9,6,15,UM2_T,"-37.79844526, 144.96411782"
442120241214,44,2024-12-14,21,48,9,57,UM3_T,"-37.79698741, 144.96441306"
44420250920,44,2025-09-20,4,2,1,3,UM3_T,"-37.79698741, 144.96441306"
179920250912,179,2025-09-12,9,53,43,96,Pow61_T,"-37.82392385, 144.96299677"
166820241206,166,2024-12-06,8,26,44,70,Spen484_T,"-37.80896733, 144.94931703"
181820250608,181,2025-06-08,8,100,213,313,Eli368_T,"-37.81009465, 144.96143149"
131720240420,131,2024-04-20,7,21,25,46,King2_T,"-37.82009057, 144.95758725"
1321420240923,132,2024-09-23,14,137,159,296,King335_T,"-37.81267639, 144.95386444"
691120250412,69,2025-04-12,11,379,245,624,FLDegC_T,"-37.81687226, 144.96559144"
6520231217,6,2023-12-17,5,66,67,133,FliS_T,"-37.81911705, 144.96558255"
61920240726,6,2024-07-26,19,752,685,1437,FliS_T,"-37.81911705, 144.96558255"
61620240801,6,2024-08-01,16,1472,802,2274,FliS_T,"-37.81911705, 144.96558255"
6020241023,6,2024-10-23,0,116,72,188,FliS_T,"-37.81911705, 144.96558255"
4720240216,4,2024-02-16,7,228,170,398,Swa123_T,"-37.81487988, 144.9660878"
41020250304,4,2025-03-04,10,1089,591,1680,Swa123_T,"-37.81487988, 144.9660878"
3520250104,3,2025-01-04,5,28,22,50,Swa295_T,"-37.81101524, 144.96429485"
671220231112,67,2023-11-12,12,306,450,756,FLDegS_T,"-37.81688755, 144.96562569"
68720240629,68,2024-06-29,7,6,4,10,FLDegN_T,"-37.8168479, 144.96559789"
681420250429,68,2025-04-29,14,302,279,581,FLDegN_T,"-37.8168479, 144.96559789"
63920250308,63,2025-03-08,9,101,132,233,Bou231_T,"-37.81333081, 144.96675571"
631520250401,63,2025-04-01,15,279,383,662,Bou231_T,"-37.81333081, 144.96675571"
122020250507,12,2025-05-07,20,110,133,243,NewQ_T,"-37.81457988, 144.94292398"
86420250214,86,2025-02-14,4,0,2,2,574Qub_T,"-37.80309992, 144.94908064"
761920240727,76,2024-07-27,19,26,34,60,KenMac_T,"-37.79453803, 144.93036194"
9520231206,9,2023-12-06,5,29,53,82,Col700_T,"-37.81982992, 144.95102555"
79020250119,79,2025-01-19,0,158,231,389,FliSS_T,"-37.81794046, 144.96616678"
231120241004,23,2024-10-04,11,199,232,431,Col623_T,"-37.81909256, 144.95452748"
23820231021,23,2023-10-21,8,66,79,145,Col623_T,"-37.81909256, 144.95452748"
512020240222,51,2024-02-22,20,87,71,158,Fra118_T,"-37.80841815, 144.95906316"
231620240611,23,2024-06-11,16,226,679,905,Col623_T,"-37.81909256, 144.95452748"
231320231118,23,2023-11-18,13,167,224,391,Col623_T,"-37.81909256, 144.95452748"
491120250427,49,2025-04-27,11,346,516,862,Eli501_T,"-37.80730068, 144.95956055"
19620240129,19,2024-01-29,6,7,7,14,LtB210_T,"-37.81237202, 144.96550671"
201120250112,20,2025-01-12,11,199,150,349,LtB170_T,"-37.81172914, 144.9682466"
141120240524,141,2024-05-24,1,12,23,35,474Fl_T,"-37.81997273, 144.95834911"
1411020240612,141,2024-06-12,10,118,100,218,474Fl_T,"-37.81997273, 144.95834911"
141220240727,141,2024-07-27,2,59,28,87,474Fl_T,"-37.81997273, 144.95834911"
1411320250419,141,2025-04-19,13,212,192,404,474Fl_T,"-37.81997273, 144.95834911"
139820241201,139,2024-12-01,8,15,19,34,Signal1647_T,"-37.81959923, 144.9632832"
1362220250529,136,2025-05-29,22,6,0,6,BirFed1120_T,"-37.8184141, 144.97357915"
1421020240205,142,2024-02-05,10,92,51,143,Hammer1584_T,"-37.81970749, 144.96795734"
1301220241218,130,2024-12-18,12,58,64,122,Bou892T,"-37.8204637, 144.94126826"
130220250403,130,2025-04-03,2,1,0,1,Bou892T,"-37.8204637, 144.94126826"
1171720251013,117,2025-10-13,17,167,396,563,Fli114F_T,"-37.81629332, 144.97090877"
1091620250308,109,2025-03-08,16,59,121,180,LatWill_T,"-37.81193681, 144.95621105"
66720231230,66,2023-12-30,7,21,46,67,QVN_T,"-37.81057846, 144.96444294"
1671220250512,167,2025-05-12,12,38,55,93,Lat526_T,"-37.81304149, 144.95155955"
1652020250609,165,2025-06-09,20,11,5,16,Spen475_T,"-37.80953359, 144.94939004"
1432220250510,143,2025-05-10,22,196,169,365,Spencer_T,"-37.821728, 144.95557015"
1431220250621,143,2025-06-21,12,436,220,656,Spencer_T,"-37.821728, 144.95557015"
132020240723,132,2024-07-23,0,20,2,22,King335_T,"-37.81267639, 144.95386444"
1072020250702,107,2025-07-02,20,49,94,143,280Will_T,"-37.81246271, 144.95690188"
133620240908,133,2024-09-08,6,89,151,240,Spen229_T,"-37.81531435, 144.95227769"
1242020250109,124,2025-01-09,20,3,9,12,BirBridge_T,"-37.81757416, 144.97329934"
681720231022,68,2023-10-22,17,146,111,257,FLDegN_T,"-37.8168479, 144.96559789"
851520250205,85,2025-02-05,15,86,105,191,488Mac_T,"-37.79432415, 144.92973378"
11020240422,1,2024-04-22,10,531,536,1067,Bou292_T,"-37.81349441, 144.96515323"
111420240408,11,2024-04-08,14,91,79,170,WatCit_T,"-37.81564989, 144.93970694"
112020250208,11,2025-02-08,20,245,263,508,WatCit_T,"-37.81564989, 144.93970694"
101720250103,10,2025-01-03,17,46,32,78,BouHbr_T,"-37.81876474, 144.94710545"
352020250203,35,2025-02-03,20,626,925,1551,SouthB_T,"-37.82018685, 144.96508508"
352120250411,35,2025-04-11,21,932,1405,2337,SouthB_T,"-37.82018685, 144.96508508"
76820250209,76,2025-02-09,8,29,8,37,KenMac_T,"-37.79453803, 144.93036194"
272120250126,27,2025-01-26,21,69,43,112,Vic_T,"-37.80606888, 144.95644692"
21620250227,2,2025-02-27,16,621,485,1106,Bou283_T,"-37.81380668, 144.96516718"
791520241220,79,2024-12-20,15,499,433,932,FliSS_T,"-37.81794046, 144.96616678"
512020240706,51,2024-07-06,20,57,49,106,Fra118_T,"-37.80841815, 144.95906316"
481920240904,48,2024-09-04,19,175,205,380,QVMQ_T,"-37.80631581, 144.95866697"
461020240119,46,2024-01-19,10,40,45,85,Pel147_T,"-37.80240719, 144.9615673"
20020241219,20,2024-12-19,0,28,38,66,LtB170_T,"-37.81172914, 144.9682466"
1171220231207,117,2023-12-07,12,183,302,485,Fli114F_T,"-37.81629332, 144.97090877"
491020250312,49,2025-03-12,10,200,291,491,Eli501_T,"-37.80730068, 144.95956055"
1371420231127,137,2023-11-27,14,15,74,89,BouHbr2353_T,"-37.81894815, 144.94612292"
1361320250401,136,2025-04-01,13,99,90,189,BirFed1120_T,"-37.8184141, 144.97357915"
142620240613,142,2024-06-13,6,50,6,56,Hammer1584_T,"-37.81970749, 144.96795734"
612320250920,61,2025-09-20,23,97,91,188,RMIT14_T,"-37.80767455, 144.96309114"
611220240327,61,2024-03-27,12,595,736,1331,RMIT14_T,"-37.80767455, 144.96309114"
1662020241229,166,2024-12-29,20,35,34,69,Spen484_T,"-37.80896733, 144.94931703"
162720241108,162,2024-11-08,7,162,104,266,Eli489_T,"-37.80740397, 144.95987909"
1621820250107,162,2025-01-07,18,299,294,593,Eli489_T,"-37.80740397, 144.95987909"
1311420250307,131,2025-03-07,14,139,124,263,King2_T,"-37.82009057, 144.95758725"
1431620251005,143,2025-10-05,16,192,212,404,Spencer_T,"-37.821728, 144.95557015"
118120240204,118,2024-02-04,1,4,2,6,Fli114C_T,"-37.81632783, 144.97090512"
66020250524,66,2025-05-24,0,190,228,418,QVN_T,"-37.81057846, 144.96444294"
702220240117,70,2024-01-17,22,142,81,223,Errol20_T,"-37.80456984, 144.94946228"
41920231203,4,2023-12-03,19,1275,1236,2511,Swa123_T,"-37.81487988, 144.9660878"
42220250402,4,2025-04-02,22,510,537,1047,Swa123_T,"-37.81487988, 144.9660878"
31920240409,3,2024-04-09,19,1126,1076,2202,Swa295_T,"-37.81101524, 144.96429485"
39920250826,39,2025-08-26,9,114,102,216,AlfPl_T,"-37.81379749, 144.96995745"
77620240603,77,2024-06-03,6,6,23,29,HarEsP_T,"-37.81441438, 144.94433026"
42920240807,42,2024-08-07,9,418,140,558,UM1_T,"-37.80008566, 144.96386412"
71220251010,71,2025-10-10,2,2,1,3,WestWP_T,"-37.81235775, 144.97136962"
142020231218,14,2023-12-18,20,515,140,655,SanBri_T,"-37.82011242, 144.96291897"
651420231114,65,2023-11-14,14,415,502,917,SwaCs_T,"-37.81569416, 144.9668064"
652020240708,65,2024-07-08,20,212,230,442,SwaCs_T,"-37.81569416, 144.9668064"
282020240107,28,2024-01-07,20,104,492,596,VAC_T,"-37.82129925, 144.96879309"
29520240306,29,2024-03-06,5,12,28,40,AG_T,"-37.8199817, 144.96872865"
291920250123,29,2025-01-23,19,172,1011,1183,AG_T,"-37.8199817, 144.96872865"
40220241004,40,2024-10-04,2,5,3,8,Spr201_T,"-37.80999341, 144.97227587"
311920250117,31,2025-01-17,19,275,240,515,Lyg161_T,"-37.80169681, 144.96658911"
311620250716,31,2025-07-16,16,132,132,264,Lyg161_T,"-37.80169681, 144.96658911"
54620240703,54,2024-07-03,6,25,12,37,Swa607_T,"-37.804024, 144.96308399"
47620240316,47,2024-03-16,6,29,76,105,Eli250_T,"-37.81258467, 144.9625775"
108320240110,108,2024-01-10,3,10,8,18,261Will_T,"-37.81295822, 144.95678789"
108620240315,108,2024-03-15,6,30,226,256,261Will_T,"-37.81295822, 144.95678789"
871420240207,87,2024-02-07,14,70,89,159,Errol23_T,"-37.80454949, 144.94921863"
611220240814,61,2024-08-14,12,572,683,1255,RMIT14_T,"-37.80767455, 144.96309114"
131720250826,131,2025-08-26,7,48,25,73,King2_T,"-37.82009057, 144.95758725"
1311920240501,131,2024-05-01,19,75,68,143,King2_T,"-37.82009057, 144.95758725"
851220240204,85,2024-02-04,12,63,63,126,488Mac_T,"-37.79432415, 144.92973378"
1420241126,1,2024-11-26,4,7,7,14,Bou292_T,"-37.81349441, 144.96515323"
181320240311,18,2024-03-11,13,35,45,80,Col12_T,"-37.81344862, 144.97305353"
632020250411,63,2025-04-11,20,249,600,849,Bou231_T,"-37.81333081, 144.96675571"
621620250610,62,2025-06-10,16,205,210,415,Lat224_T,"-37.80996494, 144.96216521"
56220240106,56,2024-01-06,2,22,52,74,Lon364_T,"-37.81234775, 144.96153311"
56520240502,56,2024-05-02,5,9,9,18,Lon364_T,"-37.81234775, 144.96153311"
242320240316,24,2024-03-16,23,422,461,883,Col620_T,"-37.81887963, 144.95449198"
11220250612,11,2025-06-12,2,0,1,1,WatCit_T,"-37.81564989, 144.93970694"
11720250706,1,2025-07-06,17,1105,859,1964,Bou292_T,"-37.81349441, 144.96515323"
862320240526,86,2024-05-26,23,0,2,2,574Qub_T,"-37.80309992, 144.94908064"
10120240408,10,2024-04-08,1,3,3,6,BouHbr_T,"-37.81876474, 144.94710545"
101320250304,10,2025-03-04,13,144,110,254,BouHbr_T,"-37.81876474, 144.94710545"
24820251009,24,2025-10-09,8,2335,264,2599,Col620_T,"-37.81887963, 144.95449198"
761420231027,76,2023-10-27,14,56,55,111,KenMac_T,"-37.79453803, 144.93036194"
58120250311,58,2025-03-11,1,30,29,59,Bou688_T,"-37.81686075, 144.95358075"
9620250616,9,2025-06-16,6,39,250,289,Col700_T,"-37.81982992, 144.95102555"
27920250905,27,2025-09-05,9,90,131,221,Vic_T,"-37.80606888, 144.95644692"
27820240920,27,2024-09-20,8,59,147,206,Vic_T,"-37.80606888, 144.95644692"
792120250224,79,2025-02-24,21,199,251,450,FliSS_T,"-37.81794046, 144.96616678"
791020240430,79,2024-04-30,10,331,285,616,FliSS_T,"-37.81794046, 144.96616678"
23320250710,23,2025-07-10,3,5,6,11,Col623_T,"-37.81909256, 144.95452748"
511520231031,51,2023-10-31,15,101,79,180,Fra118_T,"-37.80841815, 144.95906316"
231020240115,23,2024-01-15,10,174,196,370,Col623_T,"-37.81909256, 144.95452748"
46020240630,46,2024-06-30,0,0,4,4,Pel147_T,"-37.80240719, 144.9615673"
522020240318,52,2024-03-18,20,222,178,400,Eli263_T,"-37.81252157, 144.9619401"
391920250428,39,2025-04-28,19,9,1,10,AlfPl_T,"-37.81379749, 144.96995745"
59820250306,59,2025-03-06,8,1617,173,1790,RMIT_T,"-37.80825648, 144.96304859"
59020250723,59,2025-07-23,0,44,65,109,RMIT_T,"-37.80825648, 144.96304859"
591320251004,59,2025-10-04,13,503,476,979,RMIT_T,"-37.80825648, 144.96304859"
71820240422,71,2024-04-22,8,36,49,85,WestWP_T,"-37.81235775, 144.97136962"
281220250817,28,2025-08-17,12,815,1080,1895,VAC_T,"-37.82129925, 144.96879309"
54220240112,54,2024-01-12,2,5,4,9,Swa607_T,"-37.804024, 144.96308399"
54020240301,54,2024-03-01,0,27,20,47,Swa607_T,"-37.804024, 144.96308399"
291020250426,29,2025-04-26,10,158,218,376,AG_T,"-37.8199817, 144.96872865"
29820250312,29,2025-03-12,8,215,151,366,AG_T,"-37.8199817, 144.96872865"
292120240515,29,2024-05-15,21,2,15,17,AG_T,"-37.8199817, 144.96872865"
142120250505,14,2025-05-05,21,169,56,225,SanBri_T,"-37.82011242, 144.96291897"
452020240209,45,2024-02-09,20,591,1040,1631,Swa148_T,"-37.81414075, 144.96609379"
361020250619,36,2025-06-19,10,166,164,330,Que85_T,"-37.81652527, 144.96121062"
36820250918,36,2025-09-18,8,211,220,431,Que85_T,"-37.81652527, 144.96121062"
681920240419,68,2024-04-19,19,144,29,173,FLDegN_T,"-37.8168479, 144.96559789"
851420231223,85,2023-12-23,14,93,97,190,488Mac_T,"-37.79432415, 144.92973378"
171620241127,17,2024-11-27,16,234,414,648,Col15_T,"-37.81362543, 144.97323591"
172220251004,17,2025-10-04,22,89,79,168,Col15_T,"-37.81362543, 144.97323591"
11020240513,1,2024-05-13,10,460,443,903,Bou292_T,"-37.81349441, 144.96515323"
1220240818,1,2024-08-18,2,19,49,68,Bou292_T,"-37.81349441, 144.96515323"
11520250724,1,2025-07-24,15,1233,1042,2275,Bou292_T,"-37.81349441, 144.96515323"
11820250811,1,2025-08-11,18,1049,694,1743,Bou292_T,"-37.81349441, 144.96515323"
182320250222,18,2025-02-22,23,46,22,68,Col12_T,"-37.81344862, 144.97305353"
182220250529,18,2025-05-29,22,20,8,28,Col12_T,"-37.81344862, 144.97305353"
122220231212,12,2023-12-12,22,130,106,236,NewQ_T,"-37.81457988, 144.94292398"
562020250404,56,2025-04-04,20,368,445,813,Lon364_T,"-37.81234775, 144.96153311"
862320241216,86,2024-12-16,23,1,3,4,574Qub_T,"-37.80309992, 144.94908064"
56520250527,56,2025-05-27,5,9,8,17,Lon364_T,"-37.81234775, 144.96153311"
722220240324,72,2024-03-24,22,68,237,305,ACMI_T,"-37.81726338, 144.96872809"
58220250215,58,2025-02-15,2,39,51,90,Bou688_T,"-37.81686075, 144.95358075"
35120240726,35,2024-07-26,1,12,51,63,SouthB_T,"-37.82018685, 144.96508508"
351520240328,35,2024-03-28,15,945,1032,1977,SouthB_T,"-37.82018685, 144.96508508"
2620231027,2,2023-10-27,6,10,25,35,Bou283_T,"-37.81380668, 144.96516718"
91920231120,9,2023-11-20,19,154,64,218,Col700_T,"-37.81982992, 144.95102555"
9720250730,9,2025-07-30,7,76,1190,1266,Col700_T,"-37.81982992, 144.95102555"
30720240520,30,2024-05-20,7,38,46,84,Lon189_T,"-37.8112185, 144.96656806"
79820241019,79,2024-10-19,8,132,103,235,FliSS_T,"-37.81794046, 144.96616678"
30620241216,30,2024-12-16,6,7,23,30,Lon189_T,"-37.8112185, 144.96656806"
252320241203,25,2024-12-03,23,77,43,120,MCEC_T,"-37.82401776, 144.95604426"
521720250830,52,2025-08-30,17,304,399,703,Eli263_T,"-37.81252157, 144.9619401"
522120241023,52,2024-10-23,21,225,120,345,Eli263_T,"-37.81252157, 144.9619401"
52020241216,52,2024-12-16,0,21,24,45,Eli263_T,"-37.81252157, 144.9619401"
51520250712,51,2025-07-12,5,11,13,24,Fra118_T,"-37.80841815, 144.95906316"
117120240715,117,2024-07-15,1,17,11,28,Fli114F_T,"-37.81629332, 144.97090877"
49020240309,49,2024-03-09,0,52,64,116,Eli501_T,"-37.80730068, 144.95956055"
191620240316,19,2024-03-16,16,703,595,1298,LtB210_T,"-37.81237202, 144.96550671"
1371620250514,137,2025-05-14,16,10,252,262,BouHbr2353_T,"-37.81894815, 144.94612292"
1371020250623,137,2025-06-23,10,16,29,45,BouHbr2353_T,"-37.81894815, 144.94612292"
137620231221,137,2023-12-21,6,19,4,23,BouHbr2353_T,"-37.81894815, 144.94612292"
1422020240225,142,2024-02-25,20,334,225,559,Hammer1584_T,"-37.81970749, 144.96795734"
492020250406,49,2025-04-06,20,121,155,276,Eli501_T,"-37.80730068, 144.95956055"
491320240122,49,2024-01-22,13,166,198,364,Eli501_T,"-37.80730068, 144.95956055"
202020250829,20,2025-08-29,20,325,553,878,LtB170_T,"-37.81172914, 144.9682466"
48020231211,48,2023-12-11,0,15,32,47,QVMQ_T,"-37.80631581, 144.95866697"
251120250305,25,2025-03-05,11,223,417,640,MCEC_T,"-37.82401776, 144.95604426"
20420250530,20,2025-05-30,4,11,14,25,LtB170_T,"-37.81172914, 144.9682466"
141520240426,141,2024-04-26,5,13,9,22,474Fl_T,"-37.81997273, 144.95834911"
141420240902,141,2024-09-02,4,8,13,21,474Fl_T,"-37.81997273, 144.95834911"
139020250817,139,2025-08-17,0,4,7,11,Signal1647_T,"-37.81959923, 144.9632832"
1371720231120,137,2023-11-20,17,26,185,211,BouHbr2353_T,"-37.81894815, 144.94612292"
1371620241002,137,2024-10-02,16,9,95,104,BouHbr2353_T,"-37.81894815, 144.94612292"
1372320250204,137,2025-02-04,23,1,2,3,BouHbr2353_T,"-37.81894815, 144.94612292"
137820250430,137,2025-04-30,8,96,30,126,BouHbr2353_T,"-37.81894815, 144.94612292"
1361720240327,136,2024-03-27,17,235,87,322,BirFed1120_T,"-37.8184141, 144.97357915"
1421020250417,142,2025-04-17,10,262,223,485,Hammer1584_T,"-37.81970749, 144.96795734"
142520250426,142,2025-04-26,5,2,0,2,Hammer1584_T,"-37.81970749, 144.96795734"
1302120250402,130,2025-04-02,21,6,8,14,Bou892T,"-37.8204637, 144.94126826"
1641020241103,164,2024-11-03,10,114,47,161,Lat526_T,"-37.813005, 144.95160411"
1641720250331,164,2025-03-31,17,133,125,258,Lat526_T,"-37.813005, 144.95160411"
1642220250421,164,2025-04-21,22,31,40,71,Lat526_T,"-37.813005, 144.95160411"
66220241208,66,2024-12-08,2,86,109,195,QVN_T,"-37.81057846, 144.96444294"
6220240305,6,2024-03-05,2,14,5,19,FliS_T,"-37.81911705, 144.96558255"
31620240415,3,2024-04-15,16,1207,1268,2475,Swa295_T,"-37.81101524, 144.96429485"
39320240505,39,2024-05-05,3,1,6,7,AlfPl_T,"-37.81379749, 144.96995745"
391420251012,39,2025-10-12,14,37,73,110,AlfPl_T,"-37.81379749, 144.96995745"
81520250517,8,2025-05-17,15,113,121,234,WebBN_T,"-37.82293543, 144.9471751"
82320240621,8,2024-06-21,23,21,22,43,WebBN_T,"-37.82293543, 144.9471751"
41620241203,41,2024-12-03,6,482,174,656,Swa31,"-37.81668634, 144.96689733"
142120250111,14,2025-01-11,21,584,156,740,SanBri_T,"-37.82011242, 144.96291897"
59120241103,59,2024-11-03,1,72,48,120,RMIT_T,"-37.80825648, 144.96304859"
591020240722,59,2024-07-22,10,1220,775,1995,RMIT_T,"-37.80825648, 144.96304859"
651620240522,65,2024-05-22,16,530,757,1287,SwaCs_T,"-37.81569416, 144.9668064"
282120250425,28,2025-04-25,21,82,58,140,VAC_T,"-37.82129925, 144.96879309"
281520231213,28,2023-12-13,15,458,740,1198,VAC_T,"-37.82129925, 144.96879309"
541520250723,54,2025-07-23,15,117,291,408,Swa607_T,"-37.804024, 144.96308399"
37120251009,37,2025-10-09,1,9,11,20,Lyg260_T,"-37.80107122, 144.96704554"
471920250629,47,2025-06-29,19,554,546,1100,Eli250_T,"-37.81258467, 144.9625775"
40220250821,40,2025-08-21,2,2,0,2,Spr201_T,"-37.80999341, 144.97227587"
211820240216,21,2024-02-16,18,581,555,1136,Bourke155_T,"-37.81267313, 144.96788288"
45420250515,45,2025-05-15,4,5,18,23,Swa148_T,"-37.81414075, 144.96609379"
212320250404,21,2025-04-04,23,290,354,644,Bourke155_T,"-37.81267313, 144.96788288"
871020250726,87,2025-07-26,10,111,109,220,Errol23_T,"-37.80454949, 144.94921863"
611020231109,61,2023-11-09,10,272,361,633,RMIT14_T,"-37.80767455, 144.96309114"
43620250412,43,2025-04-12,6,9,10,19,UM2_T,"-37.79844526, 144.96411782"
44020250506,44,2025-05-06,0,4,0,4,UM3_T,"-37.79698741, 144.96441306"
179720250218,179,2025-02-18,7,37,15,52,Pow61_T,"-37.82392385, 144.96299677"
165820250413,165,2025-04-13,8,15,22,37,Spen475_T,"-37.80953359, 144.94939004"
1811520250823,181,2025-08-23,15,1001,1325,2326,Eli368_T,"-37.81009465, 144.96143149"
1621020250717,162,2025-07-17,10,280,328,608,Eli489_T,"-37.80740397, 144.95987909"
132920240202,132,2024-02-02,9,137,102,239,King335_T,"-37.81267639, 144.95386444"
135920250118,135,2025-01-18,9,259,357,616,Spen161_T,"-37.8172861, 144.95319102"
1071320250601,107,2025-06-01,13,86,169,255,280Will_T,"-37.81246271, 144.95690188"
1331720241230,133,2024-12-30,17,612,511,1123,Spen229_T,"-37.81531435, 144.95227769"
67520250505,67,2025-05-05,5,4,7,11,FLDegS_T,"-37.81688755, 144.96562569"
32020240117,3,2024-01-17,20,946,765,1711,Swa295_T,"-37.81101524, 144.96429485"
3520250212,3,2025-02-12,5,18,26,44,Swa295_T,"-37.81101524, 144.96429485"
8720240710,8,2024-07-10,7,118,98,216,WebBN_T,"-37.82293543, 144.9471751"
14520240619,14,2024-06-19,5,49,35,84,SanBri_T,"-37.82011242, 144.96291897"
59220241010,59,2024-10-10,2,11,27,38,RMIT_T,"-37.80825648, 144.96304859"
77120250221,77,2025-02-21,1,6,1,7,HarEsP_T,"-37.81441438, 144.94433026"
77420250817,77,2025-08-17,4,1,1,2,HarEsP_T,"-37.81441438, 144.94433026"
78420250411,78,2025-04-11,4,1,0,1,HarEsB_T,"-37.81471642, 144.9446508"
54820231216,54,2023-12-16,8,16,18,34,Swa607_T,"-37.804024, 144.96308399"
5620250907,5,2025-09-07,6,48,49,97,PriNW_T,"-37.81874249, 144.96787656"
21320250625,21,2025-06-25,3,2,5,7,Bourke155_T,"-37.81267313, 144.96788288"
362020240325,36,2024-03-25,20,92,108,200,Que85_T,"-37.81652527, 144.96121062"
361020240408,36,2024-04-08,10,163,129,292,Que85_T,"-37.81652527, 144.96121062"
871320250217,87,2025-02-17,13,129,158,287,Errol23_T,"-37.80454949, 144.94921863"
61220240128,61,2024-01-28,2,50,17,67,RMIT14_T,"-37.80767455, 144.96309114"
50020250829,50,2025-08-29,0,7,4,11,Lyg309_T,"-37.79808192, 144.96721013"
50620240928,50,2024-09-28,6,2,3,5,Lyg309_T,"-37.79808192, 144.96721013"
431520250203,43,2025-02-03,15,69,111,180,UM2_T,"-37.79844526, 144.96411782"
43620250208,43,2025-02-08,6,4,1,5,UM2_T,"-37.79844526, 144.96411782"
45920240504,45,2024-05-04,9,210,192,402,Swa148_T,"-37.81414075, 144.96609379"
45320250105,45,2025-01-05,3,11,80,91,Swa148_T,"-37.81414075, 144.96609379"
1661720250428,166,2025-04-28,17,72,79,151,Spen484_T,"-37.80896733, 144.94931703"
1651820250318,165,2025-03-18,18,65,40,105,Spen475_T,"-37.80953359, 144.94939004"
165120250604,165,2025-06-04,1,1,0,1,Spen475_T,"-37.80953359, 144.94939004"
1651720250903,165,2025-09-03,17,80,38,118,Spen475_T,"-37.80953359, 144.94939004"
1401220240416,140,2024-04-16,12,103,93,196,Boyd2837_T,"-37.82590962, 144.96185972"
1311420240415,131,2024-04-15,14,138,89,227,King2_T,"-37.82009057, 144.95758725"
143520240529,143,2024-05-29,5,12,22,34,Spencer_T,"-37.821728, 144.95557015"
132820250909,132,2025-09-09,8,114,96,210,King335_T,"-37.81267639, 144.95386444"
1071220250112,107,2025-01-12,12,24,36,60,280Will_T,"-37.81246271, 144.95690188"
68720250711,68,2025-07-11,7,54,32,86,FLDegN_T,"-37.8168479, 144.96559789"
561620250216,56,2025-02-16,16,294,335,629,Lon364_T,"-37.81234775, 144.96153311"
10920231204,10,2023-12-04,9,59,124,183,BouHbr_T,"-37.81876474, 144.94710545"
241120240707,24,2024-07-07,11,718,446,1164,Col620_T,"-37.81887963, 144.95449198"
352320231201,35,2023-12-01,23,1112,1495,2607,SouthB_T,"-37.82018685, 144.96508508"
21620250812,2,2025-08-12,16,576,613,1189,Bou283_T,"-37.81380668, 144.96516718"
91620250401,9,2025-04-01,16,2652,128,2780,Col700_T,"-37.81982992, 144.95102555"
79420240224,79,2024-02-24,4,37,42,79,FliSS_T,"-37.81794046, 144.96616678"
53920250527,53,2025-05-27,9,370,221,591,Col254_T,"-37.81564191, 144.965499"
521120250711,52,2025-07-11,11,317,231,548,Eli263_T,"-37.81252157, 144.9619401"
522220240114,52,2024-01-14,22,84,104,188,Eli263_T,"-37.81252157, 144.9619401"
109320250506,109,2025-05-06,3,1,5,6,LatWill_T,"-37.81193681, 144.95621105"
49820240525,49,2024-05-25,8,166,103,269,Eli501_T,"-37.80730068, 144.95956055"
1091920240930,109,2024-09-30,19,75,123,198,LatWill_T,"-37.81193681, 144.95621105"
164120250510,164,2025-05-10,1,3,11,14,Lat526_T,"-37.813005, 144.95160411"
1372120231109,137,2023-11-09,21,4,16,20,BouHbr2353_T,"-37.81894815, 144.94612292"
1421920250509,142,2025-05-09,19,53,26,79,Hammer1584_T,"-37.81970749, 144.96795734"
1421320250518,142,2025-05-18,13,642,592,1234,Hammer1584_T,"-37.81970749, 144.96795734"
1421220240927,142,2024-09-27,12,711,869,1580,Hammer1584_T,"-37.81970749, 144.96795734"
161620250412,161,2025-04-12,6,27,27,54,BirArt1109_T,"-37.81851276, 144.97131336"
842020250225,84,2025-02-25,20,683,892,1575,ElFi_T,"-37.81798049, 144.96503383"
31120240317,3,2024-03-17,11,576,770,1346,Swa295_T,"-37.81101524, 144.96429485"
39120251011,39,2025-10-11,1,6,2,8,AlfPl_T,"-37.81379749, 144.96995745"
81020240101,8,2024-01-01,10,69,145,214,WebBN_T,"-37.82293543, 144.9471751"
411120240115,41,2024-01-15,11,1434,1337,2771,Swa31,"-37.81668634, 144.96689733"
411320240215,41,2024-02-15,13,1899,1684,3583,Swa31,"-37.81668634, 144.96689733"
782220250814,78,2025-08-14,22,2,17,19,HarEsB_T,"-37.81471642, 144.9446508"
78220251017,78,2025-10-17,2,0,4,4,HarEsB_T,"-37.81471642, 144.9446508"
711920240826,71,2024-08-26,19,4,14,18,WestWP_T,"-37.81235775, 144.97136962"
652320240426,65,2024-04-26,23,113,223,336,SwaCs_T,"-37.81569416, 144.9668064"
771320250313,77,2025-03-13,13,167,128,295,HarEsP_T,"-37.81441438, 144.94433026"
311120241210,31,2024-12-10,11,99,95,194,Lyg161_T,"-37.80169681, 144.96658911"
311220231122,31,2023-11-22,12,139,126,265,Lyg161_T,"-37.80169681, 144.96658911"
401920240807,40,2024-08-07,19,104,91,195,Spr201_T,"-37.80999341, 144.97227587"
21720250613,21,2025-06-13,7,19,26,45,Bourke155_T,"-37.81267313, 144.96788288"
36720250817,36,2025-08-17,7,14,21,35,Que85_T,"-37.81652527, 144.96121062"
36420250823,36,2025-08-23,4,17,11,28,Que85_T,"-37.81652527, 144.96121062"
108320250911,108,2025-09-11,3,5,3,8,261Will_T,"-37.81295822, 144.95678789"
108520241116,108,2024-11-16,5,8,13,21,261Will_T,"-37.81295822, 144.95678789"
87120240219,87,2024-02-19,1,0,1,1,Errol23_T,"-37.80454949, 144.94921863"
431520240317,43,2024-03-17,15,122,65,187,UM2_T,"-37.79844526, 144.96411782"
432320240408,43,2024-04-08,23,2,4,6,UM2_T,"-37.79844526, 144.96411782"
1401820241014,140,2024-10-14,18,122,147,269,Boyd2837_T,"-37.82590962, 144.96185972"
1401220250610,140,2025-06-10,12,75,60,135,Boyd2837_T,"-37.82590962, 144.96185972"
162620241205,162,2024-12-05,6,81,54,135,Eli489_T,"-37.80740397, 144.95987909"
185820250726,185,2025-07-26,8,108,120,228,Eli197_T,"-37.81374643, 144.96276183"
1401620231207,140,2023-12-07,16,100,109,209,Boyd2837_T,"-37.82590962, 144.96185972"
1321720240416,132,2024-04-16,17,203,176,379,King335_T,"-37.81267639, 144.95386444"
134620231202,134,2023-12-02,6,65,62,127,Spen201_T,"-37.81694221, 144.95303935"
1332120250404,133,2025-04-04,21,435,267,702,Spen229_T,"-37.81531435, 144.95227769"
1181520240613,118,2024-06-13,15,8,16,24,Fli114C_T,"-37.81632783, 144.97090512"
1181120250222,118,2025-02-22,11,17,12,29,Fli114C_T,"-37.81632783, 144.97090512"
1071620241218,107,2024-12-18,16,187,147,334,280Will_T,"-37.81246271, 144.95690188"
6320240210,6,2024-02-10,3,49,46,95,FliS_T,"-37.81911705, 144.96558255"
84520240325,84,2024-03-25,5,62,45,107,ElFi_T,"-37.81798049, 144.96503383"
6720250720,6,2025-07-20,7,116,99,215,FliS_T,"-37.81911705, 144.96558255"
4120240913,4,2024-09-13,1,38,11,49,Swa123_T,"-37.81487988, 144.9660878"
3020240623,3,2024-06-23,0,303,430,733,Swa295_T,"-37.81101524, 144.96429485"
351420250515,35,2025-05-15,14,885,906,1791,SouthB_T,"-37.82018685, 144.96508508"
53420231117,53,2023-11-17,4,5,2,7,Col254_T,"-37.81564191, 144.965499"
52720231220,52,2023-12-20,7,57,75,132,Eli263_T,"-37.81252157, 144.9619401"
521320231122,52,2023-11-22,13,563,522,1085,Eli263_T,"-37.81252157, 144.9619401"
511820241212,51,2024-12-12,18,121,109,230,Fra118_T,"-37.80841815, 144.95906316"
51420240730,51,2024-07-30,4,4,7,11,Fra118_T,"-37.80841815, 144.95906316"
191020240702,19,2024-07-02,10,158,101,259,LtB210_T,"-37.81237202, 144.96550671"
201120250228,20,2025-02-28,11,112,130,242,LtB170_T,"-37.81172914, 144.9682466"
1372020240605,137,2024-06-05,20,2,3,5,BouHbr2353_T,"-37.81894815, 144.94612292"
1371820240607,137,2024-06-07,18,6,37,43,BouHbr2353_T,"-37.81894815, 144.94612292"
1641020250105,164,2025-01-05,10,79,28,107,Lat526_T,"-37.813005, 144.95160411"
1381320240628,138,2024-06-28,13,9,5,14,EntPark1671_T,"-37.81996544, 144.95981454"
1171820241230,117,2024-12-30,18,197,259,456,Fli114F_T,"-37.81629332, 144.97090877"
691320240223,69,2024-02-23,13,238,266,504,FLDegC_T,"-37.81687226, 144.96559144"
6020240320,6,2024-03-20,0,94,47,141,FliS_T,"-37.81911705, 144.96558255"
6720250217,6,2025-02-17,7,440,557,997,FliS_T,"-37.81911705, 144.96558255"
662220240621,66,2024-06-21,22,666,445,1111,QVN_T,"-37.81057846, 144.96444294"
69220250825,69,2025-08-25,2,0,1,1,FLDegC_T,"-37.81687226, 144.96559144"
6620250605,6,2025-06-05,6,178,345,523,FliS_T,"-37.81911705, 144.96558255"
3020241223,3,2024-12-23,0,127,108,235,Swa295_T,"-37.81101524, 144.96429485"
41220240724,4,2024-07-24,12,1392,1136,2528,Swa123_T,"-37.81487988, 144.9660878"
41220241107,4,2024-11-07,12,1545,1092,2637,Swa123_T,"-37.81487988, 144.9660878"
8820240311,8,2024-03-11,8,68,93,161,WebBN_T,"-37.82293543, 144.9471751"
411220250523,41,2025-05-23,12,422,377,799,Swa31,"-37.81668634, 144.96689733"
28120240326,28,2024-03-26,1,11,2,13,VAC_T,"-37.82129925, 144.96879309"
29420250111,29,2025-01-11,4,3,8,11,AG_T,"-37.8199817, 144.96872865"
281620250723,28,2025-07-23,16,293,996,1289,VAC_T,"-37.82129925, 144.96879309"
401520240901,40,2024-09-01,15,223,110,333,Spr201_T,"-37.80999341, 144.97227587"
361320250131,36,2025-01-31,13,258,264,522,Que85_T,"-37.81652527, 144.96121062"
36720240623,36,2024-06-23,7,11,11,22,Que85_T,"-37.81652527, 144.96121062"
37720240216,37,2024-02-16,7,13,33,46,Lyg260_T,"-37.80107122, 144.96704554"
501420250929,50,2025-09-29,14,248,237,485,Lyg309_T,"-37.79808192, 144.96721013"
441620240724,44,2024-07-24,16,134,87,221,UM3_T,"-37.79698741, 144.96441306"
452120250821,45,2025-08-21,21,339,639,978,Swa148_T,"-37.81414075, 144.96609379"
167820250929,167,2025-09-29,8,15,55,70,Lat526_T,"-37.81304149, 144.95155955"
1811820250513,181,2025-05-13,18,1060,1206,2266,Eli368_T,"-37.81009465, 144.96143149"
134020240130,134,2024-01-30,0,24,42,66,Spen201_T,"-37.81694221, 144.95303935"
1331720240713,133,2024-07-13,17,491,396,887,Spen229_T,"-37.81531435, 144.95227769"
1301920250712,130,2025-07-12,19,48,14,62,Bou892T,"-37.8204637, 144.94126826"
1381620250119,138,2025-01-19,16,4,13,17,EntPark1671_T,"-37.81996544, 144.95981454"
49220240828,49,2024-08-28,2,22,30,52,Eli501_T,"-37.80730068, 144.95956055"
1091920240917,109,2024-09-17,19,96,154,250,LatWill_T,"-37.81193681, 144.95621105"
81520241007,8,2024-10-07,15,101,192,293,WebBN_T,"-37.82293543, 144.9471751"
41820250527,41,2025-05-27,8,114,144,258,Swa31,"-37.81668634, 144.96689733"
65920231019,65,2023-10-19,9,323,177,500,SwaCs_T,"-37.81569416, 144.9668064"
541720250811,54,2025-08-11,17,207,547,754,Swa607_T,"-37.804024, 144.96308399"
282120240728,28,2024-07-28,21,65,41,106,VAC_T,"-37.82129925, 144.96879309"
401720250130,40,2025-01-30,17,127,245,372,Spr201_T,"-37.80999341, 144.97227587"
312020240807,31,2024-08-07,20,128,163,291,Lyg161_T,"-37.80169681, 144.96658911"
361420250612,36,2025-06-12,14,234,268,502,Que85_T,"-37.81652527, 144.96121062"
37520250130,37,2025-01-30,5,2,9,11,Lyg260_T,"-37.80107122, 144.96704554"
47820250522,47,2025-05-22,8,282,675,957,Eli250_T,"-37.81258467, 144.9625775"
441120240910,44,2024-09-10,11,91,72,163,UM3_T,"-37.79698741, 144.96441306"
118220240819,118,2024-08-19,2,1,3,4,Fli114C_T,"-37.81632783, 144.97090512"
107220240908,107,2024-09-08,2,22,10,32,280Will_T,"-37.81246271, 144.95690188"
871620250312,87,2025-03-12,16,88,97,185,Errol23_T,"-37.80454949, 144.94921863"
611420240505,61,2024-05-05,14,438,581,1019,RMIT14_T,"-37.80767455, 144.96309114"
501020240325,50,2024-03-25,10,120,172,292,Lyg309_T,"-37.79808192, 144.96721013"
50820240503,50,2024-05-03,8,40,74,114,Lyg309_T,"-37.79808192, 144.96721013"
179920250720,179,2025-07-20,9,40,28,68,Pow61_T,"-37.82392385, 144.96299677"
165620240901,165,2024-09-01,6,1,2,3,Spen475_T,"-37.80953359, 144.94939004"
1622020241215,162,2024-12-15,20,235,197,432,Eli489_T,"-37.80740397, 144.95987909"
1432120250227,143,2025-02-27,21,171,141,312,Spencer_T,"-37.821728, 144.95557015"
681520241030,68,2024-10-30,15,223,201,424,FLDegN_T,"-37.8168479, 144.96559789"
851120231019,85,2023-10-19,11,101,73,174,488Mac_T,"-37.79432415, 144.92973378"
172120250528,17,2025-05-28,21,67,47,114,Col15_T,"-37.81362543, 144.97323591"
1020250306,1,2025-03-06,0,13,16,29,Bou292_T,"-37.81349441, 144.96515323"
181020240611,18,2024-06-11,10,119,190,309,Col12_T,"-37.81344862, 144.97305353"
181520251013,18,2025-10-13,15,288,121,409,Col12_T,"-37.81344862, 144.97305353"
182320240424,18,2024-04-24,23,0,3,3,Col12_T,"-37.81344862, 144.97305353"
632220250121,63,2025-01-21,22,16,77,93,Bou231_T,"-37.81333081, 144.96675571"
631120250917,63,2025-09-17,11,235,324,559,Bou231_T,"-37.81333081, 144.96675571"
621020241128,62,2024-11-28,10,150,155,305,Lat224_T,"-37.80996494, 144.96216521"
621920241220,62,2024-12-20,19,185,146,331,Lat224_T,"-37.80996494, 144.96216521"
56620240627,56,2024-06-27,6,28,18,46,Lon364_T,"-37.81234775, 144.96153311"
862120241027,86,2024-10-27,21,2,8,10,574Qub_T,"-37.80309992, 144.94908064"
86920250923,86,2025-09-23,9,47,27,74,574Qub_T,"-37.80309992, 144.94908064"
761420241021,76,2024-10-21,14,58,64,122,KenMac_T,"-37.79453803, 144.93036194"
22120241009,2,2024-10-09,21,111,166,277,Bou283_T,"-37.81380668, 144.96516718"
2620240223,2,2024-02-23,6,18,22,40,Bou283_T,"-37.81380668, 144.96516718"
9820250826,9,2025-08-26,8,138,3172,3310,Col700_T,"-37.81982992, 144.95102555"
301820250311,30,2025-03-11,18,213,385,598,Lon189_T,"-37.8112185, 144.96656806"
51820231227,51,2023-12-27,8,57,31,88,Fra118_T,"-37.80841815, 144.95906316"
671720241026,67,2024-10-26,17,400,602,1002,FLDegS_T,"-37.81688755, 144.96562569"
17920240822,17,2024-08-22,9,719,236,955,Col15_T,"-37.81362543, 144.97323591"
631620240317,63,2024-03-17,16,278,315,593,Bou231_T,"-37.81333081, 144.96675571"
12920231120,12,2023-11-20,9,130,130,260,NewQ_T,"-37.81457988, 144.94292398"
11520250806,1,2025-08-06,15,943,986,1929,Bou292_T,"-37.81349441, 144.96515323"
682020240508,68,2024-05-08,20,66,16,82,FLDegN_T,"-37.8168479, 144.96559789"
62520250604,62,2025-06-04,5,6,7,13,Lat224_T,"-37.80996494, 144.96216521"
561320240915,56,2024-09-15,13,424,296,720,Lon364_T,"-37.81234775, 144.96153311"
761520241231,76,2024-12-31,15,31,26,57,KenMac_T,"-37.79453803, 144.93036194"
21320250209,2,2025-02-09,13,580,703,1283,Bou283_T,"-37.81380668, 144.96516718"
79820250308,79,2025-03-08,8,177,86,263,FliSS_T,"-37.81794046, 144.96616678"
52320240101,52,2024-01-01,3,163,98,261,Eli263_T,"-37.81252157, 144.9619401"
201720240928,20,2024-09-28,17,372,406,778,LtB170_T,"-37.81172914, 144.9682466"
522320241104,52,2024-11-04,23,104,71,175,Eli263_T,"-37.81252157, 144.9619401"
139020250304,139,2025-03-04,0,7,1,8,Signal1647_T,"-37.81959923, 144.9632832"
136920241222,136,2024-12-22,9,83,62,145,BirFed1120_T,"-37.8184141, 144.97357915"
1422120250527,142,2025-05-27,21,8,0,8,Hammer1584_T,"-37.81970749, 144.96795734"
75620240501,75,2024-05-01,6,34,14,48,SprFli_T,"-37.81515276, 144.97467661"
751320250422,75,2025-04-22,13,68,65,133,SprFli_T,"-37.81515276, 144.97467661"
8620250209,8,2025-02-09,6,9,21,30,WebBN_T,"-37.82293543, 144.9471751"
78720240625,78,2024-06-25,7,9,19,28,HarEsB_T,"-37.81471642, 144.9446508"
781020240112,78,2024-01-12,10,33,51,84,HarEsB_T,"-37.81471642, 144.9446508"
592120240625,59,2024-06-25,21,307,173,480,RMIT_T,"-37.80825648, 144.96304859"
281520240527,28,2024-05-27,15,374,615,989,VAC_T,"-37.82129925, 144.96879309"
71620240904,71,2024-09-04,6,3,3,6,WestWP_T,"-37.81235775, 144.97136962"
712320240525,71,2024-05-25,23,13,4,17,WestWP_T,"-37.81235775, 144.97136962"
28520231118,28,2023-11-18,5,12,33,45,VAC_T,"-37.82129925, 144.96879309"
471820250413,47,2025-04-13,18,789,689,1478,Eli250_T,"-37.81258467, 144.9625775"
212020241125,21,2024-11-25,20,214,227,441,Bourke155_T,"-37.81267313, 144.96788288"
211020250316,21,2025-03-16,10,81,71,152,Bourke155_T,"-37.81267313, 144.96788288"
361920240306,36,2024-03-06,19,120,135,255,Que85_T,"-37.81652527, 144.96121062"
361620240312,36,2024-03-12,16,189,227,416,Que85_T,"-37.81652527, 144.96121062"
371320250314,37,2025-03-14,13,50,64,114,Lyg260_T,"-37.80107122, 144.96704554"
371120231025,37,2023-10-25,11,70,58,128,Lyg260_T,"-37.80107122, 144.96704554"
371920240226,37,2024-02-26,19,174,157,331,Lyg260_T,"-37.80107122, 144.96704554"
87620240302,87,2024-03-02,6,7,4,11,Errol23_T,"-37.80454949, 144.94921863"
611420250822,61,2025-08-22,14,536,799,1335,RMIT14_T,"-37.80767455, 144.96309114"
611320250928,61,2025-09-28,13,347,427,774,RMIT14_T,"-37.80767455, 144.96309114"
502220241224,50,2024-12-24,22,36,22,58,Lyg309_T,"-37.79808192, 144.96721013"
501420250512,50,2025-05-12,14,160,160,320,Lyg309_T,"-37.79808192, 144.96721013"
501020240708,50,2024-07-08,10,102,110,212,Lyg309_T,"-37.79808192, 144.96721013"
441220250529,44,2025-05-29,12,137,108,245,UM3_T,"-37.79698741, 144.96441306"
431120240407,43,2024-04-07,11,71,67,138,UM2_T,"-37.79844526, 144.96411782"
431920241123,43,2024-11-23,19,24,31,55,UM2_T,"-37.79844526, 144.96411782"
452320240705,45,2024-07-05,23,428,369,797,Swa148_T,"-37.81414075, 144.96609379"
51420250331,5,2025-03-31,14,892,1012,1904,PriNW_T,"-37.81874249, 144.96787656"
52220250409,5,2025-04-09,22,159,129,288,PriNW_T,"-37.81874249, 144.96787656"
166920250828,166,2025-08-28,9,19,29,48,Spen484_T,"-37.80896733, 144.94931703"
1671820241122,167,2024-11-22,18,49,92,141,Lat526_T,"-37.81304149, 144.95155955"
852220240412,85,2024-04-12,22,15,13,28,488Mac_T,"-37.79432415, 144.92973378"
852220250416,85,2025-04-16,22,9,7,16,488Mac_T,"-37.79432415, 144.92973378"
17520240329,17,2024-03-29,5,21,10,31,Col15_T,"-37.81362543, 144.97323591"
11820231221,1,2023-12-21,18,1737,1896,3633,Bou292_T,"-37.81349441, 144.96515323"
62620240330,62,2024-03-30,6,15,14,29,Lat224_T,"-37.80996494, 144.96216521"
56720240222,56,2024-02-22,7,66,79,145,Lon364_T,"-37.81234775, 144.96153311"
12420241108,12,2024-11-08,4,0,1,1,NewQ_T,"-37.81457988, 144.94292398"
111820241226,11,2024-12-26,18,137,138,275,WatCit_T,"-37.81564989, 144.93970694"
241720250208,24,2025-02-08,17,555,1286,1841,Col620_T,"-37.81887963, 144.95449198"
24720250520,24,2025-05-20,7,1149,270,1419,Col620_T,"-37.81887963, 144.95449198"
27120240217,27,2024-02-17,1,16,10,26,Vic_T,"-37.80606888, 144.95644692"
58720250407,58,2025-04-07,7,683,104,787,Bou688_T,"-37.81686075, 144.95358075"
21920240904,2,2024-09-04,19,169,172,341,Bou283_T,"-37.81380668, 144.96516718"
792120250203,79,2025-02-03,21,197,209,406,FliSS_T,"-37.81794046, 144.96616678"
301920240729,30,2024-07-29,19,239,265,504,Lon189_T,"-37.8112185, 144.96656806"
511020231105,51,2023-11-05,10,102,109,211,Fra118_T,"-37.80841815, 144.95906316"
461020250806,46,2025-08-06,10,146,64,210,Pel147_T,"-37.80240719, 144.9615673"
52820231230,52,2023-12-30,8,39,31,70,Eli263_T,"-37.81252157, 144.9619401"
51720250318,51,2025-03-18,7,33,25,58,Fra118_T,"-37.80841815, 144.95906316"
1361420240924,136,2024-09-24,14,68,47,115,BirFed1120_T,"-37.8184141, 144.97357915"
1301120250822,130,2025-08-22,11,53,42,95,Bou892T,"-37.8204637, 144.94126826"
1612320250122,161,2025-01-22,23,3,161,164,BirArt1109_T,"-37.81851276, 144.97131336"
1171120250612,117,2025-06-12,11,129,156,285,Fli114F_T,"-37.81629332, 144.97090877"
1231020250422,123,2025-04-22,10,29,16,45,BirBridge_T,"-37.81753741, 144.97329734"
1381220250904,138,2025-09-04,12,6,4,10,EntPark1671_T,"-37.81996544, 144.95981454"
1171720231222,117,2023-12-22,17,216,191,407,Fli114F_T,"-37.81629332, 144.97090877"
692020241106,69,2024-11-06,20,42,15,57,FLDegC_T,"-37.81687226, 144.96559144"
41620250901,4,2025-09-01,16,1270,1185,2455,Swa123_T,"-37.81487988, 144.9660878"
702120250217,70,2025-02-17,21,55,58,113,Errol20_T,"-37.80456984, 144.94946228"
70620250629,70,2025-06-29,6,3,7,10,Errol20_T,"-37.80456984, 144.94946228"
70720250813,70,2025-08-13,7,35,34,69,Errol20_T,"-37.80456984, 144.94946228"
3120250413,3,2025-04-13,1,246,226,472,Swa295_T,"-37.81101524, 144.96429485"
41520250806,41,2025-08-06,5,120,61,181,Swa31,"-37.81668634, 144.96689733"
781520250605,78,2025-06-05,15,16,89,105,HarEsB_T,"-37.81471642, 144.9446508"
141020231206,14,2023-12-06,10,306,137,443,SanBri_T,"-37.82011242, 144.96291897"
711120250824,71,2025-08-24,11,5,5,10,WestWP_T,"-37.81235775, 144.97136962"
311320250105,31,2025-01-05,13,152,110,262,Lyg161_T,"-37.80169681, 144.96658911"
36420240521,36,2024-05-21,4,5,4,9,Que85_T,"-37.81652527, 144.96121062"
1081420241011,108,2024-10-11,14,231,248,479,261Will_T,"-37.81295822, 144.95678789"
61720231204,61,2023-12-04,7,64,126,190,RMIT14_T,"-37.80767455, 144.96309114"
441120240618,44,2024-06-18,11,75,66,141,UM3_T,"-37.79698741, 144.96441306"
25120240807,25,2024-08-07,1,3,3,6,MCEC_T,"-37.82401776, 144.95604426"
48820250114,48,2025-01-14,8,158,100,258,QVMQ_T,"-37.80631581, 144.95866697"
192120231205,19,2023-12-05,21,345,522,867,LtB210_T,"-37.81237202, 144.96550671"
301020250903,30,2025-09-03,10,103,179,282,Lon189_T,"-37.8112185, 144.96656806"
46520240608,46,2024-06-08,5,4,0,4,Pel147_T,"-37.80240719, 144.9615673"
20320240112,20,2024-01-12,3,21,39,60,LtB170_T,"-37.81172914, 144.9682466"
462020250826,46,2025-08-26,20,1,0,1,Pel147_T,"-37.80240719, 144.9615673"
141720250331,141,2025-03-31,7,49,35,84,474Fl_T,"-37.81997273, 144.95834911"
141820231122,141,2023-11-22,8,139,144,283,474Fl_T,"-37.81997273, 144.95834911"
1361420241217,136,2024-12-17,14,65,36,101,BirFed1120_T,"-37.8184141, 144.97357915"
49820240908,49,2024-09-08,8,135,122,257,Eli501_T,"-37.80730068, 144.95956055"
691220240219,69,2024-02-19,12,236,256,492,FLDegC_T,"-37.81687226, 144.96559144"
692320241113,69,2024-11-13,23,7,10,17,FLDegC_T,"-37.81687226, 144.96559144"
61020240120,6,2024-01-20,10,779,617,1396,FliS_T,"-37.81911705, 144.96558255"
841920231122,84,2023-11-22,19,754,1198,1952,ElFi_T,"-37.81798049, 144.96503383"
841020241004,84,2024-10-04,10,918,706,1624,ElFi_T,"-37.81798049, 144.96503383"
70620241202,70,2024-12-02,6,9,8,17,Errol20_T,"-37.80456984, 144.94946228"
8920250928,8,2025-09-28,9,84,154,238,WebBN_T,"-37.82293543, 144.9471751"
82220241201,8,2024-12-01,22,15,14,29,WebBN_T,"-37.82293543, 144.9471751"
75620250807,75,2025-08-07,6,14,21,35,SprFli_T,"-37.81515276, 144.97467661"
75820250810,75,2025-08-10,8,15,30,45,SprFli_T,"-37.81515276, 144.97467661"
41920231106,41,2023-11-06,9,1299,492,1791,Swa31,"-37.81668634, 144.96689733"
781420240813,78,2024-08-13,14,33,65,98,HarEsB_T,"-37.81471642, 144.9446508"
771720231110,77,2023-11-10,17,172,75,247,HarEsP_T,"-37.81441438, 144.94433026"
141720240229,14,2024-02-29,17,1067,210,1277,SanBri_T,"-37.82011242, 144.96291897"
65620240301,65,2024-03-01,6,60,32,92,SwaCs_T,"-37.81569416, 144.9668064"
541220231216,54,2023-12-16,12,108,79,187,Swa607_T,"-37.804024, 144.96308399"
281520240819,28,2024-08-19,15,422,669,1091,VAC_T,"-37.82129925, 144.96879309"
28520240608,28,2024-06-08,5,15,50,65,VAC_T,"-37.82129925, 144.96879309"
291320250717,29,2025-07-17,13,288,292,580,AG_T,"-37.8199817, 144.96872865"
29820251015,29,2025-10-15,8,191,156,347,AG_T,"-37.8199817, 144.96872865"
401420250524,40,2025-05-24,14,146,169,315,Spr201_T,"-37.80999341, 144.97227587"
401220231211,40,2023-12-11,12,269,352,621,Spr201_T,"-37.80999341, 144.97227587"
541220250226,54,2025-02-26,12,125,163,288,Swa607_T,"-37.804024, 144.96308399"
36020240417,36,2024-04-17,0,7,21,28,Que85_T,"-37.81652527, 144.96121062"
37020231211,37,2023-12-11,0,45,9,54,Lyg260_T,"-37.80107122, 144.96704554"
471420250905,47,2025-09-05,14,959,928,1887,Eli250_T,"-37.81258467, 144.9625775"
471820250619,47,2025-06-19,18,1057,755,1812,Eli250_T,"-37.81258467, 144.9625775"
442320240816,44,2024-08-16,23,16,5,21,UM3_T,"-37.79698741, 144.96441306"
452120241105,45,2024-11-05,21,108,370,478,Swa148_T,"-37.81414075, 144.96609379"
451720250115,45,2025-01-15,17,677,685,1362,Swa148_T,"-37.81414075, 144.96609379"
1322120250624,132,2025-06-24,21,80,69,149,King335_T,"-37.81267639, 144.95386444"
1081420250523,108,2025-05-23,14,385,247,632,261Will_T,"-37.81295822, 144.95678789"
1081720251012,108,2025-10-12,17,122,124,246,261Will_T,"-37.81295822, 144.95678789"
184920250918,184,2025-09-18,9,399,438,837,Eli124_T,"-37.81512416, 144.96371988"
131320240825,131,2024-08-25,3,46,116,162,King2_T,"-37.82009057, 144.95758725"
1401520240216,140,2024-02-16,15,107,81,188,Boyd2837_T,"-37.82590962, 144.96185972"
143720240808,143,2024-08-08,7,98,121,219,Spencer_T,"-37.821728, 144.95557015"
134020240309,134,2024-03-09,0,97,100,197,Spen201_T,"-37.81694221, 144.95303935"
135220241127,135,2024-11-27,2,8,9,17,Spen161_T,"-37.8172861, 144.95319102"
672120250129,67,2025-01-29,21,123,182,305,FLDegS_T,"-37.81688755, 144.96562569"
682320250215,68,2025-02-15,23,21,23,44,FLDegN_T,"-37.8168479, 144.96559789"
631820240823,63,2024-08-23,18,335,300,635,Bou231_T,"-37.81333081, 144.96675571"
121420250212,12,2025-02-12,14,85,59,144,NewQ_T,"-37.81457988, 144.94292398"
101720250725,10,2025-07-25,17,249,95,344,BouHbr_T,"-37.81876474, 144.94710545"
271220250520,27,2025-05-20,12,213,159,372,Vic_T,"-37.80606888, 144.95644692"
272120250920,27,2025-09-20,21,85,36,121,Vic_T,"-37.80606888, 144.95644692"
791320241031,79,2024-10-31,13,459,376,835,FliSS_T,"-37.81794046, 144.96616678"
79920240218,79,2024-02-18,9,301,182,483,FliSS_T,"-37.81794046, 144.96616678"
792020250710,79,2025-07-10,20,196,228,424,FliSS_T,"-37.81794046, 144.96616678"
23220241008,23,2024-10-08,2,7,3,10,Col623_T,"-37.81909256, 144.95452748"
231020231226,23,2023-12-26,10,103,81,184,Col623_T,"-37.81909256, 144.95452748"
301320250311,30,2025-03-11,13,287,368,655,Lon189_T,"-37.8112185, 144.96656806"
23720250716,23,2025-07-16,7,330,213,543,Col623_T,"-37.81909256, 144.95452748"
51720250421,51,2025-04-21,7,18,24,42,Fra118_T,"-37.80841815, 144.95906316"
202220241212,20,2024-12-12,22,170,420,590,LtB170_T,"-37.81172914, 144.9682466"
141020240329,141,2024-03-29,0,45,111,156,474Fl_T,"-37.81997273, 144.95834911"
141820240402,141,2024-04-02,8,79,92,171,474Fl_T,"-37.81997273, 144.95834911"
136120241019,136,2024-10-19,1,1,0,1,BirFed1120_T,"-37.8184141, 144.97357915"
1421620240730,142,2024-07-30,16,308,283,591,Hammer1584_T,"-37.81970749, 144.96795734"
1611620241212,161,2024-12-12,16,79,93,172,BirArt1109_T,"-37.81851276, 144.97131336"
1611320250801,161,2025-08-01,13,177,174,351,BirArt1109_T,"-37.81851276, 144.97131336"
1611120240626,161,2024-06-26,11,162,108,270,BirArt1109_T,"-37.81851276, 144.97131336"
117520250119,117,2025-01-19,5,9,13,22,Fli114F_T,"-37.81629332, 144.97090877"
66520250515,66,2025-05-15,5,14,33,47,QVN_T,"-37.81057846, 144.96444294"
69720240724,69,2024-07-24,7,58,18,76,FLDegC_T,"-37.81687226, 144.96559144"
66420240413,66,2024-04-13,4,24,8,32,QVN_T,"-37.81057846, 144.96444294"
32320240513,3,2024-05-13,23,224,187,411,Swa295_T,"-37.81101524, 144.96429485"
751620240415,75,2024-04-15,16,42,46,88,SprFli_T,"-37.81515276, 144.97467661"
39120250301,39,2025-03-01,1,10,16,26,AlfPl_T,"-37.81379749, 144.96995745"
75120240506,75,2024-05-06,1,0,1,1,SprFli_T,"-37.81515276, 144.97467661"
41220240821,41,2024-08-21,2,18,21,39,Swa31,"-37.81668634, 144.96689733"
771020241109,77,2024-11-09,10,172,135,307,HarEsP_T,"-37.81441438, 144.94433026"
771020250214,77,2025-02-14,10,89,71,160,HarEsP_T,"-37.81441438, 144.94433026"
772120250620,77,2025-06-20,21,83,51,134,HarEsP_T,"-37.81441438, 144.94433026"
772320250911,77,2025-09-11,23,27,12,39,HarEsP_T,"-37.81441438, 144.94433026"
781020241009,78,2024-10-09,10,23,36,59,HarEsB_T,"-37.81471642, 144.9446508"
29820240609,29,2024-06-09,8,43,124,167,AG_T,"-37.8199817, 144.96872865"
59520250425,59,2025-04-25,5,8,6,14,RMIT_T,"-37.80825648, 144.96304859"
591720250830,59,2025-08-30,17,638,534,1172,RMIT_T,"-37.80825648, 144.96304859"
711620231218,71,2023-12-18,16,19,8,27,WestWP_T,"-37.81235775, 144.97136962"
59720240630,59,2024-06-30,7,16,19,35,RMIT_T,"-37.80825648, 144.96304859"
541420250904,54,2025-09-04,14,169,200,369,Swa607_T,"-37.804024, 144.96308399"
54220250415,54,2025-04-15,2,12,11,23,Swa607_T,"-37.804024, 144.96308399"
28920240905,28,2024-09-05,9,517,345,862,VAC_T,"-37.82129925, 144.96879309"
281720231019,28,2023-10-19,17,464,1116,1580,VAC_T,"-37.82129925, 144.96879309"
312020250107,31,2025-01-07,20,242,199,441,Lyg161_T,"-37.80169681, 144.96658911"
37620240513,37,2024-05-13,6,7,4,11,Lyg260_T,"-37.80107122, 144.96704554"
37320240519,37,2024-05-19,3,1,5,6,Lyg260_T,"-37.80107122, 144.96704554"
5720240721,5,2024-07-21,7,210,296,506,PriNW_T,"-37.81874249, 144.96787656"
212020250910,21,2025-09-10,20,161,203,364,Bourke155_T,"-37.81267313, 144.96788288"
21020240519,21,2024-05-19,0,339,269,608,Bourke155_T,"-37.81267313, 144.96788288"
21420240614,21,2024-06-14,4,17,29,46,Bourke155_T,"-37.81267313, 144.96788288"
1661020250609,166,2025-06-09,10,25,30,55,Spen484_T,"-37.80896733, 144.94931703"
131620240319,131,2024-03-19,6,27,25,52,King2_T,"-37.82009057, 144.95758725"
143620240608,143,2024-06-08,6,26,33,59,Spencer_T,"-37.821728, 144.95557015"
1321120241209,132,2024-12-09,11,120,81,201,King335_T,"-37.81267639, 144.95386444"
134920241016,134,2024-10-16,9,370,415,785,Spen201_T,"-37.81694221, 144.95303935"
1341520241104,134,2024-11-04,15,571,494,1065,Spen201_T,"-37.81694221, 144.95303935"
1351420250130,135,2025-01-30,14,309,398,707,Spen161_T,"-37.8172861, 144.95319102"
442020250311,44,2025-03-11,20,34,44,78,UM3_T,"-37.79698741, 144.96441306"
441520250406,44,2025-04-06,15,63,42,105,UM3_T,"-37.79698741, 144.96441306"
166420250309,166,2025-03-09,4,1,0,1,Spen484_T,"-37.80896733, 144.94931703"
162120250907,162,2025-09-07,1,57,36,93,Eli489_T,"-37.80740397, 144.95987909"
140920240128,140,2024-01-28,9,110,25,135,Boyd2837_T,"-37.82590962, 144.96185972"
143720250415,143,2025-04-15,7,67,96,163,Spencer_T,"-37.821728, 144.95557015"
134320240711,134,2024-07-11,3,23,12,35,Spen201_T,"-37.81694221, 144.95303935"
135820250103,135,2025-01-03,8,165,168,333,Spen161_T,"-37.8172861, 144.95319102"
135120240118,135,2024-01-18,1,27,28,55,Spen161_T,"-37.8172861, 144.95319102"
67320250421,67,2025-04-21,3,4,2,6,FLDegS_T,"-37.81688755, 144.96562569"
851520240116,85,2024-01-16,15,45,55,100,488Mac_T,"-37.79432415, 144.92973378"
11020240526,1,2024-05-26,10,474,524,998,Bou292_T,"-37.81349441, 144.96515323"
681520241120,68,2024-11-20,15,252,194,446,FLDegN_T,"-37.8168479, 144.96559789"
632120250808,63,2025-08-08,21,88,241,329,Bou231_T,"-37.81333081, 144.96675571"
12020250702,1,2025-07-02,20,198,244,442,Bou292_T,"-37.81349441, 144.96515323"
62420231222,62,2023-12-22,4,15,11,26,Lat224_T,"-37.80996494, 144.96216521"
62120240408,62,2024-04-08,1,38,33,71,Lat224_T,"-37.80996494, 144.96216521"
121920250418,12,2025-04-18,19,393,301,694,NewQ_T,"-37.81457988, 144.94292398"
242320231218,24,2023-12-18,23,111,177,288,Col620_T,"-37.81887963, 144.95449198"
72920240819,72,2024-08-19,9,214,123,337,ACMI_T,"-37.81726338, 144.96872809"
24020251005,24,2025-10-05,0,126,213,339,Col620_T,"-37.81887963, 144.95449198"
35120250215,35,2025-02-15,1,113,195,308,SouthB_T,"-37.82018685, 144.96508508"
722220250901,72,2025-09-01,22,11,39,50,ACMI_T,"-37.81726338, 144.96872809"
22320250128,2,2025-01-28,23,18,50,68,Bou283_T,"-37.81380668, 144.96516718"
561920251005,56,2025-10-05,19,381,509,890,Lon364_T,"-37.81234775, 144.96153311"
2220250730,2,2025-07-30,2,3,7,10,Bou283_T,"-37.81380668, 144.96516718"
79520250131,79,2025-01-31,5,25,32,57,FliSS_T,"-37.81794046, 144.96616678"
791620231215,79,2023-12-15,16,723,537,1260,FliSS_T,"-37.81794046, 144.96616678"
51020240329,51,2024-03-29,0,23,33,56,Fra118_T,"-37.80841815, 144.95906316"
511020241112,51,2024-11-12,10,68,75,143,Fra118_T,"-37.80841815, 144.95906316"
79020250712,79,2025-07-12,0,49,58,107,FliSS_T,"-37.81794046, 144.96616678"
232020240430,23,2024-04-30,20,60,188,248,Col623_T,"-37.81909256, 144.95452748"
461620240929,46,2024-09-29,16,62,56,118,Pel147_T,"-37.80240719, 144.9615673"
461020250319,46,2025-03-19,10,147,87,234,Pel147_T,"-37.80240719, 144.9615673"
191820241029,19,2024-10-29,18,586,428,1014,LtB210_T,"-37.81237202, 144.96550671"
191020250610,19,2025-06-10,10,167,148,315,LtB210_T,"-37.81237202, 144.96550671"
301320250603,30,2025-06-03,13,284,371,655,Lon189_T,"-37.8112185, 144.96656806"
25820240704,25,2024-07-04,8,185,308,493,MCEC_T,"-37.82401776, 144.95604426"
202020240411,20,2024-04-11,20,381,629,1010,LtB170_T,"-37.81172914, 144.9682466"
1411420250502,141,2025-05-02,14,237,108,345,474Fl_T,"-37.81997273, 144.95834911"
1421820231126,142,2023-11-26,18,397,499,896,Hammer1584_T,"-37.81970749, 144.96795734"
130820240407,130,2024-04-07,8,1,1,2,Bou892T,"-37.8204637, 144.94126826"
1231020240210,123,2024-02-10,10,23,8,31,BirBridge_T,"-37.81753741, 144.97329734"
1381720250125,138,2025-01-25,17,4,6,10,EntPark1671_T,"-37.81996544, 144.95981454"
1091320240624,109,2024-06-24,13,199,212,411,LatWill_T,"-37.81193681, 144.95621105"
662220250530,66,2025-05-30,22,693,618,1311,QVN_T,"-37.81057846, 144.96444294"
662020250708,66,2025-07-08,20,923,627,1550,QVN_T,"-37.81057846, 144.96444294"
66920250728,66,2025-07-28,9,274,401,675,QVN_T,"-37.81057846, 144.96444294"
661320240821,66,2024-08-21,13,1171,1209,2380,QVN_T,"-37.81057846, 144.96444294"
69920250907,69,2025-09-07,9,173,62,235,FLDegC_T,"-37.81687226, 144.96559144"
1241320250115,124,2025-01-15,13,6,9,15,BirBridge_T,"-37.81757416, 144.97329934"
124820250812,124,2025-08-12,8,3,3,6,BirBridge_T,"-37.81757416, 144.97329934"
871520241012,87,2024-10-12,15,82,109,191,Errol23_T,"-37.80454949, 144.94921863"
87320240224,87,2024-02-24,3,1,1,2,Errol23_T,"-37.80454949, 144.94921863"
611320240420,61,2024-04-20,13,279,467,746,RMIT14_T,"-37.80767455, 144.96309114"
431720240918,43,2024-09-18,17,339,414,753,UM2_T,"-37.79844526, 144.96411782"
179720250303,179,2025-03-03,7,41,21,62,Pow61_T,"-37.82392385, 144.96299677"
167020240928,167,2024-09-28,0,3,9,12,Lat526_T,"-37.81304149, 144.95155955"
1311420240726,131,2024-07-26,14,148,97,245,King2_T,"-37.82009057, 144.95758725"
17020251013,17,2025-10-13,0,5,6,11,Col15_T,"-37.81362543, 144.97323591"
11720240716,1,2024-07-16,17,1117,863,1980,Bou292_T,"-37.81349441, 144.96515323"
63920240701,63,2024-07-01,9,135,155,290,Bou231_T,"-37.81333081, 144.96675571"
681520240530,68,2024-05-30,15,159,90,249,FLDegN_T,"-37.8168479, 144.96559789"
182220250304,18,2025-03-04,22,23,4,27,Col12_T,"-37.81344862, 144.97305353"
63120240105,63,2024-01-05,1,19,73,92,Bou231_T,"-37.81333081, 144.96675571"
56220240802,56,2024-08-02,2,13,11,24,Lon364_T,"-37.81234775, 144.96153311"
56320241224,56,2024-12-24,3,3,10,13,Lon364_T,"-37.81234775, 144.96153311"
241120240201,24,2024-02-01,11,614,441,1055,Col620_T,"-37.81887963, 144.95449198"
24120240420,24,2024-04-20,1,72,95,167,Col620_T,"-37.81887963, 144.95449198"
242220241122,24,2024-11-22,22,280,578,858,Col620_T,"-37.81887963, 144.95449198"
561820251001,56,2025-10-01,18,390,507,897,Lon364_T,"-37.81234775, 144.96153311"
72020240131,72,2024-01-31,0,7,17,24,ACMI_T,"-37.81726338, 144.96872809"
2520231208,2,2023-12-08,5,3,19,22,Bou283_T,"-37.81380668, 144.96516718"
21620240718,2,2024-07-18,16,589,546,1135,Bou283_T,"-37.81380668, 144.96516718"
462320231113,46,2023-11-13,23,26,18,44,Pel147_T,"-37.80240719, 144.9615673"
511020240315,51,2024-03-15,10,124,96,220,Fra118_T,"-37.80841815, 144.95906316"
19820241001,19,2024-10-01,8,116,52,168,LtB210_T,"-37.81237202, 144.96550671"
461320240612,46,2024-06-12,13,131,154,285,Pel147_T,"-37.80240719, 144.9615673"
20820240526,20,2024-05-26,8,28,38,66,LtB170_T,"-37.81172914, 144.9682466"
20320240613,20,2024-06-13,3,8,1,9,LtB170_T,"-37.81172914, 144.9682466"
25520231026,25,2023-10-26,5,16,12,28,MCEC_T,"-37.82401776, 144.95604426"
1372020241118,137,2024-11-18,20,3,31,34,BouHbr2353_T,"-37.81894815, 144.94612292"
141020240308,141,2024-03-08,0,10,28,38,474Fl_T,"-37.81997273, 144.95834911"
1422020240109,142,2024-01-09,20,484,368,852,Hammer1584_T,"-37.81970749, 144.96795734"
142720240714,142,2024-07-14,7,33,14,47,Hammer1584_T,"-37.81970749, 144.96795734"
1301420241201,130,2024-12-01,14,46,36,82,Bou892T,"-37.8204637, 144.94126826"
1611420241029,161,2024-10-29,14,96,107,203,BirArt1109_T,"-37.81851276, 144.97131336"
1232120250101,123,2025-01-01,21,6,0,6,BirBridge_T,"-37.81753741, 144.97329734"
1231820250613,123,2025-06-13,18,7,0,7,BirBridge_T,"-37.81753741, 144.97329734"
109920250311,109,2025-03-11,9,105,419,524,LatWill_T,"-37.81193681, 144.95621105"
1092120240414,109,2024-04-14,21,34,87,121,LatWill_T,"-37.81193681, 144.95621105"
662020250227,66,2025-02-27,20,1297,991,2288,QVN_T,"-37.81057846, 144.96444294"
66420250305,66,2025-03-05,4,10,17,27,QVN_T,"-37.81057846, 144.96444294"
69420240215,69,2024-02-15,4,1,0,1,FLDegC_T,"-37.81687226, 144.96559144"
69720250421,69,2025-04-21,7,36,14,50,FLDegC_T,"-37.81687226, 144.96559144"
41820231129,4,2023-11-29,18,1464,1131,2595,Swa123_T,"-37.81487988, 144.9660878"
701520240322,70,2024-03-22,15,164,140,304,Errol20_T,"-37.80456984, 144.94946228"
8220240131,8,2024-01-31,2,2,2,4,WebBN_T,"-37.82293543, 144.9471751"
8120240414,8,2024-04-14,1,1,1,2,WebBN_T,"-37.82293543, 144.9471751"
411620250704,41,2025-07-04,16,1611,1676,3287,Swa31,"-37.81668634, 144.96689733"
41120231109,41,2023-11-09,1,53,85,138,Swa31,"-37.81668634, 144.96689733"
41320240416,41,2024-04-16,3,22,28,50,Swa31,"-37.81668634, 144.96689733"
77220250210,77,2025-02-10,2,8,1,9,HarEsP_T,"-37.81441438, 144.94433026"
41220250612,4,2025-06-12,12,1696,1288,2984,Swa123_T,"-37.81487988, 144.9660878"
701920240509,70,2024-05-09,19,114,222,336,Errol20_T,"-37.80456984, 144.94946228"
701420240906,70,2024-09-06,14,144,179,323,Errol20_T,"-37.80456984, 144.94946228"
81520240305,8,2024-03-05,15,100,193,293,WebBN_T,"-37.82293543, 144.9471751"
75820250721,75,2025-07-21,8,62,46,108,SprFli_T,"-37.81515276, 144.97467661"
77820241107,77,2024-11-07,8,121,181,302,HarEsP_T,"-37.81441438, 144.94433026"
77520250206,77,2025-02-06,5,12,19,31,HarEsP_T,"-37.81441438, 144.94433026"
42920240704,42,2024-07-04,9,84,72,156,UM1_T,"-37.80008566, 144.96386412"
781520231227,78,2023-12-27,15,47,84,131,HarEsB_T,"-37.81471642, 144.9446508"
592020250307,59,2025-03-07,20,186,414,600,RMIT_T,"-37.80825648, 144.96304859"
65720240208,65,2024-02-08,7,238,96,334,SwaCs_T,"-37.81569416, 144.9668064"
40620241225,40,2024-12-25,6,6,9,15,Spr201_T,"-37.80999341, 144.97227587"
311220231205,31,2023-12-05,12,123,114,237,Lyg161_T,"-37.80169681, 144.96658911"
51420250710,5,2025-07-10,14,931,1012,1943,PriNW_T,"-37.81874249, 144.96787656"
45320251003,45,2025-10-03,3,15,16,31,Swa148_T,"-37.81414075, 144.96609379"
51520250324,5,2025-03-24,15,1089,945,2034,PriNW_T,"-37.81874249, 144.96787656"
361620240125,36,2024-01-25,16,215,193,408,Que85_T,"-37.81652527, 144.96121062"
108120241125,108,2024-11-25,1,15,14,29,261Will_T,"-37.81295822, 144.95678789"
871620240815,87,2024-08-15,16,99,94,193,Errol23_T,"-37.80454949, 144.94921863"
87120241225,87,2024-12-25,1,2,2,4,Errol23_T,"-37.80454949, 144.94921863"
502220250209,50,2025-02-09,22,60,23,83,Lyg309_T,"-37.79808192, 144.96721013"
251420240116,25,2024-01-16,14,0,0,0,MCEC_T,"-37.82401776, 144.95604426"
20320250115,20,2025-01-15,3,10,3,13,LtB170_T,"-37.81172914, 144.9682466"
201620240224,20,2024-02-24,16,390,478,868,LtB170_T,"-37.81172914, 144.9682466"
19720250929,19,2025-09-29,7,32,19,51,LtB210_T,"-37.81237202, 144.96550671"
1392020240604,139,2024-06-04,20,20,16,36,Signal1647_T,"-37.81959923, 144.9632832"
1171420240408,117,2024-04-08,14,148,171,319,Fli114F_T,"-37.81629332, 144.97090877"
66720250312,66,2025-03-12,7,104,306,410,QVN_T,"-37.81057846, 144.96444294"
4120241206,4,2024-12-06,1,110,95,205,Swa123_T,"-37.81487988, 144.9660878"
70620240222,70,2024-02-22,6,13,9,22,Errol20_T,"-37.80456984, 144.94946228"
702320250302,70,2025-03-02,23,3,6,9,Errol20_T,"-37.80456984, 144.94946228"
75920240204,75,2024-02-04,9,19,28,47,SprFli_T,"-37.81515276, 144.97467661"
8620250604,8,2025-06-04,6,12,8,20,WebBN_T,"-37.82293543, 144.9471751"
422220240520,42,2024-05-20,22,28,78,106,UM1_T,"-37.80008566, 144.96386412"
711920250611,71,2025-06-11,19,6,13,19,WestWP_T,"-37.81235775, 144.97136962"
291120250529,29,2025-05-29,11,412,506,918,AG_T,"-37.8199817, 144.96872865"
31320250915,31,2025-09-15,3,7,1,8,Lyg161_T,"-37.80169681, 144.96658911"
1081720250921,108,2025-09-21,17,133,106,239,261Will_T,"-37.81295822, 144.95678789"
1081120240913,108,2024-09-13,11,161,266,427,261Will_T,"-37.81295822, 144.95678789"
61220250401,61,2025-04-01,2,9,5,14,RMIT14_T,"-37.80767455, 144.96309114"
611020251010,61,2025-10-10,10,333,642,975,RMIT14_T,"-37.80767455, 144.96309114"
502020240227,50,2024-02-27,20,305,199,504,Lyg309_T,"-37.79808192, 144.96721013"
43620231103,43,2023-11-03,6,30,4,34,UM2_T,"-37.79844526, 144.96411782"
44520250514,44,2025-05-14,5,0,1,1,UM3_T,"-37.79698741, 144.96441306"
771120250901,77,2025-09-01,11,120,114,234,HarEsP_T,"-37.81441438, 144.94433026"
78220241005,78,2024-10-05,2,0,3,3,HarEsB_T,"-37.81471642, 144.9446508"
291020240814,29,2024-08-14,10,112,176,288,AG_T,"-37.8199817, 144.96872865"
59720250910,59,2025-09-10,7,186,77,263,RMIT_T,"-37.80825648, 144.96304859"
71620240629,71,2024-06-29,6,5,4,9,WestWP_T,"-37.81235775, 144.97136962"
712220250605,71,2025-06-05,22,24,17,41,WestWP_T,"-37.81235775, 144.97136962"
65020240731,65,2024-07-31,0,80,24,104,SwaCs_T,"-37.81569416, 144.9668064"
28420250609,28,2025-06-09,4,12,8,20,VAC_T,"-37.82129925, 144.96879309"
281420241003,28,2024-10-03,14,892,1135,2027,VAC_T,"-37.82129925, 144.96879309"
29320240530,29,2024-05-30,3,0,2,2,AG_T,"-37.8199817, 144.96872865"
472020240208,47,2024-02-08,20,681,511,1192,Eli250_T,"-37.81258467, 144.9625775"
40120240316,40,2024-03-16,1,28,6,34,Spr201_T,"-37.80999341, 144.97227587"
311820240624,31,2024-06-24,18,154,159,313,Lyg161_T,"-37.80169681, 144.96658911"
361920240119,36,2024-01-19,19,193,130,323,Que85_T,"-37.81652527, 144.96121062"
36420250828,36,2025-08-28,4,2,5,7,Que85_T,"-37.81652527, 144.96121062"
1331420250110,133,2025-01-10,14,477,497,974,Spen229_T,"-37.81531435, 144.95227769"
1071620241025,107,2024-10-25,16,227,144,371,280Will_T,"-37.81246271, 144.95690188"
107320250507,107,2025-05-07,3,1,6,7,280Will_T,"-37.81246271, 144.95690188"
1182320240705,118,2024-07-05,23,16,11,27,Fli114C_T,"-37.81632783, 144.97090512"
108820250514,108,2025-05-14,8,238,2620,2858,261Will_T,"-37.81295822, 144.95678789"
871020250609,87,2025-06-09,10,53,65,118,Errol23_T,"-37.80454949, 144.94921863"
87920231222,87,2023-12-22,9,101,90,191,Errol23_T,"-37.80454949, 144.94921863"
612120240611,61,2024-06-11,21,162,146,308,RMIT14_T,"-37.80767455, 144.96309114"
431920240917,43,2024-09-17,19,80,431,511,UM2_T,"-37.79844526, 144.96411782"
1661620250707,166,2025-07-07,16,71,46,117,Spen484_T,"-37.80896733, 144.94931703"
167820250304,167,2025-03-04,8,27,101,128,Lat526_T,"-37.81304149, 144.95155955"
132820240401,132,2024-04-01,8,62,30,92,King335_T,"-37.81267639, 144.95386444"
131020231121,131,2023-11-21,0,6,0,6,King2_T,"-37.82009057, 144.95758725"
68020240220,68,2024-02-20,0,2,0,2,FLDegN_T,"-37.8168479, 144.96559789"
18320231228,18,2023-12-28,3,1,0,1,Col12_T,"-37.81344862, 144.97305353"
181620240411,18,2024-04-11,16,581,149,730,Col12_T,"-37.81344862, 144.97305353"
62020250819,62,2025-08-19,0,42,33,75,Lat224_T,"-37.80996494, 144.96216521"
111020250629,11,2025-06-29,10,46,63,109,WatCit_T,"-37.81564989, 144.93970694"
122220241202,12,2024-12-02,22,70,72,142,NewQ_T,"-37.81457988, 144.94292398"
76320241002,76,2024-10-02,3,2,0,2,KenMac_T,"-37.79453803, 144.93036194"
762320240119,76,2024-01-19,23,10,5,15,KenMac_T,"-37.79453803, 144.93036194"
511220250723,51,2025-07-23,12,120,109,229,Fra118_T,"-37.80841815, 144.95906316"
522220240119,52,2024-01-19,22,344,216,560,Eli263_T,"-37.81252157, 144.9619401"
25720240520,25,2024-05-20,7,116,346,462,MCEC_T,"-37.82401776, 144.95604426"
201020250113,20,2025-01-13,10,106,100,206,LtB170_T,"-37.81172914, 144.9682466"
201920240302,20,2024-03-02,19,611,640,1251,LtB170_T,"-37.81172914, 144.9682466"
1371320250806,137,2025-08-06,13,35,77,112,BouHbr2353_T,"-37.81894815, 144.94612292"
1391320241123,139,2024-11-23,13,46,55,101,Signal1647_T,"-37.81959923, 144.9632832"
1391820241227,139,2024-12-27,18,88,84,172,Signal1647_T,"-37.81959923, 144.9632832"
1361420231223,136,2023-12-23,14,48,65,113,BirFed1120_T,"-37.8184141, 144.97357915"
1361020241004,136,2024-10-04,10,30,40,70,BirFed1120_T,"-37.8184141, 144.97357915"
136920241016,136,2024-10-16,9,85,77,162,BirFed1120_T,"-37.8184141, 144.97357915"
1171720250526,117,2025-05-26,17,174,328,502,Fli114F_T,"-37.81629332, 144.97090877"
691020250707,69,2025-07-07,10,270,219,489,FLDegC_T,"-37.81687226, 144.96559144"
841320231028,84,2023-10-28,13,989,1125,2114,ElFi_T,"-37.81798049, 144.96503383"
84820240301,84,2024-03-01,8,1121,383,1504,ElFi_T,"-37.81798049, 144.96503383"
84720240927,84,2024-09-27,7,202,179,381,ElFi_T,"-37.81798049, 144.96503383"
1671820250407,167,2025-04-07,18,23,63,86,Lat526_T,"-37.81304149, 144.95155955"
1311520231022,131,2023-10-22,15,147,61,208,King2_T,"-37.82009057, 144.95758725"
143420241124,143,2024-11-24,4,26,10,36,Spencer_T,"-37.821728, 144.95557015"
1322220240730,132,2024-07-30,22,66,44,110,King335_T,"-37.81267639, 144.95386444"
1351420240727,135,2024-07-27,14,391,280,671,Spen161_T,"-37.8172861, 144.95319102"
1352220240715,135,2024-07-15,22,1,2,3,Spen161_T,"-37.8172861, 144.95319102"
107120231202,107,2023-12-02,1,28,8,36,280Will_T,"-37.81246271, 144.95690188"
66820250512,66,2025-05-12,8,236,555,791,QVN_T,"-37.81057846, 144.96444294"
66720241117,66,2024-11-17,7,30,52,82,QVN_T,"-37.81057846, 144.96444294"
661620241224,66,2024-12-24,16,1419,1565,2984,QVN_T,"-37.81057846, 144.96444294"
691720240213,69,2024-02-13,17,122,128,250,FLDegC_T,"-37.81687226, 144.96559144"
842220241228,84,2024-12-28,22,628,688,1316,ElFi_T,"-37.81798049, 144.96503383"
31520241123,3,2024-11-23,15,896,907,1803,Swa295_T,"-37.81101524, 144.96429485"
1520241220,1,2024-12-20,5,3,13,16,Bou292_T,"-37.81349441, 144.96515323"
18820240923,18,2024-09-23,8,78,1054,1132,Col12_T,"-37.81344862, 144.97305353"
631020231129,63,2023-11-29,10,165,212,377,Bou231_T,"-37.81333081, 144.96675571"
861420250730,86,2025-07-30,14,63,70,133,574Qub_T,"-37.80309992, 144.94908064"
11920231216,11,2023-12-16,9,63,66,129,WatCit_T,"-37.81564989, 144.93970694"
241220241023,24,2024-10-23,12,878,861,1739,Col620_T,"-37.81887963, 144.95449198"
76520240602,76,2024-06-02,5,0,1,1,KenMac_T,"-37.79453803, 144.93036194"
721820240722,72,2024-07-22,18,114,274,388,ACMI_T,"-37.81726338, 144.96872809"
35720241029,35,2024-10-29,7,500,819,1319,SouthB_T,"-37.82018685, 144.96508508"
21920250306,2,2025-03-06,19,358,431,789,Bou283_T,"-37.81380668, 144.96516718"
58620250414,58,2025-04-14,6,231,44,275,Bou688_T,"-37.81686075, 144.95358075"
792120240821,79,2024-08-21,21,235,226,461,FliSS_T,"-37.81794046, 144.96616678"
23620241109,23,2024-11-09,6,18,24,42,Col623_T,"-37.81909256, 144.95452748"
23920250113,23,2025-01-13,9,220,156,376,Col623_T,"-37.81909256, 144.95452748"
461220250116,46,2025-01-16,12,82,83,165,Pel147_T,"-37.80240719, 144.9615673"
511820250128,51,2025-01-28,18,97,102,199,Fra118_T,"-37.80841815, 144.95906316"
511620240602,51,2024-06-02,16,186,126,312,Fra118_T,"-37.80841815, 144.95906316"
491220231229,49,2023-12-29,12,391,704,1095,Eli501_T,"-37.80730068, 144.95956055"
19020250217,19,2025-02-17,0,51,94,145,LtB210_T,"-37.81237202, 144.96550671"
482220240329,48,2024-03-29,22,64,82,146,QVMQ_T,"-37.80631581, 144.95866697"
30020250930,30,2025-09-30,0,30,51,81,Lon189_T,"-37.8112185, 144.96656806"
1371520251016,137,2025-10-16,15,39,132,171,BouHbr2353_T,"-37.81894815, 144.94612292"
1411120241228,141,2024-12-28,11,200,151,351,474Fl_T,"-37.81997273, 144.95834911"
142520240607,142,2024-06-07,5,8,2,10,Hammer1584_T,"-37.81970749, 144.96795734"
161120250101,161,2025-01-01,1,429,379,808,BirArt1109_T,"-37.81851276, 144.97131336"
1381420240802,138,2024-08-02,14,4,8,12,EntPark1671_T,"-37.81996544, 144.95981454"
1231020240815,123,2024-08-15,10,7,0,7,BirBridge_T,"-37.81753741, 144.97329734"
491220240530,49,2024-05-30,12,338,503,841,Eli501_T,"-37.80730068, 144.95956055"
109220241230,109,2024-12-30,2,8,6,14,LatWill_T,"-37.81193681, 144.95621105"
109220250202,109,2025-02-02,2,7,12,19,LatWill_T,"-37.81193681, 144.95621105"
662320231207,66,2023-12-07,23,269,176,445,QVN_T,"-37.81057846, 144.96444294"
661020240502,66,2024-05-02,10,478,495,973,QVN_T,"-37.81057846, 144.96444294"
662020250209,66,2025-02-09,20,660,577,1237,QVN_T,"-37.81057846, 144.96444294"
66720241014,66,2024-10-14,7,86,196,282,QVN_T,"-37.81057846, 144.96444294"
661620241120,66,2024-11-20,16,1254,1340,2594,QVN_T,"-37.81057846, 144.96444294"
66020231024,66,2023-10-24,0,63,44,107,QVN_T,"-37.81057846, 144.96444294"
41520250124,4,2025-01-24,15,1700,1564,3264,Swa123_T,"-37.81487988, 144.9660878"
392320241123,39,2024-11-23,23,10,16,26,AlfPl_T,"-37.81379749, 144.96995745"
39020250910,39,2025-09-10,0,0,4,4,AlfPl_T,"-37.81379749, 144.96995745"
772020241026,77,2024-10-26,20,189,186,375,HarEsP_T,"-37.81441438, 144.94433026"
782220250327,78,2025-03-27,22,17,101,118,HarEsB_T,"-37.81471642, 144.9446508"
141620240625,14,2024-06-25,16,639,176,815,SanBri_T,"-37.82011242, 144.96291897"
29920250925,29,2025-09-25,9,114,105,219,AG_T,"-37.8199817, 144.96872865"
29520241111,29,2024-11-11,5,12,24,36,AG_T,"-37.8199817, 144.96872865"
31520240229,31,2024-02-29,5,17,11,28,Lyg161_T,"-37.80169681, 144.96658911"
361720250219,36,2025-02-19,17,323,288,611,Que85_T,"-37.81652527, 144.96121062"
372320250806,37,2025-08-06,23,26,32,58,Lyg260_T,"-37.80107122, 144.96704554"
851120231122,85,2023-11-22,11,67,61,128,488Mac_T,"-37.79432415, 144.92973378"
851920231217,85,2023-12-17,19,55,56,111,488Mac_T,"-37.79432415, 144.92973378"
851720250326,85,2025-03-26,17,74,128,202,488Mac_T,"-37.79432415, 144.92973378"
181020240110,18,2024-01-10,10,138,205,343,Col12_T,"-37.81344862, 144.97305353"
18720250627,18,2025-06-27,7,23,204,227,Col12_T,"-37.81344862, 144.97305353"
682320240109,68,2024-01-09,23,16,5,21,FLDegN_T,"-37.8168479, 144.96559789"
671220241011,67,2024-10-11,12,550,846,1396,FLDegS_T,"-37.81688755, 144.96562569"
67920250216,67,2025-02-16,9,109,157,266,FLDegS_T,"-37.81688755, 144.96562569"
62620240317,62,2024-03-17,6,64,20,84,Lat224_T,"-37.80996494, 144.96216521"
62020250319,62,2025-03-19,0,88,63,151,Lat224_T,"-37.80996494, 144.96216521"
561920240203,56,2024-02-03,19,253,379,632,Lon364_T,"-37.81234775, 144.96153311"
56520240411,56,2024-04-11,5,10,4,14,Lon364_T,"-37.81234775, 144.96153311"
861520231216,86,2023-12-16,15,40,47,87,574Qub_T,"-37.80309992, 144.94908064"
1320251008,1,2025-10-08,3,5,10,15,Bou292_T,"-37.81349441, 144.96515323"
121420231029,12,2023-10-29,14,1429,1378,2807,NewQ_T,"-37.81457988, 144.94292398"
12720251007,12,2025-10-07,7,140,74,214,NewQ_T,"-37.81457988, 144.94292398"
562320250713,56,2025-07-13,23,21,62,83,Lon364_T,"-37.81234775, 144.96153311"
56920251016,56,2025-10-16,9,173,161,334,Lon364_T,"-37.81234775, 144.96153311"
58920251010,58,2025-10-10,9,866,163,1029,Bou688_T,"-37.81686075, 144.95358075"
581520250806,58,2025-08-06,15,545,589,1134,Bou688_T,"-37.81686075, 144.95358075"
92020240514,9,2024-05-14,20,125,47,172,Col700_T,"-37.81982992, 144.95102555"
2120250527,2,2025-05-27,1,0,2,2,Bou283_T,"-37.81380668, 144.96516718"
272120231228,27,2023-12-28,21,75,47,122,Vic_T,"-37.80606888, 144.95644692"
271720240224,27,2024-02-24,17,136,104,240,Vic_T,"-37.80606888, 144.95644692"
531720250125,53,2025-01-25,17,538,383,921,Col254_T,"-37.81564191, 144.965499"
532020240808,53,2024-08-08,20,179,247,426,Col254_T,"-37.81564191, 144.965499"
19320241019,19,2024-10-19,3,45,43,88,LtB210_T,"-37.81237202, 144.96550671"
482320240401,48,2024-04-01,23,17,12,29,QVMQ_T,"-37.80631581, 144.95866697"
481220240827,48,2024-08-27,12,288,330,618,QVMQ_T,"-37.80631581, 144.95866697"
1802120250927,180,2025-09-27,21,11,4,15,Mac330_T,"-37.79497059, 144.93530329"
1392320250121,139,2025-01-21,23,7,16,23,Signal1647_T,"-37.81959923, 144.9632832"
1611720250214,161,2025-02-14,17,171,130,301,BirArt1109_T,"-37.81851276, 144.97131336"
1642320240910,164,2024-09-10,23,9,30,39,Lat526_T,"-37.813005, 144.95160411"
441820240207,44,2024-02-07,18,34,9,43,UM3_T,"-37.79698741, 144.96441306"
44220240409,44,2024-04-09,2,1,0,1,UM3_T,"-37.79698741, 144.96441306"
441920240630,44,2024-06-30,19,6,10,16,UM3_T,"-37.79698741, 144.96441306"
212220240214,21,2024-02-14,22,357,372,729,Bourke155_T,"-37.81267313, 144.96788288"
21420240525,21,2024-05-25,4,8,14,22,Bourke155_T,"-37.81267313, 144.96788288"
1321620251006,132,2025-10-06,16,162,188,350,King335_T,"-37.81267639, 144.95386444"
1071820231019,107,2023-10-19,18,134,150,284,280Will_T,"-37.81246271, 144.95690188"
1651320250225,165,2025-02-25,13,39,35,74,Spen475_T,"-37.80953359, 144.94939004"
1622220250624,162,2025-06-24,22,60,50,110,Eli489_T,"-37.80740397, 144.95987909"
1621520250902,162,2025-09-02,15,236,484,720,Eli489_T,"-37.80740397, 144.95987909"
1621020250106,162,2025-01-06,10,61,80,141,Eli489_T,"-37.80740397, 144.95987909"
162120250420,162,2025-04-20,1,66,52,118,Eli489_T,"-37.80740397, 144.95987909"
1071020231125,107,2023-11-25,10,107,105,212,280Will_T,"-37.81246271, 144.95690188"
1322220231219,132,2023-12-19,22,77,57,134,King335_T,"-37.81267639, 144.95386444"
134220241220,134,2024-12-20,2,21,18,39,Spen201_T,"-37.81694221, 144.95303935"
1071720240922,107,2024-09-22,17,61,93,154,280Will_T,"-37.81246271, 144.95690188"
133520250510,133,2025-05-10,5,33,62,95,Spen229_T,"-37.81531435, 144.95227769"
1331420231217,133,2023-12-17,14,407,504,911,Spen229_T,"-37.81531435, 144.95227769"
1241520250427,124,2025-04-27,15,5,11,16,BirBridge_T,"-37.81757416, 144.97329934"
17620240204,17,2024-02-04,6,14,15,29,Col15_T,"-37.81362543, 144.97323591"
18820240304,18,2024-03-04,8,74,1240,1314,Col12_T,"-37.81344862, 144.97305353"
18220240209,18,2024-02-09,2,0,1,1,Col12_T,"-37.81344862, 144.97305353"
63220250618,63,2025-06-18,2,0,14,14,Bou231_T,"-37.81333081, 144.96675571"
10520231231,10,2023-12-31,5,2,0,2,BouHbr_T,"-37.81876474, 144.94710545"
10320250320,10,2025-03-20,3,2,2,4,BouHbr_T,"-37.81876474, 144.94710545"
721920250203,72,2025-02-03,19,38,93,131,ACMI_T,"-37.81726338, 144.96872809"
721120231210,72,2023-12-10,11,380,656,1036,ACMI_T,"-37.81726338, 144.96872809"
762020250115,76,2025-01-15,20,12,27,39,KenMac_T,"-37.79453803, 144.93036194"
761220250214,76,2025-02-14,12,108,55,163,KenMac_T,"-37.79453803, 144.93036194"
351220251015,35,2025-10-15,12,1366,1315,2681,SouthB_T,"-37.82018685, 144.96508508"
58720250524,58,2025-05-24,7,107,43,150,Bou688_T,"-37.81686075, 144.95358075"
792320250201,79,2025-02-01,23,192,262,454,FliSS_T,"-37.81794046, 144.96616678"
531620240705,53,2024-07-05,16,702,638,1340,Col254_T,"-37.81564191, 144.965499"
79820250804,79,2025-08-04,8,362,241,603,FliSS_T,"-37.81794046, 144.96616678"
462120250807,46,2025-08-07,21,1,0,1,Pel147_T,"-37.80240719, 144.9615673"
52920231106,52,2023-11-06,9,150,237,387,Eli263_T,"-37.81252157, 144.9619401"
191620250808,19,2025-08-08,16,571,415,986,LtB210_T,"-37.81237202, 144.96550671"
191620240701,19,2024-07-01,16,488,331,819,LtB210_T,"-37.81237202, 144.96550671"
171420240106,17,2024-01-06,14,171,108,279,Col15_T,"-37.81362543, 144.97323591"
68020240117,68,2024-01-17,0,4,3,7,FLDegN_T,"-37.8168479, 144.96559789"
181820231031,18,2023-10-31,18,280,87,367,Col12_T,"-37.81344862, 144.97305353"
181820241225,18,2024-12-25,18,37,17,54,Col12_T,"-37.81344862, 144.97305353"
181420250313,18,2025-03-13,14,308,180,488,Col12_T,"-37.81344862, 144.97305353"
671020240806,67,2024-08-06,10,319,417,736,FLDegS_T,"-37.81688755, 144.96562569"
62820241126,62,2024-11-26,8,47,101,148,Lat224_T,"-37.80996494, 144.96216521"
561120240526,56,2024-05-26,11,284,156,440,Lon364_T,"-37.81234775, 144.96153311"
862120240130,86,2024-01-30,21,20,32,52,574Qub_T,"-37.80309992, 144.94908064"
86520250827,86,2025-08-27,5,0,3,3,574Qub_T,"-37.80309992, 144.94908064"
241120250711,24,2025-07-11,11,909,461,1370,Col620_T,"-37.81887963, 144.95449198"
531020240801,53,2024-08-01,10,456,338,794,Col254_T,"-37.81564191, 144.965499"
511920240203,51,2024-02-03,19,159,79,238,Fra118_T,"-37.80841815, 144.95906316"
23420240212,23,2024-02-12,4,6,0,6,Col623_T,"-37.81909256, 144.95452748"
461020231203,46,2023-12-03,10,20,17,37,Pel147_T,"-37.80240719, 144.9615673"
52520240102,52,2024-01-02,5,14,10,24,Eli263_T,"-37.81252157, 144.9619401"
49520250120,49,2025-01-20,5,26,29,55,Eli501_T,"-37.80730068, 144.95956055"
491920241016,49,2024-10-16,19,390,437,827,Eli501_T,"-37.80730068, 144.95956055"
19820250406,19,2025-04-06,8,37,35,72,LtB210_T,"-37.81237202, 144.96550671"
43220240815,43,2024-08-15,2,11,6,17,UM2_T,"-37.79844526, 144.96411782"
431320250430,43,2025-04-30,13,276,340,616,UM2_T,"-37.79844526, 144.96411782"
70120241001,70,2024-10-01,1,0,1,1,Errol20_T,"-37.80456984, 144.94946228"
182720251002,182,2025-10-02,7,64,65,129,King163_T,"-37.81627451, 144.95550503"
166520250816,166,2025-08-16,5,1,1,2,Spen484_T,"-37.80896733, 144.94931703"
1622320250112,162,2025-01-12,23,97,56,153,Eli489_T,"-37.80740397, 144.95987909"
1621720240704,162,2024-07-04,17,195,310,505,Eli489_T,"-37.80740397, 144.95987909"
132920241104,132,2024-11-04,9,105,61,166,King335_T,"-37.81267639, 144.95386444"
132120240211,132,2024-02-11,1,54,30,84,King335_T,"-37.81267639, 144.95386444"
1342220231205,134,2023-12-05,22,195,221,416,Spen201_T,"-37.81694221, 144.95303935"
135020250426,135,2025-04-26,0,27,52,79,Spen161_T,"-37.8172861, 144.95319102"
17620251001,17,2025-10-01,6,158,40,198,Col15_T,"-37.81362543, 144.97323591"
1720250715,1,2025-07-15,7,77,109,186,Bou292_T,"-37.81349441, 144.96515323"
56620250325,56,2025-03-25,6,25,40,65,Lon364_T,"-37.81234775, 144.96153311"
861220240125,86,2024-01-25,12,69,80,149,574Qub_T,"-37.80309992, 144.94908064"
86820240613,86,2024-06-13,8,48,22,70,574Qub_T,"-37.80309992, 144.94908064"
241820250801,24,2025-08-01,18,619,975,1594,Col620_T,"-37.81887963, 144.95449198"
721420240318,72,2024-03-18,14,132,276,408,ACMI_T,"-37.81726338, 144.96872809"
58320240614,58,2024-06-14,3,7,14,21,Bou688_T,"-37.81686075, 144.95358075"
301920240930,30,2024-09-30,19,235,356,591,Lon189_T,"-37.8112185, 144.96656806"
301420240121,30,2024-01-21,14,320,486,806,Lon189_T,"-37.8112185, 144.96656806"
30320240123,30,2024-01-23,3,2,9,11,Lon189_T,"-37.8112185, 144.96656806"
792220250817,79,2025-08-17,22,101,168,269,FliSS_T,"-37.81794046, 144.96616678"
23720250131,23,2025-01-31,7,153,131,284,Col623_T,"-37.81909256, 144.95452748"
232320250329,23,2025-03-29,23,58,86,144,Col623_T,"-37.81909256, 144.95452748"
301720241007,30,2024-10-07,17,261,345,606,Lon189_T,"-37.8112185, 144.96656806"
511320250215,51,2025-02-15,13,127,131,258,Fra118_T,"-37.80841815, 144.95906316"
481020231127,48,2023-11-27,10,162,96,258,QVMQ_T,"-37.80631581, 144.95866697"
46120240623,46,2024-06-23,1,4,13,17,Pel147_T,"-37.80240719, 144.9615673"
136020241031,136,2024-10-31,0,2,0,2,BirFed1120_T,"-37.8184141, 144.97357915"
1301020240314,130,2024-03-14,10,22,18,40,Bou892T,"-37.8204637, 144.94126826"
1611920250813,161,2025-08-13,19,2,2,4,BirArt1109_T,"-37.81851276, 144.97131336"
123720250331,123,2025-03-31,7,30,8,38,BirBridge_T,"-37.81753741, 144.97329734"
1232320250630,123,2025-06-30,23,1,0,1,BirBridge_T,"-37.81753741, 144.97329734"
1171320240121,117,2024-01-21,13,222,267,489,Fli114F_T,"-37.81629332, 144.97090877"
1171420240429,117,2024-04-29,14,104,123,227,Fli114F_T,"-37.81629332, 144.97090877"
109620240818,109,2024-08-18,6,12,10,22,LatWill_T,"-37.81193681, 144.95621105"
671120240402,67,2024-04-02,11,326,433,759,FLDegS_T,"-37.81688755, 144.96562569"
67120240912,67,2024-09-12,1,7,11,18,FLDegS_T,"-37.81688755, 144.96562569"
661220241111,66,2024-11-11,12,842,1138,1980,QVN_T,"-37.81057846, 144.96444294"
691720231121,69,2023-11-21,17,142,156,298,FLDegC_T,"-37.81687226, 144.96559144"
84320250619,84,2025-06-19,3,12,13,25,ElFi_T,"-37.81798049, 144.96503383"
41120240722,4,2024-07-22,11,912,632,1544,Swa123_T,"-37.81487988, 144.9660878"
4520250803,4,2025-08-03,5,43,29,72,Swa123_T,"-37.81487988, 144.9660878"
3820240405,3,2024-04-05,8,158,299,457,Swa295_T,"-37.81101524, 144.96429485"
31620240812,3,2024-08-12,16,1116,1301,2417,Swa295_T,"-37.81101524, 144.96429485"
3720241101,3,2024-11-01,7,67,84,151,Swa295_T,"-37.81101524, 144.96429485"
201820240413,20,2024-04-13,18,884,727,1611,LtB170_T,"-37.81172914, 144.9682466"
1412120241011,141,2024-10-11,21,121,129,250,474Fl_T,"-37.81997273, 144.95834911"
1392120241017,139,2024-10-17,21,16,10,26,Signal1647_T,"-37.81959923, 144.9632832"
136620250613,136,2025-06-13,6,8,1,9,BirFed1120_T,"-37.8184141, 144.97357915"
1421020250524,142,2025-05-24,10,365,339,704,Hammer1584_T,"-37.81970749, 144.96795734"
1301220240609,130,2024-06-09,12,18,29,47,Bou892T,"-37.8204637, 144.94126826"
1641720250623,164,2025-06-23,17,127,98,225,Lat526_T,"-37.813005, 144.95160411"
1231320250419,123,2025-04-19,13,36,30,66,BirBridge_T,"-37.81753741, 144.97329734"
1302320240919,130,2024-09-19,23,0,1,1,Bou892T,"-37.8204637, 144.94126826"
69920241231,69,2024-12-31,9,151,95,246,FLDegC_T,"-37.81687226, 144.96559144"
69720250714,69,2025-07-14,7,76,30,106,FLDegC_T,"-37.81687226, 144.96559144"
691620250820,69,2025-08-20,16,151,216,367,FLDegC_T,"-37.81687226, 144.96559144"
841020250131,84,2025-01-31,10,746,548,1294,ElFi_T,"-37.81798049, 144.96503383"
661920240130,66,2024-01-30,19,817,678,1495,QVN_T,"-37.81057846, 144.96444294"
32020241019,3,2024-10-19,20,904,1084,1988,Swa295_T,"-37.81101524, 144.96429485"
39620240602,39,2024-06-02,6,9,4,13,AlfPl_T,"-37.81379749, 144.96995745"
411420250515,41,2025-05-15,14,343,315,658,Swa31,"-37.81668634, 144.96689733"
771620240327,77,2024-03-27,16,210,145,355,HarEsP_T,"-37.81441438, 144.94433026"
422020240910,42,2024-09-10,20,84,197,281,UM1_T,"-37.80008566, 144.96386412"
77420240122,77,2024-01-22,4,1,2,3,HarEsP_T,"-37.81441438, 144.94433026"
711920250109,71,2025-01-09,19,16,14,30,WestWP_T,"-37.81235775, 144.97136962"
591220250406,59,2025-04-06,12,391,330,721,RMIT_T,"-37.80825648, 144.96304859"
40620250410,40,2025-04-10,6,33,38,71,Spr201_T,"-37.80999341, 144.97227587"
371620241116,37,2024-11-16,16,53,89,142,Lyg260_T,"-37.80107122, 144.96704554"
471620250304,47,2025-03-04,16,987,812,1799,Eli250_T,"-37.81258467, 144.9625775"
45120240619,45,2024-06-19,1,14,25,39,Swa148_T,"-37.81414075, 144.96609379"
452120240808,45,2024-08-08,21,205,537,742,Swa148_T,"-37.81414075, 144.96609379"
1081920251005,108,2025-10-05,19,99,97,196,261Will_T,"-37.81295822, 144.95678789"
612320241019,61,2024-10-19,23,280,135,415,RMIT14_T,"-37.80767455, 144.96309114"
441420240426,44,2024-04-26,14,124,97,221,UM3_T,"-37.79698741, 144.96441306"
441220241227,44,2024-12-27,12,33,24,57,UM3_T,"-37.79698741, 144.96441306"
1821920250929,182,2025-09-29,19,269,247,516,King163_T,"-37.81627451, 144.95550503"
1661720241010,166,2024-10-10,17,80,67,147,Spen484_T,"-37.80896733, 144.94931703"
167720250123,167,2025-01-23,7,23,62,85,Lat526_T,"-37.81304149, 144.95155955"
1401920250324,140,2025-03-24,19,67,60,127,Boyd2837_T,"-37.82590962, 144.96185972"
143920241002,143,2024-10-02,9,111,201,312,Spencer_T,"-37.821728, 144.95557015"
143520241219,143,2024-12-19,5,19,30,49,Spencer_T,"-37.821728, 144.95557015"
132720240820,132,2024-08-20,7,29,17,46,King335_T,"-37.81267639, 144.95386444"
135220241210,135,2024-12-10,2,18,15,33,Spen161_T,"-37.8172861, 144.95319102"
135420250704,135,2025-07-04,4,19,10,29,Spen161_T,"-37.8172861, 144.95319102"
1181320250914,118,2025-09-14,13,14,15,29,Fli114C_T,"-37.81632783, 144.97090512"
61620241219,6,2024-12-19,16,1986,1233,3219,FliS_T,"-37.81911705, 144.96558255"
84720240323,84,2024-03-23,7,181,191,372,ElFi_T,"-37.81798049, 144.96503383"
701920240405,70,2024-04-05,19,159,218,377,Errol20_T,"-37.80456984, 144.94946228"
31520240627,3,2024-06-27,15,989,1068,2057,Swa295_T,"-37.81101524, 144.96429485"
82220250903,8,2025-09-03,22,5,10,15,WebBN_T,"-37.82293543, 144.9471751"
81120231021,8,2023-10-21,11,156,245,401,WebBN_T,"-37.82293543, 144.9471751"
751920241202,75,2024-12-02,19,24,30,54,SprFli_T,"-37.81515276, 144.97467661"
75120240819,75,2024-08-19,1,6,3,9,SprFli_T,"-37.81515276, 144.97467661"
591620240819,59,2024-08-19,16,1144,1602,2746,RMIT_T,"-37.80825648, 144.96304859"
542220240510,54,2024-05-10,22,65,141,206,Swa607_T,"-37.804024, 144.96308399"
47920240402,47,2024-04-02,9,234,499,733,Eli250_T,"-37.81258467, 144.9625775"
